name,gender,ratio,females,males,total
Davontre,M,100,0,46,46
Mythias,M,100,0,51,51
Graven,M,100,0,5,5
Aleksandr,M,100,0,1117,1117
Ellasophia,F,100,5,0,5
Eriyah,F,100,46,0,46
Kate,F,100,60740,77,60817
Dinora,F,100,730,0,730
Jode,F,85,146,25,171
Caspian,M,100,0,509,509
Cassiana,F,100,33,0,33
Qadree,M,100,0,24,24
Zaory,F,100,6,0,6
Elimelech,M,100,0,727,727
Knoelle,F,100,22,0,22
Belkis,F,100,381,0,381
Alinda,F,100,413,0,413
Vincetta,F,100,11,0,11
Landen,M,99,162,20889,21051
Nilay,M,98,5,207,212
Ruth,F,100,143880,490,144370
Ashanti,F,94,11135,756,11891
Ivyona,F,100,30,0,30
Perris,M,62,107,174,281
Bahiyah,F,100,6,0,6
Pong,M,100,0,21,21
Lameria,F,100,15,0,15
Ganiya,F,100,25,0,25
Kingmichael,M,100,0,7,7
Omiyah,F,100,11,0,11
Arlander,M,100,0,41,41
Shaniki,F,100,5,0,5
Reshia,F,100,5,0,5
Tyres,M,100,0,45,45
Omara,F,100,179,0,179
Jamesryan,M,100,0,23,23
Lois,F,99,55835,370,56205
Sybrena,F,100,5,0,5
Daler,M,100,0,11,11
Baya,F,100,280,0,280
Jovone,M,100,0,5,5
Joyclyn,F,100,75,0,75
Adrainne,F,100,13,0,13
Taritha,F,100,5,0,5
Jamese,F,100,748,0,748
Kialee,F,100,78,0,78
Lycia,F,100,71,0,71
Wryder,M,100,0,18,18
Kateisha,F,100,26,0,26
Crisanto,M,100,0,186,186
Darrean,F,53,18,16,34
Kemarah,F,100,8,0,8
Natally,F,100,389,0,389
Danae,F,100,6300,6,6306
Ensign,M,100,0,5,5
Kimimila,F,100,77,0,77
Donnise,F,100,44,0,44
Gissel,F,100,2307,0,2307
Melba,F,100,6564,0,6564
Arsha,F,77,33,10,43
Fenley,F,100,5,0,5
Alita,F,100,1345,0,1345
Joshaun,M,100,0,56,56
Kendrika,F,100,6,0,6
Nanayaa,F,100,41,0,41
Maurisio,M,100,0,310,310
Kamiya,F,100,1894,0,1894
Nyjae,F,100,168,0,168
Amalya,F,100,214,0,214
Tika,F,100,348,0,348
Dorrine,F,100,138,0,138
Demis,M,100,0,10,10
Najon,M,100,0,10,10
Mariaangela,F,100,7,0,7
Sicely,F,100,13,0,13
Marveen,F,100,5,0,5
Lindsley,F,50,15,15,30
Lamart,M,100,0,56,56
Joesiah,M,100,0,334,334
Paras,M,100,0,260,260
Yabriel,M,100,0,5,5
Adrin,M,96,12,288,300
Marvelous,M,75,39,117,156
Starlyn,F,100,613,0,613
Dareen,F,97,297,10,307
Miri,F,100,465,0,465
Laurianna,F,100,24,0,24
Shlomie,M,100,0,107,107
Jasminda,F,100,11,0,11
Leibish,M,100,0,78,78
Lexiee,F,100,5,0,5
Livy,F,100,123,0,123
Bronnie,M,100,0,8,8
Bradan,M,100,0,402,402
Jubei,M,100,0,34,34
Harwood,M,100,0,37,37
Omri,M,98,10,519,529
Tomeco,F,100,21,0,21
Geetha,F,100,23,0,23
Tyndall,F,100,5,0,5
Dkota,M,100,0,5,5
Rotem,F,89,42,5,47
Marisia,F,100,29,0,29
Simitrio,M,100,0,5,5
Haylo,F,100,66,0,66
Peggy,F,100,136360,312,136672
Kamarah,F,100,139,0,139
Leannie,F,100,36,0,36
Devoe,M,100,0,14,14
Roderica,F,100,135,0,135
Francita,F,100,6,0,6
Nadirah,F,100,802,0,802
Maryori,F,100,83,0,83
Jema,F,100,265,0,265
Mashad,M,100,0,6,6
Jayzeon,M,100,0,16,16
Jantel,F,100,5,0,5
Abilyn,F,100,5,0,5
Jeryka,F,100,5,0,5
Asley,F,100,605,0,605
Naysa,F,100,331,0,331
Rodrika,F,100,6,0,6
Flip,M,100,0,5,5
Allyria,F,100,11,0,11
Jissele,F,100,11,0,11
Sarait,F,100,5,0,5
Ashan,M,100,0,130,130
Yarilis,F,100,13,0,13
Breeley,F,100,85,0,85
Militza,F,100,77,0,77
Tashina,F,100,1758,0,1758
Veralynn,F,100,29,0,29
Dolton,M,100,0,253,253
Ciyanna,F,100,22,0,22
Charlsa,F,100,5,0,5
Demeco,M,100,0,65,65
Jeloni,M,100,0,12,12
Caine,M,100,0,1369,1369
Latifah,F,100,1414,0,1414
Lakitta,F,100,20,0,20
Kundana,F,100,5,0,5
Breanne,F,100,10079,0,10079
Margarite,F,100,560,0,560
Keny,M,98,5,203,208
Yaditzel,F,100,6,0,6
Ireion,F,100,6,0,6
Kuwanda,F,100,5,0,5
Ulice,M,100,0,10,10
Timira,F,100,63,0,63
Jakyri,M,100,0,93,93
Deirore,F,100,5,0,5
Deepa,F,100,478,0,478
Milanie,F,100,65,0,65
Brax,M,100,0,125,125
Kennysha,F,100,6,0,6
Estrellita,F,100,957,0,957
Kamirra,F,100,51,0,51
Allisha,F,100,865,0,865
Kayjuan,M,100,0,5,5
Kellyann,F,100,1805,0,1805
Franisco,M,100,0,26,26
Verdell,M,55,568,704,1272
Quontez,M,100,0,12,12
Kearston,F,99,417,6,423
Jeffery,M,99,1189,222663,223852
Dawneisha,F,100,5,0,5
Ulonda,F,100,176,0,176
Lindzy,F,100,204,0,204
Tureka,F,100,11,0,11
Jovan,M,89,1079,8686,9765
Kendon,M,100,0,680,680
Mikiah,F,77,393,116,509
Dannielyn,F,100,6,0,6
Paying,F,100,25,0,25
Hailen,F,100,26,0,26
Jaeshon,M,100,0,32,32
Rogers,M,100,10,2668,2678
Wilisha,F,100,5,0,5
Vernessia,F,100,15,0,15
Ricki,F,64,3706,2120,5826
Moxley,M,100,0,11,11
Delwood,M,100,0,5,5
Pualani,F,100,102,0,102
Shahan,M,100,0,179,179
Monterey,F,100,6,0,6
Ymari,F,100,17,0,17
Deilani,F,100,5,0,5
Ezperanza,F,100,13,0,13
Said,M,100,0,2180,2180
Josabet,F,100,5,0,5
Shanetha,F,100,113,0,113
Celio,M,100,0,22,22
Evelise,F,100,54,0,54
Tertia,F,100,10,0,10
Arlana,F,100,494,0,494
Tajohn,M,100,0,29,29
Rondez,M,100,0,5,5
Steffan,M,100,0,1316,1316
Julianys,F,100,19,0,19
Aliyssa,F,100,7,0,7
Arminda,F,100,825,0,825
Khair,M,100,0,43,43
Delonda,F,100,296,0,296
Shaqualia,F,100,16,0,16
Aaren,M,72,282,717,999
Napua,F,100,6,0,6
Daylin,M,58,916,1263,2179
Josei,F,100,5,0,5
Kashlyn,F,100,138,0,138
Marletta,F,100,221,0,221
Brendia,F,100,118,0,118
Jariyah,F,98,566,10,576
Bryttnii,F,100,6,0,6
Saraphine,F,100,10,0,10
Laronte,M,100,0,12,12
Milin,M,100,0,11,11
Leovardo,M,100,0,247,247
Noleen,F,100,5,0,5
Kynndal,F,100,6,0,6
Jedrik,M,100,0,19,19
Apollos,M,100,0,50,50
Tiondra,F,100,82,0,82
Raife,M,100,0,53,53
Keitlyn,F,100,25,0,25
Selebrity,F,100,5,0,5
Shontez,M,100,0,55,55
Lakeshi,F,100,16,0,16
Atanya,F,100,6,0,6
Alyssandra,F,100,622,0,622
Thaissa,F,100,5,0,5
Anahita,F,100,305,0,305
Jasonn,M,100,0,6,6
Nowshin,F,100,11,0,11
Nakeyah,F,100,22,0,22
Markevius,M,100,0,131,131
Chalandra,F,100,15,0,15
Selana,F,100,20,0,20
Mccarty,M,100,0,5,5
Shunna,F,100,76,0,76
Kiara,F,100,45215,221,45436
Emelita,F,100,10,0,10
Quanesia,F,100,7,0,7
Allysandra,F,100,35,0,35
Esmay,F,100,51,0,51
Narcisco,M,100,0,5,5
Soctt,M,100,0,33,33
Hara,F,100,95,0,95
Joelliane,F,100,17,0,17
Louie,M,98,273,11834,12107
Askari,M,100,0,135,135
Carita,F,100,691,0,691
Richad,M,100,0,309,309
Joylynn,F,100,488,0,488
Shmaya,M,100,0,42,42
Kelvontae,M,100,0,11,11
Antenette,F,100,6,0,6
Tyriana,F,100,252,0,252
Damarrion,M,100,0,227,227
Anwan,M,100,0,5,5
Yaresli,F,100,42,0,42
Ysa,F,100,17,0,17
Laquina,F,100,47,0,47
Lafrederick,M,100,0,5,5
Ajanay,F,100,136,0,136
Donalee,F,100,206,0,206
Corutney,F,100,5,0,5
Makaylan,F,100,46,0,46
Helaina,F,100,776,0,776
Ferrari,F,84,38,7,45
Morning,F,100,157,0,157
Leeaira,F,100,11,0,11
Gayleen,F,100,427,0,427
Morine,F,100,12,0,12
Corsica,F,100,86,0,86
Khaleelah,F,100,107,0,107
Jory,M,86,475,2921,3396
Cyara,F,100,246,0,246
Aujanai,F,100,5,0,5
Cheriann,F,100,5,0,5
Janmichael,M,100,0,279,279
Markishia,F,100,5,0,5
Ginevra,F,100,126,0,126
Ebecca,F,100,38,0,38
Able,M,100,0,689,689
Miesha,F,100,2440,0,2440
Dru,M,61,1430,2192,3622
Abenezer,M,100,0,109,109
Ladarryl,M,100,0,62,62
Maruska,F,100,6,0,6
Shellene,F,100,285,0,285
Oberon,M,100,0,39,39
Lavanda,F,100,338,0,338
Rashandra,F,100,16,0,16
Junae,F,100,20,0,20
Onyx,M,63,442,738,1180
Savi,F,100,35,0,35
Afrodita,F,100,16,0,16
Falon,F,96,1801,73,1874
Reagyn,F,100,147,0,147
Maureene,F,100,5,0,5
Alvera,F,100,271,0,271
Taquella,F,100,5,0,5
Zelda,F,100,4104,0,4104
Therion,M,100,0,10,10
Majid,M,100,0,472,472
Jashante,F,100,6,0,6
Lakisa,F,100,263,0,263
Jayzin,M,100,0,12,12
Vinicius,M,100,0,290,290
Shaquandria,F,100,6,0,6
Elin,F,97,2866,85,2951
Shakira,F,100,7998,0,7998
Noble,M,98,68,3049,3117
Sefton,M,100,0,5,5
Jkyla,F,100,6,0,6
Burman,M,100,0,10,10
Kaceon,M,100,0,10,10
Braelen,M,100,0,185,185
Zariyha,F,100,25,0,25
Gerika,F,100,29,0,29
Keshia,F,100,5381,6,5387
Kevi,F,52,11,10,21
Daishon,M,100,0,161,161
Maejor,M,100,0,32,32
Noah,M,100,1492,308452,309944
Sonnet,F,100,248,0,248
Lahna,F,100,281,0,281
Davidjoseph,M,100,0,5,5
Crystale,F,100,203,0,203
Parnika,F,100,113,0,113
Lorel,F,100,217,0,217
Kaisean,M,100,0,6,6
Kelli,F,100,74547,300,74847
Asis,M,100,0,5,5
Vickilyn,F,100,10,0,10
Tkai,F,50,72,72,144
Marielys,F,100,256,0,256
Shourya,M,100,0,140,140
Manroop,F,100,24,0,24
Rb,M,100,0,5,5
Kelynn,F,69,47,21,68
Robynn,F,100,1176,0,1176
Margert,F,100,226,0,226
Shakaylah,F,100,8,0,8
Tyrek,M,100,0,2009,2009
Lerissa,F,100,27,0,27
Lexanie,F,100,6,0,6
Chloejane,F,100,6,0,6
Darenda,F,100,174,0,174
Bryndee,F,100,7,0,7
Quiara,F,100,311,0,311
Likita,F,100,32,0,32
Tatijana,F,100,68,0,68
Akeelah,F,100,1228,0,1228
Munira,F,100,363,0,363
Tyquana,F,100,45,0,45
Joes,M,100,0,5,5
Tamal,M,100,0,16,16
Charrelle,F,100,16,0,16
Darus,M,100,0,84,84
Janelisse,F,100,12,0,12
Gale,F,78,13399,3739,17138
Krik,M,100,0,12,12
Silvya,F,100,10,0,10
Jermanine,M,100,0,16,16
Enari,F,100,5,0,5
Rashieka,F,100,5,0,5
Deron,M,99,35,5431,5466
Keziah,F,98,2469,62,2531
Devra,F,100,712,0,712
Lorett,F,100,15,0,15
Jalay,F,100,11,0,11
Kohle,M,100,0,90,90
Detra,F,100,1996,0,1996
Alarik,M,100,0,58,58
Luchiano,M,100,0,79,79
Felisity,F,100,18,0,18
Danavia,F,100,7,0,7
Anaijah,F,100,153,0,153
Brahian,M,100,0,5,5
Arlette,F,100,3720,0,3720
Sigfredo,M,100,0,251,251
Balal,M,100,0,17,17
Dajuan,M,100,0,3258,3258
Adelynne,F,100,370,0,370
Eldine,F,100,7,0,7
Lakyria,F,100,6,0,6
Siriyah,F,100,37,0,37
Kijuana,F,100,76,0,76
Breck,M,83,380,1838,2218
Miyako,F,100,64,0,64
Sultana,F,100,192,0,192
Aiven,M,100,0,191,191
Keywana,F,100,11,0,11
Kylea,F,100,1428,0,1428
Christine,F,100,466220,1584,467804
Caffie,F,100,78,0,78
Lexe,F,100,5,0,5
Jovina,F,100,49,0,49
Dulani,M,100,0,11,11
Alejondro,M,100,0,6,6
Gerik,M,100,0,104,104
Garred,M,100,0,38,38
Rhoan,M,100,0,21,21
Tamea,F,100,292,0,292
Tabbie,F,100,26,0,26
Anchita,F,100,6,0,6
Kelie,F,100,273,0,273
Sahal,M,100,0,20,20
Meredy,F,100,5,0,5
Dolly,F,100,5930,5,5935
Antuwan,M,100,0,5,5
Jaquashia,F,100,15,0,15
Demetrics,M,100,0,23,23
Keyri,F,100,414,0,414
Mellany,F,100,428,0,428
Izai,M,100,0,37,37
Alexza,F,100,195,0,195
Evannie,F,100,48,0,48
Kazen,M,100,0,29,29
Erhan,M,100,0,5,5
Johnray,M,100,0,15,15
Angelicamae,F,100,7,0,7
Dacari,M,100,0,182,182
Zamora,F,100,412,0,412
Zyona,F,100,96,0,96
Dashown,M,100,0,5,5
Dshaun,M,100,0,268,268
Mandalynn,F,100,27,0,27
Huriel,M,100,0,277,277
Sareniti,F,100,5,0,5
Jazzmen,F,100,488,0,488
Clint,M,100,54,29030,29084
Aashna,F,100,543,0,543
Jme,F,100,5,0,5
Bisola,F,100,5,0,5
Xoaquin,M,100,0,6,6
Jaedan,M,84,83,450,533
Sharryn,F,100,5,0,5
Harly,F,87,152,22,174
Prajin,M,100,0,5,5
Mayeda,F,100,10,0,10
Lindita,F,100,40,0,40
Cissy,F,100,418,0,418
Divin,M,100,0,5,5
Delanny,F,100,43,0,43
Bettyjo,F,100,446,0,446
Starlet,F,100,898,0,898
Lizbeht,F,100,29,0,29
Kortne,F,100,69,0,69
Gerred,M,100,0,43,43
Diyanna,F,100,5,0,5
Nikeisha,F,100,236,0,236
Ilda,F,100,827,0,827
Lawerence,M,100,0,1917,1917
Pheobe,F,100,535,0,535
Forestt,M,100,0,5,5
Dimitra,F,100,782,0,782
Nahyla,F,100,11,0,11
Adika,M,100,0,13,13
Enijah,F,100,158,0,158
Karyle,F,100,10,0,10
Jolyon,M,100,0,31,31
Walta,F,100,19,0,19
Ricarda,F,100,390,0,390
Machael,M,98,5,195,200
Nazirah,F,100,134,0,134
Turney,M,100,0,5,5
Ragad,F,100,24,0,24
Jacqulin,F,100,475,0,475
Dennette,F,100,209,0,209
Kaelie,F,100,636,0,636
Scotia,F,100,24,0,24
Tenli,F,100,23,0,23
Sunem,F,100,17,0,17
Mareyah,F,100,5,0,5
Demeko,M,100,0,32,32
Airah,F,100,7,0,7
Nyier,M,100,0,16,16
Shukriyyah,F,100,12,0,12
Jayrell,M,100,0,8,8
Yecenia,F,100,1230,5,1235
Dequinton,M,100,0,19,19
Nasrin,F,100,68,0,68
Livvie,F,100,33,0,33
Khalee,M,88,10,73,83
Adysyn,F,100,32,0,32
Zelma,F,100,1780,0,1780
Shihab,M,100,0,67,67
Leathia,F,100,20,0,20
Evalin,F,100,87,0,87
Xayla,F,100,56,0,56
Deuce,M,100,0,66,66
Maezy,F,100,5,0,5
Leilia,F,100,17,0,17
Reeca,F,100,12,0,12
Antwanett,F,100,5,0,5
Yonna,F,100,119,0,119
Azaylee,F,100,12,0,12
Nicolino,M,100,0,27,27
Lucya,F,100,5,0,5
Dasian,M,100,0,6,6
Khadidja,F,100,36,0,36
Bryin,M,100,0,16,16
Jeannemarie,F,100,265,0,265
Kyeson,M,100,0,5,5
Tessie,F,100,2399,0,2399
Mackinzi,F,100,26,0,26
Oghosa,F,100,5,0,5
Bartt,M,100,0,115,115
Terase,F,100,10,0,10
Yulissa,F,100,3316,0,3316
Irina,F,100,1212,0,1212
Analie,F,100,292,0,292
Sereniti,F,100,536,0,536
Zubeyr,M,100,0,11,11
Viveka,F,100,87,0,87
Jocasta,F,100,10,0,10
Dujuana,F,100,25,0,25
Cybelle,F,100,26,0,26
Nimrit,F,100,56,0,56
Besim,M,100,0,32,32
Kaveen,M,100,0,5,5
Hildegarde,F,100,86,0,86
Alayn,M,100,0,11,11
Sharonn,F,100,43,0,43
Prithiv,M,100,0,6,6
Toney,M,97,143,4411,4554
Tayna,F,100,874,0,874
Jessiah,M,84,181,975,1156
Leeta,F,100,136,0,136
Gwynda,F,100,10,0,10
Mayka,F,100,20,0,20
Emilianne,F,100,10,0,10
Kodey,M,98,11,658,669
Tyjaun,M,100,0,14,14
Laquesha,F,100,946,0,946
Jashiyah,F,100,13,0,13
Kinika,F,100,10,0,10
Diahann,F,100,353,0,353
Summerrose,F,100,20,0,20
Averyonna,F,100,14,0,14
Saidou,M,100,0,5,5
Maanvi,F,100,30,0,30
Melva,F,100,3978,0,3978
Mystery,F,100,216,0,216
Zarya,F,100,328,0,328
Arhonda,F,100,28,0,28
Eryca,F,100,161,0,161
Nijayah,F,100,11,0,11
Nicholas,M,100,2924,825931,828855
Jacelyn,F,100,2329,0,2329
Tieisha,F,100,90,0,90
Breniya,F,100,131,0,131
Aileene,F,100,81,0,81
Elijah,M,100,986,228696,229682
Simeko,F,100,7,0,7
Esi,F,100,18,0,18
Leim,M,100,0,40,40
Carlea,F,100,291,0,291
Dezjuan,M,100,0,22,22
Yanky,M,100,0,54,54
Lashai,F,100,210,0,210
Burlin,M,100,0,69,69
Mirabai,F,100,16,0,16
Arai,F,100,35,0,35
Amarin,F,50,5,5,10
Padgett,F,100,5,0,5
Anslee,F,100,854,0,854
Irlene,F,100,19,0,19
Brieya,F,100,5,0,5
Jenella,F,100,39,0,39
Jimel,M,100,0,105,105
Montie,M,81,200,856,1056
Celsa,F,100,55,0,55
Junjie,M,100,0,5,5
Tanisha,F,100,18995,21,19016
Ashrit,M,100,0,6,6
Suhaani,F,100,15,0,15
Honie,F,100,7,0,7
Latora,F,100,521,0,521
Broady,M,100,0,83,83
Marria,F,100,81,0,81
Reion,M,100,0,5,5
Amirh,F,100,5,0,5
Canishia,F,100,7,0,7
Theresa,F,100,265451,781,266232
Schenita,F,100,15,0,15
Osaretin,M,100,0,6,6
Jazelle,F,100,1842,0,1842
Kahlin,M,84,11,59,70
Jonnita,F,100,26,0,26
Riad,M,100,0,158,158
Silviano,M,100,0,158,158
Jarade,M,100,0,5,5
Kamry,F,98,717,16,733
Melville,M,100,0,319,319
Yaneth,F,100,786,0,786
Christyann,F,100,68,0,68
Justina,F,100,10347,6,10353
Raeleen,F,100,476,0,476
Rokeisha,F,100,36,0,36
Jackelynn,F,100,121,0,121
Brittania,F,100,402,0,402
Jadonte,M,100,0,5,5
Romelia,F,100,913,0,913
Yissell,F,100,15,0,15
Mahaila,F,100,109,0,109
Bryleah,F,100,5,0,5
Esgar,M,100,0,544,544
Lakynn,F,100,115,0,115
Khi,M,96,7,158,165
Juany,F,100,5,0,5
Biatriz,F,100,21,0,21
Devlon,M,100,0,93,93
Yudiel,M,100,0,6,6
Jossette,F,100,80,0,80
Celyn,F,100,6,0,6
Trayvonne,M,100,0,30,30
Reddington,M,100,0,6,6
Pravallika,F,100,5,0,5
Gwenivere,F,100,296,0,296
Thommy,M,100,0,17,17
Kirke,M,100,0,46,46
Erianne,F,100,23,0,23
Isidoro,M,100,0,835,835
Beaver,M,100,0,19,19
Rannie,M,85,15,87,102
Ogochukwu,F,100,5,0,5
Wyndell,M,100,0,238,238
Aralis,F,100,5,0,5
Lekendrick,M,100,0,193,193
Rozalia,F,100,58,0,58
Branigan,F,56,39,31,70
Jianny,M,100,0,5,5
Lizeth,F,100,7810,9,7819
Raunda,F,100,5,0,5
Jinnie,F,100,237,0,237
Wendie,F,100,1999,0,1999
Hudy,F,100,5,0,5
Lorne,M,99,33,3249,3282
Dylam,M,100,0,10,10
Shawnise,F,100,92,0,92
Adelae,F,100,124,0,124
Benetta,F,100,290,0,290
Jeramiyah,M,100,0,5,5
Kaniala,M,100,0,5,5
Evelinda,F,100,15,0,15
Amandra,F,100,23,0,23
Loey,F,100,17,0,17
Delloyd,M,100,0,5,5
Melik,M,100,0,392,392
Jaclene,F,100,89,0,89
Laylianna,F,100,10,0,10
Vivienna,F,100,5,0,5
Krissi,F,100,341,0,341
Tiffiney,F,100,1040,0,1040
Janica,F,100,579,0,579
Dylynn,F,100,83,0,83
Nolana,F,100,31,0,31
Amarisa,F,100,90,0,90
Perian,F,100,73,0,73
Kyaria,F,100,18,0,18
Latania,F,100,497,0,497
Marelli,F,100,12,0,12
Javiah,F,100,16,0,16
Brisyn,M,100,0,34,34
Corrie,F,84,6167,1142,7309
Kharlee,F,100,12,0,12
Gelen,F,100,5,0,5
Lancing,M,100,0,5,5
Serge,M,100,0,1234,1234
Jodelle,F,100,275,0,275
Garrhett,M,100,0,14,14
Jayln,M,64,226,401,627
Leona,F,100,16693,0,16693
Fantasy,F,100,107,0,107
Devean,M,100,0,198,198
Mathieu,M,100,0,2010,2010
Jermonte,M,100,0,40,40
Lucindy,F,100,130,0,130
Malyn,F,100,137,0,137
Lesi,F,100,19,0,19
Shaharra,F,100,6,0,6
Deriek,M,100,0,11,11
Lajae,F,100,18,0,18
Karras,M,100,0,6,6
Cilia,F,100,48,0,48
Libbey,F,100,108,0,108
Ikher,M,100,0,7,7
Carleen,F,100,4592,0,4592
Sherrena,F,100,10,0,10
Allyza,F,100,5,0,5
Reyona,F,100,13,0,13
Meg,F,100,5119,0,5119
Facundo,M,100,0,133,133
Jernisha,F,100,16,0,16
Jaymian,M,100,0,72,72
Marene,F,100,48,0,48
Idrena,F,100,5,0,5
Harper,F,91,38649,3903,42552
Nadim,M,100,0,323,323
Albie,M,100,0,53,53
Chantrelle,F,100,28,0,28
Delali,F,100,19,0,19
Lashondra,F,100,1096,0,1096
Itzany,F,100,5,0,5
Latosia,F,100,21,0,21
Escarleth,F,100,24,0,24
Mehreen,F,100,310,0,310
Jannette,F,100,3913,0,3913
Shylynn,F,100,320,0,320
Jimere,M,100,0,10,10
Riese,M,65,32,59,91
Quintisha,F,100,43,0,43
Kiersten,F,100,13999,5,14004
Naviya,F,100,39,0,39
Sharlee,F,100,506,0,506
Jyren,M,100,0,83,83
Jamielynn,F,100,516,0,516
Jannessa,F,100,222,0,222
Almedin,M,100,0,25,25
Doug,M,100,5,19737,19742
Sanea,F,100,7,0,7
Barakat,F,100,5,0,5
Tsega,F,100,10,0,10
Chang,M,98,5,302,307
Chiquitha,F,100,5,0,5
Callison,F,100,14,0,14
Uwe,M,100,0,35,35
Nadyah,F,100,60,0,60
Mazlyn,F,100,37,0,37
Twon,M,100,0,5,5
Jaelia,F,100,6,0,6
Jeconiah,M,100,0,7,7
Brnadon,M,100,0,53,53
Ahmyah,F,100,62,0,62
Terr,M,100,0,5,5
Gabina,F,100,25,0,25
Shadonna,F,100,638,0,638
Becky,F,100,76950,139,77089
Ruslan,M,100,0,352,352
Chasmin,F,100,12,0,12
Amriel,F,100,17,0,17
Karlesha,F,100,21,0,21
Cheril,F,100,205,0,205
Nkem,F,100,5,0,5
Schrie,F,100,5,0,5
Dadne,F,100,5,0,5
Zhoe,F,100,102,0,102
Tena,F,100,5587,0,5587
Kailie,F,100,1221,0,1221
Neon,M,100,0,11,11
Bradlyn,M,100,0,15,15
Eleuterio,M,100,0,498,498
Joyce,F,100,187782,649,188431
Joycene,F,100,10,0,10
Delvia,F,100,25,0,25
Oniel,M,100,0,162,162
Dionca,F,100,16,0,16
Sahibdeep,M,100,0,8,8
Makenze,F,100,187,0,187
Robley,M,100,0,89,89
Arnesia,F,100,67,0,67
Adriean,M,100,0,18,18
Sheonna,F,100,12,0,12
Elyssa,F,100,6513,0,6513
Nevah,F,100,183,0,183
Jeanelle,F,100,1727,0,1727
Mukul,M,100,0,13,13
Jasom,M,100,0,10,10
Tishika,F,100,6,0,6
Desrae,F,100,36,0,36
Leoul,M,100,0,5,5
Ayania,F,100,52,0,52
Alizee,F,100,286,0,286
Diondria,F,100,43,0,43
Tallie,F,99,408,5,413
Rokko,M,100,0,10,10
Jabre,M,93,10,126,136
Berdena,F,100,11,0,11
Leteisha,F,100,18,0,18
Ivie,F,98,998,16,1014
Elizebeth,F,100,1835,0,1835
Jumar,M,100,0,138,138
Dayshon,M,100,0,233,233
Ariyonna,F,100,402,0,402
Edwards,M,100,0,198,198
Taniqua,F,100,605,0,605
Brandom,M,100,0,289,289
Koesha,F,100,5,0,5
Tyjanique,F,100,6,0,6
Kaylanicole,F,100,16,0,16
Kaedan,M,98,5,300,305
Jona,F,84,1540,302,1842
Zebidiah,M,100,0,5,5
Devonn,M,95,23,410,433
Farmer,M,100,0,17,17
Lorrina,F,100,55,0,55
Chastelin,F,100,40,0,40
Keyshawn,M,99,24,3646,3670
Dhamar,F,100,71,0,71
Jaquaisha,F,100,6,0,6
Luckey,M,100,0,5,5
Carlianna,F,100,10,0,10
Aniela,F,100,654,0,654
Ronny,M,96,397,10206,10603
Trivia,F,100,160,0,160
Marionette,F,100,67,0,67
Judeah,F,100,5,0,5
Leeandra,F,100,327,0,327
Jaeliana,F,100,148,0,148
Nuri,M,55,191,229,420
Meleta,F,100,12,0,12
Cassander,F,100,24,0,24
Vinia,F,100,12,0,12
Alekza,F,100,17,0,17
Champaign,F,100,23,0,23
Ruari,F,61,87,55,142
Rahiem,M,100,0,552,552
Bocar,M,100,0,11,11
Danine,F,100,291,0,291
Lysette,F,100,762,0,762
Madylyn,F,100,88,0,88
Thomasine,F,100,1042,0,1042
Kodyn,M,100,0,5,5
Cathelene,F,100,18,0,18
Soyini,F,100,59,0,59
Lorine,F,100,1591,0,1591
Arnessa,F,100,32,0,32
Tihara,F,100,5,0,5
Shavante,F,100,32,0,32
Dequantez,M,100,0,5,5
Cassondr,F,100,8,0,8
Kelsee,F,100,1647,0,1647
Arryn,F,93,63,5,68
Makayla,F,100,95097,152,95249
Tinashe,F,50,5,5,10
Jagan,M,100,0,25,25
Brigston,M,100,0,8,8
Jakerria,F,100,163,0,163
Dracy,M,100,0,21,21
Teyler,F,100,18,0,18
Lilium,F,100,35,0,35
Tramarion,M,100,0,19,19
Venture,M,100,0,6,6
Luigino,M,100,0,5,5
Miron,M,100,0,164,164
Melica,F,100,27,0,27
Ryka,F,100,48,0,48
Jazabelle,F,100,9,0,9
Stepfanie,F,100,182,0,182
Chelena,F,100,16,0,16
Akin,M,100,0,268,268
Donnavan,M,100,0,147,147
Jannae,F,100,140,0,140
Kasumi,F,100,70,0,70
Quanda,F,100,502,0,502
Prayash,M,100,0,5,5
Shakendra,F,100,255,0,255
Eloisa,F,100,3224,0,3224
Kaimarie,F,100,6,0,6
Jarien,M,100,0,35,35
Rahaf,F,100,309,0,309
Rutvik,M,100,0,10,10
Lile,F,100,5,0,5
Gerasimos,M,100,0,195,195
Jaykon,M,100,0,5,5
Aadya,F,100,558,0,558
Joslyne,F,100,71,0,71
Jhoel,M,100,0,55,55
Thorpe,M,100,0,6,6
Sabbir,M,100,0,6,6
Tasos,M,100,0,6,6
Mistina,F,100,93,0,93
Yaretcy,F,100,5,0,5
Megean,F,100,174,0,174
Samarria,F,100,54,0,54
Eben,M,100,6,2362,2368
Toya,F,99,3930,23,3953
Ismael,M,100,73,30962,31035
Agnew,M,100,0,5,5
Marticia,F,100,67,0,67
Ansony,M,100,0,5,5
Josianne,F,100,15,0,15
Karionna,F,100,11,0,11
Kadeijah,F,100,15,0,15
Autherine,F,100,46,0,46
Alayiah,F,100,302,0,302
Emerlee,F,100,12,0,12
Rashanique,F,100,6,0,6
Migel,M,100,0,1552,1552
Nischal,M,100,0,39,39
Grover,M,100,0,5297,5297
Maquisha,F,100,10,0,10
Porsche,F,100,2090,0,2090
Tyaisa,F,100,26,0,26
Abelino,M,100,0,515,515
Antwian,M,100,0,70,70
Saun,M,100,0,10,10
Amyre,F,89,98,12,110
Shironda,F,100,83,0,83
Mateus,M,100,0,513,513
Jarquise,M,100,0,22,22
Dajoun,M,100,0,46,46
Jhamir,M,100,0,141,141
Adalee,F,100,1310,0,1310
Jazariyah,F,100,35,0,35
Thaddeous,M,100,0,45,45
Javelle,M,100,0,117,117
Lonniel,M,100,0,6,6
Khamden,M,100,0,13,13
Kristiane,F,100,114,0,114
Arpan,M,97,5,194,199
Preston,M,99,542,87455,87997
Krieg,M,100,0,43,43
Datavion,M,100,0,32,32
Kristen,F,99,216004,2057,218061
Chelesa,F,100,180,0,180
Damarea,M,94,10,149,159
Ilyana,F,100,689,0,689
Patrycja,F,100,227,0,227
Siam,M,100,0,52,52
Trinadee,F,100,62,0,62
Katlan,F,100,27,0,27
Ramirez,M,100,0,49,49
Cathrin,F,100,21,0,21
Loye,M,77,26,87,113
Kaula,F,100,204,0,204
Juron,M,100,0,64,64
Cirino,M,100,0,5,5
Starsky,M,100,0,134,134
Antara,F,100,157,0,157
Kateryn,F,100,121,0,121
Montero,M,100,0,49,49
Raphaella,F,100,197,0,197
Nashaun,M,100,0,273,273
Ailin,F,99,812,5,817
Dallie,F,100,96,0,96
Shaunae,F,100,71,0,71
Melburn,M,100,0,58,58
Shaquonna,F,100,28,0,28
Sessily,F,100,6,0,6
Priscillia,F,100,335,0,335
Domanic,M,99,11,1093,1104
Levearn,F,100,5,0,5
Tushara,F,100,5,0,5
Lorelle,F,100,657,0,657
Rhianna,F,100,5546,0,5546
Baneen,F,100,93,0,93
Myking,M,100,0,76,76
Jayvee,M,100,0,10,10
Erison,M,100,0,5,5
Eddi,M,95,6,114,120
Nazariyah,F,100,15,0,15
Taneja,F,100,52,0,52
Mercedi,F,100,6,0,6
Vallene,F,100,7,0,7
Jennylee,F,100,96,0,96
Joben,M,100,0,19,19
Attia,F,100,7,0,7
Quintia,F,100,10,0,10
Aciel,M,100,0,7,7
Yesmine,F,100,5,0,5
Kendrich,M,100,0,16,16
Brioni,F,100,11,0,11
Salita,F,100,55,0,55
Josue,M,100,185,43458,43643
Josegabriel,M,100,0,5,5
Nickholas,M,100,0,94,94
Skylyn,F,100,681,0,681
Latrecia,F,100,445,0,445
Adalei,F,100,93,0,93
Seda,F,100,161,0,161
Surafel,M,100,0,67,67
Shakaria,F,100,69,0,69
Shiwanda,F,100,12,0,12
Jermy,M,100,0,711,711
Ameisha,F,100,72,0,72
Eyram,F,100,5,0,5
Kiandra,F,100,922,0,922
Maddalynn,F,100,174,0,174
Heavenlyn,F,100,6,0,6
Braidyn,M,84,83,425,508
Green,M,100,0,195,195
Chaliyah,F,100,24,0,24
Hade,F,100,58,0,58
Markeil,M,100,0,35,35
Terriss,M,100,0,12,12
Tannim,M,100,0,5,5
Bernadine,F,100,5421,0,5421
Malaiah,F,100,86,0,86
Maleina,F,100,18,0,18
Sahiba,F,100,84,0,84
Monai,F,100,172,0,172
Dasya,F,100,43,0,43
Quanesha,F,100,687,0,687
Dechlan,M,100,0,17,17
Johncarlos,M,100,0,441,441
Gita,F,100,420,0,420
Najah,F,98,1659,33,1692
Trynati,F,100,5,0,5
Aadhyan,M,100,0,5,5
Xareny,F,100,5,0,5
Givanni,M,100,0,80,80
Mikhal,M,88,5,37,42
Jezlin,F,100,5,0,5
Bohan,M,100,0,24,24
Ivania,F,100,473,0,473
Lauraine,F,100,294,0,294
Vick,M,100,0,329,329
Sahvannah,F,100,73,0,73
Jaymason,M,100,0,73,73
Kaliana,F,100,440,0,440
Lilan,F,100,20,0,20
Caralena,F,100,24,0,24
Tiffany,F,100,334277,1191,335468
Terryon,M,100,0,239,239
Bromley,M,100,0,5,5
Laurelei,F,100,35,0,35
Cleatis,M,100,0,24,24
Sophonie,F,100,133,0,133
Kuper,M,100,0,98,98
Markeia,F,100,144,0,144
Lawonna,F,100,22,0,22
Tanida,F,100,5,0,5
Jakota,M,100,0,100,100
Ashini,F,100,5,0,5
Lousie,F,100,17,0,17
Zarhia,F,100,15,0,15
Ronnette,F,100,738,0,738
Chanay,F,100,61,0,61
Aunika,F,100,303,0,303
Trumell,M,100,0,5,5
Feras,M,100,0,377,377
Haden,M,96,144,3262,3406
Lakecia,F,100,629,0,629
Lenford,M,100,0,42,42
Marlvin,M,100,0,5,5
Kirana,F,100,48,0,48
Keanne,F,100,22,0,22
Neishaly,F,100,6,0,6
Shalinda,F,100,270,0,270
Chatrice,F,100,5,0,5
Lisbel,F,100,17,0,17
Avae,F,100,5,0,5
Theren,M,100,0,8,8
Dejesus,M,100,0,22,22
Maclayne,F,100,17,0,17
Laneva,F,100,5,0,5
Amair,M,100,0,56,56
Orrey,M,100,0,5,5
Akyiah,F,100,6,0,6
Ashland,F,84,581,110,691
Jermaya,F,100,55,0,55
Nioka,F,100,108,0,108
Jaquata,F,100,7,0,7
Caylib,M,100,0,7,7
Avelardo,M,100,0,245,245
Zarrah,F,100,51,0,51
Pam,F,100,29643,23,29666
Taeven,M,100,0,16,16
Laquatta,F,100,7,0,7
Meha,F,100,167,0,167
Daequan,M,100,0,744,744
Marinda,F,100,1445,0,1445
Alithia,F,100,75,0,75
Ailan,M,100,0,6,6
Mahleah,F,100,11,0,11
Dnaiel,M,100,0,48,48
Shonica,F,100,72,0,72
Loretha,F,100,923,0,923
Shawndra,F,100,677,0,677
Guilian,M,100,0,7,7
Tekara,F,100,22,0,22
Rebbie,F,100,55,0,55
Rochan,F,100,5,0,5
Sharnece,F,100,17,0,17
Mecayla,F,100,5,0,5
Chiam,M,100,0,21,21
Cattleya,F,100,377,0,377
Jasirah,F,100,12,0,12
Yuxuan,M,72,5,13,18
Jessamae,F,100,7,0,7
Chrishauna,F,100,73,0,73
Oz,M,100,0,289,289
Jagjot,M,100,0,6,6
Dre,M,100,0,550,550
Gildo,M,100,0,5,5
Adedoyin,F,100,12,0,12
Americus,F,100,400,0,400
Suset,F,100,19,0,19
Robet,M,100,0,629,629
Benedict,M,100,0,4315,4315
Makeshia,F,100,98,0,98
Javy,M,100,0,38,38
Jontelle,F,100,5,0,5
Bartley,M,100,0,1155,1155
Sarabella,F,100,65,0,65
Tmara,F,100,10,0,10
Ciela,F,100,125,0,125
Rafuel,M,100,0,7,7
Gaylord,M,100,0,1371,1371
Devrin,M,100,0,87,87
Roshun,M,81,15,65,80
Kailanie,F,100,30,0,30
Inika,F,100,53,0,53
Tamarra,F,100,1195,0,1195
Aylana,F,100,128,0,128
Hayden,M,81,20897,86571,107468
Kennard,M,100,0,1778,1778
Adallyn,F,100,18,0,18
Bridgitt,F,100,150,0,150
Jettsen,M,100,0,5,5
Charvon,F,100,5,0,5
Aelisa,F,100,5,0,5
Lavonnia,F,100,16,0,16
Lamyah,F,100,230,0,230
Challis,F,85,87,15,102
Eiden,M,100,0,275,275
Dannica,F,100,411,0,411
Yulieth,F,100,57,0,57
Lashaunda,F,100,1421,0,1421
Blayklee,F,100,64,0,64
Aleesia,F,100,355,0,355
Lataveon,M,100,0,5,5
Nyria,F,100,10,0,10
Germell,M,100,0,5,5
Arrielle,F,100,273,0,273
Dominus,M,100,0,11,11
Larrry,M,100,0,5,5
Latrease,F,100,289,0,289
Mashon,M,100,0,6,6
Kelesha,F,100,5,0,5
Sharome,M,100,0,5,5
Brace,M,100,0,78,78
Orlandus,M,100,0,116,116
Lateresa,F,100,10,0,10
Daphyne,F,100,110,0,110
Trenon,M,100,0,11,11
Daelyn,F,69,946,425,1371
Jasniel,M,100,0,9,9
Mykayla,F,100,2446,0,2446
Tommye,F,99,340,5,345
Jamecia,F,100,817,0,817
Johnson,M,100,16,3886,3902
Tallyn,F,59,51,36,87
Coulette,F,100,5,0,5
Taylorlynn,F,100,10,0,10
Kaeo,M,100,0,216,216
Tremane,M,100,0,73,73
Jakylee,F,100,16,0,16
Lareesa,F,100,48,0,48
Lilyanah,F,100,174,0,174
Gordana,F,100,40,0,40
Ivia,F,100,5,0,5
Maysaa,F,100,6,0,6
Jamary,M,81,5,21,26
Jaretta,F,100,22,0,22
Dejania,F,100,5,0,5
Kenay,M,100,0,24,24
Goran,M,100,0,108,108
Rayvion,M,100,0,63,63
Benaiah,M,100,0,864,864
Syrus,M,100,0,1057,1057
Ardell,M,71,337,818,1155
Kamber,F,100,556,0,556
Keauna,F,100,342,0,342
Valier,F,100,5,0,5
Jeanphilippe,M,100,0,33,33
Kamirah,F,100,232,0,232
Ibeth,F,100,386,0,386
Aricia,F,100,32,0,32
Khaleel,M,100,0,765,765
Jareka,F,100,6,0,6
Deonnie,F,100,5,0,5
Lakenzi,F,100,5,0,5
Rewa,F,100,140,0,140
Nisma,F,100,15,0,15
Liev,M,100,0,166,166
Naw,F,100,58,0,58
Mercer,M,85,81,462,543
Isauro,M,100,0,298,298
Marcasia,F,100,17,0,17
Darniesha,F,100,10,0,10
Sarani,F,100,5,0,5
Jonh,M,100,0,155,155
Yaheli,F,100,24,0,24
Cameria,F,100,11,0,11
Arcely,F,100,22,0,22
Yamily,F,100,54,0,54
Antonios,M,100,0,741,741
Brynlei,F,100,50,0,50
Nesreen,F,100,187,0,187
Kailla,F,100,11,0,11
Willam,M,100,0,1399,1399
Addelynn,F,100,329,0,329
Manoa,M,100,0,16,16
Zyler,M,100,0,716,716
Felesia,F,100,87,0,87
Theartis,M,100,0,12,12
Viola,F,100,11925,0,11925
Henritta,F,100,60,0,60
Jachai,M,96,10,258,268
Lanecia,F,100,143,0,143
Makenya,F,100,34,0,34
Kayja,F,100,37,0,37
Leisly,F,100,38,0,38
Daviette,F,100,7,0,7
Ya,F,87,34,5,39
Taeon,M,100,0,12,12
Bern,M,100,0,57,57
Grissel,F,100,225,0,225
Elley,F,100,225,0,225
Shan,M,72,808,2105,2913
Scottia,F,100,5,0,5
Adore,F,91,136,13,149
Taimak,M,100,0,19,19
Azon,M,100,0,19,19
Trisha,F,100,39339,53,39392
Gequan,M,100,0,10,10
Mervat,F,100,12,0,12
Melecia,F,100,40,0,40
Abery,F,100,7,0,7
Chantoria,F,100,5,0,5
Makis,M,100,0,7,7
Jameshia,F,100,725,0,725
Karenann,F,100,115,0,115
Tameyka,F,100,5,0,5
Anaiyah,F,100,951,0,951
Dedrianna,F,100,6,0,6
Flormaria,F,100,24,0,24
Asberry,M,100,0,32,32
Adhithi,F,100,24,0,24
Damary,F,100,379,0,379
Mael,M,100,0,155,155
Ayanni,F,100,113,0,113
Zuley,F,100,80,0,80
Ziheir,M,100,0,5,5
Krishal,M,100,0,5,5
Rochester,M,100,0,154,154
Ceyda,F,100,88,0,88
Khala,F,100,281,0,281
Yesmeen,F,100,39,0,39
Nakosha,F,100,15,0,15
Kiaron,M,100,0,5,5
Eilan,M,100,0,39,39
Analuz,F,100,49,0,49
Yazira,F,100,31,0,31
Gerianne,F,100,506,0,506
Ellysen,F,100,7,0,7
Yesennia,F,100,77,0,77
Yolaunda,F,100,14,0,14
Dawuan,M,100,0,47,47
Brajon,M,100,0,8,8
Amala,F,100,147,0,147
Bezawit,F,100,38,0,38
Esaias,M,100,0,359,359
Florinda,F,100,952,0,952
Kiandria,F,100,61,0,61
Callysta,F,100,51,0,51
Davaunte,M,100,0,5,5
Yarrow,F,77,54,16,70
Jamaria,F,97,1048,37,1085
Nakysha,F,100,11,0,11
Lajeana,F,100,106,0,106
Maydean,F,100,6,0,6
Maicy,F,100,89,0,89
Mablene,F,100,15,0,15
Shantara,F,100,146,0,146
Leslyn,F,100,151,0,151
Jarrion,M,100,0,21,21
Janeka,F,100,249,0,249
Napoleon,M,100,0,3567,3567
Latrisa,F,100,144,0,144
Jahred,M,100,0,131,131
Kayvon,M,100,0,927,927
Shanaye,F,100,122,0,122
Jeffy,M,100,0,49,49
Sydney,F,97,158289,4100,162389
Kalaysha,F,100,32,0,32
Edynn,F,100,70,0,70
Shadron,M,100,0,11,11
Steffani,F,100,985,0,985
Damarkus,M,100,0,272,272
Devine,M,52,627,687,1314
Shanni,F,100,28,0,28
Jaddan,M,100,0,5,5
Jaymion,M,100,0,5,5
Juliane,F,100,2070,0,2070
Denaysia,F,100,51,0,51
Priscilia,F,100,9,0,9
Trinka,F,100,81,0,81
Nochum,M,100,0,149,149
Lucca,M,86,338,2096,2434
Jilberto,M,100,0,189,189
Darci,F,100,6204,0,6204
Miaja,F,100,35,0,35
Emalia,F,100,136,0,136
Ernel,M,100,0,5,5
Utsav,M,100,0,15,15
Kayleejo,F,100,12,0,12
Latongia,F,100,10,0,10
Majayla,F,100,18,0,18
Humzah,M,100,0,138,138
Corando,M,100,0,7,7
Tivona,F,100,38,0,38
Ruthi,F,100,18,0,18
Shawneequa,F,100,90,0,90
Maianh,F,100,21,0,21
Shyleah,F,100,5,0,5
Charnika,F,100,62,0,62
Halene,F,100,5,0,5
Leonel,M,100,5,15504,15509
Grayci,F,100,53,0,53
Ciannah,F,100,19,0,19
Karran,F,100,11,0,11
Windy,F,100,4889,12,4901
Rheia,F,100,5,0,5
Garald,M,100,0,174,174
Onna,F,100,467,0,467
Juliza,F,100,498,0,498
Lajayceon,M,100,0,5,5
Aneysha,F,100,5,0,5
Stellan,M,100,0,404,404
Muntaha,F,100,138,0,138
Shirlyn,F,100,305,0,305
Rider,M,100,0,872,872
Golda,F,100,1125,0,1125
Volvi,M,100,0,7,7
Wafaa,F,100,56,0,56
Exzavior,M,100,0,29,29
Siosiua,M,100,0,7,7
Borna,M,100,0,40,40
Latreisha,F,100,12,0,12
Bara,M,100,0,12,12
Vyla,F,100,30,0,30
Josanne,F,100,58,0,58
Cutler,M,100,0,612,612
Lamor,M,100,0,49,49
Janeicia,F,100,5,0,5
Shaft,M,100,0,103,103
Kayleah,F,100,491,0,491
Toxie,M,100,0,5,5
Jemica,F,100,42,0,42
Siona,F,100,238,0,238
Georffrey,M,100,0,16,16
Mayre,F,100,10,0,10
Pearle,F,100,41,0,41
Aaleigha,F,100,139,0,139
Rye,M,92,43,467,510
Tamilyn,F,100,101,0,101
Floyda,F,100,5,0,5
Marciana,F,100,185,0,185
Deldrick,M,100,0,225,225
Jareem,M,100,0,29,29
Jolia,F,100,37,0,37
Jamaika,F,100,26,0,26
Cielle,F,100,45,0,45
Sohum,M,100,0,376,376
Alajandro,M,100,0,7,7
Barbe,F,100,36,0,36
Menley,F,100,13,0,13
Dawt,F,100,32,0,32
Joane,F,100,617,0,617
Damario,M,100,0,1124,1124
Macailyn,F,100,10,0,10
Teneika,F,100,19,0,19
Tanyka,F,100,29,0,29
Ruston,M,100,0,588,588
Tylur,M,100,0,5,5
Delrae,F,100,113,0,113
Ashlly,F,100,11,0,11
Raeqwan,M,100,0,14,14
Neidelyn,F,100,5,0,5
Ilysa,F,100,18,0,18
Trayson,M,100,0,289,289
Manasseh,M,99,5,338,343
Ilze,F,100,68,0,68
Tenajah,F,100,11,0,11
Aubrieanna,F,100,25,0,25
Jovial,F,100,5,0,5
Inge,F,100,513,0,513
Khaliq,M,100,0,553,553
Annica,F,100,572,0,572
Emryck,M,100,0,5,5
Lafondra,F,100,45,0,45
Britza,F,100,16,0,16
Arlyn,F,61,1408,905,2313
Jovannie,M,97,11,308,319
Diore,F,100,39,0,39
Aletia,F,100,55,0,55
Kynleigh,F,100,872,0,872
Haloa,M,100,0,9,9
Letisa,F,100,10,0,10
Bryttnee,F,100,10,0,10
Corban,M,100,6,2729,2735
Giliana,F,100,61,0,61
Twanika,F,100,6,0,6
Rayan,M,86,596,3632,4228
Jazzlyne,F,100,47,0,47
Kura,F,100,59,0,59
Shanyk,F,100,6,0,6
Deborrah,F,100,882,0,882
Mistica,F,100,25,0,25
Habacuc,M,100,0,10,10
Marcial,M,100,0,1583,1583
Kyona,F,100,215,0,215
Lidea,F,100,5,0,5
Tyray,M,100,0,319,319
Kortez,M,100,0,548,548
Alois,M,100,0,215,215
Keane,M,100,0,1236,1236
Delia,F,100,19263,24,19287
Syler,M,97,18,538,556
Chryl,F,100,217,0,217
Makhaya,F,100,5,0,5
Qaiden,M,100,0,5,5
Teaka,F,100,15,0,15
Taura,F,100,433,0,433
Laysha,F,100,752,0,752
Amrutha,F,100,174,0,174
Dondrey,M,100,0,5,5
Sahriyah,F,100,6,0,6
Khou,F,100,30,0,30
Zainb,F,100,5,0,5
Ovella,F,100,22,0,22
Deaundray,M,100,0,16,16
Azilee,F,100,12,0,12
Laroderick,M,100,0,21,21
Abhinay,M,100,0,5,5
Nahari,F,100,5,0,5
Zuleimy,F,100,21,0,21
Arfa,F,100,63,0,63
Genna,F,100,2920,0,2920
Loriyah,F,100,6,0,6
Taeghan,F,100,10,0,10
Kentral,M,100,0,45,45
Keyuana,F,100,78,0,78
Sharion,F,100,563,0,563
Montez,M,95,156,2799,2955
Jaree,F,54,106,92,198
Lashyia,F,100,20,0,20
Jaquasha,F,100,71,0,71
Lynmarie,F,100,19,0,19
Michellene,F,100,17,0,17
Zoey,F,100,57701,180,57881
Lathen,M,100,0,298,298
Zamar,M,100,0,321,321
Afrah,F,100,160,0,160
Nehal,F,67,135,66,201
Kaylianna,F,100,184,0,184
Kemauri,M,85,49,269,318
Diannie,F,100,79,0,79
Wimberly,F,100,27,0,27
Krispin,M,100,0,5,5
Jourdan,F,57,2217,1669,3886
Puaolena,F,100,5,0,5
Mirjana,F,100,112,0,112
Deyjah,F,100,52,0,52
Deenah,F,100,22,0,22
Thoma,M,84,15,79,94
Oluwatosin,F,53,150,132,282
Ashwin,M,100,0,1684,1684
Larkie,F,50,5,5,10
Mirtha,F,100,532,0,532
Jahairy,F,100,5,0,5
Kemily,F,100,29,0,29
Dewanna,F,100,688,0,688
Takena,F,100,11,0,11
Jehoshua,M,100,0,14,14
Preciosa,F,100,150,0,150
Sadiga,F,100,17,0,17
Tenyah,F,100,6,0,6
Goble,M,100,0,5,5
Tahjanay,F,100,6,0,6
Damel,M,100,0,64,64
Jesmarie,F,100,39,0,39
Breonca,F,100,38,0,38
Tayen,F,68,65,31,96
Rushon,M,100,0,16,16
Jaikob,M,100,0,72,72
Arinzechukwu,M,100,0,22,22
Mariyon,M,100,0,20,20
Khairee,M,100,0,11,11
Elleen,F,100,103,0,103
Ezariyah,F,100,10,0,10
Shyler,F,62,163,102,265
Kendree,F,100,5,0,5
Nakisa,F,100,26,0,26
Diannia,F,100,333,0,333
Shaheim,M,100,0,209,209
Vertina,F,100,52,0,52
Jolynda,F,100,86,0,86
Reilly,F,55,4723,3851,8574
Aleanna,F,100,95,0,95
Caster,M,100,0,75,75
Djon,M,100,0,99,99
Nichloas,M,100,0,43,43
Hatem,M,100,0,59,59
Parizoda,F,100,12,0,12
Zeric,M,100,0,109,109
Magdalina,F,100,99,0,99
Sharae,F,100,1275,0,1275
Tri,M,100,0,611,611
Drea,F,100,554,0,554
Nandika,F,100,66,0,66
Haig,M,100,0,319,319
Joel,M,99,1934,224114,226048
Salima,F,100,436,0,436
Sherise,F,100,975,0,975
Wendeline,F,100,12,0,12
Ramsy,M,100,0,5,5
Lexii,F,100,104,0,104
Joscelynn,F,100,153,0,153
Jaydalee,F,100,69,0,69
Giomar,M,100,0,98,98
Harkeem,M,100,0,6,6
Elijahwan,M,100,0,6,6
Tyteanna,F,100,154,0,154
Mynika,F,100,6,0,6
Hong,F,72,450,179,629
Shant,M,100,0,742,742
Donni,F,97,179,6,185
Eustacia,F,100,151,0,151
Cruze,M,100,0,333,333
Breeze,F,95,625,33,658
Senneca,M,100,0,11,11
Blaide,M,100,0,6,6
Desitny,F,100,5,0,5
Zaphira,F,100,18,0,18
Jeanene,F,100,1669,0,1669
Lelianna,F,100,5,0,5
Jessicaanne,F,100,60,0,60
Grecia,F,100,4440,0,4440
Caelyn,F,100,1903,5,1908
Yolandita,F,100,6,0,6
Roth,M,100,0,220,220
Draegan,M,100,0,37,37
Lynnessa,F,100,5,0,5
Orbin,M,100,0,53,53
Suesan,F,100,56,0,56
Conchata,F,100,15,0,15
Martini,F,100,26,0,26
Jedaiah,M,100,0,108,108
Jennipher,F,100,639,0,639
Enos,M,100,0,1573,1573
Nakshatra,F,100,43,0,43
Mahonri,M,100,0,88,88
Isileli,M,100,0,18,18
Jamisha,F,100,694,0,694
Jazlyn,F,100,10796,0,10796
Krischelle,F,100,10,0,10
Antonial,M,100,0,5,5
Cavan,M,100,0,1341,1341
Trishelle,F,100,205,0,205
Shaurice,F,100,42,0,42
Esten,M,100,0,120,120
Poem,F,100,6,0,6
Shiheim,M,100,0,10,10
Dilana,F,100,70,0,70
Glenyce,F,100,17,0,17
Hendry,M,100,0,77,77
Sharli,F,100,26,0,26
Makenlee,F,100,178,0,178
Dunstan,M,100,0,5,5
Taquilla,F,100,219,0,219
Tantanea,F,100,8,0,8
Danylah,F,100,65,0,65
Shantrel,F,100,42,0,42
Davonte,M,100,5,4128,4133
Caolan,M,100,0,24,24
Silviana,F,100,11,0,11
Taygan,F,87,138,20,158
Arria,F,100,188,0,188
Talyia,F,100,72,0,72
Anelie,F,100,27,0,27
Pierceson,M,100,0,31,31
Maelis,F,100,6,0,6
Gibert,M,100,0,5,5
Arthelia,F,100,10,0,10
Darrick,M,100,11,7902,7913
Ayofemi,F,100,14,0,14
Haashim,M,100,0,7,7
Djanae,F,100,5,0,5
Sanaai,F,100,80,0,80
Rudyard,M,100,0,23,23
Shely,F,100,36,0,36
Erenest,M,100,0,5,5
Jacare,M,100,0,6,6
Madysn,F,100,26,0,26
Lucky,M,87,336,2318,2654
Leonydus,M,100,0,5,5
Rossi,M,55,202,246,448
Evola,F,100,5,0,5
Staisha,F,100,82,0,82
Aundreia,F,100,5,0,5
Elrico,M,100,0,38,38
Jovani,M,98,109,5402,5511
Tria,F,100,239,0,239
Shiffon,F,100,18,0,18
Judia,F,100,11,0,11
Azrielle,F,100,112,0,112
Haset,F,100,71,0,71
Juleesa,F,100,24,0,24
Fanisha,F,100,39,0,39
Mensah,M,100,0,33,33
Zolah,F,100,13,0,13
Farley,M,99,10,717,727
Dermaine,M,100,0,46,46
Jaclyn,F,100,47750,103,47853
Lorisa,F,100,402,0,402
Gabril,M,100,0,11,11
Kendrix,M,96,17,390,407
Ranim,F,100,19,0,19
Fhernando,M,100,0,5,5
Mette,F,100,62,0,62
Sephra,F,100,40,0,40
Khrystyne,F,100,97,0,97
Drae,M,100,0,96,96
Daiana,F,100,837,0,837
Clyde,M,99,233,38056,38289
Momin,M,100,0,168,168
Soumya,F,100,256,0,256
Eloyd,M,100,0,10,10
Harout,M,100,0,287,287
Sharice,F,100,1459,0,1459
Sonceria,F,100,5,0,5
Narin,M,74,11,32,43
Austin,M,99,4107,376803,380910
Anush,M,100,0,73,73
Tomi,F,95,2287,120,2407
Kaikoa,M,100,0,51,51
Madoxx,M,100,0,22,22
Soryn,F,63,17,10,27
Snow,F,99,396,6,402
Kiajah,F,100,46,0,46
Shakenya,F,100,151,0,151
Yajayra,F,100,304,0,304
Lilliemae,F,100,18,0,18
Ruqaiya,F,100,11,0,11
Strickland,M,100,0,5,5
Evans,M,99,24,2311,2335
Kuan,M,100,0,24,24
Adisyn,F,100,947,0,947
Cas,M,100,0,53,53
Nigell,M,100,0,6,6
Mireyli,F,100,43,0,43
Tavan,M,100,0,32,32
Machele,F,100,381,0,381
Rozana,F,100,28,0,28
Dezerey,F,100,6,0,6
Peaches,F,100,702,0,702
Laderrion,M,100,0,22,22
Nelse,M,100,0,5,5
Madolynn,F,100,39,0,39
Yamiled,F,100,37,0,37
Klayre,F,100,7,0,7
Jerrine,F,100,76,0,76
Syanne,F,100,224,0,224
Patriccia,F,100,6,0,6
Asmar,M,100,0,170,170
Hevyn,F,100,39,0,39
Denes,M,100,0,5,5
Damariyon,M,100,0,27,27
Cerjio,M,100,0,5,5
Graye,F,50,5,5,10
Taishi,M,100,0,54,54
Oluwajoba,M,100,0,5,5
Micaih,M,100,0,10,10
Sameyah,F,100,10,0,10
Raafay,M,100,0,7,7
Naledi,F,100,7,0,7
Arelin,F,100,6,0,6
Zamiah,F,100,302,0,302
Abheek,M,100,0,7,7
Breion,M,75,45,137,182
Elkan,M,100,0,24,24
Katrin,F,100,1009,0,1009
Mishale,F,100,6,0,6
Legacy,F,81,761,181,942
Enrika,F,100,71,0,71
Bryanda,F,100,94,0,94
Chea,F,84,80,15,95
Roz,F,100,45,0,45
Shimaya,F,100,7,0,7
Kirstie,F,100,4150,0,4150
Zyien,M,80,12,48,60
Kelty,F,100,120,0,120
Maryela,F,100,99,0,99
Zaquavious,M,100,0,5,5
Myeka,F,100,14,0,14
Laneeka,F,100,10,0,10
Albertico,M,100,0,5,5
Jadin,M,69,643,1438,2081
Arka,M,100,0,16,16
Gerlean,F,100,11,0,11
Londa,F,100,1443,0,1443
Brodderick,M,100,0,10,10
Samoni,F,100,32,0,32
Aurash,M,100,0,13,13
Shyana,F,100,263,0,263
Dreauna,F,100,5,0,5
Dettrick,M,100,0,5,5
Endya,F,100,260,0,260
Oleksiy,M,100,0,5,5
Xanden,M,100,0,5,5
Berel,M,100,0,89,89
Nethaniel,M,100,0,223,223
Stevii,F,100,6,0,6
Olibia,F,100,5,0,5
Makirah,F,100,23,0,23
Harim,M,100,0,108,108
Karenda,F,100,35,0,35
Gerzon,M,100,0,12,12
Tahjanae,F,100,78,0,78
Geneva,F,100,18761,11,18772
Terric,M,100,0,36,36
Tuwanna,F,100,152,0,152
Emmasophia,F,100,26,0,26
Jayriel,M,100,0,19,19
Bennjamin,M,100,0,10,10
Catilin,F,100,58,0,58
Kiefer,M,100,0,1826,1826
Tekela,F,100,121,0,121
Alexanderia,F,100,739,0,739
Srivatsan,M,100,0,10,10
Abbi,F,100,1932,0,1932
Lacheryl,F,100,156,0,156
Ajoni,M,100,0,10,10
Jahziyah,F,100,18,0,18
Paull,M,100,0,5,5
Brookelin,F,100,74,0,74
Dyonte,M,100,0,30,30
Ervie,M,100,0,18,18
Anikia,F,100,5,0,5
Kylia,F,100,880,0,880
Karizmah,F,100,6,0,6
Natsha,F,100,115,0,115
Antonita,F,100,17,0,17
Harless,M,100,0,56,56
Elwanda,F,100,188,0,188
Sharnae,F,100,373,0,373
Tenasia,F,100,79,0,79
Cleste,F,100,5,0,5
Konstantina,F,100,419,0,419
Jamerious,M,100,0,31,31
Yohsuke,M,100,0,5,5
Mayuko,F,100,26,0,26
Vestina,F,100,5,0,5
Bryhanna,F,100,20,0,20
Daronte,M,100,0,94,94
Kiril,M,100,0,124,124
Deylani,F,100,16,0,16
Tarha,F,100,5,0,5
Hinata,F,94,98,6,104
Hyun,M,61,168,258,426
Maryruth,F,100,98,0,98
Trevyon,M,100,0,133,133
Jahsir,M,100,0,382,382
Paisley,F,100,18183,24,18207
Semaria,F,100,12,0,12
Laylene,F,100,6,0,6
Darneshia,F,100,171,0,171
Jareli,F,100,201,0,201
Benley,M,100,0,5,5
Keisel,M,100,0,5,5
Talibah,F,100,123,0,123
Ksenia,F,100,323,0,323
Khalila,F,100,237,0,237
Anjel,M,72,376,991,1367
Hawwa,F,100,26,0,26
Tateana,F,100,39,0,39
Taressa,F,100,362,0,362
Gelisa,F,100,129,0,129
Ladawn,F,100,1510,0,1510
Jessus,M,100,0,31,31
Kavaughn,M,100,0,87,87
Zinab,F,100,41,0,41
Quaseem,M,100,0,6,6
Lakeba,F,100,28,0,28
Jasaun,M,100,0,146,146
Giannah,F,100,284,0,284
Brettlee,M,100,0,5,5
Quarterrio,M,100,0,11,11
Abdulhakim,M,100,0,16,16
Madi,F,100,169,0,169
Shalimar,F,99,634,5,639
Loxie,F,100,11,0,11
Chrisanthi,F,100,5,0,5
Lizet,F,100,2437,0,2437
Anaja,F,100,220,0,220
Cydnie,F,100,384,0,384
Mandolyn,F,100,58,0,58
Lavelda,F,100,7,0,7
Ailana,F,100,99,0,99
Asif,M,100,0,523,523
Finlea,F,100,5,0,5
Hollice,F,71,17,7,24
Beva,F,100,41,0,41
Kacen,M,100,0,451,451
Channell,F,100,391,0,391
Jenese,F,100,157,0,157
Janeika,F,100,30,0,30
Tiela,F,100,28,0,28
Demaya,F,100,208,0,208
Cearra,F,100,336,0,336
Raeshell,F,100,42,0,42
Matthais,M,100,0,34,34
Butch,M,100,0,2666,2666
Ravan,F,100,230,0,230
Jemarion,M,100,0,110,110
Wyndee,F,100,5,0,5
Emrah,M,100,0,90,90
Breslyn,F,100,144,0,144
Dearon,M,100,0,21,21
Adaliene,F,100,12,0,12
Midhuna,F,100,10,0,10
Nekesha,F,100,280,0,280
She,F,100,5,0,5
Deann,F,100,9226,0,9226
Daliylah,F,100,10,0,10
Deandres,M,100,0,8,8
Migelangel,M,100,0,14,14
Shakeyah,F,100,12,0,12
Hau,M,88,13,97,110
Charod,M,100,0,57,57
Sharnia,F,100,6,0,6
Tida,F,100,92,0,92
Valrie,F,100,597,0,597
Stellah,F,100,60,0,60
Anorah,F,100,61,0,61
Takeyla,F,100,106,0,106
Kaya,F,94,7417,498,7915
Rafay,M,100,0,176,176
Eusebio,M,100,0,1849,1849
Demetries,M,100,0,61,61
Nikkea,F,100,28,0,28
Zephania,F,100,10,0,10
Angeliqu,F,100,5,0,5
Jekari,M,100,0,10,10
Kryslynn,F,100,47,0,47
Kayler,F,56,112,87,199
Shaketta,F,100,98,0,98
Nuzhat,F,100,28,0,28
Acquanette,F,100,13,0,13
Gwenevieve,F,100,11,0,11
Leonta,M,100,0,25,25
Than,M,100,0,36,36
Dredon,M,100,0,40,40
Melaney,F,100,1139,0,1139
Gernard,M,100,0,17,17
Javori,M,100,0,11,11
Gracilyn,F,100,69,0,69
Kayal,F,100,59,0,59
Sherall,F,100,5,0,5
Hadelyn,F,100,15,0,15
Keldrick,M,100,0,751,751
Smaran,M,100,0,92,92
Austinjames,M,100,0,37,37
Justinkyle,M,100,0,13,13
Deyaneira,F,100,52,0,52
Andranae,F,100,11,0,11
Kealia,F,100,22,0,22
Emeria,F,100,5,0,5
Mckell,F,97,412,13,425
Zoejane,F,100,99,0,99
Jil,F,100,518,0,518
Khristan,M,100,0,5,5
Nazly,F,100,65,0,65
Henrick,M,100,0,120,120
Tracee,F,100,3412,10,3422
Danieljoseph,M,100,0,21,21
Breyunna,F,100,6,0,6
Dalisa,F,100,334,0,334
Coriah,F,100,5,0,5
Rajvi,F,100,39,0,39
Jordan,M,73,126910,349416,476326
Lashayla,F,100,466,0,466
Kianne,F,100,41,0,41
Jamariyon,M,100,0,56,56
Alferdo,M,100,0,10,10
Denzyl,M,100,0,5,5
Ltanya,F,100,506,0,506
Shayma,F,100,137,0,137
Jyshawn,M,100,0,22,22
Kizzey,F,100,24,0,24
Aliyaah,F,100,46,0,46
Lucilia,F,100,70,0,70
Jamael,M,100,0,383,383
Loreene,F,100,5,0,5
Kolbey,M,91,22,224,246
Amberlin,F,100,192,0,192
Augustas,M,100,0,19,19
Marranda,F,100,71,0,71
Demetrise,F,81,25,6,31
Blayten,M,100,0,11,11
Ruxin,M,100,0,70,70
Neeli,F,100,23,0,23
Rodneysha,F,100,5,0,5
Haether,F,100,6,0,6
Quatrell,M,100,0,17,17
Nasair,M,100,0,26,26
Rayshaun,M,100,0,898,898
Sharl,F,100,52,0,52
Merl,M,98,11,494,505
Ekamveer,M,100,0,22,22
Dinnah,F,100,5,0,5
Cleaster,F,90,44,5,49
Cleston,M,100,0,18,18
Daud,M,100,0,148,148
Zakariyah,M,73,19,51,70
Greidy,F,100,99,0,99
Chanden,M,100,0,52,52
Tamani,F,100,112,0,112
Aneissa,F,100,31,0,31
Sammyjo,F,100,24,0,24
Gloriann,F,100,163,0,163
Terrio,M,100,0,21,21
Riha,F,100,10,0,10
Sonequa,F,100,5,0,5
Cheisea,F,100,22,0,22
Zahin,M,100,0,16,16
Meagan,F,100,41228,72,41300
Hannha,F,100,5,0,5
Schelle,F,100,10,0,10
Axiry,F,100,5,0,5
Weylon,M,100,0,5,5
Joanell,F,100,39,0,39
Eulalia,F,100,1297,0,1297
Lanaye,F,100,14,0,14
Jazly,F,100,28,0,28
Ilaya,F,100,11,0,11
Athenamarie,F,100,5,0,5
Leddi,F,100,6,0,6
Mallori,F,100,1441,0,1441
Theresea,F,100,245,0,245
Brayan,M,100,18,12934,12952
Sebert,M,100,0,6,6
Yusei,M,100,0,36,36
Tenika,F,100,1029,0,1029
Mellanie,F,100,989,0,989
Solia,F,100,48,0,48
Tyquavius,M,100,0,16,16
Matthewryan,M,100,0,16,16
Dunta,M,100,0,10,10
Bryceson,M,100,0,350,350
Teyah,F,100,304,0,304
Maximum,M,100,0,75,75
Trenitee,F,100,10,0,10
Citlalli,F,100,2064,0,2064
Trishonda,F,100,11,0,11
Italie,F,100,22,0,22
Gaylene,F,100,1866,0,1866
Evanston,M,100,0,10,10
Hazle,F,100,117,0,117
Aarohi,F,100,266,0,266
Amonti,M,92,5,55,60
Nitaya,F,100,15,0,15
Tenell,F,100,7,0,7
Christna,F,100,104,0,104
Negeen,F,100,15,0,15
Daoud,M,100,0,198,198
Tevita,M,100,0,639,639
Mcallister,M,72,11,29,40
Dwain,M,100,0,4727,4727
Kentaro,M,100,0,318,318
Aleila,F,100,53,0,53
Berniya,F,100,5,0,5
Carmeisha,F,100,18,0,18
Erland,M,100,0,40,40
Clare,F,98,18568,376,18944
Patriana,F,100,6,0,6
Jamita,F,100,56,0,56
Kokeeta,F,100,5,0,5
Mikial,M,100,0,17,17
Audriena,F,100,24,0,24
Meighan,F,100,564,0,564
Amira,F,100,10282,0,10282
Annanicole,F,100,25,0,25
Raynal,M,100,0,10,10
Rephael,M,100,0,40,40
Rashondra,F,100,5,0,5
Esmae,F,100,214,0,214
Tyrian,M,95,6,110,116
Stevonte,M,100,0,10,10
Ajalon,F,63,12,7,19
Shantel,F,99,10090,59,10149
Keyatta,F,100,115,0,115
Denaja,F,100,147,0,147
Mosie,M,100,0,18,18
Lusiana,F,100,13,0,13
Katilin,F,100,155,0,155
Lendon,M,100,0,242,242
Carlotte,F,100,16,0,16
Xeng,M,100,0,137,137
Harmonii,F,100,150,0,150
Peng,M,100,0,227,227
Traneice,F,100,10,0,10
Lusha,F,100,5,0,5
Anassa,F,100,8,0,8
Hudes,F,100,5,0,5
Aviram,M,100,0,5,5
Stassi,F,100,46,0,46
Continia,F,100,5,0,5
Marsinah,F,100,5,0,5
Paublo,M,100,0,33,33
Tammi,F,100,13884,0,13884
Jamontay,M,100,0,6,6
Kaos,M,100,0,25,25
Cisely,F,100,5,0,5
Aylee,F,100,203,0,203
Monzerrad,F,100,5,0,5
Kaliya,F,100,671,0,671
Boysie,M,100,0,10,10
Claressa,F,100,396,0,396
Everlei,F,100,5,0,5
Keelin,F,78,956,265,1221
Mailan,F,100,33,0,33
Cayenne,F,94,347,24,371
Danish,M,100,0,340,340
Maxxen,M,100,0,5,5
Aashrita,F,100,41,0,41
Tabish,M,100,0,16,16
Jayonte,M,100,0,11,11
Daven,M,96,92,2174,2266
Addyson,F,100,12698,33,12731
Reghan,F,100,797,0,797
Krosby,M,92,5,56,61
Quenna,F,100,142,0,142
Aaronn,M,100,0,22,22
Fawna,F,100,168,0,168
Niari,F,100,10,0,10
Talaina,F,100,10,0,10
Ranjit,M,100,0,154,154
Lorah,F,100,87,0,87
Arazeli,F,100,5,0,5
Raschell,F,100,6,0,6
Florentina,F,100,546,0,546
Joceline,F,100,1497,0,1497
Spartacus,M,100,0,29,29
Shahed,F,92,114,10,124
Desirree,F,100,27,0,27
Darith,M,100,0,10,10
Liala,F,100,104,0,104
Mackaylee,F,100,13,0,13
Zaleigh,F,100,82,0,82
Levee,F,100,5,0,5
Latawn,F,100,5,0,5
Adisen,F,100,179,0,179
Conye,M,100,0,8,8
Cyric,M,100,0,30,30
Jimique,M,100,0,5,5
Delilha,F,100,6,0,6
Junious,M,100,0,399,399
Kaityln,F,100,127,0,127
Dawnisha,F,100,122,0,122
Mirya,F,100,5,0,5
Attalia,F,100,18,0,18
Tomma,F,100,61,0,61
Brijida,F,100,10,0,10
Ganyn,M,100,0,7,7
Jaxon,M,100,225,47020,47245
Klaudia,F,100,879,0,879
Taj,M,92,361,4033,4394
Stamatina,F,100,5,0,5
Azende,M,100,0,27,27
Darlene,F,100,128756,344,129100
Vickiann,F,100,15,0,15
Assyria,F,100,117,0,117
Vonshae,F,100,5,0,5
Xylah,F,100,61,0,61
Cirildo,M,100,0,5,5
Zorriah,F,100,5,0,5
Aliciya,F,100,20,0,20
Bardo,M,100,0,39,39
Tredan,M,100,0,5,5
Malchijah,M,100,0,5,5
Chelita,F,100,37,0,37
Kawtar,F,100,11,0,11
Yedda,F,100,5,0,5
Cortlyn,F,95,309,15,324
Ciarah,F,100,251,0,251
Sakeena,F,100,507,0,507
Pierre,M,99,74,14563,14637
Jabraylon,M,100,0,42,42
Johneice,F,100,5,0,5
Torlan,M,100,0,5,5
Shjon,M,100,0,74,74
Adriaunna,F,100,53,0,53
Jung,M,54,128,149,277
Cesiah,F,100,67,0,67
Aithen,M,100,0,40,40
Danylle,F,100,128,0,128
Damarys,F,100,492,0,492
Jesuan,M,100,0,5,5
Zoren,M,100,0,35,35
Nathin,M,100,0,223,223
Karie,F,100,5291,0,5291
Torrel,M,100,0,11,11
Vonzel,M,100,0,5,5
Cassidi,F,100,788,0,788
Jhonnie,M,100,0,37,37
Kymia,F,100,95,0,95
Lonza,M,100,0,61,61
Pai,F,100,6,0,6
Journye,F,100,36,0,36
Neyah,F,100,71,0,71
Twania,F,100,63,0,63
Sapna,F,100,546,0,546
Eragon,M,100,0,63,63
Rahm,M,100,0,55,55
Anahid,F,100,71,0,71
Simranjit,F,83,70,14,84
Travarus,M,100,0,77,77
Brendi,F,100,118,0,118
Domonique,F,75,5132,1738,6870
Delorice,F,100,19,0,19
Coltn,M,100,0,10,10
Kalishia,F,100,15,0,15
Eliyahna,F,100,5,0,5
Vidhu,M,100,0,5,5
Vernall,M,100,0,5,5
Analydia,F,100,5,0,5
Dellar,F,100,17,0,17
Oshaye,M,100,0,10,10
Michalia,F,100,46,0,46
Evangelina,F,100,6358,0,6358
Kingstan,M,100,0,5,5
Sannidhi,F,100,11,0,11
Yuriy,M,100,0,154,154
Wateen,F,100,28,0,28
Fernanda,F,100,13039,26,13065
Kalita,F,100,40,0,40
Aleksey,M,97,10,376,386
Kimette,F,100,10,0,10
Mecaela,F,100,10,0,10
Cottrell,M,100,0,76,76
Jayar,M,100,0,5,5
Vernice,F,93,2027,164,2191
Dijon,M,95,69,1313,1382
Demelza,F,100,12,0,12
Damla,F,100,11,0,11
Hollie,F,98,16906,328,17234
Tyauna,F,100,149,0,149
Mirca,F,100,71,0,71
Tanith,F,100,122,0,122
Taeshawn,M,100,0,278,278
Grigoriy,M,100,0,14,14
Lanena,F,100,5,0,5
Geovana,F,100,212,0,212
Annaliesse,F,100,13,0,13
Chantina,F,100,45,0,45
Mariusz,M,100,0,80,80
Shaneisha,F,100,98,0,98
Kalleb,M,100,0,20,20
Theseus,M,100,0,124,124
Hadessah,F,100,99,0,99
Arliz,F,100,13,0,13
Paulann,F,100,13,0,13
Cenith,F,100,10,0,10
Nathane,M,100,0,25,25
Taniece,F,100,17,0,17
Sandrika,F,100,50,0,50
Joram,M,100,0,194,194
Janasha,F,100,170,0,170
Read,M,100,0,207,207
Aquavion,M,100,0,5,5
Renesmae,F,100,73,0,73
Trevon,M,100,25,13192,13217
Jazen,M,100,0,67,67
Travell,M,100,0,758,758
Chrishna,F,100,5,0,5
Darylle,M,100,0,6,6
Shavonn,F,100,174,0,174
Idalis,F,100,805,0,805
Amalea,F,100,63,0,63
Arnoldo,M,100,0,3908,3908
Marykathryn,F,100,457,0,457
Minsa,F,100,22,0,22
Kyiana,F,100,54,0,54
Treyvaughn,M,100,0,46,46
Kimerly,F,100,603,0,603
Rahim,M,100,0,1414,1414
Seiji,M,100,0,315,315
Genendy,F,100,5,0,5
Kazzandra,F,100,65,0,65
Deztany,F,100,5,0,5
Edguin,M,100,0,6,6
Muaz,M,100,0,151,151
Uri,M,97,30,837,867
Olesha,F,100,5,0,5
Phat,M,100,0,124,124
Keddrick,M,100,0,114,114
Charle,M,83,115,579,694
Jorja,F,100,2320,0,2320
Theofilos,M,100,0,5,5
Tikila,F,100,11,0,11
Geovoni,M,100,0,18,18
Abigaelle,F,100,86,0,86
Kaylena,F,100,486,0,486
Cyla,F,100,243,0,243
Camillus,M,100,0,5,5
Narada,M,97,7,201,208
Yessenia,F,100,7020,12,7032
Vasilia,F,100,69,0,69
Kamica,F,100,70,0,70
Kongmong,M,100,0,7,7
Mellisa,F,100,4563,0,4563
Keimiyah,F,100,11,0,11
Keta,F,100,128,0,128
Orren,M,100,0,313,313
David,M,100,10321,2830626,2840947
Kadaysha,F,100,16,0,16
Nedved,M,100,0,7,7
Suleymi,F,100,5,0,5
Alexsis,F,87,1253,190,1443
Makauri,M,100,0,5,5
Samad,M,100,0,658,658
Nuria,F,100,550,0,550
Brelynn,F,99,560,5,565
Nalene,F,100,5,0,5
Jeffer,M,100,0,25,25
Tatyanah,F,100,51,0,51
Taisia,F,100,57,0,57
Jerol,M,100,0,68,68
Avariella,F,100,18,0,18
Alimatou,F,100,13,0,13
Mccoy,M,98,26,1470,1496
Devlen,M,100,0,23,23
Ging,F,100,5,0,5
Kyairra,F,100,5,0,5
Jeferson,M,100,0,275,275
Shenyah,F,100,5,0,5
Jakarah,F,100,6,0,6
Nykayla,F,100,88,0,88
Afifah,F,100,15,0,15
Vianay,F,100,5,0,5
Glenita,F,100,22,0,22
Zihan,M,55,13,16,29
Teirney,F,100,7,0,7
Mikie,M,93,18,234,252
Lasaundra,F,100,300,0,300
Erickah,F,100,10,0,10
Wasseem,M,100,0,6,6
Anielle,F,100,55,0,55
Mykol,M,100,0,25,25
Shakeima,F,100,23,0,23
Jayzon,M,100,0,180,180
Linnae,F,100,278,0,278
Pollyanne,F,100,22,0,22
Torrion,M,100,0,129,129
Jovaun,M,100,0,124,124
Cequan,M,100,0,29,29
Damaso,M,100,0,269,269
Jameya,F,100,165,0,165
Simrandeep,F,100,5,0,5
Caroljean,F,100,12,0,12
Nyangel,F,100,12,0,12
Shaguana,F,100,54,0,54
Marlowe,F,59,1142,800,1942
Lacalvin,M,100,0,5,5
Verenisse,F,100,22,0,22
Trynton,M,100,0,20,20
Janyne,F,100,21,0,21
Izora,F,100,93,0,93
Bernadina,F,100,49,0,49
Devannie,F,100,5,0,5
Scotty,M,99,179,17306,17485
Lashenda,F,100,6,0,6
Dejean,M,100,0,192,192
Shieka,F,100,13,0,13
Aleida,F,100,1408,0,1408
Fauna,F,100,110,0,110
Lauriane,F,100,5,0,5
Zorawar,M,100,0,19,19
Duyen,F,100,184,0,184
Keionte,M,100,0,74,74
Claudean,F,100,68,0,68
Platinum,F,100,5,0,5
Mekos,M,100,0,10,10
Margarie,F,100,5,0,5
Adaleen,F,100,40,0,40
Rutva,F,100,6,0,6
Nikkolas,M,100,0,460,460
Safire,F,100,71,0,71
Ashanee,F,100,5,0,5
Kwasi,M,100,0,614,614
Ziraily,F,100,7,0,7
Karyzma,F,100,26,0,26
Sabryn,F,100,164,0,164
Mahisha,F,100,5,0,5
Monchelle,F,100,17,0,17
Amorae,F,100,5,0,5
Melvie,F,100,12,0,12
Ladell,M,83,162,771,933
Quintonio,M,100,0,10,10
Jhoanna,F,100,314,0,314
Colsyn,M,100,0,25,25
Jarina,F,100,11,0,11
Ophelie,F,100,6,0,6
Jennessy,F,100,105,0,105
Stephin,M,100,0,6,6
Aevin,M,100,0,15,15
Tamiaya,F,100,5,0,5
Allinson,F,100,23,0,23
Orin,M,100,11,2497,2508
Olajawon,M,100,0,19,19
Deshane,M,93,17,238,255
Zamayra,F,100,5,0,5
Gerlad,M,100,0,65,65
Pinky,F,100,179,0,179
Quetzal,F,59,58,40,98
Amahia,F,100,13,0,13
Sanjeet,M,100,0,11,11
Musiq,M,63,10,17,27
Jacy,F,82,3146,674,3820
Shakur,M,99,9,1056,1065
Lansing,M,100,0,248,248
Gisselle,F,100,8887,0,8887
Trotter,M,100,0,21,21
Chyrisse,F,100,15,0,15
Alekzander,M,100,0,757,757
Trevis,M,99,10,1719,1729
Astraea,F,100,45,0,45
Alizeh,F,100,122,0,122
Jaired,M,100,0,55,55
Rose,F,100,144163,512,144675
Stephana,F,100,141,0,141
Hadara,F,100,44,0,44
Ezequias,M,100,0,70,70
Colyn,M,98,10,644,654
Anakin,M,100,0,1769,1769
Kywaun,M,100,0,11,11
Nicholette,F,100,1236,0,1236
Akaia,F,100,39,0,39
Mollie,F,100,19770,6,19776
Kingjoseph,M,100,0,5,5
Alaynah,F,100,624,0,624
Krystelle,F,100,178,0,178
Mosha,M,100,0,18,18
Shinae,F,100,41,0,41
Jamayia,F,100,69,0,69
Tyanne,F,100,477,0,477
Shoshone,F,100,11,0,11
Codell,M,100,0,5,5
Shanquan,M,100,0,5,5
Zunilda,F,100,6,0,6
Reality,F,100,210,0,210
Thailand,M,89,10,84,94
Tashyra,F,100,162,0,162
Kazariah,F,100,17,0,17
Kyalo,M,100,0,5,5
Jachob,M,100,0,146,146
Andress,M,100,0,5,5
Taylan,M,69,255,571,826
Safiatou,F,100,65,0,65
Music,F,50,6,6,12
Meloney,F,100,894,0,894
Anni,F,100,462,0,462
Meshaun,F,100,6,0,6
Julizza,F,100,62,0,62
Kristien,F,87,264,41,305
Juane,M,100,0,32,32
Marcis,M,100,0,44,44
Bartly,M,100,0,5,5
Jemar,M,100,0,455,455
Aislynn,F,100,1536,0,1536
Shanyce,F,100,267,0,267
Makisha,F,100,446,0,446
Devontre,M,100,0,166,166
Zaiveon,M,100,0,12,12
Rikesha,F,100,23,0,23
Krystyna,F,100,1632,0,1632
Masashi,M,100,0,23,23
Deylen,M,100,0,7,7
Omar,M,100,435,87099,87534
Kristopher,M,100,297,60094,60391
Shinice,F,100,32,0,32
Jacary,M,100,0,21,21
Jenece,F,100,17,0,17
Fredick,M,100,0,161,161
Johanson,M,100,0,5,5
Pacita,F,100,10,0,10
Zoella,F,100,24,0,24
Thema,F,100,35,0,35
Caio,M,100,0,407,407
Tamalyn,F,100,144,0,144
Hee,F,100,21,0,21
Saulius,M,100,0,15,15
Cina,F,100,114,0,114
Kahla,F,100,679,0,679
Trinitee,F,100,1226,0,1226
Aleksi,M,68,28,59,87
Alezae,F,100,13,0,13
Kaviya,F,100,15,0,15
Jnae,F,100,196,0,196
Moncerath,F,100,17,0,17
Vardell,M,100,0,8,8
Nyliah,F,100,149,0,149
Panagiotes,M,100,0,6,6
Rafeek,M,100,0,5,5
Prenisha,F,100,5,0,5
Zamyriah,F,100,21,0,21
Gracelee,F,100,42,0,42
Ailene,F,100,868,0,868
Aubrilyn,F,100,5,0,5
Osmara,F,100,269,0,269
Shaheedah,F,100,5,0,5
Lillea,F,100,6,0,6
Kearstan,F,100,5,0,5
Ameris,F,100,224,0,224
Md,M,100,0,230,230
Joon,M,90,37,339,376
Margaretta,F,100,581,0,581
Zeki,M,100,0,45,45
Crescencio,M,100,0,150,150
Nazareth,M,60,448,680,1128
Antonela,F,100,72,0,72
Sohpia,F,100,11,0,11
Marzell,M,98,5,197,202
Dominio,M,100,0,5,5
Sahil,M,100,0,2444,2444
Moustapha,M,100,0,239,239
Trenetta,F,100,10,0,10
Malikai,M,100,0,748,748
Estes,M,100,0,57,57
Oree,M,100,0,34,34
Kearius,M,100,0,5,5
Romanita,F,100,42,0,42
Vaiden,M,100,0,34,34
Kahleah,F,100,97,0,97
Avanta,M,100,0,11,11
Tanmayi,F,100,32,0,32
Luisgustavo,M,100,0,17,17
Aeiden,M,100,0,10,10
Madylynn,F,100,36,0,36
Camyia,F,100,35,0,35
Emmilou,F,100,5,0,5
Alakai,M,100,0,188,188
Shontai,F,100,17,0,17
Ziyaad,M,100,0,16,16
Jhamal,M,100,0,56,56
Emnet,F,100,73,0,73
Hoss,M,100,0,28,28
Larrey,M,100,0,7,7
Aniyiah,F,100,65,0,65
Allayna,F,100,417,0,417
Shraddha,F,100,177,0,177
Affan,M,100,0,208,208
Audrynna,F,100,11,0,11
Alvey,M,100,0,31,31
Barbarajo,F,100,33,0,33
Tanganyika,F,100,113,0,113
Keomi,F,100,6,0,6
Robertson,M,100,0,399,399
Leimomi,F,100,77,0,77
Marvena,F,100,70,0,70
Torron,M,100,0,24,24
Rykar,M,100,0,41,41
Sarii,F,100,5,0,5
Kolden,M,100,0,184,184
Kenyanna,F,100,222,0,222
Khailynn,F,100,14,0,14
Yazeed,M,100,0,273,273
Shaylor,M,100,0,10,10
Takyla,F,100,277,0,277
Marcas,M,100,0,214,214
Christyanna,F,100,86,0,86
Joneric,M,100,0,99,99
Diony,M,100,0,24,24
Iylah,F,100,70,0,70
Nesha,F,100,477,0,477
Chaim,M,100,6,7793,7799
Meghon,F,100,5,0,5
Savyon,M,100,0,85,85
Lyza,F,100,495,0,495
Rhilynn,F,100,133,0,133
Meliha,F,100,36,0,36
Emunah,F,100,106,0,106
Jeson,M,100,0,62,62
Yuvonka,F,100,6,0,6
Mikea,F,100,224,0,224
Shareka,F,100,795,0,795
Daqwan,M,100,0,227,227
Kynslie,F,100,159,0,159
Arrieanna,F,100,12,0,12
Margrit,F,100,56,0,56
Brennon,M,100,0,3892,3892
Ugochi,F,100,106,0,106
Roczen,M,100,0,50,50
Davina,F,100,6921,0,6921
Monalisa,F,100,1043,0,1043
Tashalee,F,100,5,0,5
Jaydrien,M,100,0,50,50
Alainie,F,100,13,0,13
Rayvone,M,100,0,16,16
Rileyann,F,100,119,0,119
Marquie,M,80,27,108,135
Marica,F,100,856,0,856
Terrea,F,100,92,0,92
Hawthorn,M,100,0,11,11
Dural,M,100,0,7,7
Elmin,M,100,0,65,65
Juleena,F,100,9,0,9
Morty,M,100,0,28,28
Jamesa,F,100,288,0,288
Clarita,F,100,663,0,663
Shikita,F,100,94,0,94
Gerrold,M,100,0,5,5
Alicha,F,100,265,0,265
Onica,F,100,259,0,259
Ezekias,M,100,0,6,6
Sheeneeka,F,100,5,0,5
Lillah,F,100,96,0,96
Lonzetta,F,100,37,0,37
Revella,F,100,5,0,5
Atenas,F,100,24,0,24
Lourita,F,100,5,0,5
Sharilee,F,100,38,0,38
Chrishun,M,100,0,56,56
Aubreyella,F,100,14,0,14
Dmarrion,M,100,0,13,13
Mathews,M,100,0,253,253
Kela,F,100,891,0,891
Sohani,F,100,11,0,11
Meryah,F,100,13,0,13
Atal,M,100,0,5,5
British,F,89,178,21,199
Jeneya,F,100,12,0,12
Lakelynn,F,100,205,0,205
Maive,F,100,19,0,19
Brijin,F,100,13,0,13
Fatemah,F,100,151,0,151
Rosalio,M,100,5,1285,1290
Ches,M,100,0,10,10
Durk,M,100,0,88,88
Idonna,F,100,5,0,5
Aakira,F,100,5,0,5
Mayer,M,100,5,1475,1480
Kheri,F,100,6,0,6
Kattina,F,100,15,0,15
Sohn,M,100,0,16,16
Latetia,F,100,10,0,10
Nimish,M,100,0,6,6
Rayburn,M,100,0,854,854
Deaundrea,F,85,33,6,39
Jeanmarc,M,100,0,162,162
Jiho,M,100,0,26,26
Norie,F,100,39,0,39
Oliana,F,100,84,0,84
Aideyn,M,100,0,14,14
Khyber,M,100,0,11,11
Sunja,F,100,11,0,11
Niamya,F,100,66,0,66
Argel,M,100,0,35,35
Tabresha,F,100,27,0,27
Petronilo,M,100,0,15,15
Breannah,F,100,553,0,553
Sobra,F,100,7,0,7
Keitha,F,100,1056,0,1056
Arnaldo,M,100,0,1888,1888
Betsie,F,100,162,0,162
Krin,F,100,11,0,11
Gili,F,100,45,0,45
Ohagi,M,100,0,7,7
Jayvaughn,M,100,0,37,37
Marlyne,F,100,236,0,236
Salvatrice,F,100,50,0,50
Jearline,F,100,99,0,99
Rakshan,M,100,0,20,20
Riviera,F,100,36,0,36
Jaysson,M,100,0,10,10
Syritta,F,100,5,0,5
Stven,M,100,0,5,5
Vyolet,F,100,50,0,50
Kattleya,F,100,73,0,73
Kerly,F,100,61,0,61
Ziyang,M,100,0,10,10
Nicholaas,M,100,0,20,20
Mauli,F,100,8,0,8
Tniyah,F,100,110,0,110
Shatari,F,100,31,0,31
Jaboa,F,100,15,0,15
Dantasia,F,100,16,0,16
Kymanie,M,100,0,5,5
Jahanara,F,100,10,0,10
Keely,F,100,11832,21,11853
Brittanica,F,100,6,0,6
Posey,F,81,120,29,149
Juneann,F,100,10,0,10
Marucs,M,100,0,7,7
Jisele,F,100,92,0,92
Carrine,F,100,53,0,53
Jahmad,M,100,0,115,115
Samoan,F,100,11,0,11
Ericha,F,100,258,0,258
Jazari,F,66,42,22,64
Rhya,F,100,154,0,154
Jessia,F,100,376,0,376
Abdulwahid,M,100,0,10,10
Deshaun,M,96,231,4994,5225
Naaliyah,F,100,15,0,15
Lequient,M,100,0,7,7
Brailin,M,100,0,11,11
Asheena,F,100,29,0,29
Raeonna,F,100,107,0,107
Sumyah,F,100,8,0,8
Tylor,M,95,446,7780,8226
Chun,M,91,10,98,108
Orlander,M,100,0,68,68
Eunique,F,98,564,10,574
Ayunna,F,100,5,0,5
Aeneas,M,100,0,325,325
Kaari,F,100,74,0,74
Nickhil,M,100,0,5,5
Loai,M,100,0,5,5
Casidee,F,100,76,0,76
Tayvien,M,100,0,65,65
Taalib,M,100,0,10,10
Lareese,F,100,21,0,21
Jalyn,F,74,4574,1587,6161
Parri,F,100,5,0,5
Miagrace,F,100,7,0,7
Josalyne,F,100,6,0,6
Karega,M,100,0,11,11
Jaciel,M,99,5,546,551
Dejahn,M,100,0,14,14
Valori,F,100,297,0,297
Alliene,F,100,10,0,10
Lanavia,F,100,6,0,6
Shae,F,78,4943,1435,6378
Rodnika,F,100,35,0,35
Raquez,M,100,0,16,16
Taiana,F,100,67,0,67
Lohoma,F,100,12,0,12
Newell,M,100,0,716,716
Orah,F,100,18,0,18
Jahin,M,100,0,5,5
Palak,F,98,289,5,294
Quiniya,F,100,37,0,37
Angellyn,F,100,17,0,17
Ananya,F,100,2706,0,2706
Junathaen,M,100,0,7,7
Kiarrah,F,100,194,0,194
Latica,F,100,89,0,89
Emmanuell,M,100,0,107,107
Jyrelle,M,100,0,5,5
Havilah,F,100,395,0,395
Bernadet,F,100,9,0,9
Latocha,F,100,16,0,16
Ludmila,F,100,112,0,112
Breanna,F,100,79998,65,80063
Nacari,M,100,0,10,10
Arlin,M,72,640,1628,2268
Annabellee,F,100,27,0,27
Rad,M,100,0,111,111
Sarmad,M,100,0,16,16
Rhyanne,F,100,37,0,37
Geoggrey,M,100,0,33,33
Rozalie,F,100,17,0,17
Anylah,F,100,668,0,668
Cheron,F,86,602,99,701
Tamiah,F,100,667,0,667
Yaritzy,F,100,166,0,166
Britanny,F,100,745,0,745
Calani,F,100,5,0,5
Jericha,F,100,216,0,216
Calee,F,100,607,0,607
Mishti,F,100,40,0,40
Aude,F,100,5,0,5
Amauriah,F,100,14,0,14
Bartholome,M,100,0,23,23
Mehnaz,F,100,5,0,5
Anastaja,F,100,12,0,12
Laramy,M,100,0,42,42
Porschia,F,100,242,0,242
Limayri,F,100,16,0,16
Makala,F,100,3321,5,3326
Cerita,F,100,104,0,104
Spencer,M,97,3036,102867,105903
Philippos,M,100,0,15,15
Sheriyah,F,100,22,0,22
Delvina,F,100,42,0,42
Iosefa,M,100,0,48,48
Tommesha,F,100,5,0,5
Aina,F,100,319,0,319
Cortavion,M,100,0,19,19
Belen,F,99,7613,63,7676
Dyeisha,F,100,26,0,26
Kass,M,100,0,55,55
Wendelyn,F,100,366,0,366
Ishaal,F,100,6,0,6
Shukura,F,100,21,0,21
Mclaine,F,100,10,0,10
Vikesh,M,100,0,5,5
Phynix,F,69,70,31,101
Elay,M,100,0,22,22
Jaimal,M,100,0,5,5
Keke,F,100,10,0,10
Jaqueze,M,100,0,20,20
Todderick,M,100,0,14,14
Mccall,F,93,942,74,1016
Pina,F,100,175,0,175
Ysabelle,F,100,372,0,372
Lynnwood,M,100,0,115,115
Garbrielle,F,100,12,0,12
Terence,M,99,165,29253,29418
Teris,M,100,0,5,5
Yanziel,M,100,0,39,39
Maneesh,M,100,0,32,32
Khyla,F,100,782,0,782
Tritia,F,100,79,0,79
Tiaya,F,100,5,0,5
Teppei,M,100,0,5,5
Gabbrielle,F,100,207,0,207
Makieh,M,100,0,5,5
Deene,F,100,6,0,6
Marzel,M,100,0,6,6
Bresha,F,100,159,0,159
Katieann,F,100,326,0,326
Hai,M,96,21,559,580
Jaalyn,M,55,5,6,11
Laneita,F,100,6,0,6
Samaia,F,100,76,0,76
Jasarah,F,100,13,0,13
Terren,M,75,169,511,680
Markius,M,100,0,11,11
Zubaida,F,100,17,0,17
Sophialynn,F,100,21,0,21
Angelo,M,99,691,49215,49906
Delanna,F,100,217,0,217
Timon,M,100,0,426,426
Damekia,F,100,5,0,5
Kolby,M,91,989,9687,10676
Velissa,F,100,42,0,42
Grayland,M,100,0,195,195
Averill,M,85,24,135,159
Janari,M,69,52,115,167
Eren,M,81,145,638,783
Larrell,M,100,0,93,93
Colbin,M,100,0,82,82
Taquez,M,100,0,5,5
Bryken,M,100,0,14,14
Nephtali,M,95,6,125,131
Rejon,M,100,0,19,19
Arkham,M,100,0,7,7
Olana,F,100,25,0,25
Trifon,M,100,0,5,5
Rockie,M,94,53,804,857
Vagas,M,100,0,5,5
Dianet,F,100,5,0,5
Mahkel,M,100,0,20,20
Kaegen,M,100,0,35,35
Loney,M,100,0,97,97
Aleasha,F,100,968,0,968
Tayea,F,100,5,0,5
Pau,M,100,0,149,149
Orenthia,M,100,0,5,5
Jurate,F,100,6,0,6
Devyon,M,100,0,83,83
Jeanete,F,100,11,0,11
Gerette,F,100,10,0,10
Redwan,M,100,0,5,5
Zier,M,100,0,28,28
Aanyah,F,100,78,0,78
Tiras,M,100,0,183,183
Karlina,F,100,276,0,276
Jaala,F,100,349,0,349
Egypt,F,92,1986,164,2150
Breyawna,F,100,14,0,14
Pandra,F,100,5,0,5
Leshonda,F,100,160,0,160
Nequila,F,100,5,0,5
Ruthia,F,100,31,0,31
Jannesa,F,100,5,0,5
Zylis,M,100,0,14,14
Fadak,F,100,7,0,7
Celicia,F,100,351,0,351
Makilah,F,100,138,0,138
Kimar,M,100,0,43,43
Kmya,F,100,184,0,184
Neng,M,94,5,78,83
Pryncess,F,100,13,0,13
Javana,F,100,67,0,67
Peerless,M,100,0,6,6
Amdanda,F,100,18,0,18
Marlisa,F,100,789,0,789
Aswath,M,100,0,5,5
Anley,F,100,5,0,5
Marlando,M,100,0,33,33
Jdyn,M,100,0,120,120
Justinpaul,M,100,0,27,27
Nikeria,F,100,156,0,156
Litza,F,100,5,0,5
Leaanne,F,100,42,0,42
Xue,M,76,34,110,144
Omeisha,F,100,5,0,5
Jrue,M,88,25,184,209
Jevon,M,98,91,4580,4671
Sidarth,M,100,0,17,17
Naeem,M,100,0,1473,1473
Maelana,F,100,5,0,5
Elston,M,100,0,688,688
Almina,F,100,62,0,62
Kartel,M,100,0,28,28
Albino,M,100,0,851,851
Devann,F,95,148,8,156
Lynet,F,100,13,0,13
Izaeh,M,100,0,6,6
Charitee,F,100,41,0,41
Leya,F,100,961,0,961
Damona,F,100,10,0,10
Mierra,F,100,11,0,11
Habil,M,100,0,5,5
Chuong,M,100,0,85,85
Kyarra,F,100,219,0,219
Leresa,F,100,10,0,10
Yamilette,F,100,525,0,525
Zylan,M,100,0,171,171
Vyanna,F,100,11,0,11
Jimmesha,F,100,12,0,12
Tazkia,F,100,6,0,6
Aferdita,F,100,6,0,6
Casadee,F,100,10,0,10
Nkosi,M,98,7,318,325
Ankitha,F,100,59,0,59
Claraliz,F,100,6,0,6
Shacoyia,F,100,11,0,11
Kande,F,100,31,0,31
Erven,M,100,0,34,34
Monterra,F,100,5,0,5
Nicolaus,M,100,0,1082,1082
Chrystin,F,100,45,0,45
Lenett,F,100,5,0,5
Larraine,F,100,529,0,529
Aerielle,F,100,190,0,190
Ivey,F,78,2285,662,2947
Kaleesha,F,100,27,0,27
Eneas,M,100,0,13,13
Izaiah,M,100,5,9204,9209
Keltsey,F,100,6,0,6
Sheletta,F,100,18,0,18
Allizae,F,100,5,0,5
Kiran,M,53,1672,1913,3585
Drisana,F,100,57,0,57
Hatcher,M,100,0,229,229
Jare,M,100,0,38,38
Theona,F,100,30,0,30
Zuhey,F,100,17,0,17
Ivin,M,100,0,313,313
Rosalee,F,100,3366,0,3366
Changa,M,100,0,27,27
Alaniz,F,100,44,0,44
Jacintha,F,100,33,0,33
Tug,M,100,0,35,35
Noriko,F,100,143,0,143
Kyndalyn,F,100,10,0,10
Eveleen,F,100,139,0,139
Nycole,F,100,942,0,942
Talajah,F,100,73,0,73
Ashleyann,F,100,315,0,315
Zeneida,F,100,15,0,15
Iraiz,F,100,16,0,16
Annelle,F,100,386,0,386
Miyali,F,100,7,0,7
Mieisha,F,100,56,0,56
Eleen,F,100,128,0,128
Tyonnah,F,100,5,0,5
Tomoko,F,100,103,0,103
Lendy,F,100,130,0,130
Eireann,F,100,33,0,33
Tustin,M,100,0,24,24
Tryon,M,100,0,34,34
Gertrude,F,100,6072,0,6072
Kandi,F,100,5444,0,5444
Teera,F,100,51,0,51
Elyan,M,100,0,115,115
Maxxon,M,100,0,42,42
Hinal,F,100,5,0,5
Jardon,M,100,0,32,32
Shuniya,F,100,6,0,6
Khadafi,M,100,0,11,11
Trenyce,F,100,123,0,123
Ettie,F,100,80,0,80
Siddeeqah,F,100,18,0,18
Amyri,F,100,134,0,134
Anndy,M,100,0,22,22
Anubis,M,100,0,65,65
Aulora,F,100,30,0,30
Juanette,F,100,103,0,103
Anaira,F,100,146,0,146
Genevra,F,100,93,0,93
Talton,M,100,0,62,62
Joyceline,F,100,82,0,82
Zanyla,F,100,165,0,165
Ilyza,F,100,5,0,5
Vassilios,M,100,0,23,23
Filicity,F,100,5,0,5
Luisito,M,100,0,15,15
Arlet,F,100,760,0,760
Ayeasha,F,100,5,0,5
Maven,M,53,186,213,399
Lashan,F,85,512,87,599
Telesa,F,100,108,0,108
Frazier,M,100,0,869,869
Delrose,F,100,5,0,5
Kenil,M,100,0,5,5
Zubaidah,F,100,5,0,5
Mialyn,F,100,16,0,16
Neev,M,100,0,280,280
Addalina,F,100,5,0,5
Christinejoy,F,100,26,0,26
Sajata,F,100,13,0,13
Brentnie,F,100,6,0,6
Horatio,M,100,0,819,819
Jonjon,M,100,0,8,8
Angus,M,100,0,3513,3513
Daynisha,F,100,17,0,17
Glennwood,M,100,0,10,10
Emmilynn,F,100,42,0,42
Megan,F,100,433986,1103,435089
Dontavious,M,100,0,1688,1688
Sofhia,F,100,56,0,56
Chardarius,M,100,0,5,5
Shravya,F,100,192,0,192
Eliano,M,100,0,11,11
Chemene,F,100,17,0,17
Annelisse,F,100,31,0,31
Laurin,F,90,1568,175,1743
Hayde,F,100,208,0,208
Breahna,F,100,521,0,521
Malekai,M,100,0,100,100
Aylena,F,100,10,0,10
Tannor,M,100,0,347,347
Mariha,F,100,334,0,334
Wana,F,100,42,0,42
Shereese,F,100,238,0,238
Taavon,M,100,0,17,17
Darcell,F,76,506,164,670
Nasiar,M,100,0,12,12
Ngela,F,100,53,0,53
Emryn,F,100,13,0,13
Debanhy,F,100,12,0,12
Walt,M,100,0,1350,1350
Yaziel,M,100,0,117,117
Akaysia,F,100,5,0,5
Dorrell,M,100,0,295,295
Mikaylynn,F,100,5,0,5
Delsen,M,100,0,5,5
Chrissette,F,100,22,0,22
Jaks,M,100,0,5,5
Levone,M,78,24,84,108
Ronna,F,100,3594,0,3594
Margaux,F,100,2143,0,2143
Tymesha,F,100,250,0,250
Elaysia,F,100,223,0,223
Emellie,F,100,14,0,14
Riis,M,100,0,10,10
Tavias,M,100,0,7,7
Azita,F,100,25,0,25
Paightyn,F,100,6,0,6
Taarna,F,100,5,0,5
Jocalyn,F,100,55,0,55
Stephine,F,100,1683,0,1683
Sian,F,93,742,55,797
Yessika,F,100,103,0,103
Klani,F,100,45,0,45
Alexxandria,F,100,15,0,15
Arnab,M,100,0,27,27
Okeima,F,100,5,0,5
Annabella,F,100,10169,0,10169
Neytiri,F,100,65,0,65
Bianka,F,100,2085,0,2085
Angelise,F,100,642,0,642
Ekco,F,100,8,0,8
Edwinn,M,100,0,11,11
Draxton,M,100,0,16,16
Aksa,F,100,5,0,5
Parmanand,M,100,0,5,5
Zhana,F,100,154,0,154
Alexiyah,F,100,37,0,37
Rondi,F,99,569,7,576
Detrina,F,100,12,0,12
Mckynleigh,F,100,36,0,36
Micahel,M,100,0,1413,1413
Grenisha,F,100,6,0,6
Mirrah,F,100,33,0,33
Leslly,F,100,5,0,5
Jabel,M,100,0,10,10
Hayzlie,F,100,5,0,5
Meshulem,M,100,0,55,55
Kyani,F,100,146,0,146
Siale,M,100,0,11,11
Davvid,M,100,0,10,10
Nilza,F,100,66,0,66
Jahriah,F,100,8,0,8
Netty,F,100,19,0,19
Jarron,M,100,0,1413,1413
Kerman,M,100,0,48,48
Fenner,M,100,0,10,10
Letecia,F,100,525,0,525
Paxtin,M,100,0,22,22
Caelix,M,100,0,6,6
Malakye,M,100,0,332,332
Triniti,F,100,2314,0,2314
Karen,F,100,798321,2238,800559
Jnay,F,100,5,0,5
Keyvon,M,100,0,528,528
Mikinlee,F,100,5,0,5
Sokhna,F,100,162,0,162
Bindi,F,100,142,0,142
Raelena,F,100,32,0,32
Melony,F,100,4187,0,4187
Orlenda,F,100,5,0,5
Kiaria,F,100,162,0,162
Mianna,F,100,381,0,381
Khrissa,F,100,5,0,5
Durva,F,100,5,0,5
Bulmaro,M,100,0,292,292
Magdelyn,F,100,165,0,165
Jetaun,F,100,142,0,142
Ruthvik,M,100,0,44,44
Sugei,F,100,6,0,6
Biaca,F,100,6,0,6
Tziry,F,100,11,0,11
Lendal,M,100,0,10,10
Noal,M,100,0,189,189
Tasma,F,100,5,0,5
Raiyna,F,100,6,0,6
Daryk,M,100,0,42,42
Najala,F,100,5,0,5
Kamaurie,M,67,11,22,33
Naraly,F,100,248,0,248
Dajanai,F,100,37,0,37
Jionni,M,98,11,641,652
Shahana,F,100,115,0,115
Vatasha,F,100,6,0,6
Casmin,F,100,5,0,5
Shivank,M,100,0,45,45
Davod,M,100,0,5,5
Dilynn,F,88,280,40,320
Nakiyla,F,100,5,0,5
Kaleshia,F,100,32,0,32
Rickeya,F,100,100,0,100
Montine,F,100,38,0,38
Mistic,F,100,5,0,5
Soila,F,100,461,0,461
Deforest,M,100,0,155,155
Lailah,F,100,3933,0,3933
Jynia,F,100,21,0,21
Tyhisha,F,100,17,0,17
Shovan,F,100,6,0,6
Marquerite,F,100,264,0,264
Joahna,F,100,6,0,6
Kamelah,F,100,26,0,26
Akiah,F,100,126,0,126
Soula,F,100,5,0,5
Oladis,F,100,5,0,5
Alieen,F,100,5,0,5
Shakeeka,F,100,14,0,14
Ambernique,F,100,10,0,10
Statham,M,100,0,32,32
Saahil,M,100,0,298,298
Fareeha,F,100,87,0,87
Placida,F,100,5,0,5
Saavi,F,100,16,0,16
Merida,F,100,477,0,477
Kerstie,F,100,69,0,69
Yeisy,F,100,5,0,5
Horace,M,100,43,13070,13113
Ruthine,F,100,12,0,12
Shakoya,F,100,96,0,96
Lin,F,62,793,491,1284
Tonji,F,100,102,0,102
Kylaa,F,100,11,0,11
Shanovia,F,100,36,0,36
Dannisha,F,100,64,0,64
Zandyr,M,100,0,64,64
Darshini,F,100,11,0,11
Reinardo,M,100,0,5,5
Darihanna,F,100,11,0,11
Darryle,M,100,0,1310,1310
Denisse,F,100,5840,0,5840
Jayne,F,100,20431,32,20463
Kiava,F,100,5,0,5
Eldar,M,100,0,108,108
Danyale,F,95,926,50,976
Zenora,F,100,5,0,5
Champale,F,100,22,0,22
Shahanna,F,100,5,0,5
Janee,F,100,3159,6,3165
Laurel,F,99,33983,382,34365
Kenitra,F,100,319,0,319
Nashira,F,100,232,0,232
Lindwood,M,100,0,36,36
Frederick,M,99,672,125877,126549
Tarell,M,100,0,817,817
Tyvan,M,100,0,43,43
Beonica,F,100,12,0,12
Jailan,M,82,32,147,179
Abigail,F,100,319451,598,320049
Cherrye,F,100,12,0,12
Kayvien,M,100,0,7,7
Rivers,M,65,409,760,1169
Nikhita,F,100,260,0,260
Karmani,F,100,5,0,5
Labib,M,100,0,62,62
Wriley,M,52,11,12,23
Lorilie,F,100,10,0,10
Cahterine,F,100,111,0,111
Jayonna,F,100,775,0,775
Shamille,F,100,25,0,25
Blaine,M,96,980,24470,25450
Maurina,F,100,94,0,94
Ashna,F,100,573,0,573
Dalhia,F,100,10,0,10
Tredarius,M,100,0,134,134
Nayan,M,98,5,307,312
Yomna,F,100,36,0,36
Kenta,M,99,5,640,645
Teneha,F,100,6,0,6
Jalee,F,100,409,0,409
Rilan,M,90,15,138,153
Dionne,F,96,9517,419,9936
Taym,M,100,0,109,109
Eremy,M,100,0,12,12
Kimayah,F,100,19,0,19
Xavia,F,98,489,11,500
Joandry,M,100,0,34,34
Jonnette,F,100,143,0,143
Genovieve,F,100,5,0,5
Samanthanicole,F,100,23,0,23
Mikan,F,100,5,0,5
Terrail,M,100,0,40,40
Kimella,F,100,5,0,5
Kymbria,F,100,11,0,11
Dionysios,M,100,0,59,59
Kael,M,100,10,2791,2801
Catrina,F,100,10018,0,10018
Tarkan,M,100,0,11,11
Elfreda,F,100,166,0,166
Ulissa,F,100,28,0,28
Madhumitha,F,100,29,0,29
Elario,M,100,0,5,5
Camrynne,F,100,7,0,7
Meghna,F,100,553,0,553
Chyene,F,100,5,0,5
Lashley,F,100,5,0,5
Milus,M,100,0,5,5
Jaquain,M,100,0,34,34
Orpheus,M,100,0,60,60
Lemar,M,100,0,1319,1319
Idaliz,F,100,108,0,108
Berit,F,100,551,0,551
Kavarion,M,100,0,16,16
Patriciajo,F,100,30,0,30
Kniya,F,100,56,0,56
Aisosa,F,100,20,0,20
Adjua,F,100,5,0,5
Chloey,F,100,994,0,994
Sherrae,F,100,44,0,44
Lluliana,F,100,26,0,26
Shreyes,M,100,0,17,17
Abran,M,100,0,1644,1644
Ayzen,M,100,0,11,11
Jermont,M,100,0,14,14
Meriel,F,100,250,0,250
Edin,M,93,59,841,900
Gissella,F,100,71,0,71
Seith,M,100,0,125,125
Correena,F,100,5,0,5
Alphonse,M,100,0,2265,2265
Amandaleigh,F,100,5,0,5
Olden,M,100,0,110,110
Samayra,F,100,66,0,66
Macye,F,100,21,0,21
Kathyern,F,100,5,0,5
Wiiliam,M,100,0,25,25
Bhumi,F,100,138,0,138
Dreyden,M,100,0,369,369
Henya,F,100,60,0,60
Iashia,F,100,13,0,13
Sairy,F,100,41,0,41
Seher,F,100,132,0,132
Veona,F,100,5,0,5
Jelaine,F,100,43,0,43
Jalane,F,100,15,0,15
Keyland,M,100,0,11,11
Abriona,F,100,20,0,20
Kierron,M,100,0,5,5
Mikahla,F,100,82,0,82
Jacobmatthew,M,100,0,5,5
Aalyah,F,100,590,0,590
Shawnisha,F,100,21,0,21
Chianti,F,95,388,20,408
Mikolas,M,100,0,13,13
Malaine,F,100,5,0,5
Dillian,M,100,0,567,567
Son,M,99,5,589,594
Charlye,F,100,181,0,181
Zalayah,F,100,131,0,131
Charlee,F,98,7798,185,7983
Gerardette,F,100,36,0,36
Julina,F,100,355,0,355
Leotis,M,100,0,544,544
Annina,F,100,121,0,121
Melane,F,100,210,0,210
Anelle,F,100,106,0,106
Chemere,F,100,79,0,79
Bryse,M,96,6,145,151
Shannara,F,100,44,0,44
Lukaus,M,100,0,5,5
Yaleska,F,100,16,0,16
Latessia,F,100,6,0,6
Dejuna,F,100,6,0,6
Angla,F,100,511,0,511
Janerica,F,100,5,0,5
Zakia,F,99,1567,16,1583
Isamu,M,100,0,41,41
Pashion,F,100,57,0,57
Isa,F,50,1493,1470,2963
Darrol,M,100,0,366,366
Alexia,F,100,40326,44,40370
Laynette,F,100,17,0,17
Danecia,F,100,64,0,64
Brezzy,F,100,5,0,5
Camyiah,F,100,18,0,18
Channce,M,100,0,5,5
Jamilya,F,100,178,0,178
Jagdeep,M,100,0,44,44
Shinesha,F,100,5,0,5
Temujin,M,100,0,39,39
Sidharth,M,100,0,501,501
Gladstone,M,100,0,19,19
Maclan,M,100,0,11,11
Jorrell,M,100,0,149,149
Emmanuella,F,100,755,0,755
Arabian,F,100,6,0,6
Armiah,F,100,10,0,10
Bernd,M,100,0,96,96
Malini,F,100,274,0,274
Rutledge,M,100,0,100,100
Taneeka,F,100,194,0,194
Kamsiyochukwu,M,76,20,63,83
Janii,F,100,22,0,22
Jilliyn,F,100,33,0,33
Brynnley,F,100,357,0,357
Aalyiah,F,100,665,0,665
Semyon,M,100,0,6,6
Javarian,M,100,0,84,84
Milian,F,100,24,0,24
Kelechukwu,M,100,0,6,6
Ninad,M,100,0,5,5
Zenja,F,100,47,0,47
Lucianna,F,100,974,0,974
Naba,F,100,139,0,139
Anke,F,100,5,0,5
Shanikwa,F,100,85,0,85
Naketta,F,100,5,0,5
Izobel,F,100,10,0,10
Katalena,F,100,102,0,102
Shad,M,100,0,4693,4693
Elroi,M,100,0,5,5
Jarus,M,100,0,5,5
Confesor,M,100,0,40,40
Jaynalis,F,100,5,0,5
Isamary,F,100,29,0,29
Valjean,F,100,160,0,160
Kaianna,F,100,71,0,71
Ankur,M,100,0,662,662
Shuvonne,F,100,5,0,5
Alwyn,M,100,0,227,227
Kayson,M,96,154,3340,3494
Markise,M,100,0,191,191
Isaiahs,M,100,0,111,111
Destynee,F,100,765,0,765
Jeweliet,F,100,10,0,10
Yehudit,F,100,89,0,89
Rudaina,F,100,5,0,5
Sae,F,92,60,5,65
Pater,M,100,0,17,17
Michigan,M,100,0,5,5
Dainara,F,100,10,0,10
Adelfa,F,100,72,0,72
Akarsh,M,100,0,29,29
Ellamaria,F,100,5,0,5
Aunaleigh,F,100,5,0,5
Joanie,F,100,4743,0,4743
Tykeith,M,100,0,5,5
Janiayah,F,100,7,0,7
Izabellah,F,100,250,0,250
Rotisha,F,100,5,0,5
Kaceson,M,100,0,5,5
Dennae,F,100,5,0,5
Danesh,M,100,0,12,12
Demarques,M,100,0,254,254
Brittyn,F,100,364,0,364
Joce,M,100,0,10,10
Madellyn,F,100,51,0,51
Kahrin,F,100,5,0,5
Bernesha,F,100,5,0,5
Kristina,F,100,133395,352,133747
Barbra,F,100,5458,0,5458
Zimri,M,94,6,98,104
Prianna,F,100,16,0,16
Taniesha,F,100,775,0,775
Jalayla,F,100,169,0,169
Dequandra,F,100,7,0,7
Tuesdee,F,100,15,0,15
Galathia,F,100,5,0,5
Sheketha,F,100,11,0,11
Mykya,F,100,5,0,5
Nikitra,F,100,5,0,5
Brettley,M,100,0,29,29
Nalleli,F,100,539,0,539
Crescent,F,100,97,0,97
Shartavia,F,100,21,0,21
Elenia,F,100,7,0,7
Solan,M,100,0,113,113
Migual,M,100,0,10,10
Shantice,F,100,125,0,125
Ashley,F,98,834620,13529,848149
Arlesa,F,100,10,0,10
Joeli,F,100,196,0,196
Takeem,M,100,0,57,57
Mikaylee,F,100,265,0,265
Tyhesha,F,100,118,0,118
Keerti,F,100,25,0,25
Shaul,M,100,0,447,447
Lius,M,100,0,5,5
Mystee,F,100,10,0,10
Shdiamond,F,100,12,0,12
Jimmer,M,100,0,9,9
Shardia,F,100,7,0,7
Tekia,F,100,377,0,377
Hannahelizabeth,F,100,5,0,5
Lukas,M,100,19,26844,26863
Yarimar,F,100,123,0,123
Kymesha,F,100,29,0,29
Yeily,F,100,97,0,97
Telisa,F,100,1097,0,1097
Tanequa,F,100,171,0,171
Ternesha,F,100,12,0,12
Deivin,M,100,0,17,17
Jashara,F,100,6,0,6
Itasha,F,100,12,0,12
Jerina,F,100,50,0,50
Arnita,F,100,1374,0,1374
Zamauria,F,100,34,0,34
Her,M,100,0,16,16
Donesha,F,100,652,0,652
Sosha,F,100,149,0,149
Iniyah,F,100,60,0,60
Kweisi,M,100,0,49,49
Caira,F,100,725,0,725
Melinna,F,100,169,0,169
Thomasjames,M,100,0,54,54
Latorria,F,100,151,0,151
Walkiria,F,100,15,0,15
Benjaman,M,100,0,978,978
Elleigh,F,100,278,0,278
Marigny,F,100,51,0,51
Eyen,M,100,0,7,7
Analah,F,100,14,0,14
Takhiya,F,100,12,0,12
Audriona,F,100,14,0,14
Antoinetta,F,100,374,0,374
Desean,M,100,11,3549,3560
Lorrayne,F,100,127,0,127
Izuchukwu,M,100,0,20,20
Kinsleigh,F,100,519,0,519
Jenilca,F,100,7,0,7
Manraj,M,100,0,243,243
Zhaki,M,100,0,5,5
Mistye,F,100,15,0,15
Marijean,F,100,172,0,172
Lopaka,M,100,0,134,134
Emileigh,F,100,1116,0,1116
Samule,M,100,0,237,237
Genesi,F,100,144,0,144
Emora,F,100,5,0,5
Thia,F,100,214,0,214
Jamaur,M,100,0,10,10
Lhiam,M,100,0,7,7
Tanzania,F,100,666,0,666
Carlton,M,99,199,29377,29576
Mareon,M,100,0,96,96
Riylee,F,100,17,0,17
Jaqualyn,M,90,11,96,107
Oasis,F,97,154,5,159
Lamyia,F,100,177,0,177
Roko,M,100,0,27,27
Rosylin,F,100,5,0,5
Man,M,65,49,92,141
Treyton,M,100,0,2689,2689
Tuwanda,F,100,161,0,161
Keyanni,F,100,42,0,42
Rondee,F,100,5,0,5
Taylea,F,100,27,0,27
Jo,F,99,92962,1006,93968
Natalya,F,100,5553,0,5553
Mardene,F,100,36,0,36
Kyneshia,F,100,6,0,6
Trish,F,100,3016,0,3016
Kyce,M,100,0,95,95
Bayleen,F,100,5,0,5
Laveya,F,100,33,0,33
Caylah,F,100,377,0,377
Bub,M,100,0,5,5
Serae,F,100,5,0,5
Jyion,M,100,0,5,5
Cinderella,F,100,401,0,401
Crystianna,F,100,9,0,9
Alizea,F,100,258,0,258
Breaanna,F,100,6,0,6
Shanetria,F,100,40,0,40
Myrion,M,100,0,20,20
Sier,M,100,0,5,5
Tyra,F,99,13933,126,14059
Jw,M,100,0,261,261
Lekayla,F,100,5,0,5
Catheleen,F,100,55,0,55
Kilby,M,100,0,6,6
Zavius,M,100,0,17,17
Moctezuma,M,100,0,17,17
Dantre,M,100,0,65,65
Aedon,M,100,0,127,127
Lakeia,F,100,519,0,519
Guyton,M,100,0,16,16
Dimetra,F,100,20,0,20
Lucah,M,100,0,125,125
Odilia,F,100,584,0,584
Electa,F,100,238,0,238
Kricia,F,100,6,0,6
Duward,M,100,0,6,6
Khan,M,100,0,266,266
Kanitra,F,100,125,0,125
Cheryn,F,100,130,0,130
Jamii,F,100,5,0,5
Margan,F,100,92,0,92
Daiyan,M,100,0,36,36
Turkessa,F,100,280,0,280
Yusha,M,100,0,20,20
Maelynne,F,100,5,0,5
Jannatul,F,100,86,0,86
Vondale,M,100,0,6,6
Elzabeth,F,100,38,0,38
Havin,F,100,28,0,28
Khamora,F,100,82,0,82
Krysteen,F,100,5,0,5
Georges,M,100,0,568,568
Sharlie,F,100,258,0,258
Keari,F,100,135,0,135
Elonda,F,100,575,0,575
Hasib,M,100,0,43,43
Doryan,M,100,0,91,91
Marya,F,100,1808,0,1808
Tonica,F,100,248,0,248
Lujain,F,100,176,0,176
Evy,F,100,717,0,717
Denroy,M,100,0,6,6
Chatal,F,100,5,0,5
Ponda,F,100,41,0,41
Artemisa,F,100,74,0,74
Namit,M,100,0,8,8
Khilyn,M,51,28,29,57
Gentri,F,100,72,0,72
Nicketa,F,100,10,0,10
Elefteria,F,100,10,0,10
Orya,F,100,5,0,5
Cleophus,M,100,0,981,981
Aarushi,F,100,589,0,589
Traver,M,100,0,290,290
Ayli,F,100,30,0,30
Navid,M,96,26,643,669
Zameir,M,100,0,22,22
Marnesha,F,100,84,0,84
Krishunna,F,100,5,0,5
Adlen,F,100,11,0,11
Ashby,M,56,605,756,1361
Makaylee,F,100,1236,0,1236
Oluwamayomikun,M,100,0,5,5
Shakeil,M,100,0,55,55
Mishell,F,100,451,0,451
Sadara,F,100,10,0,10
Yochanan,M,100,0,180,180
Eraldo,M,100,0,6,6
Altie,M,100,0,10,10
Gavian,M,100,0,5,5
Ellee,F,100,836,0,836
Anoush,F,100,21,0,21
Dajean,M,100,0,24,24
Davidjeremiah,M,100,0,5,5
Olyvea,F,100,10,0,10
Quinell,M,100,0,28,28
Maliki,M,100,0,746,746
Sakia,F,100,263,0,263
Skip,M,100,0,1686,1686
Shria,F,100,34,0,34
Shahnawaz,M,100,0,5,5
Ellias,M,100,0,202,202
Meryam,F,100,29,0,29
Dalibor,M,100,0,5,5
Urena,F,100,5,0,5
Count,M,100,0,5,5
Yoland,F,100,249,0,249
Landers,M,100,0,54,54
Dom,M,100,0,183,183
Addelin,F,100,22,0,22
Tashia,F,100,2359,0,2359
Azula,F,100,33,0,33
Robertcharles,M,100,0,5,5
Paje,F,100,6,0,6
Ameina,F,100,6,0,6
Loany,F,100,31,0,31
Jakayle,F,100,5,0,5
Coey,F,50,5,5,10
Johni,F,100,239,0,239
Brette,F,98,568,11,579
Emerlynn,F,100,6,0,6
Achel,F,100,39,0,39
Ashleyrose,F,100,32,0,32
Sheyda,F,100,23,0,23
Rhania,F,100,6,0,6
Nouf,F,100,12,0,12
Deverly,F,100,5,0,5
Ohm,M,100,0,175,175
Rhodesia,F,100,95,0,95
Esmeraldo,F,100,46,0,46
Rictavious,M,100,0,5,5
Jassidy,F,100,21,0,21
Kristoher,M,100,0,7,7
Tayvin,M,94,19,313,332
Scout,F,68,1934,906,2840
Dazhane,F,100,154,0,154
Tanechia,F,100,6,0,6
Damere,M,100,0,180,180
Ebru,F,100,22,0,22
Ismaaeel,M,100,0,5,5
Deda,F,100,5,0,5
Dandrick,M,100,0,5,5
Guadelupe,F,100,34,0,34
Maryka,F,100,5,0,5
Dierre,M,100,0,144,144
Gerrald,M,100,0,93,93
Gricell,F,100,6,0,6
Tonnette,F,100,382,0,382
Eulas,M,100,0,75,75
Areeg,F,100,11,0,11
Carola,F,100,567,0,567
Lisha,F,100,2351,0,2351
Kwinn,F,100,5,0,5
Kalandra,F,100,201,0,201
Kaibren,M,100,0,6,6
Ahsha,F,100,82,0,82
Jaylany,F,100,12,0,12
Grady,M,99,163,23140,23303
Zohan,M,100,0,13,13
Rickeeta,F,100,5,0,5
Oluwatoni,F,75,79,26,105
Benn,M,100,0,300,300
Hervey,M,100,0,344,344
Jaylenne,F,100,170,0,170
Shaton,F,91,101,10,111
Dakara,F,100,12,0,12
Katelynd,F,100,274,0,274
Eammon,M,100,0,11,11
Oli,M,100,0,12,12
Davy,M,94,124,2081,2205
Joi,F,100,5274,0,5274
Cieria,F,100,52,0,52
Fariba,F,100,12,0,12
Ninnette,F,100,5,0,5
Jerika,F,100,1376,0,1376
Mirsad,M,100,0,10,10
Roxii,F,100,5,0,5
Keyandrea,F,100,5,0,5
Sella,F,100,5,0,5
Alline,F,100,135,0,135
Lylianah,F,100,45,0,45
Rasha,F,94,600,37,637
Tahari,F,57,63,47,110
Tahshawn,M,100,0,5,5
Shahmir,M,100,0,28,28
Jaques,M,98,5,306,311
Layeska,F,100,5,0,5
Dayveion,M,100,0,5,5
Mizell,M,100,0,32,32
Lakeyia,F,100,178,0,178
Amaliya,F,100,42,0,42
Sobrina,F,100,12,0,12
Neelan,M,100,0,12,12
Kentarius,M,100,0,72,72
Tulia,F,100,23,0,23
Solena,F,100,41,0,41
Gari,F,76,407,130,537
Latae,F,100,5,0,5
Hinton,M,100,0,119,119
Denajia,F,100,10,0,10
Adonai,M,77,144,477,621
Deaudre,M,100,0,15,15
Edelina,F,100,10,0,10
Jereny,M,100,0,6,6
Levy,M,99,22,1509,1531
Halleli,F,100,5,0,5
Herold,M,100,0,99,99
Jasime,F,100,116,0,116
Andrekia,F,100,7,0,7
Shaili,F,100,144,0,144
Janeen,F,100,5809,0,5809
Zander,M,100,21,15518,15539
Melbra,F,100,5,0,5
Hadden,M,96,16,419,435
Marciela,F,100,21,0,21
Lorieann,F,100,73,0,73
Davison,M,100,0,232,232
Sarith,M,100,0,11,11
Murry,M,99,5,884,889
Aalanah,F,100,21,0,21
Ladaisia,F,100,6,0,6
Shaquille,M,93,387,5283,5670
Abbra,F,100,36,0,36
Shaynna,F,100,233,0,233
Daltry,M,100,0,6,6
Meuy,F,100,43,0,43
Marguitta,F,100,13,0,13
Aprill,F,100,406,0,406
Percilla,F,100,366,0,366
Devara,F,100,7,0,7
Tamecca,F,100,67,0,67
Rimantas,M,100,0,6,6
Elayne,F,100,1616,0,1616
Zahmaria,F,100,5,0,5
Taeryn,F,100,5,0,5
Chasidee,F,100,28,0,28
Tempsett,F,100,5,0,5
Gitana,F,100,15,0,15
Tammy,F,100,331039,1386,332425
Avshalom,M,100,0,5,5
Starkey,M,100,0,5,5
Marguarite,F,100,30,0,30
Tangelo,M,100,0,5,5
Sheharyar,M,100,0,5,5
Heller,F,100,5,0,5
Mende,F,100,61,0,61
Elijuah,M,100,0,45,45
Jeric,M,100,0,526,526
Shalini,F,100,759,0,759
Kalysa,F,100,59,0,59
Akeara,F,100,6,0,6
Aneiyah,F,100,5,0,5
Ande,F,82,159,36,195
Jacobey,M,100,0,151,151
Ashwika,F,100,95,0,95
Avalyse,F,100,11,0,11
Jaytee,M,100,0,15,15
Jaquilla,F,100,90,0,90
Chatavia,F,100,10,0,10
Mickenna,F,100,51,0,51
Landrum,M,100,0,28,28
Travis,M,99,1720,286336,288056
Felisitas,F,100,7,0,7
Shiza,F,100,115,0,115
Bernicia,F,100,7,0,7
Kolbee,M,53,47,54,101
Corderial,M,100,0,5,5
Stehpanie,F,100,10,0,10
Jeslyn,F,100,1172,0,1172
Octaviana,F,100,5,0,5
Malaiya,F,100,195,0,195
Dequita,F,100,86,0,86
Ellyza,F,100,5,0,5
Callon,M,100,0,20,20
Virginie,F,100,26,0,26
Cade,M,100,91,23941,24032
Sereena,F,100,259,0,259
Daizia,F,100,19,0,19
Elysabeth,F,100,180,0,180
Raetta,F,100,44,0,44
Inese,F,100,16,0,16
Marylen,F,100,18,0,18
Jeiel,M,100,0,23,23
Koamalu,M,100,0,15,15
Paris,F,77,24233,7078,31311
Archan,M,100,0,12,12
Austria,F,100,17,0,17
Carrah,F,100,137,0,137
Camerynn,F,100,11,0,11
Tausif,M,100,0,16,16
Ramone,M,99,12,2190,2202
Rooks,M,100,0,5,5
Mckala,F,100,230,0,230
Scharlene,F,100,68,0,68
Ebanie,F,100,11,0,11
Domiano,M,100,0,10,10
Laiona,F,100,5,0,5
Laiklynn,F,100,12,0,12
Charolet,F,100,17,0,17
Daesean,M,100,0,235,235
Susannah,F,100,6358,0,6358
Serene,F,100,2025,0,2025
Davenia,F,100,12,0,12
Nikitas,M,100,0,67,67
Thamer,M,100,0,11,11
Nassem,M,100,0,6,6
Caley,F,94,2350,145,2495
Suleika,F,100,137,0,137
Julianna,F,100,37741,26,37767
Joelly,F,100,129,0,129
Duvier,M,100,0,7,7
Janani,F,100,295,0,295
Jaymier,M,100,0,35,35
Sheliza,F,100,5,0,5
Annmargaret,F,100,189,0,189
Mandilyn,F,100,34,0,34
Arlee,F,81,347,84,431
Reigha,F,100,6,0,6
Eshe,F,100,56,0,56
Alaycia,F,100,181,0,181
Neilla,F,100,5,0,5
Babby,F,100,34,0,34
Karthikeya,M,100,0,115,115
Willena,F,100,325,0,325
Tyranae,F,100,5,0,5
Cantrice,F,100,51,0,51
Valentinna,F,100,5,0,5
Glenward,M,100,0,6,6
Miani,F,100,36,0,36
Lashaya,F,100,268,0,268
Townes,M,100,0,362,362
Seymone,F,100,65,0,65
Kataleah,F,100,44,0,44
Lache,F,100,109,0,109
Maaseiah,M,100,0,5,5
Britlany,F,100,13,0,13
Mesina,F,100,10,0,10
Avonelle,F,100,17,0,17
Snezana,F,100,40,0,40
Tramon,M,100,0,306,306
Danillie,F,100,12,0,12
Josiana,F,100,17,0,17
Deaisha,F,100,170,0,170
Deadrick,M,100,0,179,179
Godrick,M,100,0,10,10
Zaydrian,M,100,0,70,70
Nieva,F,100,10,0,10
Daivd,M,100,0,963,963
Khalise,F,100,74,0,74
Averiana,F,100,143,0,143
Kenah,F,100,8,0,8
Eliasib,M,100,0,5,5
Miylah,F,100,17,0,17
Areti,F,100,29,0,29
Armesha,F,100,16,0,16
Gurnoor,F,62,178,109,287
Alaynie,F,100,10,0,10
Zafirah,F,100,126,0,126
Acamas,M,100,0,6,6
Minika,F,100,18,0,18
Jeovanni,M,100,0,370,370
Corddaryl,M,100,0,5,5
Yaroslav,M,100,0,144,144
Brenita,F,100,55,0,55
Faten,F,100,167,0,167
Briyana,F,100,762,0,762
Kayshawn,M,100,0,347,347
Shaunte,F,95,1693,88,1781
Sabien,M,100,0,175,175
Iver,M,100,0,363,363
Athelia,F,100,11,0,11
Vincenzo,M,100,0,6216,6216
Vianey,F,100,3086,0,3086
Isenia,F,100,18,0,18
Kornelia,F,100,22,0,22
Kareemah,F,100,354,0,354
Niola,F,100,5,0,5
Isais,M,100,0,165,165
Forum,F,100,5,0,5
Yerin,F,100,27,0,27
Tiffanymarie,F,100,25,0,25
Kyris,M,100,0,34,34
Safira,F,100,128,0,128
Mckeon,M,100,0,10,10
Fleetwood,M,100,0,11,11
Nicklos,M,100,0,251,251
Aliou,M,100,0,88,88
Omariah,F,100,12,0,12
Jimesha,F,100,77,0,77
Dhanya,F,100,159,0,159
Dileydi,F,100,6,0,6
Conleigh,F,100,39,0,39
Vihana,F,100,30,0,30
Coltan,M,100,0,652,652
Kovin,M,100,0,14,14
Edrey,M,100,0,13,13
Ngocanh,F,100,5,0,5
Sacorya,F,100,5,0,5
Nathanim,M,100,0,12,12
Aidel,F,100,200,0,200
Yomar,M,100,0,262,262
De,M,53,539,617,1156
Lautaro,M,100,0,74,74
Eldrin,M,100,0,15,15
Karanvir,M,100,0,61,61
Julaine,F,100,409,0,409
Kairah,F,100,120,0,120
Juaquina,F,100,23,0,23
Garr,M,100,0,22,22
Paal,M,100,0,14,14
Nyshon,M,100,0,5,5
Redith,F,100,5,0,5
Namita,F,100,135,0,135
Cevion,M,100,0,11,11
Romia,F,100,5,0,5
Suleima,F,100,286,0,286
Sayonara,F,100,6,0,6
Teshawna,F,100,54,0,54
Quantia,F,100,102,0,102
Kirstee,F,100,32,0,32
Derek,M,100,910,223548,224458
Selenne,F,100,63,0,63
Ieshea,F,100,50,0,50
Jademarie,F,100,28,0,28
Qmari,M,100,0,10,10
Dely,F,100,5,0,5
Leshauna,F,100,5,0,5
Deella,F,100,5,0,5
Azarriah,F,100,48,0,48
Isiaih,M,100,0,187,187
Mergim,M,100,0,25,25
Rakshitha,F,100,5,0,5
Kamahao,M,100,0,32,32
Timayah,F,100,6,0,6
Jahaziel,M,100,0,885,885
Thomasjohn,M,100,0,16,16
Janniah,F,100,5,0,5
Travas,M,100,0,199,199
Lusine,F,100,85,0,85
Daphnee,F,100,321,0,321
Neepa,F,100,6,0,6
Nierra,F,100,22,0,22
Palani,M,100,0,30,30
Johannie,F,100,5,0,5
Lilyrae,F,100,6,0,6
Lucecita,F,100,19,0,19
Coady,M,100,0,189,189
Thuthuy,F,100,5,0,5
Loi,M,82,12,53,65
Pearlean,F,100,194,0,194
Breshia,F,100,6,0,6
Ajdin,M,100,0,245,245
Mylik,M,100,0,113,113
Preet,M,62,77,125,202
Shymia,F,100,15,0,15
Jacorien,M,100,0,21,21
Menucha,F,100,360,0,360
Annzlee,F,100,13,0,13
Genissa,F,100,5,0,5
Maryjoy,F,100,28,0,28
Marielisa,F,100,10,0,10
Phares,M,100,0,31,31
Shontee,F,100,41,0,41
Katharin,F,100,77,0,77
Colen,M,100,0,330,330
Jeffory,M,100,0,1117,1117
Nidra,F,100,44,0,44
Saheb,M,100,0,5,5
Kashea,F,100,36,0,36
Dadriana,F,100,6,0,6
Janaee,F,100,11,0,11
Arethea,F,100,28,0,28
Saleste,F,100,10,0,10
Genesys,F,100,279,0,279
Amylyn,F,100,12,0,12
Kevyn,M,89,235,1933,2168
Kitzie,F,100,27,0,27
Niquisha,F,100,5,0,5
Roda,F,100,68,0,68
Tereka,F,100,107,0,107
Charetta,F,100,5,0,5
Davonn,M,100,0,241,241
Lizanne,F,100,404,0,404
Tamille,F,100,15,0,15
Kayon,M,97,6,232,238
Cherelyn,F,100,14,0,14
Beretta,F,100,77,0,77
Chesa,F,100,32,0,32
Kadri,F,100,5,0,5
Yohel,M,100,0,16,16
Nakisha,F,100,2459,0,2459
Omni,F,95,192,10,202
Valerieann,F,100,23,0,23
Caliel,M,100,0,10,10
Sherryn,F,100,18,0,18
Jamarco,M,100,0,226,226
Jolie,F,100,10038,0,10038
Lontrell,M,100,0,6,6
Shelbylyn,F,100,21,0,21
Temesa,F,100,5,0,5
Cadyn,M,70,360,847,1207
Kahiem,M,100,0,5,5
Andalasia,F,100,22,0,22
Shernice,F,100,22,0,22
Krystalle,F,100,74,0,74
Estralita,F,100,11,0,11
Lake,M,86,261,1659,1920
Carston,M,100,0,493,493
Marven,M,100,0,268,268
Janenne,F,100,12,0,12
Ekansh,M,100,0,58,58
Nigeria,F,100,755,0,755
Delino,M,100,0,7,7
Ahmarria,F,100,5,0,5
Zorian,M,100,0,174,174
Demetris,M,73,892,2465,3357
Joelie,F,100,179,0,179
Aliany,F,100,87,0,87
Mattia,M,51,136,140,276
Maegon,F,100,10,0,10
Grindle,F,100,21,0,21
Joyette,F,100,10,0,10
Nilayah,F,100,10,0,10
Ewald,M,100,0,33,33
Dovon,M,100,0,13,13
Marium,F,100,298,0,298
Aljoharah,F,100,5,0,5
Sanihya,F,100,5,0,5
Rhondalyn,F,100,137,0,137
Reshad,M,100,0,160,160
Kernis,M,100,0,6,6
Hadassah,F,100,4219,0,4219
Almon,M,100,0,327,327
Anges,F,100,5,0,5
Atarah,F,100,204,0,204
Ale,M,100,0,8,8
Niyat,F,100,5,0,5
Romello,M,100,0,1593,1593
Doua,M,58,28,39,67
Shamarah,F,100,28,0,28
Isayiah,M,100,0,6,6
Brodi,M,82,124,555,679
Venicia,F,100,189,0,189
Rashawnda,F,100,376,0,376
Sylee,F,100,10,0,10
Cattaleya,F,100,137,0,137
Carleton,M,100,0,1957,1957
Graceson,M,86,23,139,162
Dak,M,100,0,62,62
Tiziana,F,100,140,0,140
Sharette,F,100,22,0,22
Analiz,F,100,523,0,523
Jewely,F,100,5,0,5
Lazara,F,100,140,0,140
Junea,F,100,5,0,5
Elishia,F,100,587,0,587
Chancelor,M,100,0,712,712
Latanga,F,100,152,0,152
Ronita,F,100,659,0,659
Stephun,M,100,0,5,5
Cyndi,F,100,3477,0,3477
Dartanian,M,100,0,193,193
Carolena,F,100,350,0,350
Leonidas,M,100,0,2898,2898
Athalia,F,100,349,0,349
Naidelyn,F,100,496,0,496
Lensa,F,100,5,0,5
Jyiah,F,100,5,0,5
Tabbitha,F,100,699,0,699
Khaleed,M,100,0,146,146
Nykesha,F,100,51,0,51
Bradlie,F,76,34,11,45
Laila,F,100,27993,23,28016
Sabine,F,100,2430,0,2430
Cristiano,M,100,0,1583,1583
Tinina,F,100,6,0,6
Jovonta,M,100,0,79,79
Jaylene,F,99,7108,75,7183
Mirola,F,100,17,0,17
Sheindel,F,100,38,0,38
Cordae,M,99,5,449,454
Nahyma,F,100,5,0,5
Letwan,M,100,0,5,5
Fredirick,M,100,0,30,30
Yanina,F,100,367,0,367
Leaser,F,100,7,0,7
Kaeley,F,100,770,0,770
Shureka,F,100,23,0,23
Genki,M,100,0,5,5
Ennifer,F,100,208,0,208
Onawa,F,100,17,0,17
Lorrane,F,100,57,0,57
Melady,F,100,85,0,85
Talisa,F,100,2011,0,2011
Deidri,F,100,5,0,5
Chaunci,F,100,5,0,5
Jayla,F,100,34310,51,34361
Deyona,F,100,95,0,95
Pavan,M,100,0,517,517
Tica,F,100,7,0,7
Janella,F,100,1507,0,1507
Casanova,M,100,0,115,115
Jena,F,100,12701,7,12708
Donnavon,M,100,0,45,45
Jillianne,F,100,459,0,459
Deavion,M,63,193,325,518
Abdur,M,100,0,233,233
Nandhana,F,100,11,0,11
Jibreal,M,100,0,6,6
Tamaron,F,100,5,0,5
Ison,M,100,0,84,84
Snya,F,100,13,0,13
Martine,F,88,2236,299,2535
Jerremy,M,100,0,404,404
Anyra,F,100,60,0,60
Niha,F,100,31,0,31
Roney,M,100,0,601,601
Kameera,F,100,5,0,5
Xzadrian,M,100,0,20,20
Dalinda,F,100,377,0,377
Nnaemeka,M,100,0,89,89
Markisha,F,100,1135,0,1135
Rodrick,M,100,5,8134,8139
Laylanie,F,100,180,0,180
Kaileb,M,100,0,606,606
Geren,M,100,0,15,15
Rhyse,M,69,64,142,206
Automn,F,100,6,0,6
Maximas,M,100,0,51,51
Quashay,F,100,10,0,10
Russ,M,100,0,4991,4991
Showanda,F,100,15,0,15
Erickia,F,100,5,0,5
Fredricks,M,100,0,10,10
Tyrrell,M,100,0,623,623
Virgia,F,100,82,0,82
Tiffannie,F,100,182,0,182
Skya,F,100,73,0,73
Demetriu,M,100,0,9,9
Arriannah,F,100,5,0,5
Kellyanne,F,100,560,0,560
Ranferi,M,100,0,132,132
Aubree,F,100,26904,31,26935
Illythia,F,100,5,0,5
Reyn,M,98,5,229,234
Josilyn,F,100,964,0,964
Somia,F,100,21,0,21
Olufunke,F,100,21,0,21
Kerena,F,100,36,0,36
Schyler,M,56,595,750,1345
Yulisa,F,100,1799,0,1799
Adelis,F,100,56,0,56
Jong,M,100,0,69,69
Jacarter,M,100,0,5,5
Lander,M,100,0,611,611
Gwenneth,F,100,110,0,110
Joscelyn,F,100,1930,0,1930
Rozeta,F,100,5,0,5
Jamear,M,100,0,114,114
Shaquetta,F,100,457,0,457
Andreamarie,F,100,15,0,15
Avelia,F,100,11,0,11
Ajla,F,100,519,0,519
Nisa,F,100,1481,0,1481
Adri,F,88,144,20,164
Anfernee,M,100,0,1180,1180
Sigurd,M,100,0,144,144
Rashone,M,82,6,28,34
Hayston,M,100,0,10,10
Angelos,M,100,0,215,215
Desari,F,100,5,0,5
Cote,M,100,0,163,163
Tearria,F,100,44,0,44
Asbel,M,100,0,19,19
Damonique,F,100,215,0,215
Shaelene,F,100,33,0,33
Ellycia,F,100,5,0,5
Taliesha,F,100,10,0,10
Kiron,M,100,0,239,239
Cateena,F,100,19,0,19
Giulio,M,100,0,440,440
Yoexis,M,100,0,6,6
Josalynn,F,100,617,0,617
Eisa,M,74,45,130,175
Berlyn,F,100,672,0,672
Duard,M,100,0,78,78
Brazen,M,100,0,59,59
Finlay,M,83,103,518,621
Kyu,M,100,0,54,54
Eustolio,M,100,0,10,10
Lonnita,F,100,5,0,5
Zel,M,100,0,5,5
Gianinna,F,100,10,0,10
Andrewjoseph,M,100,0,32,32
Naamah,F,100,47,0,47
Milisa,F,100,312,0,312
Dehlila,F,100,18,0,18
Chinwendu,F,100,16,0,16
Raima,F,100,140,0,140
Massiel,F,100,687,0,687
Mayko,M,100,0,6,6
Daevin,M,100,0,53,53
Marking,M,100,0,5,5
Watt,M,100,0,49,49
Leshae,F,100,94,0,94
Kidada,F,100,93,0,93
Taeshia,F,100,5,0,5
Carime,F,100,132,0,132
Candyse,F,100,10,0,10
Ricquita,F,100,5,0,5
Estavon,M,100,0,5,5
Larmont,M,100,0,10,10
Solmaira,F,100,15,0,15
Jaia,F,100,556,0,556
Taria,F,96,679,26,705
Tenneill,F,100,5,0,5
Arkeem,M,100,0,197,197
Yuvaan,M,100,0,73,73
Delantae,M,100,0,5,5
Marqita,F,100,28,0,28
Milania,F,100,1658,0,1658
Moona,F,100,7,0,7
Tashae,F,100,345,0,345
Guillaume,M,100,0,310,310
Cason,M,99,60,6454,6514
Leconte,M,100,0,6,6
Jordanmichael,M,100,0,11,11
Nitya,F,99,732,5,737
Simy,F,100,10,0,10
Keyjuan,M,100,0,58,58
Heida,F,100,29,0,29
Tella,F,100,16,0,16
Taylorgrace,F,100,5,0,5
Rondrick,M,100,0,78,78
Yae,F,100,5,0,5
Erum,F,100,114,0,114
Chennelle,F,100,10,0,10
Drevonn,M,100,0,6,6
Ziomara,F,100,202,0,202
Monalee,F,100,11,0,11
Laurna,F,100,60,0,60
Ahlivia,F,100,75,0,75
Nakhia,F,100,246,0,246
Zyesha,F,100,10,0,10
Onedia,F,100,12,0,12
Lakoya,F,100,11,0,11
Malaia,F,100,163,0,163
Seta,F,100,15,0,15
Madelinne,F,100,16,0,16
Jozilyn,F,100,20,0,20
Nabia,F,100,15,0,15
Avren,M,100,0,8,8
Ocie,M,74,287,820,1107
Dazya,F,100,16,0,16
Keileigh,F,100,198,0,198
Armad,M,100,0,33,33
Darla,F,100,36104,27,36131
Elisah,M,72,37,95,132
Laterica,F,100,202,0,202
Swastik,M,100,0,7,7
Miyabi,F,100,25,0,25
Kedus,M,100,0,33,33
Abdulkadir,M,100,0,100,100
Chadney,M,90,5,43,48
Isalena,F,100,5,0,5
Prayag,M,100,0,17,17
Cayton,M,80,27,111,138
Cate,F,100,1455,0,1455
Alicia,F,100,210934,666,211600
Deantwan,M,100,0,17,17
Trakeila,F,100,7,0,7
Zuhayr,M,100,0,144,144
Atif,M,100,0,405,405
Jerramy,M,100,0,43,43
Delaynee,F,100,154,0,154
Elyzabeth,F,100,413,0,413
Joksan,M,100,0,13,13
Dawid,M,100,0,293,293
Tatem,F,59,276,188,464
Meichele,F,100,6,0,6
Nancyjo,F,100,52,0,52
Niurca,F,100,5,0,5
Kazoua,F,100,63,0,63
Jamaurion,M,100,0,80,80
Edman,M,100,0,43,43
Emmett,M,100,38,23011,23049
Romell,M,98,22,1219,1241
Ledeja,F,100,5,0,5
Lainie,F,100,1606,0,1606
Cloretta,F,100,23,0,23
Tyasiah,F,100,27,0,27
Akaysha,F,100,131,0,131
Tayzha,F,100,20,0,20
Khaliah,F,100,929,0,929
Williman,M,100,0,5,5
Irsa,F,100,14,0,14
Zahier,M,100,0,12,12
Micaelah,F,100,17,0,17
Pascha,F,100,214,0,214
Mustafaa,M,100,0,32,32
Miyoshi,F,100,311,0,311
Tynan,M,100,0,665,665
Atreau,M,100,0,5,5
Onnaleigh,F,100,5,0,5
Dayln,M,93,6,77,83
Malicai,M,100,0,5,5
Nickolis,M,100,0,258,258
Kohl,M,100,0,1527,1527
Jyllian,F,100,244,0,244
Ellijah,M,100,0,423,423
Alesia,F,100,7179,0,7179
Veryl,M,100,0,100,100
Jerelene,F,100,62,0,62
Mattingly,F,81,224,53,277
Brandyce,F,100,100,0,100
Duquan,M,100,0,87,87
Stacci,F,100,6,0,6
Million,M,100,0,102,102
Sefora,F,100,127,0,127
Naydeen,F,100,72,0,72
Talei,F,100,17,0,17
Marsa,F,100,61,0,61
Jacinda,F,100,4066,0,4066
Louren,F,100,58,0,58
Anneshia,F,100,5,0,5
Dynasti,F,100,340,0,340
Koltynn,M,100,0,5,5
Gervais,M,100,0,6,6
Ticha,F,100,5,0,5
Bambie,F,100,227,0,227
Ishayu,M,100,0,6,6
Lindle,M,100,0,11,11
Nejla,F,100,108,0,108
Goku,M,100,0,11,11
Rehanna,F,100,215,0,215
Aryanne,F,100,51,0,51
Skyelyn,F,100,62,0,62
Evoleth,F,100,122,0,122
Eulice,M,100,0,18,18
Minako,F,100,7,0,7
Jasek,M,100,0,7,7
Sephina,F,100,14,0,14
Senovio,M,100,0,6,6
Elliet,F,100,83,0,83
Kaley,F,100,12446,25,12471
Muna,F,100,875,0,875
Carsyn,F,71,2297,943,3240
Venera,F,100,7,0,7
Saku,M,100,0,5,5
Relanda,F,100,6,0,6
Wagner,M,100,0,249,249
Nimsi,F,100,130,0,130
Taisa,F,100,146,0,146
Marrk,M,100,0,5,5
Sena,F,92,1389,126,1515
Deshaune,M,100,0,19,19
Lillis,F,100,48,0,48
Concettina,F,100,24,0,24
Roree,F,100,35,0,35
Zadee,F,100,11,0,11
Cadden,M,100,0,66,66
Tynica,F,100,5,0,5
Ko,M,81,10,44,54
Manny,M,100,0,2868,2868
Zo,F,86,60,10,70
Mckinzy,F,100,133,0,133
Sadee,F,100,678,0,678
Sema,F,100,141,0,141
Ridah,F,100,16,0,16
Xandir,M,100,0,11,11
Adonnis,M,100,0,338,338
Annasofia,F,100,98,0,98
Atheana,F,100,17,0,17
Tomesha,F,100,249,0,249
Phuongvy,F,100,6,0,6
Melvena,F,100,101,0,101
Taysia,F,100,486,0,486
Anaya,F,100,9242,0,9242
Sayre,M,57,62,81,143
Harshika,F,100,41,0,41
Consepcion,F,100,121,0,121
Vinay,M,100,0,1055,1055
Xanadu,F,100,10,0,10
Manjari,F,100,6,0,6
Jarayah,F,100,5,0,5
Dasir,M,100,0,18,18
Evie,F,100,6226,5,6231
Kathan,M,100,0,162,162
Maximus,M,100,7,17659,17666
Azaan,M,100,0,516,516
Victoriamarie,F,100,18,0,18
Khawla,F,100,5,0,5
Mirianna,F,100,10,0,10
Lynnise,F,100,10,0,10
Ahana,F,100,422,0,422
Harish,M,100,0,322,322
Tyrika,F,100,137,0,137
Azahria,F,100,41,0,41
Jahlani,M,94,11,165,176
Sumayyah,F,100,554,0,554
Travonn,M,100,0,47,47
Francy,F,100,141,0,141
Ivan,M,99,498,96137,96635
Sharad,M,100,0,105,105
Kimbrell,F,50,5,5,10
Wenonah,F,100,148,0,148
Hadia,F,100,332,0,332
Quinlin,M,97,5,189,194
Quince,M,100,0,336,336
Adryan,M,85,157,890,1047
Yuraima,F,100,22,0,22
Taurance,M,100,0,5,5
Lacye,F,100,119,0,119
Cayliana,F,100,18,0,18
Linoshka,F,100,6,0,6
Zatavia,F,100,6,0,6
Alta,F,100,3044,0,3044
Johnte,M,100,0,172,172
Amyah,F,100,2303,0,2303
Chevonda,F,100,11,0,11
Anarosa,F,100,327,0,327
Hanalei,F,100,106,0,106
Michayla,F,100,1316,0,1316
Annaliese,F,100,3547,0,3547
Britt,M,60,2883,4255,7138
Layaan,F,100,38,0,38
Jakob,M,100,0,28564,28564
Ervine,M,100,0,11,11
Srithik,M,100,0,20,20
Chereka,F,100,37,0,37
Thurayya,F,100,5,0,5
Haeden,M,87,34,226,260
Aba,F,81,22,5,27
Leonzo,M,100,0,15,15
Ta,F,87,207,30,237
Teneka,F,100,508,0,508
Favor,F,81,241,57,298
Tannaz,F,100,36,0,36
Deavonte,M,100,0,24,24
Reeshemah,F,100,121,0,121
Jeanella,F,100,25,0,25
Avilene,F,100,92,0,92
Kerissa,F,100,491,0,491
Tizoc,M,100,0,51,51
Ginae,F,100,5,0,5
Sokoya,F,100,5,0,5
Hristopher,M,100,0,194,194
Aashka,F,100,124,0,124
Elizabet,F,100,1690,0,1690
Annakatherine,F,100,44,0,44
Kristupas,M,100,0,5,5
Leelynd,M,100,0,69,69
Stash,M,100,0,5,5
Joielle,F,100,6,0,6
Crit,M,100,0,24,24
Nahaven,F,100,8,0,8
Lanxton,M,100,0,16,16
Kerline,F,100,102,0,102
Jayken,M,100,0,10,10
Rayven,F,95,2318,133,2451
Thedford,M,100,0,18,18
Leiam,M,100,0,73,73
Yasleen,F,100,47,0,47
Branndon,M,100,0,261,261
Sareth,M,63,7,12,19
Anivea,F,100,56,0,56
Kamyrie,F,100,6,0,6
Chris,M,86,20957,129459,150416
Zavannah,F,100,84,0,84
Ursla,F,100,18,0,18
Zim,M,100,0,6,6
Lloyal,M,100,0,7,7
Tyleen,F,100,28,0,28
Kelin,M,59,310,442,752
Ryanpatrick,M,100,0,5,5
Aalysia,F,100,6,0,6
Magaly,F,100,4651,0,4651
Shavaughn,F,94,174,11,185
Williemae,F,100,40,0,40
Jeremmy,M,100,0,34,34
Evonn,F,100,5,0,5
Antuane,M,100,0,131,131
Jacie,F,100,3499,5,3504
Lynzy,F,100,79,0,79
Sheamus,M,100,0,363,363
Tykeem,M,100,0,304,304
Lovella,F,100,453,0,453
Zayvion,M,100,0,906,906
Buffie,F,100,868,0,868
Chelcey,F,100,152,0,152
Naiomi,F,100,588,0,588
Yaya,M,100,0,35,35
Aaryan,M,99,6,968,974
Aydon,M,100,0,513,513
Lamecca,F,100,22,0,22
Judette,F,100,6,0,6
Amyas,M,100,0,27,27
Andrek,M,100,0,5,5
Wash,M,100,0,105,105
Melloney,F,100,29,0,29
Jackelinne,F,100,22,0,22
Arinna,F,100,17,0,17
Markes,M,100,0,148,148
Eelijah,M,100,0,5,5
Peterjohn,M,100,0,44,44
Augustino,M,100,0,177,177
Kaiwen,M,100,0,20,20
Tairen,F,100,5,0,5
Foxy,F,100,5,0,5
Demiko,M,100,0,16,16
Shontell,F,99,651,6,657
Kajuan,M,100,0,603,603
Martiana,F,100,50,0,50
Jocelinne,F,100,6,0,6
Stryker,M,100,0,746,746
Shadasia,F,100,129,0,129
Aunyae,F,100,38,0,38
Khoury,M,100,0,103,103
Donzaleigh,F,100,9,0,9
Leatta,F,100,18,0,18
Raelinn,F,100,20,0,20
Kebria,F,100,6,0,6
Kentrell,M,98,66,3097,3163
Satanya,F,100,28,0,28
Michelleanne,F,100,5,0,5
Tshaye,F,100,5,0,5
Paysen,F,74,119,41,160
Deeric,M,100,0,177,177
Maci,F,100,13323,6,13329
Brittaini,F,100,5,0,5
Montral,M,100,0,15,15
Jostein,M,100,0,6,6
Trelin,M,100,0,17,17
Claryssa,F,100,212,0,212
Armin,M,100,0,1556,1556
Anon,M,100,0,5,5
Jhair,M,100,0,119,119
Harris,M,99,82,6726,6808
Kavonta,M,100,0,13,13
Kimbla,F,100,5,0,5
Twanetta,F,100,9,0,9
Khader,M,100,0,23,23
Abagayle,F,100,336,0,336
Kristafer,M,100,0,43,43
Yevette,F,100,833,0,833
Elektra,F,100,590,0,590
Cobee,M,100,0,18,18
Norna,F,100,6,0,6
Doty,F,100,7,0,7
Santita,F,100,61,0,61
Onofre,M,100,0,165,165
Sueellen,F,100,393,0,393
Deveda,F,100,26,0,26
Eda,F,100,961,0,961
Suria,F,100,55,0,55
Addalee,F,100,109,0,109
Tahmir,M,100,0,172,172
Jossimar,M,100,0,5,5
Tricity,F,100,8,0,8
Issac,M,100,17,17764,17781
Cramer,M,100,0,34,34
Jacksyn,M,82,33,152,185
Kimberlyy,F,100,5,0,5
Shota,M,100,0,260,260
Dimitrius,M,100,0,855,855
Samual,M,100,0,4044,4044
Zye,M,100,0,6,6
Tibisay,F,100,6,0,6
Stavon,M,100,0,29,29
Rylyn,F,80,406,99,505
Tachiana,F,100,5,0,5
Mubeen,M,100,0,33,33
Dotty,F,100,589,0,589
Jimyah,F,100,16,0,16
Janelli,F,100,201,0,201
Oliviya,F,100,56,0,56
Jaini,F,100,18,0,18
Kolt,M,100,0,1271,1271
Endea,F,100,30,0,30
Vedant,M,100,0,678,678
Jadielys,F,100,5,0,5
Mckinzie,F,100,1389,0,1389
Dameta,F,100,5,0,5
Afsana,F,100,97,0,97
Rodny,M,100,0,60,60
Tyshanta,F,100,6,0,6
Wilver,M,100,0,157,157
Elihue,M,100,0,10,10
Jameerah,F,100,20,0,20
Geni,F,100,329,0,329
Allycia,F,100,348,0,348
Azuree,F,100,105,0,105
Ralphy,M,100,0,55,55
Shakayia,F,100,5,0,5
Marshaya,F,100,11,0,11
Drayon,M,100,0,11,11
Valena,F,100,417,0,417
Delaya,F,100,5,0,5
Eraclio,M,100,0,49,49
Tyer,M,100,0,6,6
Keylen,M,57,166,221,387
Kloee,F,100,606,0,606
Yatzari,F,100,170,0,170
Dayesha,F,100,5,0,5
Kwamain,M,100,0,19,19
Jevonna,F,100,11,0,11
Sef,M,100,0,11,11
Dajonae,F,100,29,0,29
Samera,F,100,455,0,455
Alisabeth,F,100,341,0,341
Kristijo,F,100,5,0,5
Viktoriya,F,100,153,0,153
Janeice,F,100,499,0,499
Cetric,M,100,0,8,8
Keyia,F,100,68,0,68
Valiere,F,100,10,0,10
Jazyra,F,100,10,0,10
Mianca,F,100,10,0,10
Piers,M,100,0,223,223
Theresann,F,100,5,0,5
Henna,F,100,1004,0,1004
Birt,M,100,0,12,12
Coty,M,88,768,5386,6154
Waldy,M,100,0,17,17
Eddrick,M,100,0,310,310
Adalaya,F,100,35,0,35
Shannae,F,100,51,0,51
Daeton,M,100,0,208,208
Shawnessy,F,100,23,0,23
Guan,M,100,0,6,6
Asyiah,F,100,21,0,21
Saffiya,F,100,17,0,17
Oladapo,M,100,0,11,11
Adero,F,100,5,0,5
Tynequa,F,100,37,0,37
Galvin,M,100,0,661,661
Doninique,F,79,73,19,92
Marise,F,100,109,0,109
Rayeanna,F,100,5,0,5
Eeva,F,100,74,0,74
Charnell,F,100,644,0,644
Alenda,F,100,50,0,50
Yahaida,F,100,5,0,5
Kynzlie,F,100,98,0,98
Daviaun,M,100,0,5,5
Lenisha,F,100,224,0,224
Dondrell,M,100,0,107,107
Russchelle,F,100,24,0,24
Mariadelourdes,F,100,17,0,17
Swaraj,M,100,0,11,11
Kermina,F,100,12,0,12
Sharoya,F,100,12,0,12
Shadasha,F,100,20,0,20
Madena,F,100,5,0,5
Addesyn,F,100,18,0,18
Eyona,F,100,16,0,16
Donn,M,98,62,3585,3647
Benjamon,M,100,0,5,5
Tanishka,F,100,187,0,187
Keagen,M,98,22,884,906
Derryl,M,100,0,742,742
Beryle,F,100,31,0,31
Sewell,M,100,0,17,17
Daina,F,100,2366,5,2371
Jeretta,F,100,19,0,19
Destyni,F,100,993,0,993
Avayla,F,100,11,0,11
Boluwatife,M,59,39,56,95
Atianna,F,100,189,0,189
Munachiso,F,80,39,10,49
Gwena,F,100,31,0,31
Nathanael,M,100,12,17840,17852
Locke,M,100,0,372,372
Glenese,F,100,5,0,5
Nykell,M,100,0,7,7
Kayzlee,F,100,62,0,62
Matvei,M,100,0,16,16
Celes,F,100,174,0,174
Aavyan,M,100,0,5,5
Rossy,F,100,420,0,420
Laquishia,F,100,49,0,49
Derriona,F,100,152,0,152
Tatasha,F,100,24,0,24
Radly,M,100,0,6,6
Breiana,F,100,315,0,315
Inmar,M,100,0,41,41
Gurley,M,100,0,5,5
Paulena,F,100,74,0,74
Cabot,M,100,0,247,247
Maevry,F,100,5,0,5
Zoyah,F,100,5,0,5
Tongia,F,100,26,0,26
Khary,M,100,0,860,860
Seanna,F,100,2063,0,2063
Cameryn,F,79,2309,622,2931
Tytiona,F,100,58,0,58
Jenevy,F,100,34,0,34
Keiajah,F,100,10,0,10
Kalyani,F,100,193,0,193
Naiima,F,100,7,0,7
Felicidad,F,100,15,0,15
Imagen,F,100,33,0,33
Raqual,F,100,59,0,59
Jaxxin,M,100,0,5,5
Leven,M,94,5,77,82
Kayleemae,F,100,5,0,5
Khyle,M,94,18,282,300
Karalina,F,100,110,0,110
Icyss,F,100,63,0,63
Desaray,F,100,1048,0,1048
Iara,F,100,132,0,132
Egan,M,95,49,871,920
Hershy,M,100,0,513,513
Shaletta,F,100,60,0,60
Yasamine,F,100,28,0,28
Delphene,F,100,15,0,15
Shawni,F,100,225,0,225
Taelynn,F,100,693,0,693
Lenita,F,100,884,0,884
Demetre,M,98,12,603,615
Lamara,F,100,336,0,336
Khloeann,F,100,19,0,19
Donquez,M,100,0,27,27
Niketta,F,100,11,0,11
Wan,F,67,10,5,15
Ahian,M,100,0,6,6
Kinyon,M,100,0,15,15
Chantille,F,100,68,0,68
Chesnie,F,100,155,0,155
Latovia,F,100,15,0,15
Milcah,F,100,72,0,72
Deletha,F,100,93,0,93
Sriniketh,M,100,0,5,5
Zamarien,M,100,0,14,14
Mawiyah,F,100,10,0,10
Ashvath,M,100,0,40,40
Sharilynn,F,100,101,0,101
Jherica,F,100,53,0,53
Marseille,F,100,9,0,9
Marlasia,F,100,36,0,36
Kahlila,F,100,28,0,28
Geron,M,100,0,371,371
Lyba,F,100,34,0,34
Ololade,F,100,16,0,16
Lajuane,M,100,0,92,92
Wajeeha,F,100,20,0,20
Cheyenn,F,100,15,0,15
Aasia,F,100,203,0,203
Nealon,M,100,0,18,18
Zaharia,F,100,43,0,43
Kloei,F,100,45,0,45
Tiembra,F,100,11,0,11
Wykeisha,F,100,20,0,20
Renisha,F,100,730,0,730
Jersie,F,100,366,0,366
Artrina,F,100,11,0,11
Stanlee,M,100,0,52,52
Keyona,F,100,2815,0,2815
Jezabella,F,100,47,0,47
Meia,F,100,358,0,358
Terice,F,100,16,0,16
Saniiyah,F,100,6,0,6
Briley,F,80,4761,1178,5939
Xienna,F,100,21,0,21
Hannes,M,100,0,32,32
Adedotun,M,100,0,5,5
Tiwatope,F,100,11,0,11
Stevanie,F,100,26,0,26
Jesalee,F,100,5,0,5
Caisen,M,100,0,125,125
Alzahra,F,100,13,0,13
Qiuana,F,100,5,0,5
Nalyjah,F,100,5,0,5
Tugg,M,100,0,5,5
Krystalmae,F,100,5,0,5
Merlene,F,100,677,0,677
Shaba,M,100,0,5,5
Latosha,F,100,6441,0,6441
Jewlian,M,100,0,21,21
Leean,F,100,83,0,83
Mayola,F,100,159,0,159
Mairead,F,100,1102,0,1102
Eneida,F,100,859,0,859
Jahzari,F,100,5,0,5
Denekia,F,100,10,0,10
Tiandria,F,100,5,0,5
Deione,M,100,0,6,6
Deshunda,F,100,53,0,53
Valesha,F,100,22,0,22
Tialisa,F,100,36,0,36
Jileen,F,100,5,0,5
Havery,M,100,0,5,5
Tylerjames,M,100,0,112,112
Saaniyah,F,100,11,0,11
Yovela,F,100,5,0,5
Aminat,F,100,80,0,80
Sokha,F,67,55,27,82
Malika,F,99,4113,36,4149
Ananiah,F,100,116,0,116
Trixi,F,100,10,0,10
Kycen,M,100,0,60,60
Mounir,M,100,0,84,84
Neelisha,F,100,8,0,8
Maritha,F,100,20,0,20
Gianluigi,M,100,0,34,34
Jometh,M,100,0,23,23
Labria,F,100,411,0,411
Tinyah,F,100,7,0,7
Lameika,F,100,35,0,35
Nyya,F,100,37,0,37
Angalee,F,100,46,0,46
Miro,M,100,0,88,88
Lakel,M,100,0,5,5
Seretta,F,100,33,0,33
Krisstina,F,100,11,0,11
Taresha,F,100,32,0,32
Joanny,F,97,151,5,156
Jaterius,M,100,0,5,5
Marlanna,F,100,16,0,16
Kolin,M,100,0,1629,1629
Yomari,F,100,24,0,24
Aldena,F,100,10,0,10
Dorethia,F,100,62,0,62
Ashey,F,100,113,0,113
Audrei,F,100,18,0,18
Jaiseon,M,100,0,10,10
Rhyland,M,92,6,72,78
Ketsia,F,100,209,0,209
Lauri,F,100,10873,37,10910
Cydne,F,100,199,0,199
Tanitha,F,100,6,0,6
Nate,M,91,303,3126,3429
Malyna,F,100,81,0,81
Vytautas,M,100,0,47,47
Mavra,F,100,7,0,7
Chadwick,M,100,22,12604,12626
Glendall,M,100,0,11,11
Berke,M,100,0,34,34
Shanka,F,100,10,0,10
Dannea,F,100,5,0,5
Breyona,F,100,494,0,494
Antonious,M,100,0,276,276
Taifa,F,100,25,0,25
Tirra,F,100,6,0,6
Jinora,F,100,9,0,9
Tiandrea,F,100,7,0,7
Branson,M,100,5,5120,5125
Krunal,M,100,0,43,43
Rishabh,M,100,0,745,745
Theran,M,100,0,250,250
Laurie,F,100,158976,716,159692
Tenile,F,100,25,0,25
Saqib,M,100,0,130,130
Ronaldo,M,100,0,4788,4788
Kwaku,M,100,0,398,398
Breonne,F,100,45,0,45
Jarvus,M,100,0,11,11
Charmain,F,100,962,0,962
Morah,F,100,5,0,5
Ismail,M,100,0,2404,2404
Dwyn,F,100,5,0,5
Geana,F,100,314,0,314
Noelle,F,100,28791,50,28841
Kamarria,F,100,55,0,55
Liko,M,100,0,17,17
Telaya,F,100,5,0,5
Harveen,F,100,23,0,23
Latorrance,M,100,0,5,5
Yaret,F,67,98,48,146
Kaseen,M,100,0,16,16
Ingmar,M,100,0,6,6
Deondre,M,100,15,3618,3633
Lanai,F,100,401,0,401
Toree,F,93,411,30,441
Dequanna,F,100,12,0,12
Mayrene,F,100,12,0,12
Lakedria,F,100,28,0,28
Olivet,F,100,5,0,5
Jose,M,99,3411,492515,495926
Otylia,F,100,11,0,11
Shamaiya,F,100,58,0,58
Ricks,M,100,0,5,5
Rontrell,M,100,0,181,181
Aizlyn,F,100,133,0,133
Navarro,M,100,0,156,156
Sharayne,F,100,24,0,24
Elloree,F,100,11,0,11
Minden,F,100,16,0,16
Tusha,F,100,10,0,10
Christion,M,99,17,1126,1143
Jeannie,F,100,28378,49,28427
Bhavana,F,100,109,0,109
Coraline,F,100,1772,0,1772
Kahne,M,97,5,170,175
Kaille,F,100,6,0,6
Jasinto,M,100,0,16,16
Lourinda,F,100,5,0,5
Dorreen,F,100,142,0,142
Aracelie,F,100,119,0,119
Kaitlyn,F,100,158601,232,158833
Lashawnta,F,100,84,0,84
Gurseerat,F,100,5,0,5
Trentity,F,100,6,0,6
Anasofia,F,100,467,0,467
Clarice,F,100,6740,0,6740
Deshad,M,100,0,18,18
Mahyar,M,100,0,15,15
Carrisa,F,100,547,0,547
Francine,F,100,24916,11,24927
Jairden,M,100,0,13,13
Othelia,F,100,12,0,12
Sherretta,F,100,5,0,5
Elisse,F,100,377,0,377
Mkaila,F,100,5,0,5
Shaquisha,F,100,108,0,108
Keyshon,M,100,0,338,338
Paycie,F,100,5,0,5
Daishia,F,100,96,0,96
Jamarre,M,100,0,31,31
Tory,M,64,3629,6590,10219
Dazire,F,100,52,0,52
Chantrea,F,100,5,0,5
Tertius,M,100,0,6,6
Lilandra,F,100,26,0,26
Shanil,F,100,6,0,6
Detta,F,100,124,0,124
Algernon,M,100,0,711,711
Corrinna,F,100,228,0,228
Mckynzie,F,100,453,0,453
Sadhvi,F,100,5,0,5
Aramis,M,91,171,1721,1892
Markeal,M,100,0,29,29
Amaar,M,100,0,250,250
Assunta,F,100,297,0,297
Kellis,F,57,93,69,162
Sammual,M,100,0,48,48
Sekina,F,100,30,0,30
Kisara,F,100,17,0,17
Lillybeth,F,100,58,0,58
Devven,M,100,0,5,5
Orian,M,86,58,366,424
Jakir,M,100,0,8,8
Aleshia,F,100,2812,0,2812
Tyreisha,F,100,76,0,76
Sanath,M,100,0,26,26
Mabell,F,100,5,0,5
Charmon,F,100,107,0,107
Emalena,F,100,5,0,5
Kystal,F,100,22,0,22
Miraha,F,100,5,0,5
Kathren,F,100,720,0,720
Tatianna,F,100,5261,0,5261
Jolynne,F,100,430,0,430
Lanay,F,100,534,0,534
Erena,F,100,15,0,15
Melanny,F,100,609,0,609
Cinder,F,100,39,0,39
Sharnette,F,100,192,0,192
Sholonda,F,100,118,0,118
Keriana,F,100,141,0,141
Xzarion,M,100,0,6,6
Thoran,M,100,0,10,10
Ramesh,M,100,0,181,181
Sarinna,F,100,10,0,10
Filippa,F,100,23,0,23
Kmora,F,100,33,0,33
Meriam,F,100,557,0,557
Arunas,M,100,0,17,17
Hedi,F,100,108,0,108
Katylin,F,100,29,0,29
Anees,M,100,0,47,47
Marqual,M,100,0,161,161
Jearlean,F,100,55,0,55
Demetrick,M,100,0,690,690
Lacricia,F,100,22,0,22
Teneasha,F,100,5,0,5
Reyna,F,100,13064,32,13096
Amauri,M,70,481,1133,1614
Anitta,F,100,77,0,77
Brittiany,F,100,737,0,737
Riyana,F,100,168,0,168
Kashonna,F,100,36,0,36
Jayniah,F,100,40,0,40
Nashayla,F,100,129,0,129
Lenona,F,100,5,0,5
Lamia,F,100,1092,0,1092
Tiphanie,F,100,622,0,622
Ronnett,F,100,61,0,61
Mikala,F,100,3912,10,3922
Lekethia,F,100,10,0,10
Jacina,F,100,16,0,16
Clift,M,100,0,6,6
Talik,M,100,0,246,246
Daejanay,F,100,20,0,20
Danil,M,100,0,167,167
Raihanna,F,100,13,0,13
Jaslenne,F,100,13,0,13
Shanely,F,100,5,0,5
Brockman,M,100,0,10,10
Oshun,F,100,5,0,5
Shateria,F,100,243,0,243
Rondallyn,F,100,8,0,8
Xylon,M,100,0,114,114
Shamekka,F,100,41,0,41
Matthen,M,100,0,35,35
Myrisa,F,100,15,0,15
Pamilyn,F,100,5,0,5
Fay,F,96,6242,282,6524
Joaogabriel,M,100,0,6,6
Apolline,F,100,17,0,17
Porter,M,97,303,9507,9810
Rogelia,F,100,6,0,6
Corlis,F,100,468,0,468
Sakinah,F,100,919,0,919
Amilliyon,F,100,5,0,5
Lakysha,F,100,162,0,162
Haneef,M,100,0,489,489
Chestina,F,100,68,0,68
Kashon,M,100,0,186,186
Taeo,M,100,0,12,12
Judge,M,100,0,1099,1099
Vrinda,F,100,167,0,167
Alyna,F,100,1799,0,1799
Aglaia,F,100,6,0,6
Chijioke,M,100,0,104,104
Iago,M,100,0,53,53
Lizvet,F,100,62,0,62
Chantilly,F,100,249,0,249
Iwalani,F,100,101,0,101
Margette,F,100,5,0,5
Jahiyah,F,100,18,0,18
Caelynn,F,100,328,0,328
Rajaun,M,100,0,17,17
Bhavesh,M,100,0,91,91
Ofa,F,88,37,5,42
Tavo,M,100,0,10,10
Harshaan,M,100,0,52,52
Carleigh,F,100,4662,0,4662
Yumika,F,100,20,0,20
Tauren,M,89,8,68,76
Druanne,F,100,63,0,63
Shadiya,F,100,36,0,36
Chelcie,F,100,763,0,763
Godfrey,M,100,0,1359,1359
Arielys,F,100,170,0,170
Brancy,F,100,17,0,17
Joselyne,F,100,1059,0,1059
Krystian,M,73,469,1298,1767
Shanel,F,100,2342,0,2342
Aadhira,F,100,29,0,29
Danella,F,100,678,0,678
Mandolin,F,100,172,0,172
Treyven,M,100,0,116,116
Ansli,F,100,5,0,5
Brisamar,F,100,13,0,13
Shadel,F,100,6,0,6
Charlonda,F,100,6,0,6
Eleanna,F,100,176,0,176
Zakyah,F,100,159,0,159
Sammuel,M,100,0,2024,2024
Melodey,F,100,35,0,35
Saraswati,F,100,5,0,5
Kiann,F,100,15,0,15
Tatevik,F,100,6,0,6
Sherokee,F,100,5,0,5
Avayiah,F,100,5,0,5
Tynasia,F,100,279,0,279
Jadel,M,100,0,22,22
Graysie,F,100,5,0,5
Owais,M,100,0,176,176
Mckinze,F,100,62,0,62
Ayeza,F,100,7,0,7
Taniaya,F,100,72,0,72
Josefrancisco,M,100,0,45,45
Josaphine,F,100,134,0,134
Haleemah,F,100,70,0,70
Bailie,F,100,1545,0,1545
Rubiana,F,100,15,0,15
Andreau,M,100,0,18,18
Skippy,M,100,0,133,133
Nachaly,F,100,5,0,5
Solie,F,100,28,0,28
Apple,F,100,351,0,351
Jefferey,M,100,0,3882,3882
Mykyah,F,100,5,0,5
Edwinna,F,100,154,0,154
Mikenley,F,100,10,0,10
Jeannette,F,100,27715,11,27726
Tavanna,F,100,5,0,5
Konika,F,100,5,0,5
Shahir,M,100,0,89,89
Mirielle,F,100,206,0,206
Tekila,F,100,57,0,57
Truxton,M,100,0,57,57
Drummond,M,100,0,20,20
Heddie,F,100,8,0,8
Cashmiere,M,100,0,5,5
Robyne,F,100,653,0,653
Copelynn,F,100,9,0,9
Bellany,F,100,36,0,36
Jerikah,F,100,15,0,15
Mardell,F,87,429,63,492
Udell,M,100,0,98,98
Shareen,F,100,906,0,906
Nickie,F,75,2713,901,3614
Shirly,F,100,516,0,516
Wuilmer,M,100,0,16,16
Dancia,F,100,5,0,5
Kariem,M,100,0,149,149
Vanie,F,100,5,0,5
Latonyia,F,100,107,0,107
Rendell,M,100,0,571,571
Haruka,F,100,420,0,420
Skylea,F,100,23,0,23
Anwar,M,96,90,2335,2425
Montasia,F,100,183,0,183
Kobei,M,100,0,5,5
Dakin,M,100,0,63,63
Bravyn,M,100,0,5,5
Renice,F,100,54,0,54
Dorelle,F,100,10,0,10
Tieara,F,100,229,0,229
Shakaila,F,100,23,0,23
Jamarkus,M,100,0,552,552
Kirstine,F,100,126,0,126
Carmia,F,100,14,0,14
Machiavelli,M,100,0,5,5
Vanesha,F,100,342,0,342
Nihash,M,100,0,14,14
Myranda,F,100,4579,0,4579
Davius,M,100,0,71,71
Zendiya,F,100,5,0,5
Kriselda,F,100,29,0,29
Mayce,F,100,417,0,417
Sarajane,F,100,454,0,454
Evette,F,100,5500,0,5500
Vladik,M,100,0,5,5
Kalea,F,100,2908,0,2908
Filip,M,100,0,1633,1633
Senequa,F,100,27,0,27
Mabel,F,100,7548,0,7548
Haidan,M,91,6,61,67
Madeliene,F,100,308,0,308
Keiren,M,90,5,43,48
Jaritzy,F,100,16,0,16
Bernadene,F,100,51,0,51
Claryce,F,100,16,0,16
Geri,F,100,6904,0,6904
Brynson,M,100,0,6,6
Genola,F,100,15,0,15
Arnelia,F,100,5,0,5
Khaira,F,100,33,0,33
Zeyla,F,100,6,0,6
Joshuarobert,M,100,0,5,5
Lashya,F,100,60,0,60
Shantay,F,100,1270,0,1270
Ruba,F,100,377,0,377
Johnnia,F,100,5,0,5
Bernita,F,100,2126,0,2126
Shannone,F,100,25,0,25
Masih,M,100,0,16,16
Nichalos,M,100,0,485,485
Tomar,M,100,0,45,45
Kanin,M,100,0,266,266
Zinedin,M,100,0,5,5
Al,M,99,98,9163,9261
Cederic,M,100,0,103,103
Biju,M,100,0,17,17
Sherita,F,100,4007,0,4007
Sabena,F,100,83,0,83
Maansi,F,100,110,0,110
Zaylin,M,63,155,266,421
Malaysha,F,100,447,0,447
Nakeia,F,100,393,0,393
Jaria,F,100,127,0,127
Rashawn,M,89,709,5814,6523
Rowyn,F,78,631,178,809
Sheylynn,F,100,5,0,5
Neina,F,100,17,0,17
Cintia,F,100,851,0,851
Desiri,F,100,10,0,10
Lynelle,F,100,2019,0,2019
Javeya,F,100,5,0,5
Valerya,F,100,113,0,113
Devena,F,100,28,0,28
Ennette,F,100,5,0,5
Hoy,M,100,0,150,150
Christian,M,95,18938,385920,404858
Hiawatha,M,77,104,357,461
Kamariana,F,100,42,0,42
Joseluiz,M,100,0,6,6
Tanae,F,100,652,0,652
Anetia,F,100,16,0,16
Bivian,F,100,7,0,7
Shiquita,F,100,456,0,456
Genecis,F,100,166,0,166
Daena,F,100,584,0,584
Classy,F,100,6,0,6
Goldia,F,100,31,0,31
Dellia,F,100,44,0,44
Ladawna,F,100,284,0,284
Passionate,F,100,5,0,5
Courtlandt,M,100,0,11,11
Zymeer,M,100,0,32,32
Shadley,M,100,0,6,6
Sebastean,M,100,0,5,5
Terilee,F,100,28,0,28
Riya,F,100,3929,0,3929
Ernell,F,100,16,0,16
Ismaela,F,100,5,0,5
Jandra,F,100,20,0,20
Ciauna,F,100,10,0,10
Danl,M,100,0,5,5
Alaan,M,100,0,13,13
Stasia,F,100,972,0,972
Emlyn,F,100,279,0,279
Celine,F,100,8531,0,8531
Dariyon,M,95,10,176,186
Keyoshia,F,100,33,0,33
Phillipp,M,100,0,25,25
Makaliah,F,100,50,0,50
Danti,M,100,0,6,6
Aarya,F,78,950,263,1213
Angiela,F,100,23,0,23
Eliijah,M,100,0,37,37
Gerod,M,100,0,295,295
Cairi,F,100,23,0,23
Latracia,F,100,16,0,16
Kenyara,F,100,5,0,5
Linzey,F,100,317,0,317
Sonnett,F,100,5,0,5
Zerah,F,100,48,0,48
Yixuan,F,100,10,0,10
Lateika,F,100,5,0,5
Lashavia,F,100,15,0,15
Siclali,F,100,60,0,60
Amonni,F,100,19,0,19
Kaven,M,100,0,682,682
Manda,F,100,1988,0,1988
Nautica,F,98,2056,50,2106
Abderrahman,M,100,0,5,5
Yasly,F,100,6,0,6
Latieka,F,100,10,0,10
Wheeler,M,100,0,528,528
Rasleen,F,100,6,0,6
Veda,F,100,4542,0,4542
Zeinabou,F,100,10,0,10
Fatema,F,100,677,0,677
Anise,F,100,837,0,837
Mareesa,F,100,75,0,75
Takim,M,100,0,8,8
Lulia,F,100,66,0,66
Zanay,F,100,47,0,47
Maleeya,F,100,233,0,233
Yavuz,M,100,0,62,62
Antonie,M,99,6,741,747
Joevan,M,100,0,5,5
Rasheeka,F,100,5,0,5
Amrom,M,100,0,204,204
Karee,F,90,731,80,811
Kinzlee,F,100,432,0,432
Rossella,F,100,17,0,17
Pristine,F,100,42,0,42
Pennyann,F,100,5,0,5
Reagen,F,88,536,71,607
Ayon,M,100,0,23,23
Antonnette,F,100,18,0,18
Maadhav,M,100,0,10,10
Cephas,M,100,0,330,330
Traylan,M,100,0,5,5
Kienna,F,100,65,0,65
Yollanda,F,100,10,0,10
Robbin,F,84,8332,1546,9878
Toluwalase,F,65,11,6,17
Arahbella,F,100,5,0,5
Liannah,F,100,45,0,45
Calistro,M,100,0,23,23
Evart,M,100,0,5,5
Adhvaith,M,100,0,23,23
Cocoa,F,100,34,0,34
Jhournee,F,100,12,0,12
Keilie,F,100,25,0,25
Teneya,F,100,44,0,44
Alok,M,100,0,200,200
Philips,M,100,0,5,5
Charanda,F,100,5,0,5
Vicie,F,100,84,0,84
Karabella,F,100,10,0,10
Naysean,M,100,0,5,5
Zoja,F,100,5,0,5
Shashanna,F,100,25,0,25
Bebe,F,100,409,0,409
Benet,M,61,20,31,51
Taiveon,M,100,0,49,49
Jacquee,F,100,6,0,6
Celese,F,100,73,0,73
Akosita,F,100,5,0,5
Rejetta,F,100,5,0,5
Shiobhan,F,100,11,0,11
Magaline,F,100,73,0,73
Mileyah,F,100,16,0,16
Weda,F,100,5,0,5
Tomyka,F,100,5,0,5
Teal,F,88,1389,193,1582
Eilean,F,100,6,0,6
Tom,M,100,134,62730,62864
Jakobey,M,100,0,37,37
Abiageal,F,100,125,0,125
Leesha,F,100,442,0,442
Sakariya,M,100,0,6,6
Gifty,F,100,38,0,38
Yakob,M,100,0,10,10
Aldijana,F,100,10,0,10
Jonovan,M,100,0,246,246
Thaddeus,M,100,26,15238,15264
Prudie,F,100,12,0,12
Knighton,M,100,0,13,13
Mitzel,F,100,24,0,24
Huong,F,100,578,0,578
Hadyn,M,54,439,520,959
Sopia,F,100,5,0,5
Omariana,F,100,16,0,16
Caleena,F,100,28,0,28
Dharti,F,100,12,0,12
Itzanami,F,100,20,0,20
Jalyna,F,100,10,0,10
Dayton,M,96,452,10681,11133
Justinrobert,M,100,0,5,5
Koki,M,100,0,108,108
Dalven,M,100,0,10,10
Janson,M,100,0,909,909
Yeshua,M,100,0,1140,1140
Korrie,F,96,690,30,720
Ashanae,F,100,25,0,25
Annaleia,F,100,24,0,24
Jasmely,F,100,6,0,6
Adell,F,77,1046,316,1362
Jefre,M,100,0,21,21
Keyahna,F,100,46,0,46
Gregorg,M,100,0,5,5
Savanna,F,100,28018,15,28033
Jennilee,F,100,483,0,483
Kantina,F,100,20,0,20
Terek,M,100,0,252,252
Shavonna,F,100,799,0,799
Oren,M,100,16,3792,3808
Coal,M,100,0,121,121
Aryannah,F,100,243,0,243
Hilde,F,100,158,0,158
Rade,M,100,0,19,19
Umang,M,100,0,5,5
Jerilynn,F,100,815,0,815
Andelin,F,100,6,0,6
Sirenia,F,100,99,0,99
Melondy,F,100,177,0,177
Brookson,M,100,0,7,7
Nechy,F,100,21,0,21
Christipher,M,100,0,620,620
Eural,M,100,0,48,48
Lataurus,M,91,5,52,57
Welborn,M,100,0,6,6
Rekeisha,F,100,23,0,23
Yukari,F,100,153,0,153
Shakria,F,100,5,0,5
Zyriana,F,100,24,0,24
Jadine,F,100,276,0,276
Chakira,F,100,229,0,229
Corintha,F,100,5,0,5
Kissie,F,100,100,0,100
Kaytlin,F,100,3176,0,3176
Danylo,M,100,0,39,39
Tirek,M,100,0,22,22
Carli,F,100,7919,5,7924
Zhaniya,F,100,73,0,73
Moises,M,100,52,23775,23827
Tearsa,F,100,203,0,203
Verla,F,100,715,0,715
Bruke,M,100,0,18,18
Cadesia,F,100,15,0,15
Deronta,M,100,0,25,25
Sybella,F,100,113,0,113
Mckinlee,F,100,758,0,758
Sali,F,100,7,0,7
Yejin,F,100,37,0,37
Taycee,F,100,52,0,52
Ligia,F,100,651,0,651
Kimo,M,100,0,789,789
Tafari,M,100,0,630,630
Chirley,F,100,5,0,5
Rickelle,F,100,282,0,282
Anibal,M,99,22,3338,3360
Jaketa,F,100,5,0,5
Abey,F,63,17,10,27
Lawana,F,100,2069,0,2069
Roshod,M,100,0,22,22
Jacquell,M,52,15,16,31
Faith,F,100,113149,216,113365
Marquel,M,91,248,2394,2642
Ilianny,F,100,5,0,5
Timotheus,M,100,0,177,177
Tyenna,F,100,11,0,11
Franciscojavier,M,100,0,123,123
Michaelgabriel,M,100,0,6,6
Eveanna,F,100,11,0,11
Africa,F,100,939,0,939
Randoph,M,100,0,16,16
Jonie,F,100,1147,0,1147
Vershaun,M,100,0,6,6
Eleonor,F,100,190,0,190
Abigai,F,100,6,0,6
Krew,M,100,0,620,620
Mahamadou,M,100,0,301,301
Marilla,F,100,184,0,184
Caril,F,100,17,0,17
Shadiqua,F,100,5,0,5
Fardowsa,F,100,62,0,62
Scholar,M,100,0,5,5
Asmara,F,100,78,0,78
Oliviah,F,100,478,0,478
Nilah,F,100,711,0,711
Deiveon,M,100,0,5,5
Annett,F,100,843,0,843
Shiomara,F,100,19,0,19
Jorrel,M,100,0,24,24
Yorlei,F,100,20,0,20
Trayshun,M,100,0,6,6
Keiah,F,100,5,0,5
Mayron,M,100,0,5,5
Verland,M,100,0,6,6
Chidi,M,100,0,183,183
Kajol,F,100,66,0,66
Fiama,F,100,11,0,11
Zayvien,M,100,0,67,67
Alexei,M,90,100,919,1019
Mattilyn,F,100,410,0,410
Carmindy,F,100,50,0,50
Shainah,F,100,24,0,24
Tinzley,F,100,56,0,56
Lani,F,98,5740,119,5859
Alsexander,M,100,0,5,5
Tanah,F,100,23,0,23
Everitt,M,100,0,162,162
Arrissa,F,100,20,0,20
Phillisa,F,100,7,0,7
Canon,M,99,24,1661,1685
Loriene,F,100,20,0,20
Amra,F,100,264,0,264
Konstantino,M,100,0,6,6
Laronzo,M,100,0,10,10
Latish,F,100,121,0,121
Anderzon,M,100,0,16,16
Dristan,M,100,0,8,8
Kelline,F,100,6,0,6
Abigial,F,100,154,0,154
Jakyi,M,100,0,46,46
Vihaas,M,100,0,5,5
Elves,M,100,0,8,8
Chandni,F,100,400,0,400
Harlowe,F,100,197,0,197
Shaleshia,F,100,5,0,5
Terik,M,100,0,109,109
Raashid,M,100,0,10,10
Ciandra,F,100,48,0,48
Syair,M,100,0,62,62
Keirnan,M,100,0,20,20
Gabriele,F,74,1982,706,2688
Vinh,M,99,10,1346,1356
Kaelani,F,100,335,0,335
Raylee,F,97,2461,69,2530
Layney,F,100,98,0,98
Lamour,M,100,0,28,28
Ezrie,F,100,47,0,47
Yuvonda,F,100,5,0,5
Dimari,M,100,0,34,34
Tijay,M,55,5,6,11
Jakeim,M,100,0,84,84
Geff,M,100,0,38,38
Kely,F,96,232,10,242
Georgi,F,88,314,43,357
Laveta,F,100,443,0,443
Danyeil,F,100,6,0,6
Mubashir,M,100,0,42,42
Pedro,M,99,406,71309,71715
Andarius,M,100,0,29,29
Maxamilian,M,100,0,66,66
Trese,F,100,60,0,60
Delle,F,100,20,0,20
Dinelle,F,100,24,0,24
Ciyana,F,100,5,0,5
Garett,M,100,0,4774,4774
Leondre,M,100,0,543,543
Aarjav,M,100,0,15,15
Eoin,M,100,0,1013,1013
Govany,M,100,0,6,6
Makinzey,F,100,65,0,65
Maha,F,100,1487,0,1487
Korissa,F,100,357,0,357
Raniah,F,100,286,0,286
Verlanda,F,100,5,0,5
Rashida,F,100,2963,6,2969
Nakhya,F,100,18,0,18
Jaydian,M,100,0,107,107
Condra,F,100,10,0,10
Brooklynn,F,100,25190,20,25210
Emmalyn,F,100,3989,0,3989
Landris,M,100,0,5,5
Izyan,M,100,0,79,79
Dayline,F,100,5,0,5
Rhythm,M,55,123,149,272
Saroun,F,100,5,0,5
Olexa,F,100,10,0,10
Cindi,F,100,7546,0,7546
Kayleeh,F,100,5,0,5
Kashish,F,100,130,0,130
Ripsi,F,100,5,0,5
Maricella,F,100,1541,0,1541
Euretha,F,100,5,0,5
Swift,M,100,0,5,5
Demaris,F,68,590,278,868
Imam,M,100,0,19,19
Hazelyn,F,100,78,0,78
Josai,M,100,0,16,16
Tyerell,M,100,0,38,38
Ceara,F,100,1494,0,1494
Kanyah,F,100,120,0,120
Nyziah,M,100,0,31,31
Milan,M,53,5023,5614,10637
Dorron,M,100,0,5,5
Zeyda,F,100,22,0,22
Maysha,F,100,11,0,11
Juliana,F,100,47461,49,47510
Nekeysha,F,100,6,0,6
Fayola,F,100,22,0,22
Steffin,M,100,0,29,29
Rosmary,F,100,62,0,62
Habiba,F,100,473,0,473
Dila,F,100,17,0,17
Helder,M,100,0,214,214
Deyanne,F,100,20,0,20
Marcellius,M,100,0,61,61
Smera,F,100,60,0,60
Deseret,F,100,11,0,11
Tyzer,M,100,0,5,5
Kailand,M,82,8,36,44
Adamm,M,100,0,6,6
Airon,M,97,5,172,177
Sancia,F,100,27,0,27
Xande,M,100,0,5,5
Eryana,F,100,39,0,39
Arshveer,M,100,0,5,5
Jenivieve,F,100,13,0,13
Hassana,F,100,42,0,42
Alyas,M,100,0,135,135
Nikki,F,98,37534,873,38407
Edit,F,100,178,0,178
Atzhiry,F,100,11,0,11
Ingra,F,100,71,0,71
Chrishonda,F,100,135,0,135
Raunel,M,100,0,64,64
Brenley,F,96,520,22,542
Yadelis,F,100,5,0,5
Keson,M,100,0,30,30
Tkaiya,F,100,8,0,8
Castina,F,100,6,0,6
Chrissean,M,100,0,10,10
Mathias,M,100,0,5791,5791
Shivam,M,100,0,1226,1226
Karmya,F,100,11,0,11
Manh,M,100,0,10,10
Kacper,M,100,0,877,877
Ashten,F,53,1085,968,2053
Chastie,F,100,5,0,5
Oceana,F,100,786,0,786
Mareck,M,100,0,5,5
Victorious,M,54,45,53,98
Elain,F,100,168,0,168
Ayron,M,98,5,260,265
Daebreona,F,100,5,0,5
Raashida,F,100,27,0,27
Jordyan,F,92,65,6,71
Cerone,M,100,0,28,28
Sixto,M,100,0,1326,1326
Moeko,F,100,6,0,6
Fardin,M,100,0,36,36
Yezen,M,100,0,24,24
Janaeh,F,100,16,0,16
Maaha,F,100,5,0,5
Issabella,F,100,1149,0,1149
Kaityn,F,100,17,0,17
Makayden,F,68,39,18,57
Zacarias,M,100,0,688,688
Marquiez,M,100,0,16,16
Roderic,M,100,0,1717,1717
Driscilla,F,100,5,0,5
Moire,F,100,11,0,11
Majesta,F,100,174,0,174
Breeyanna,F,100,5,0,5
Relinda,F,100,46,0,46
Mariclare,F,100,10,0,10
Terriek,M,100,0,5,5
Namari,M,67,26,52,78
Braileigh,F,100,43,0,43
Kristhian,M,100,0,25,25
Faraji,M,100,0,45,45
Laylamarie,F,100,49,0,49
Zell,M,76,17,53,70
Eudelia,F,100,62,0,62
Lexandro,M,100,0,5,5
Morica,F,100,7,0,7
Mariadejesus,F,100,571,0,571
Mabrie,F,100,26,0,26
Ifrain,M,100,0,10,10
Taima,F,100,89,0,89
Narvel,M,100,0,26,26
Danetria,F,100,8,0,8
Ifeoluwa,F,69,183,83,266
Azailya,F,100,18,0,18
Catosha,F,100,6,0,6
Samaara,F,100,5,0,5
Tramanh,F,100,24,0,24
Daries,M,100,0,40,40
Arlanda,F,77,67,20,87
Ojany,M,100,0,11,11
Omarie,M,94,12,178,190
Yobana,F,100,105,0,105
Emel,F,100,11,0,11
Britanee,F,100,133,0,133
Wallene,F,100,7,0,7
Lailie,F,100,65,0,65
Pelin,F,100,54,0,54
Nahshon,M,100,0,606,606
Lachell,F,100,189,0,189
Aniesha,F,100,121,0,121
Jarae,F,76,197,62,259
Macky,M,100,0,79,79
Christey,F,100,40,0,40
Harol,M,100,0,28,28
Kaylanie,F,100,243,0,243
Breesha,F,100,14,0,14
Marilu,F,100,1787,0,1787
Roniesha,F,100,178,0,178
Vinaya,F,100,76,0,76
Tkiyah,F,100,32,0,32
Eluid,M,100,0,10,10
Clarese,F,100,38,0,38
Kellisa,F,100,5,0,5
Carisia,F,100,11,0,11
Tauris,M,100,0,25,25
Bonniejo,F,100,15,0,15
Trasen,M,100,0,5,5
Jovonnie,M,82,6,28,34
Noeli,F,100,311,0,311
Lera,F,100,505,0,505
Calbe,M,100,0,9,9
Shemia,F,100,142,0,142
Araly,F,100,92,0,92
Seananthony,M,100,0,36,36
Rosezena,F,100,6,0,6
Garlene,F,100,20,0,20
Tylee,F,76,1037,322,1359
Zyrah,F,100,143,0,143
Tygan,M,100,0,5,5
Ernetta,F,100,7,0,7
Bomani,M,100,0,111,111
Mekella,F,100,6,0,6
Lizabella,F,100,42,0,42
Damato,M,100,0,21,21
Woodley,M,100,0,133,133
Rosalyn,F,100,13176,0,13176
Isabellagrace,F,100,28,0,28
Ryston,M,100,0,6,6
Laquanta,F,100,333,0,333
Gabija,F,100,33,0,33
Altan,M,100,0,37,37
Ivyrose,F,100,28,0,28
Leander,M,99,23,3096,3119
Jarvais,M,100,0,5,5
Sebian,M,100,0,6,6
Aveline,F,100,296,0,296
Camariah,F,100,5,0,5
Chevis,M,96,11,264,275
Shemaiah,F,95,251,12,263
Chinomso,M,100,0,5,5
Nicollas,M,100,0,27,27
Shaheeda,F,100,11,0,11
Shykerria,F,100,5,0,5
Alarah,F,100,7,0,7
Trimaine,M,100,0,64,64
Jaeley,F,100,50,0,50
Dorit,F,100,40,0,40
Arianie,F,100,49,0,49
Letanya,F,100,92,0,92
Douachee,F,100,6,0,6
Binaca,F,100,5,0,5
Rithy,M,100,0,64,64
Lanaea,F,100,5,0,5
Danisa,F,100,82,0,82
Stevens,M,100,0,939,939
Jahkhi,M,100,0,6,6
Aner,M,100,0,5,5
Mtisha,F,100,5,0,5
Tsukasa,M,100,0,10,10
Darnetha,F,100,6,0,6
Makayln,F,100,5,0,5
Arali,F,100,53,0,53
Murice,M,100,0,77,77
Lawhitney,F,100,5,0,5
Madoc,M,100,0,104,104
Cedric,M,99,273,37624,37897
Galilea,F,100,4372,0,4372
Leylany,F,100,93,0,93
Victorino,M,100,0,304,304
Emmitt,M,100,0,5092,5092
Elizabethann,F,100,432,0,432
Sherree,F,100,1509,0,1509
Presten,M,100,0,496,496
Kyliemarie,F,100,11,0,11
Chimaobi,M,100,0,46,46
Haani,F,100,47,0,47
Strider,M,100,0,189,189
Mallely,F,100,19,0,19
Yarisbeth,F,100,42,0,42
Roel,M,100,0,3931,3931
Gregery,M,100,0,488,488
Lakessha,F,100,5,0,5
Tiffinee,F,100,55,0,55
Shuron,M,54,40,47,87
Lizy,F,100,13,0,13
Schrita,F,100,6,0,6
Ileen,F,100,937,0,937
Tauri,F,100,61,0,61
Suvir,M,100,0,34,34
Zeina,F,100,606,0,606
Albin,M,100,0,935,935
Tieler,M,85,35,193,228
Serita,F,100,1112,0,1112
Yordanos,F,100,38,0,38
Ingrid,F,100,21853,17,21870
Glenise,F,100,26,0,26
Yaitza,F,100,22,0,22
Uneek,F,100,6,0,6
Marisha,F,100,1527,0,1527
Terel,M,100,0,145,145
Alejadro,M,100,0,5,5
Aarvin,M,100,0,5,5
Augustis,M,100,0,5,5
Nan,F,100,3495,0,3495
Marce,F,87,169,26,195
Serani,M,76,6,19,25
Danessa,F,100,673,0,673
Gunars,M,100,0,13,13
Shenoah,F,100,13,0,13
Gizella,F,100,47,0,47
Jvante,M,100,0,11,11
Kimbereley,F,100,11,0,11
Petrina,F,100,1635,0,1635
Nely,F,100,541,0,541
Jaliyl,M,100,0,11,11
Frederique,F,100,11,0,11
Shinead,F,100,19,0,19
Totiyana,F,100,5,0,5
Lizzett,F,100,221,0,221
Chian,F,100,5,0,5
Joshua,M,100,4867,1169616,1174483
Normandy,F,100,43,0,43
Xenna,F,100,16,0,16
Mancel,M,100,0,36,36
Masoud,M,100,0,42,42
Haifa,F,100,136,0,136
Zikeya,F,100,7,0,7
Kaitlynne,F,100,915,0,915
Harshini,F,100,220,0,220
Labarbara,F,100,34,0,34
Jaylianna,F,100,102,0,102
Hanley,M,66,139,267,406
Obinna,M,100,0,707,707
Ismerai,F,100,214,0,214
Lonnesha,F,100,5,0,5
Turmaine,M,100,0,6,6
Crystalee,F,100,65,0,65
Collenn,F,100,5,0,5
Ericah,F,100,84,0,84
Chizaram,F,95,104,6,110
Brey,M,100,0,23,23
Julea,F,100,111,0,111
Yengkong,M,100,0,40,40
Charls,M,100,0,154,154
Griffin,M,98,508,32432,32940
Jireh,F,52,587,543,1130
Ravneet,F,96,154,7,161
Tyelar,M,100,0,6,6
Tymisha,F,100,51,0,51
Ayelet,F,100,610,0,610
Dayvonna,F,100,5,0,5
Kendra,F,100,91486,349,91835
Sheneice,F,100,28,0,28
Cartez,M,100,0,389,389
Chrisa,F,100,92,0,92
Jahmarion,M,100,0,93,93
Raymondo,M,100,0,312,312
Andreena,F,100,10,0,10
Tawona,F,100,78,0,78
Lawaun,M,100,0,5,5
Chelette,F,100,16,0,16
Laniah,F,100,641,0,641
Julia,F,100,274352,934,275286
Ausha,F,100,230,0,230
Randeen,F,100,5,0,5
Michaelangel,M,100,0,10,10
Rasheen,M,93,95,1326,1421
Shemekia,F,100,333,0,333
Munha,F,100,5,0,5
Armentha,F,100,34,0,34
Shardaye,F,100,17,0,17
Evalani,F,100,13,0,13
Quinzell,M,100,0,59,59
Torica,F,100,7,0,7
Ulices,M,100,0,1036,1036
Domynique,F,100,6,0,6
Lawrie,F,100,131,0,131
Kemondre,M,100,0,13,13
Torre,M,67,403,814,1217
Tazariah,F,100,8,0,8
Rozetta,F,100,264,0,264
Jimeka,F,100,101,0,101
Lakeysia,F,100,29,0,29
Shaunia,F,100,7,0,7
Brandey,F,100,209,0,209
Rythm,M,100,0,5,5
Charleson,M,100,0,16,16
Elhadj,M,100,0,131,131
Carriana,F,100,12,0,12
Joryn,F,100,13,0,13
Tianah,F,100,205,0,205
Hoa,F,51,270,262,532
Jaslynn,F,100,1567,0,1567
Macklan,M,100,0,12,12
Tymber,F,97,320,11,331
Lataiya,F,100,5,0,5
Wensley,M,100,0,6,6
Alaiyna,F,100,34,0,34
Catilaya,F,100,5,0,5
Malvern,M,100,0,66,66
Madaly,F,100,10,0,10
Jamerius,M,100,0,107,107
Nyela,F,100,184,0,184
Orben,M,100,0,5,5
Lakeeta,F,100,183,0,183
Winda,F,100,152,0,152
Desnee,F,100,7,0,7
Yzabel,F,100,56,0,56
Opie,M,100,0,96,96
Hollace,F,96,128,5,133
Jocylyn,F,100,9,0,9
Jaxsun,M,100,0,64,64
Shelise,F,100,132,0,132
Sujood,F,100,5,0,5
Iyla,F,100,583,0,583
Shemiah,F,100,160,0,160
Rhyder,M,93,45,571,616
Eladio,M,100,0,1494,1494
Marty,M,91,3105,29822,32927
Lad,M,100,0,11,11
Noretha,F,100,5,0,5
Ingris,F,100,235,0,235
Joelynn,F,100,196,0,196
Tyreeka,F,100,15,0,15
Maddan,M,100,0,11,11
Shylea,F,100,7,0,7
Auralee,F,100,12,0,12
Vickilynn,F,100,21,0,21
Ludwing,M,100,0,12,12
Umika,F,100,17,0,17
Dezerai,F,100,6,0,6
Janilya,F,100,6,0,6
Rosita,F,100,4339,0,4339
Yaretzy,F,100,1612,0,1612
Pegah,F,100,75,0,75
Adelai,F,100,136,0,136
Kirkland,M,99,12,1901,1913
Kaliyana,F,100,25,0,25
Kordae,M,100,0,142,142
Winifred,F,96,5139,219,5358
Shawntaye,F,100,12,0,12
Divina,F,100,903,0,903
Amondre,M,100,0,23,23
Madhav,M,100,0,320,320
Hermenia,F,100,30,0,30
Koti,F,100,5,0,5
Taitym,F,100,38,0,38
Arvil,M,100,0,483,483
Michaelchristop,M,100,0,5,5
Keaundra,F,100,230,0,230
Deval,M,100,0,72,72
Madeleyn,F,100,49,0,49
Fennell,M,100,0,5,5
Kirsti,F,100,1010,0,1010
Carrol,F,60,1258,851,2109
Mamediarra,F,100,17,0,17
Agostino,M,100,0,322,322
Lochlan,M,98,21,1213,1234
Janielle,F,100,579,0,579
Safin,M,100,0,17,17
Raashan,M,100,0,5,5
Chardae,F,100,698,0,698
Bojan,M,100,0,25,25
Damarques,M,100,0,24,24
Percival,M,100,0,462,462
Yushica,F,100,5,0,5
Charnea,F,100,24,0,24
Darrias,M,100,0,11,11
Lion,M,100,0,111,111
Sahrish,F,100,6,0,6
Macks,M,100,0,18,18
Zyier,M,100,0,202,202
Daymian,M,100,0,479,479
Miechelle,F,100,27,0,27
Iryana,F,100,16,0,16
Sonjia,F,100,876,0,876
Aquinas,M,100,0,5,5
Shelma,F,100,22,0,22
Ashalee,F,100,23,0,23
Marcail,F,100,16,0,16
Vonda,F,100,7177,11,7188
Kenyari,F,53,10,9,19
Arinjay,M,100,0,10,10
Adylyn,F,100,6,0,6
Everick,M,100,0,40,40
Shatierra,F,100,5,0,5
Ashlin,F,94,2297,155,2452
Pegge,F,100,97,0,97
Aanvi,F,100,81,0,81
Dayron,M,100,0,490,490
Amarilys,F,100,327,0,327
Earla,F,100,215,0,215
Frederi,M,100,0,15,15
Rennetta,F,100,12,0,12
Johnessa,F,100,5,0,5
Eusebia,F,100,37,0,37
Pracilla,F,100,5,0,5
Geona,F,100,5,0,5
Thiago,M,100,0,2727,2727
Joezette,F,100,5,0,5
Samaris,F,100,28,0,28
Paije,F,100,212,0,212
Sherrick,M,97,5,166,171
Alexzia,F,100,175,0,175
Madaliene,F,100,6,0,6
Emmalinn,F,100,11,0,11
Adit,M,100,0,246,246
Evangel,M,100,0,12,12
Merdis,F,100,24,0,24
Saloma,F,100,315,0,315
Toschia,F,100,5,0,5
Haakon,M,100,0,287,287
Eriyanna,F,100,138,0,138
Jaliana,F,100,52,0,52
Tasheka,F,100,408,0,408
Melayah,F,100,70,0,70
Dazon,M,100,0,39,39
Tyanah,F,100,53,0,53
Andi,F,83,3360,669,4029
Danasha,F,100,273,0,273
Lenvil,M,100,0,5,5
Chary,F,100,7,0,7
Umesh,M,100,0,5,5
Pike,M,100,0,114,114
Maina,F,100,5,0,5
Houa,F,70,181,79,260
Sherley,F,100,699,0,699
Britanna,F,100,5,0,5
Izek,M,100,0,324,324
Mycala,F,100,87,0,87
Evangelyne,F,100,47,0,47
Fany,F,100,78,0,78
Kden,M,100,0,153,153
Seleem,M,100,0,6,6
Paloma,F,100,7508,0,7508
Sunay,M,100,0,28,28
Shaqueta,F,100,145,0,145
Amando,M,86,134,849,983
Cheylee,F,100,15,0,15
Bates,M,100,0,40,40
Alayjha,F,100,17,0,17
Arjeta,F,100,5,0,5
Pavel,M,100,0,1166,1166
Qwen,M,100,0,5,5
Isarel,M,100,0,15,15
Jawayne,M,100,0,11,11
Imala,F,100,23,0,23
Urielle,F,100,6,0,6
Holden,M,99,124,17076,17200
Lamiyah,F,100,512,0,512
Kailynne,F,100,195,0,195
Kaedyn,M,63,537,924,1461
Gailen,M,93,6,85,91
Burnest,M,100,0,5,5
Chairty,F,100,59,0,59
Elyce,F,100,723,0,723
Cadet,M,100,0,5,5
Avory,F,57,335,249,584
Susen,F,100,162,0,162
Emalei,F,100,5,0,5
Maycie,F,100,1066,0,1066
Charlote,F,100,10,0,10
Rohini,F,100,293,0,293
Amariauna,F,100,5,0,5
Wuendi,F,100,5,0,5
Edrie,F,100,62,0,62
Roquan,M,100,0,21,21
Terrilee,F,100,139,0,139
Isalei,F,100,5,0,5
Treavon,M,100,0,230,230
Emmelie,F,100,24,0,24
Kanyia,F,100,146,0,146
Silka,F,100,52,0,52
Rosalina,F,100,2457,0,2457
Rudee,F,100,17,0,17
Azahel,M,100,0,56,56
Ilina,F,100,94,0,94
Selvyn,M,100,0,10,10
Delona,F,100,178,0,178
Tranquilino,M,100,0,41,41
Praneeth,M,100,0,105,105
Guyanne,F,100,5,0,5
Ladarrell,M,100,0,63,63
Shawnmichael,M,100,0,156,156
Lelah,F,100,514,0,514
Ronreco,M,100,0,5,5
Celestte,F,100,12,0,12
Johnphilip,M,100,0,28,28
Criston,M,83,19,90,109
Josephthomas,M,100,0,5,5
Guardian,M,100,0,5,5
Aryianna,F,100,154,0,154
Aeddon,M,100,0,26,26
Stefanni,F,100,5,0,5
Tristin,M,76,2735,8754,11489
Ramatoulaye,F,100,122,0,122
Minnie,F,100,10517,21,10538
Latif,M,100,0,366,366
Ricketta,F,100,83,0,83
Gwenlyn,F,100,57,0,57
Dianira,F,100,44,0,44
Landis,M,86,234,1434,1668
Aqueela,F,100,5,0,5
Anjanet,F,100,9,0,9
Garian,M,100,0,16,16
Florestela,F,100,16,0,16
Amandia,F,100,43,0,43
Treveion,M,100,0,54,54
Lyell,M,100,0,16,16
Mackey,M,100,0,314,314
Misel,F,100,13,0,13
Evyan,F,100,5,0,5
Marren,F,100,29,0,29
Berra,F,100,21,0,21
Azyrah,F,100,10,0,10
Latavia,F,100,2273,0,2273
Xzandria,F,100,80,0,80
Syier,M,100,0,6,6
Ranique,F,100,34,0,34
Dyante,M,100,0,15,15
Pierrie,M,100,0,13,13
Annalynn,F,100,765,0,765
Lakimberly,F,100,19,0,19
Annaliece,F,100,10,0,10
Marshelia,F,100,35,0,35
Osia,F,100,5,0,5
Myashia,F,100,5,0,5
Shamore,M,100,0,6,6
Lorez,F,100,11,0,11
Auriana,F,100,549,0,549
Antrel,M,100,0,10,10
Niket,M,100,0,23,23
Ryllie,F,100,65,0,65
Glendalis,F,100,12,0,12
Kapish,M,100,0,5,5
Keeyan,M,100,0,34,34
Sadi,F,99,551,5,556
Knova,F,100,5,0,5
Parry,M,100,0,408,408
Phyllip,M,100,0,87,87
Makaelyn,F,100,133,0,133
Marnay,F,100,15,0,15
Nichet,F,100,5,0,5
Roxeanne,F,100,10,0,10
Chanina,M,100,0,15,15
Iyona,F,100,450,0,450
Antowan,M,100,0,119,119
Kimori,F,100,75,0,75
Venton,M,100,0,23,23
Uriel,M,99,180,14237,14417
Boni,F,100,317,0,317
Oluwafemi,M,100,0,171,171
Dalon,M,100,0,668,668
Dyvion,M,100,0,5,5
Bilqis,F,100,5,0,5
Parsa,M,100,0,498,498
Jaelani,F,100,88,0,88
Kinneret,F,100,5,0,5
Trevond,M,100,0,22,22
Aleece,F,100,580,0,580
Jayliz,F,100,5,0,5
Wannetta,F,100,290,0,290
Jeneane,F,100,388,0,388
Raaghav,M,100,0,33,33
Jekai,M,100,0,16,16
Kirtley,M,100,0,6,6
Mercades,F,100,576,0,576
Lamont,M,99,165,21074,21239
Lauraelizabeth,F,100,6,0,6
Mariann,F,100,4704,0,4704
Deannia,F,100,17,0,17
Crystalann,F,100,150,0,150
Monecia,F,100,36,0,36
Margaretann,F,100,181,0,181
Domani,M,98,5,254,259
Davinna,F,100,11,0,11
Relena,F,100,44,0,44
Latijera,F,100,11,0,11
Olando,M,100,0,604,604
Sanjida,F,100,38,0,38
Gailyn,F,100,103,0,103
Sosie,F,100,81,0,81
Aalani,F,100,34,0,34
Charneka,F,100,5,0,5
Amilliona,F,100,5,0,5
Ahmari,M,70,292,670,962
Ziza,F,100,74,0,74
Vashaun,M,97,6,204,210
Jahshawn,M,100,0,54,54
Raymi,F,100,16,0,16
Laquin,M,100,0,5,5
Dionysia,F,100,33,0,33
Sirin,F,100,11,0,11
Tremica,F,100,5,0,5
Semyra,F,100,6,0,6
Catarena,F,100,6,0,6
Aaziyah,F,100,18,0,18
Zico,M,100,0,12,12
Esteffany,F,100,46,0,46
Zariana,F,100,150,0,150
Breeyah,F,100,5,0,5
Nickolette,F,100,124,0,124
Timeko,F,100,37,0,37
Makyleigh,F,100,6,0,6
Sherolyn,F,100,132,0,132
Don,M,99,454,69771,70225
Nelvia,F,100,12,0,12
Demontre,M,100,0,480,480
Ajax,M,100,0,135,135
Daanish,M,100,0,99,99
Leasa,F,100,922,0,922
Janicia,F,100,204,0,204
Pranati,F,100,60,0,60
Chayten,M,100,0,17,17
Haydi,F,100,6,0,6
Uwais,M,100,0,21,21
Jamiesha,F,100,121,0,121
Luisita,F,100,6,0,6
Samarrah,F,100,65,0,65
Malvika,F,100,69,0,69
Shydae,F,100,20,0,20
Chuefeng,M,100,0,5,5
Sansa,F,100,23,0,23
Shasha,F,100,209,0,209
Newborn,M,62,11,18,29
Finian,M,100,0,405,405
Antoninette,F,100,60,0,60
Jamalle,M,100,0,14,14
Meghan,F,100,93829,226,94055
Lamariana,F,100,13,0,13
Shametrice,F,100,5,0,5
Yuvonne,F,100,112,0,112
Falen,F,100,185,0,185
Enes,M,100,0,191,191
Archana,F,100,395,0,395
Lawrenzo,M,100,0,16,16
Naeshawn,M,100,0,19,19
Seandee,F,100,8,0,8
Deviny,F,100,13,0,13
Haizel,F,100,51,0,51
Karissia,F,100,14,0,14
Tansey,F,100,21,0,21
Kainoah,M,100,0,55,55
Dreda,F,100,10,0,10
Crist,M,100,0,536,536
Ankoma,M,100,0,6,6
Mister,M,100,0,541,541
Reicher,M,100,0,5,5
Jansiel,M,100,0,12,12
Shreehan,M,100,0,5,5
Alantae,M,100,0,10,10
Armistead,M,100,0,5,5
Areeb,M,100,0,312,312
Sammantha,F,100,1946,0,1946
Kirkwood,M,100,0,15,15
Ronae,F,100,158,0,158
Beaonca,F,100,5,0,5
Marielis,F,100,250,0,250
Zykeriya,F,100,5,0,5
Athleen,F,100,10,0,10
Antawon,M,100,0,28,28
Jhonattan,M,100,0,7,7
Trevaun,M,100,0,236,236
Dwana,F,100,953,0,953
Shatonna,F,100,29,0,29
Emaleigh,F,100,882,0,882
Jessicalee,F,100,40,0,40
Saraanne,F,100,21,0,21
Kristjan,M,100,0,213,213
Ciniya,F,100,51,0,51
Treshell,F,100,5,0,5
Corvin,M,100,0,509,509
Khloemae,F,100,5,0,5
Lashera,F,100,37,0,37
Yordy,M,100,0,248,248
Chaunte,F,100,464,0,464
Tangela,F,100,3783,0,3783
Nancilee,F,100,6,0,6
Kolawole,M,100,0,43,43
Jakeelah,F,100,11,0,11
Syrius,M,100,0,5,5
Tamaya,F,100,1006,0,1006
Vidushi,F,100,37,0,37
Deitric,M,100,0,13,13
Edmond,M,100,7,10121,10128
Katena,F,100,65,0,65
Caidin,M,100,0,84,84
Karimen,F,100,5,0,5
Blayden,M,100,0,498,498
Laelia,F,100,77,0,77
Anira,F,100,70,0,70
Edica,F,100,5,0,5
Sarely,F,100,55,0,55
Atinuke,F,100,5,0,5
Zahi,M,100,0,49,49
Timathy,M,100,0,279,279
Annibella,F,100,12,0,12
Kemarri,M,100,0,27,27
Jonahan,M,100,0,12,12
Atie,F,100,5,0,5
Jeziah,M,94,20,297,317
Leslian,F,100,27,0,27
Jamiir,M,100,0,11,11
Taushia,F,100,5,0,5
Telesia,F,100,90,0,90
Bobijo,F,100,16,0,16
Courtlan,M,100,0,23,23
Chanti,F,100,110,0,110
Arlyne,F,100,288,0,288
Mynette,F,100,10,0,10
Prajwal,M,100,0,66,66
Toyah,F,100,8,0,8
Vincente,M,100,0,2494,2494
Edika,F,100,5,0,5
Savion,M,100,17,3903,3920
Tyliq,M,100,0,5,5
Demarkis,M,100,0,111,111
Fintan,M,100,0,231,231
Orianna,F,100,912,0,912
Jsamine,F,100,6,0,6
Nikea,F,100,328,0,328
Ashanna,F,100,94,0,94
Shellaine,F,100,5,0,5
Jereomy,M,100,0,6,6
Bryseida,F,100,53,0,53
Damain,M,100,0,355,355
Johnine,F,100,48,0,48
Valor,M,92,24,277,301
Kynnlie,F,100,6,0,6
Raycine,F,100,5,0,5
Jrew,M,100,0,14,14
Hosannah,F,100,10,0,10
Keristen,F,100,20,0,20
Novah,F,77,188,55,243
Jarielis,F,100,33,0,33
Raenna,F,100,6,0,6
Brijet,F,100,5,0,5
Felipa,F,100,741,0,741
Kenalee,F,100,5,0,5
Kathleen,F,100,466625,1077,467702
Kahmyra,F,100,5,0,5
Xing,F,58,7,5,12
Francois,M,100,5,1357,1362
Gerrick,M,100,0,558,558
Oliveah,F,100,70,0,70
Duffy,M,97,16,458,474
Tymeka,F,100,191,0,191
Danajah,F,100,260,0,260
Saidi,F,100,62,0,62
Child,M,60,53,78,131
Takyrah,F,100,25,0,25
Arilynn,F,100,110,0,110
Ashianna,F,100,5,0,5
Cordeja,F,100,5,0,5
Sabrah,F,100,13,0,13
Filiberto,M,100,0,1970,1970
Brinlea,F,100,5,0,5
Ladarious,M,100,0,417,417
Luai,M,100,0,15,15
Konisha,F,100,7,0,7
Katti,F,100,191,0,191
Deangela,F,100,1198,0,1198
Zao,M,100,0,17,17
Lakin,F,84,1642,313,1955
Rainna,F,100,190,0,190
Jacquin,M,86,5,31,36
Iseah,M,100,0,148,148
Fame,F,100,7,0,7
Ariyunna,F,100,6,0,6
Sophal,M,100,0,37,37
Ben,M,100,105,35188,35293
Marcquel,M,100,0,12,12
Saliyah,F,100,332,0,332
Merelyn,F,100,153,0,153
Deztiny,F,100,223,0,223
Charvae,F,100,11,0,11
Roddick,M,100,0,12,12
Erion,M,78,113,401,514
Christl,F,100,61,0,61
Edita,F,100,77,0,77
Amaure,M,100,0,18,18
Jenssy,M,100,0,5,5
Kevona,F,100,113,0,113
Daesia,F,100,65,0,65
Meera,F,100,2068,0,2068
Hezakiah,M,100,0,60,60
Yamiles,F,100,43,0,43
Baisley,F,100,10,0,10
Kamakana,M,100,0,17,17
Dantavis,M,100,0,11,11
Anabele,F,100,5,0,5
Hovanes,M,100,0,63,63
Tiandra,F,100,484,0,484
Jacksin,M,100,0,10,10
Vesenia,F,100,40,0,40
Daenna,F,100,5,0,5
Laurean,F,100,10,0,10
Tamarius,M,100,0,182,182
Jadan,M,76,343,1096,1439
Shandal,F,100,10,0,10
Alynna,F,100,591,0,591
Tyquisha,F,100,96,0,96
Terie,F,100,343,0,343
Diania,F,100,478,0,478
Wasim,M,100,0,127,127
Ezra,M,95,1402,26774,28176
Kelley,F,90,45764,4835,50599
Shalynda,F,100,17,0,17
Jeshaiah,M,100,0,10,10
Marlicia,F,100,70,0,70
Nakira,F,100,389,0,389
Zanaiya,F,100,95,0,95
Quantel,M,100,0,76,76
Irl,M,100,0,107,107
Lateshia,F,100,682,0,682
Uryah,M,100,0,21,21
Gerriann,F,100,57,0,57
Lashelia,F,100,5,0,5
Eliase,M,100,0,5,5
Calix,M,100,0,320,320
Vibhu,M,100,0,23,23
Xazier,M,100,0,46,46
Samra,F,100,399,0,399
Laurelyn,F,100,86,0,86
Kokou,M,100,0,5,5
Kajetan,M,100,0,6,6
Desiraye,F,100,111,0,111
Roshena,F,100,22,0,22
Iassac,M,100,0,5,5
Franda,F,100,5,0,5
Lawenda,F,100,5,0,5
Marshanna,F,100,24,0,24
Jahmil,M,100,0,218,218
Tsianina,F,100,5,0,5
Roben,F,71,314,130,444
Maressia,F,100,5,0,5
Delcine,F,100,29,0,29
Adoni,M,100,0,79,79
Taleisa,F,100,5,0,5
Aalayiah,F,100,7,0,7
Yesmi,F,100,5,0,5
Nakaylah,F,100,50,0,50
Devinlee,M,100,0,5,5
Leo,M,100,316,66400,66716
Deyvi,M,100,0,69,69
Randolf,M,100,0,864,864
Genard,M,100,0,49,49
Brittin,F,66,216,113,329
Naor,M,100,0,12,12
Aubra,F,58,32,23,55
Fabienne,F,100,481,0,481
Yoruba,F,100,13,0,13
Shakirra,F,100,138,0,138
Tindra,F,100,5,0,5
Alixe,F,100,5,0,5
Tyrissa,F,100,16,0,16
Darlina,F,100,131,0,131
Mallary,F,100,747,0,747
Takaylah,F,100,16,0,16
Chalmers,M,100,0,235,235
Tsai,M,100,0,10,10
Kariann,F,100,781,0,781
Chayston,M,100,0,14,14
Lainee,F,100,797,0,797
Kito,M,93,11,155,166
Manette,F,100,241,0,241
Prairie,F,100,238,0,238
Wannette,F,100,14,0,14
Jeaniece,F,100,5,0,5
Jalitza,F,100,48,0,48
Sheyna,F,100,196,0,196
Victoralfonso,M,100,0,15,15
Anindita,F,100,8,0,8
Jaishon,M,100,0,162,162
Jnyla,F,100,18,0,18
Kyale,M,100,0,10,10
Masai,M,100,0,258,258
Koltin,M,100,0,617,617
Sbrina,F,100,5,0,5
Waheedah,F,100,7,0,7
Penelope,F,100,31719,0,31719
Nimra,F,100,199,0,199
Autrey,M,93,5,66,71
Janluis,M,100,0,16,16
Mayeli,F,100,372,0,372
Aziz,M,100,0,1129,1129
Zainah,F,100,137,0,137
Vito,M,100,0,6686,6686
Artresha,F,100,5,0,5
Trinnie,F,100,10,0,10
Shakti,F,95,86,5,91
Zaquan,M,100,0,485,485
Diamonte,M,93,32,439,471
Keria,F,100,444,0,444
Macartney,F,100,6,0,6
Rajbir,M,100,0,30,30
Ismelda,F,100,101,0,101
Darleta,F,100,5,0,5
Filemon,M,100,0,347,347
Doyce,M,100,0,243,243
Mareli,F,100,972,0,972
Cuong,M,100,0,554,554
Josefine,F,100,410,0,410
Berkeley,F,68,1014,475,1489
Undrae,M,100,0,5,5
Ronith,M,100,0,106,106
Cayman,M,75,250,764,1014
Laycen,M,100,0,7,7
Ariyanna,F,100,2053,0,2053
Ariany,F,100,234,0,234
Milia,F,100,170,0,170
Keleah,F,100,40,0,40
Penelopy,F,100,21,0,21
Ohara,F,77,20,6,26
Dalenna,F,100,16,0,16
Lawton,M,100,0,1334,1334
Leniah,F,100,60,0,60
Darniece,F,100,10,0,10
Lashonn,F,100,32,0,32
Trevorjames,M,100,0,5,5
Velinda,F,100,821,0,821
Alaxandria,F,100,10,0,10
Annakay,F,100,23,0,23
Kogan,M,100,0,16,16
Kalkidan,F,100,92,0,92
Sebashtian,M,100,0,20,20
Ammar,M,100,0,1783,1783
Damoney,M,100,0,52,52
Tahara,F,100,282,0,282
Devereux,M,100,0,6,6
Jathen,M,100,0,150,150
Shanari,F,100,17,0,17
Grabiel,M,100,0,548,548
Idiris,M,100,0,23,23
Raimon,M,100,0,22,22
Zykeriah,F,100,83,0,83
Albert,M,99,859,156330,157189
Loralynn,F,100,21,0,21
Jerrianna,F,100,5,0,5
Konor,M,100,0,209,209
Mileyna,F,100,5,0,5
Vonzella,F,100,98,0,98
Skarlet,F,100,205,0,205
Tallen,M,100,0,416,416
Kiosha,F,100,175,0,175
Renai,F,100,74,0,74
Stafon,M,100,0,5,5
Xea,F,100,5,0,5
Hannahrae,F,100,5,0,5
Latashia,F,100,1798,0,1798
Kemare,M,100,0,7,7
Taniayah,F,100,5,0,5
Oluwafunmilola,F,100,5,0,5
Normand,M,100,0,1465,1465
Teaera,F,100,12,0,12
Rohana,F,100,17,0,17
Nakio,M,100,0,5,5
Amybeth,F,100,116,0,116
Britteney,F,100,82,0,82
Nicko,M,97,8,227,235
Biak,F,68,13,6,19
Rehgan,F,100,10,0,10
Murray,M,98,96,6104,6200
Oliviarose,F,100,63,0,63
Author,M,100,0,521,521
Dulan,M,100,0,5,5
Axxel,M,100,0,76,76
Ion,M,100,0,195,195
Indiana,F,52,694,644,1338
Yannik,M,100,0,13,13
Jashayla,F,100,185,0,185
Taksh,M,100,0,24,24
Kianni,F,100,171,0,171
Wanna,F,100,99,0,99
Girlie,F,100,13,0,13
Inocente,M,100,0,64,64
Akeena,F,100,29,0,29
Danelia,F,100,87,0,87
Dao,M,68,88,189,277
Brittaney,F,100,3275,0,3275
Quanterrius,M,100,0,14,14
Shaimaa,F,100,11,0,11
Dua,F,100,337,0,337
Darko,M,100,0,23,23
Haoyu,M,100,0,15,15
Jaysan,M,100,0,5,5
Braxley,M,100,0,16,16
Javeah,F,100,135,0,135
Dornell,M,100,0,289,289
Quran,M,98,34,1618,1652
Tea,F,100,2249,0,2249
Zale,M,100,0,81,81
Shamarcus,M,100,0,70,70
Anuar,M,100,0,197,197
Annaise,F,100,5,0,5
Meret,F,100,5,0,5
Sajid,M,100,0,327,327
Glendean,F,100,5,0,5
Kymbre,F,100,8,0,8
Tabby,F,97,162,5,167
Kramer,M,99,6,489,495
Mylania,F,100,14,0,14
Rosendo,M,100,0,3736,3736
Angelissa,F,100,70,0,70
Jefferson,M,100,0,15107,15107
Baron,M,100,0,5206,5206
Siyon,M,100,0,33,33
Shakota,F,100,45,0,45
Thressa,F,100,402,0,402
Lekevia,F,100,6,0,6
Acquanetta,F,100,203,0,203
Eriann,F,100,5,0,5
Susanne,F,100,17790,0,17790
Jarick,M,100,0,76,76
Quantina,F,100,225,0,225
Pryia,F,100,10,0,10
Kristof,M,100,0,244,244
Diante,M,98,20,1279,1299
Kayah,F,100,308,0,308
Shavada,F,100,5,0,5
Caryna,F,100,6,0,6
Dimitrios,M,100,0,2308,2308
Yousuke,M,100,0,5,5
Sulay,F,100,65,0,65
Lolethia,F,100,5,0,5
Nazarria,F,100,6,0,6
Ridwaan,M,100,0,5,5
Shalima,F,100,5,0,5
Nidhi,F,100,1223,0,1223
Meliss,F,100,351,0,351
Seymour,M,100,0,619,619
Cramon,M,100,0,5,5
Hebert,M,100,0,392,392
Jurell,M,100,0,139,139
Perpetua,F,100,40,0,40
Ahren,M,100,0,809,809
Trisia,F,100,51,0,51
Mahiyah,F,100,30,0,30
Adonte,M,100,0,172,172
Ritney,F,100,5,0,5
Dylan,M,97,9326,331731,341057
Breshai,F,100,5,0,5
Teresea,F,100,441,0,441
Susin,F,100,5,0,5
Nadelyn,F,100,56,0,56
Duanna,F,100,63,0,63
Johnna,F,100,9337,0,9337
Demmie,F,100,5,0,5
Kaicen,M,100,0,52,52
Liliann,F,100,398,0,398
Anokhi,F,100,60,0,60
Klohe,F,100,96,0,96
Aayana,F,100,99,0,99
Tarae,F,91,104,10,114
Jacquilyn,F,100,314,0,314
Lisl,F,100,60,0,60
Nylen,M,88,5,37,42
Daryon,M,100,0,166,166
Jeffrey,M,100,3374,934568,937942
Quinya,F,100,26,0,26
Cholena,F,100,5,0,5
Kerica,F,100,5,0,5
Donatella,F,100,186,0,186
Tazia,F,100,303,0,303
Hector,M,99,476,91018,91494
Serhat,M,100,0,5,5
Chaely,F,100,8,0,8
Breana,F,100,10997,0,10997
Avannah,F,100,46,0,46
Syncere,M,77,375,1286,1661
Clarena,F,100,5,0,5
Alei,F,100,5,0,5
Vashti,F,100,1249,0,1249
Keyshanna,F,100,15,0,15
Jalen,M,96,1618,34615,36233
Javonne,F,55,362,302,664
Enesha,F,100,5,0,5
Chimdi,M,100,0,7,7
Iyonia,F,100,32,0,32
Jennedy,F,100,6,0,6
Charliann,F,100,22,0,22
Baba,M,100,0,23,23
Bee,M,79,137,529,666
Evelynrose,F,100,14,0,14
Treena,F,100,835,0,835
Lakelia,F,100,28,0,28
Rubianna,F,100,10,0,10
Lakedia,F,100,16,0,16
Suna,F,100,20,0,20
Davidallen,M,100,0,5,5
Domari,M,100,0,5,5
Tekayla,F,100,59,0,59
Durwood,M,100,0,721,721
Willem,M,100,0,2128,2128
Takindra,F,100,6,0,6
Crystalrose,F,100,32,0,32
Arnetha,F,100,242,0,242
Jessalyn,F,100,3065,0,3065
Isara,F,100,5,0,5
Nyshea,F,100,16,0,16
Zacharya,M,100,0,5,5
Getsemany,F,100,5,0,5
Asasha,F,100,5,0,5
Jonlucas,M,100,0,5,5
Fredie,M,100,0,364,364
Remelda,F,100,5,0,5
Kailanny,F,100,6,0,6
Satish,M,100,0,28,28
Malaisia,F,100,10,0,10
Yuma,M,81,55,230,285
Finnan,M,100,0,52,52
Barbett,F,100,6,0,6
Ysidoro,M,100,0,6,6
Dyquan,M,100,0,186,186
Kinslee,F,100,1305,0,1305
Taigon,M,100,0,5,5
Tami,F,100,37713,72,37785
Dartavius,M,100,0,17,17
Tim,M,100,181,71946,72127
Isse,M,100,0,13,13
Estell,F,86,284,45,329
Missey,F,100,72,0,72
Vilma,F,100,2470,0,2470
Keryl,F,100,66,0,66
Tshanti,F,100,7,0,7
Danyea,F,100,5,0,5
Shirely,F,100,100,0,100
Jeryl,F,60,855,566,1421
Alvan,M,100,0,280,280
Jewelya,F,100,29,0,29
Sharocka,F,100,5,0,5
Cainin,M,100,0,15,15
Cayson,M,98,31,1969,2000
Surraya,F,100,5,0,5
Syeria,F,100,6,0,6
Jamika,F,100,1379,0,1379
Danald,M,100,0,5,5
Taeyah,F,100,5,0,5
Tyqwan,M,100,0,65,65
Merrianne,F,100,80,0,80
Tameke,F,100,5,0,5
Mekaila,F,100,137,0,137
Davyne,F,100,31,0,31
Natisa,F,100,6,0,6
Samvel,M,100,0,105,105
Davisha,F,100,209,0,209
Lashenna,F,100,19,0,19
Charmayne,F,100,1219,0,1219
Noeliz,F,100,6,0,6
Presila,F,100,6,0,6
Pavly,M,100,0,5,5
Isabeli,F,100,5,0,5
Pansey,F,100,22,0,22
Dakiya,F,100,124,0,124
Troyce,M,85,43,249,292
Silk,F,100,8,0,8
Courey,M,100,0,25,25
Jenisse,F,100,75,0,75
Deddie,F,100,7,0,7
Annarosa,F,100,23,0,23
Miren,F,100,40,0,40
Annalya,F,100,14,0,14
Dontevius,M,100,0,7,7
Jadiel,M,100,0,2548,2548
Shawnda,F,100,2539,0,2539
Koketa,F,100,6,0,6
Arkim,M,100,0,7,7
Kadrian,M,96,11,242,253
Cesare,M,100,0,419,419
Iayana,F,100,21,0,21
Jahem,M,100,0,33,33
Jakoria,F,100,11,0,11
Mirium,F,100,7,0,7
Embrie,F,100,72,0,72
Cherrice,F,100,32,0,32
Zamere,M,100,0,82,82
Siddhan,M,100,0,15,15
Hadley,F,94,18143,1176,19319
Keleni,F,100,7,0,7
Anagabriela,F,100,116,0,116
Braelynn,F,97,3057,81,3138
Aiah,F,100,18,0,18
Jacklyn,F,100,14028,5,14033
Arabella,F,100,10140,0,10140
Elvester,M,100,0,5,5
Khup,M,100,0,23,23
Saralyn,F,100,995,0,995
Gabryele,F,100,7,0,7
Khiala,F,100,6,0,6
Sebastiano,M,100,0,589,589
Tomisha,F,100,311,0,311
Aubry,F,81,2593,612,3205
Patsy,F,98,32263,735,32998
Siddiq,M,100,0,125,125
Eliandra,F,100,5,0,5
Shacoya,F,100,187,0,187
Markeem,M,100,0,141,141
Shyia,F,100,62,0,62
Jeremian,M,100,0,64,64
Ayeshah,F,100,12,0,12
Johnsie,F,100,167,0,167
Kimimela,F,100,7,0,7
Zyarah,F,100,19,0,19
Evolett,F,100,99,0,99
Takaya,F,94,78,5,83
Avaa,F,100,6,0,6
Shanille,F,100,15,0,15
Ladreka,F,100,5,0,5
Yediel,M,100,0,47,47
Menna,F,100,108,0,108
Nykisha,F,100,40,0,40
Disheka,F,100,5,0,5
Talika,F,100,50,0,50
Khamara,F,100,18,0,18
Vierra,F,100,5,0,5
Trebor,M,100,0,475,475
Ferron,M,88,12,85,97
Radiah,F,100,108,0,108
Bernave,M,100,0,18,18
Karema,F,100,62,0,62
Harpal,M,100,0,13,13
Valene,F,100,654,0,654
Shaleka,F,100,60,0,60
Mikelyn,F,100,39,0,39
Briar,M,68,1347,2894,4241
Shennel,F,100,5,0,5
Chella,F,100,115,0,115
Farhiyo,F,100,13,0,13
Jos,M,100,0,41,41
Joddie,F,100,34,0,34
Tyina,F,100,28,0,28
Cartlin,F,100,6,0,6
Aydenn,M,98,8,507,515
Domitila,F,100,90,0,90
Tochukwu,M,100,0,28,28
Catriona,F,100,548,0,548
Corinth,F,100,5,0,5
Mikaili,F,100,90,0,90
Amaia,F,100,1197,0,1197
Dianne,F,100,58400,104,58504
Keisuke,M,100,0,148,148
Jozee,F,100,131,0,131
Tamblyn,F,100,18,0,18
Piccola,F,100,11,0,11
Brain,M,100,10,4591,4601
Bellinda,F,100,5,0,5
Sujal,M,100,0,44,44
Shaka,M,81,142,600,742
Kenteria,F,100,21,0,21
Tateum,M,52,25,27,52
Samyr,M,100,0,5,5
Ras,M,100,0,137,137
Gevan,M,100,0,12,12
Shaquina,F,100,123,0,123
Tifanie,F,100,407,0,407
Seleny,F,100,51,0,51
Darro,M,100,0,5,5
Serrena,F,100,110,0,110
Kaydense,F,100,68,0,68
Destane,F,100,72,0,72
Imauri,M,100,0,5,5
Arlenys,F,100,33,0,33
Allecia,F,100,175,0,175
Tiadra,F,100,5,0,5
Adalina,F,100,718,0,718
Jonchristopher,M,100,0,10,10
Lexly,F,100,15,0,15
Hao,M,99,5,399,404
Lexas,F,100,29,0,29
Biancia,F,100,40,0,40
Raushan,M,100,0,33,33
Jahanna,F,100,158,0,158
Chanette,F,100,75,0,75
Zoraida,F,100,1955,0,1955
Lakaia,F,100,17,0,17
Allyiah,F,100,161,0,161
Siti,F,100,11,0,11
Sheny,F,100,21,0,21
Aberdeen,F,100,88,0,88
Auroralynn,F,100,5,0,5
Zamareon,M,100,0,5,5
Ajavion,M,100,0,20,20
Azael,M,100,0,1368,1368
Ayeleen,F,100,10,0,10
Lyndsae,F,100,5,0,5
Darica,F,100,64,0,64
Brody,M,100,201,56599,56800
Vardan,M,100,0,22,22
Decora,F,100,21,0,21
Rheannon,F,100,440,0,440
Joyner,M,100,0,5,5
Kathlene,F,100,2640,0,2640
Artis,M,92,256,2811,3067
Eloi,M,100,0,17,17
Caetlin,F,100,24,0,24
Marteeka,F,100,5,0,5
Cuauhtli,M,100,0,6,6
Melodia,F,100,10,0,10
Daquion,M,100,0,11,11
Vonne,F,100,58,0,58
Starsha,F,100,260,0,260
Lakya,F,100,236,0,236
Eisley,F,98,809,15,824
Chess,M,100,0,13,13
Niyomi,F,100,10,0,10
Chanita,F,100,404,0,404
Dominik,M,99,95,7294,7389
Brenton,M,100,18,13309,13327
Corii,F,100,5,0,5
Jaiyana,F,100,303,0,303
Tashanna,F,100,438,0,438
Annabela,F,100,11,0,11
Zeid,M,100,0,49,49
Diaquan,M,100,0,5,5
Indonesia,F,100,83,0,83
Lyndse,F,100,36,0,36
Yeshaya,M,100,0,492,492
Veronic,F,100,19,0,19
Onix,M,100,0,185,185
Daveta,F,100,10,0,10
Adalye,F,100,10,0,10
Karra,F,100,938,0,938
Sherrl,F,100,17,0,17
Michaline,F,100,51,0,51
Quaid,M,100,0,651,651
Viana,F,100,465,0,465
Naijah,F,100,179,0,179
Dorlisa,F,100,146,0,146
Myshawn,M,100,0,109,109
Ahniyla,F,100,10,0,10
Tarnesha,F,100,112,0,112
Orlyn,M,100,0,25,25
Nathann,M,100,0,6,6
Lailani,F,100,915,0,915
Taiesha,F,100,251,0,251
Eissa,M,100,0,13,13
Shawne,F,65,796,429,1225
Nyagoa,F,100,5,0,5
Mohammad,M,100,10,11899,11909
Kawena,F,91,104,10,114
Luian,M,100,0,32,32
Barisha,F,100,5,0,5
Zimal,F,100,25,0,25
Euginia,F,100,5,0,5
Shavonne,F,100,2940,0,2940
Synithia,F,100,5,0,5
Virma,F,100,11,0,11
Tiger,M,96,35,890,925
Alixandrea,F,100,100,0,100
Eyon,M,100,0,48,48
Dayzi,F,100,10,0,10
Nerisa,F,100,10,0,10
Yue,M,68,39,81,120
Abeeha,F,100,70,0,70
Akai,M,90,32,302,334
Tiare,F,100,1170,0,1170
Jameira,F,100,35,0,35
Dandrell,M,100,0,5,5
Kerk,M,100,0,10,10
Sylvanus,M,100,0,118,118
Kayrene,F,100,10,0,10
Lanelda,F,100,5,0,5
Damerius,M,100,0,35,35
Asah,M,100,0,79,79
Tamarious,M,100,0,18,18
Knoxville,M,100,0,5,5
Sincere,M,83,985,4983,5968
Monteco,M,100,0,24,24
Nand,M,100,0,28,28
Tymell,M,100,0,16,16
Tanyia,F,100,511,0,511
Ilyse,F,100,360,0,360
Dorin,M,86,21,129,150
Kyrollos,M,100,0,65,65
Keary,M,84,104,564,668
Calla,F,100,2338,0,2338
Dorthia,F,100,11,0,11
Marquilla,F,100,20,0,20
Bosie,M,100,0,7,7
Jaewoo,M,100,0,5,5
Merald,M,100,0,5,5
Allante,M,77,131,444,575
Zeno,M,100,0,497,497
Ranon,M,100,0,59,59
Ramisa,F,100,68,0,68
Dmon,M,100,0,21,21
Rethel,F,100,11,0,11
Caedmon,M,100,0,746,746
Lister,M,100,0,10,10
Jacquella,F,100,34,0,34
Raymesha,F,100,5,0,5
Latrika,F,100,6,0,6
Stepehn,M,100,0,58,58
Jonilee,F,100,5,0,5
Lekha,F,100,81,0,81
Janelis,F,100,258,0,258
Lathaniel,M,100,0,160,160
Preya,F,100,35,0,35
Jeira,F,100,5,0,5
Jennicka,F,100,15,0,15
Iszabella,F,100,147,0,147
Kobby,M,100,0,11,11
Llubia,F,100,6,0,6
Pio,M,100,0,136,136
Keanu,M,96,202,4311,4513
Kadaja,F,100,52,0,52
Neariah,F,100,37,0,37
Keydy,F,100,42,0,42
Ernestor,M,100,0,5,5
Jola,F,100,56,0,56
Delexus,F,100,12,0,12
Arlyssa,F,100,10,0,10
Lanorris,M,100,0,146,146
Adreina,F,100,11,0,11
Tolanda,F,100,58,0,58
Vinesha,F,100,18,0,18
Calum,M,100,0,1095,1095
Jahjuan,M,100,0,7,7
Bula,F,100,5,0,5
Rhond,F,100,5,0,5
Aminata,F,100,1455,0,1455
Tamecka,F,100,127,0,127
Teosha,F,100,119,0,119
Lataysha,F,100,109,0,109
Grae,F,52,51,47,98
Shanen,F,73,131,48,179
Sarafina,F,100,517,0,517
Danniella,F,100,147,0,147
Jefri,M,100,0,30,30
Tereas,F,100,20,0,20
Trishona,F,100,5,0,5
Doralynn,F,100,6,0,6
Tallin,M,100,0,74,74
Jezenia,F,100,6,0,6
Buryl,M,100,0,5,5
Lyta,F,100,11,0,11
Tradon,M,100,0,16,16
Gerrid,M,100,0,22,22
Aasiya,F,100,128,0,128
Cledis,M,100,0,11,11
Zuriel,M,85,219,1219,1438
Yariliz,F,100,15,0,15
Nikerria,F,100,19,0,19
Ikey,M,100,0,37,37
Kenetta,F,100,17,0,17
Melarie,F,100,5,0,5
Norita,F,100,259,0,259
Austine,M,55,123,153,276
Megnan,F,100,16,0,16
Mariela,F,100,10011,8,10019
Dyrk,M,100,0,10,10
Newton,M,100,0,2025,2025
Telishia,F,100,6,0,6
Ridley,M,66,291,567,858
Lucifer,M,100,0,71,71
Khamyla,F,100,5,0,5
Gehrig,M,100,0,599,599
Dipesh,M,100,0,19,19
Aristede,M,100,0,22,22
Osmany,M,100,0,110,110
Kode,M,100,0,58,58
Delorian,M,78,10,36,46
Elizer,M,100,0,87,87
Aquasia,F,100,31,0,31
Xica,F,100,8,0,8
Marja,F,100,403,0,403
Sulekha,F,100,5,0,5
Tippi,F,100,100,0,100
Devonte,M,100,32,10481,10513
Daquita,F,100,51,0,51
Wale,M,100,0,23,23
Gabreille,F,100,67,0,67
Ryszard,M,100,0,33,33
Wilfried,M,100,0,10,10
Leahla,F,100,13,0,13
Steffano,M,100,0,20,20
Zabella,F,100,68,0,68
Mialani,F,100,73,0,73
Shelbey,F,100,896,0,896
Shyrl,F,100,123,0,123
Iquan,M,100,0,25,25
Makynlie,F,100,51,0,51
Saderia,F,100,5,0,5
Daleysha,F,100,9,0,9
Yelina,F,100,54,0,54
Charryse,F,100,34,0,34
Beunka,F,100,26,0,26
Dianey,F,100,177,0,177
Natallia,F,100,137,0,137
Jesselle,F,100,180,0,180
Shekeita,F,100,6,0,6
Darney,M,100,0,5,5
Bennington,M,100,0,5,5
Kalolaine,F,100,23,0,23
Kanako,F,100,46,0,46
Makida,F,100,10,0,10
Jasie,F,100,197,0,197
Dewone,M,100,0,39,39
Marda,F,100,181,0,181
Patyn,F,100,5,0,5
Carlitos,M,100,0,452,452
Nigel,M,99,68,11060,11128
Ilian,M,72,35,91,126
Umayma,F,100,5,0,5
Tarrius,M,100,0,5,5
Darneisha,F,100,184,0,184
Yaralis,F,100,6,0,6
Monterion,M,100,0,5,5
Zacora,F,100,10,0,10
Lavena,F,100,454,0,454
Maurus,M,100,0,5,5
Missel,F,100,5,0,5
Darliss,F,100,10,0,10
Cleatrice,F,100,5,0,5
Aalaiya,F,100,7,0,7
Faustino,M,100,0,2474,2474
Richter,M,100,0,11,11
Domminic,M,100,0,25,25
Yamato,M,100,0,89,89
Dong,M,100,0,316,316
Dazia,F,100,331,0,331
Jamilia,F,100,464,0,464
Luwanda,F,100,148,0,148
Talishia,F,100,104,0,104
Ludwig,M,100,0,658,658
Rayjon,M,100,0,137,137
Ruel,M,100,0,639,639
Jabriya,F,100,10,0,10
Dorcas,F,100,2861,0,2861
Tejasvi,F,100,78,0,78
Samartha,F,100,7,0,7
Yanika,F,100,22,0,22
Canyla,F,100,5,0,5
Cesley,F,100,50,0,50
Mistee,F,100,250,0,250
Quineisha,F,100,40,0,40
Isamari,F,100,27,0,27
Takerra,F,100,61,0,61
Thomes,M,100,0,161,161
Ndey,F,100,5,0,5
Alesi,F,100,62,0,62
Ailiyah,F,100,10,0,10
Evren,M,97,7,226,233
Ku,M,100,0,22,22
Reberta,F,100,5,0,5
Dystanie,F,100,15,0,15
Lynnai,F,100,7,0,7
Julias,M,100,0,73,73
Asenath,F,100,158,0,158
Angelyca,F,100,26,0,26
Ariajade,F,100,5,0,5
Anissa,F,100,11569,5,11574
Sierrea,F,100,5,0,5
Tracei,F,100,5,0,5
Kouture,F,100,22,0,22
Usama,M,100,0,161,161
Mercie,F,100,151,0,151
Josearmando,M,100,0,148,148
Taesean,M,100,0,108,108
Dayion,M,100,0,5,5
Dezirae,F,100,1771,0,1771
Trenecia,F,100,40,0,40
Holsten,M,100,0,5,5
Harshal,M,100,0,80,80
Mccabe,M,100,0,91,91
Fontane,M,100,0,5,5
Menashe,M,100,0,252,252
Cherea,F,100,17,0,17
Myjah,F,100,11,0,11
Umoja,M,100,0,5,5
Khylen,M,100,0,134,134
Quetzy,F,100,5,0,5
Anecia,F,100,629,0,629
Hakima,F,100,29,0,29
Damiah,F,100,282,0,282
Manjinder,M,100,0,5,5
Makesha,F,100,473,0,473
Shanvi,F,100,57,0,57
Mchael,M,100,0,5,5
Zeshan,M,100,0,250,250
Salmo,F,100,7,0,7
Jerimiyah,M,100,0,10,10
Damarquis,M,100,0,56,56
Trea,M,72,112,289,401
Neah,F,100,366,0,366
Charvi,F,100,162,0,162
Tamyra,F,100,2176,0,2176
Fiori,F,100,11,0,11
Daffney,F,100,202,0,202
Asha,F,100,7119,32,7151
Miho,F,100,95,0,95
Iceola,F,100,5,0,5
Shambria,F,100,165,0,165
Jaeci,F,100,17,0,17
Jaymarie,F,100,86,0,86
Kendricks,M,100,0,77,77
Aryanna,F,100,7175,0,7175
Elainey,F,100,30,0,30
Oluyemi,M,100,0,5,5
Sharmyn,F,100,12,0,12
Amandamarie,F,100,77,0,77
Jaqueline,F,100,14251,23,14274
Daylah,F,100,69,0,69
Sahalie,F,100,57,0,57
Loistene,F,100,8,0,8
Zadrian,M,100,0,209,209
Chiqueta,F,100,26,0,26
Aaliayh,F,100,47,0,47
Levin,M,100,0,930,930
Kwynn,F,100,43,0,43
Greyden,M,100,0,208,208
Penrose,F,100,6,0,6
Rosalua,F,100,15,0,15
Dakarri,M,100,0,43,43
Jussiah,M,100,0,5,5
Chalena,F,100,31,0,31
Joeleen,F,100,186,0,186
Shardea,F,100,49,0,49
Shakeyda,F,100,5,0,5
Layna,F,100,2026,0,2026
Gianetta,F,100,7,0,7
Sharese,F,100,887,0,887
Elvin,M,100,6,9057,9063
Twisha,F,100,28,0,28
Aristotle,M,100,0,721,721
Salinda,F,100,195,0,195
Kerre,F,100,28,0,28
Seattle,F,95,96,5,101
Keelah,F,100,22,0,22
Jaya,F,99,2823,23,2846
Dymon,F,94,369,22,391
Zaviera,F,100,25,0,25
Hillel,M,100,0,958,958
Mikle,M,100,0,111,111
Austinlee,M,100,0,15,15
Margoth,F,100,10,0,10
Medea,F,100,202,0,202
Angelisse,F,100,153,0,153
Jvion,M,100,0,180,180
Amelio,M,100,0,159,159
Lapria,F,100,11,0,11
Jearold,M,100,0,5,5
Maahir,M,100,0,53,53
Jaylanis,F,100,11,0,11
Saifullah,M,100,0,56,56
Ameliagrace,F,100,10,0,10
Royesha,F,100,6,0,6
Harryson,M,100,0,7,7
Nehemiah,M,97,372,12362,12734
Staria,F,100,62,0,62
Arbella,F,100,11,0,11
Dcarlos,M,100,0,20,20
Erenst,M,100,0,5,5
Delron,M,100,0,70,70
Dominquie,F,50,5,5,10
Areli,F,99,5119,64,5183
Denarrius,M,100,0,5,5
Haelee,F,100,195,0,195
Phylecia,F,100,22,0,22
Candias,F,100,23,0,23
Lazette,F,100,139,0,139
Miyosha,F,100,13,0,13
Amon,M,100,0,1533,1533
Marlii,F,100,10,0,10
Sevannah,F,100,71,0,71
Dereka,F,100,412,0,412
Camber,F,96,406,19,425
Memory,F,100,991,0,991
Anyelis,F,100,6,0,6
Chalmer,M,100,0,181,181
Christoph,M,100,0,1028,1028
Yanilet,F,100,30,0,30
Lora,F,100,35200,75,35275
Tileah,F,100,18,0,18
Zekeriah,M,100,0,5,5
Arbin,M,100,0,19,19
Mahdi,M,100,0,1477,1477
Madalie,F,100,29,0,29
Miraya,F,100,394,0,394
Durinda,F,100,206,0,206
Wills,M,100,0,17,17
Lurena,F,100,64,0,64
Corey,M,95,8788,178694,187482
Benajamin,M,100,0,16,16
Kurtiss,M,100,0,245,245
Odile,F,100,43,0,43
Anitria,F,100,112,0,112
Tysa,F,100,37,0,37
Jareliz,F,100,10,0,10
Francell,F,50,5,5,10
Adrew,M,100,0,31,31
Gyna,F,100,5,0,5
Alfrieda,F,100,163,0,163
Terray,M,100,0,11,11
Aquille,M,100,0,17,17
Mahlaya,F,100,25,0,25
Camaya,F,100,219,0,219
Kirk,M,100,197,63156,63353
Ysidro,M,100,0,731,731
Mallory,F,98,51676,803,52479
Lymon,M,100,0,14,14
Draylen,M,100,0,75,75
Elisheva,F,100,1650,0,1650
Charaine,F,100,5,0,5
Charnise,F,100,215,0,215
Abas,M,100,0,60,60
Jerremiah,M,100,0,5,5
German,M,100,5,8389,8394
Dameka,F,100,240,0,240
Joeann,F,100,605,0,605
Vrisa,F,100,5,0,5
Tashon,M,95,15,314,329
Kenijah,F,100,108,0,108
Tonita,F,100,850,0,850
Jatisha,F,100,5,0,5
Simora,F,100,65,0,65
Jadasia,F,100,82,0,82
Brylen,M,90,39,345,384
Dellie,F,100,34,0,34
Damiyon,M,100,0,36,36
Nohelani,F,100,61,0,61
Tricia,F,100,39785,88,39873
Treston,M,100,0,1129,1129
Shauntae,F,99,689,5,694
Kenlyn,F,93,142,10,152
Riona,F,100,339,0,339
Dyce,M,100,0,6,6
Journee,F,99,3544,33,3577
Giannella,F,100,11,0,11
Kartina,F,100,40,0,40
Corayma,F,100,75,0,75
Diyana,F,100,73,0,73
Shnika,F,100,7,0,7
Jamy,F,66,745,383,1128
Jasyiah,F,63,17,10,27
Maddisson,F,100,6,0,6
Shavanda,F,100,24,0,24
Corniyah,F,100,12,0,12
Ashely,F,99,6392,70,6462
Jicel,F,100,11,0,11
Caulin,M,100,0,173,173
Alixander,M,100,0,232,232
Clairity,F,100,10,0,10
Mahir,M,100,0,613,613
Imanol,M,100,0,1135,1135
Hitzel,F,100,11,0,11
Athen,M,100,0,437,437
Murrey,M,100,0,5,5
Shaqita,F,100,7,0,7
Tenecia,F,100,301,0,301
Lalania,F,100,81,0,81
Liliauna,F,100,58,0,58
Indsay,F,100,6,0,6
Thanh,M,62,650,1074,1724
Amal,F,89,2110,259,2369
Yumaira,F,100,5,0,5
Tamanna,F,100,160,0,160
Maycee,F,100,2024,0,2024
Mckail,M,100,0,5,5
Kyela,F,100,53,0,53
Asaph,M,100,0,170,170
Zanyra,F,100,5,0,5
Pascale,F,100,574,0,574
Ltoya,F,100,10,0,10
Tareva,F,100,85,0,85
Hillary,F,98,27929,596,28525
Yoshimi,F,100,7,0,7
Terrielle,F,100,17,0,17
Wesam,M,100,0,280,280
Bhakti,F,100,130,0,130
Raedean,F,100,39,0,39
Sebella,F,100,12,0,12
Nacala,F,100,6,0,6
Ruhani,F,100,61,0,61
Meryll,F,100,6,0,6
Dayiana,F,100,5,0,5
Emilee,F,100,20910,8,20918
Kahlen,F,81,267,62,329
Shanitta,F,100,37,0,37
Aitiana,F,100,6,0,6
Trayanna,F,100,20,0,20
Ajit,M,100,0,230,230
Chinara,F,100,71,0,71
Philicity,F,100,6,0,6
Shirlina,F,100,5,0,5
Shedonna,F,100,5,0,5
Brennan,M,94,1918,29355,31273
Marjeanne,F,100,5,0,5
Alexarae,F,100,97,0,97
Lexine,F,100,287,0,287
Leanora,F,100,603,0,603
Izel,F,79,865,234,1099
Jayn,F,100,34,0,34
Jayson,M,100,32,29659,29691
Kaser,M,100,0,5,5
Yarleth,F,100,5,0,5
Amogh,M,100,0,535,535
Nima,M,80,225,912,1137
Irin,F,50,5,5,10
Bautista,M,100,0,41,41
Anjalena,F,100,6,0,6
Kendrya,F,100,5,0,5
Jalean,M,100,0,28,28
Shoshanna,F,100,685,0,685
Hosie,M,100,0,340,340
Mickeal,M,100,0,915,915
Shevin,M,100,0,13,13
Aroura,F,100,53,0,53
Clementine,F,100,3014,0,3014
Samaya,F,100,2065,0,2065
Barbee,F,100,67,0,67
Avriella,F,100,5,0,5
Kimm,F,80,386,96,482
Kypten,M,100,0,5,5
Kamaire,M,100,0,5,5
Reneshia,F,100,74,0,74
Bg,F,100,49,0,49
Wanjiku,F,100,5,0,5
Mashunda,F,100,5,0,5
Jaxzon,M,100,0,15,15
Ellanah,F,100,5,0,5
Gamya,F,100,5,0,5
Shaunay,F,100,5,0,5
Meggin,F,100,345,0,345
Marcangelo,M,100,0,22,22
Vaniah,F,100,54,0,54
Zakery,M,100,0,1310,1310
Efthymia,F,100,5,0,5
Shuree,F,100,151,0,151
Ashaunte,F,100,91,0,91
Santigo,M,100,0,7,7
Anjannette,F,100,72,0,72
Saied,M,100,0,35,35
Anubhav,M,100,0,10,10
Jahnathan,M,100,0,7,7
Yannira,F,100,6,0,6
Meiqi,F,100,5,0,5
Loletia,F,100,23,0,23
Jayiden,M,100,0,5,5
Lorilyn,F,100,291,0,291
Ajahn,M,100,0,6,6
Zaret,F,100,10,0,10
Marilene,F,100,19,0,19
Kentrevious,M,100,0,5,5
Jolieann,F,100,5,0,5
Noriah,F,100,181,0,181
Poul,M,100,0,34,34
Donchevell,M,100,0,6,6
Juluis,M,100,0,242,242
Juanfrancisco,M,100,0,30,30
Harumi,F,100,74,0,74
Ryenne,F,100,206,0,206
Aniyla,F,100,356,0,356
Jemiya,F,100,35,0,35
Coryion,M,100,0,12,12
Tyiana,F,100,154,0,154
Olaoluwa,M,100,0,106,106
Maikou,F,100,38,0,38
Mariagabriela,F,100,7,0,7
Elisio,M,100,0,20,20
Naryiah,F,100,56,0,56
Tryston,M,99,10,1203,1213
Calvion,M,100,0,21,21
Ayme,F,100,311,0,311
Zbigniew,M,100,0,28,28
Eilis,F,100,150,0,150
Varie,F,100,7,0,7
Akyra,F,100,534,0,534
Sereana,F,100,10,0,10
Shyra,F,100,760,0,760
Keyleen,F,100,50,0,50
Marenda,F,100,134,0,134
Revere,M,100,0,14,14
Kesan,M,100,0,39,39
Jessalynne,F,100,10,0,10
Katalea,F,100,47,0,47
Kassee,F,100,18,0,18
Samyla,F,100,10,0,10
Artemus,M,100,0,426,426
Anacamila,F,100,25,0,25
Haja,F,100,166,0,166
Latoyer,F,100,10,0,10
Danean,F,100,127,0,127
Eason,M,100,0,994,994
Azarious,M,100,0,6,6
Keiontae,M,100,0,55,55
Zenobia,F,100,2295,0,2295
Ubong,M,100,0,10,10
Adean,M,82,5,23,28
Geonte,M,100,0,5,5
Kasee,F,100,365,0,365
Vikash,M,100,0,162,162
Feigy,F,100,37,0,37
Geordyn,F,100,17,0,17
Marra,F,100,300,0,300
Nataysia,F,100,28,0,28
Niven,M,100,0,24,24
Carmie,F,100,144,0,144
Charnaye,F,100,5,0,5
Natira,F,100,31,0,31
Chrsitopher,M,100,0,176,176
Lamiracle,F,100,156,0,156
Matalie,F,100,129,0,129
Rohn,M,100,0,368,368
Skyllar,F,100,155,0,155
Hutson,M,100,0,265,265
Mokshith,M,100,0,10,10
Amado,M,100,0,2610,2610
Lilany,F,100,5,0,5
Davita,F,100,709,0,709
Malayja,F,100,75,0,75
Chanci,F,100,56,0,56
Zariha,F,100,22,0,22
Charolette,F,100,1929,0,1929
Elienai,F,100,151,0,151
Skarleth,F,100,99,0,99
Ama,F,100,540,0,540
Divon,M,100,0,64,64
Gabryela,F,100,142,0,142
Kashunda,F,100,37,0,37
Vaniyah,F,100,75,0,75
Charlia,F,100,23,0,23
Adaly,F,100,384,0,384
Jadynn,F,94,511,34,545
Hadlea,F,100,56,0,56
Pageant,F,100,5,0,5
Yilin,F,100,34,0,34
Jolene,F,100,26163,12,26175
Yonathan,M,100,0,1109,1109
Myler,M,100,0,5,5
Margaretmary,F,100,132,0,132
Quiera,F,100,114,0,114
Breaun,F,76,16,5,21
Mosley,F,50,6,6,12
Ehvan,M,100,0,5,5
Sonja,F,100,30204,29,30233
Jlaya,F,100,10,0,10
Jahsean,M,100,0,43,43
Gianina,F,100,550,0,550
Lashawndra,F,100,256,0,256
Marterrion,M,100,0,5,5
Yvannah,F,100,5,0,5
Julitsa,F,100,11,0,11
Couture,F,100,50,0,50
Cong,M,100,0,48,48
Jacqui,F,98,837,13,850
Zenna,F,100,216,0,216
Valeire,F,100,12,0,12
Jurnie,F,100,141,0,141
Lavesha,F,100,22,0,22
Alexsandria,F,100,172,0,172
Amran,F,80,140,36,176
Johnpatrick,M,100,0,396,396
Emilliano,M,100,0,80,80
Nazyia,F,100,174,0,174
Shawnta,F,94,1812,118,1930
Mitia,F,100,6,0,6
Tynajah,F,100,19,0,19
Oliviyah,F,100,15,0,15
Brindy,F,100,99,0,99
Arshdeep,M,86,21,133,154
Andrade,M,100,0,5,5
Braxtin,M,98,5,282,287
Ledra,F,100,15,0,15
Channel,F,100,1461,0,1461
Stclair,M,100,0,15,15
Dison,M,100,0,11,11
Arhiana,F,100,43,0,43
Jermicheal,M,100,0,21,21
Ahsoka,F,100,5,0,5
Tanaka,F,93,129,10,139
Yair,M,100,0,3441,3441
Deba,F,100,18,0,18
Hortensia,F,100,616,0,616
Bettylou,F,100,141,0,141
Imanuel,M,100,0,244,244
Caeleigh,F,100,197,0,197
Avonna,F,100,224,0,224
Lya,F,100,402,0,402
Denita,F,100,2733,0,2733
Kuno,M,100,0,5,5
Elijio,M,100,0,398,398
Jesilyn,F,100,87,0,87
Korsica,F,100,6,0,6
Daphne,F,100,28594,7,28601
Kensingtyn,F,100,6,0,6
Nicollette,F,100,1224,0,1224
Maddin,M,100,0,16,16
Ottie,M,84,19,103,122
Corbi,F,100,5,0,5
Tonae,F,100,101,0,101
Ahmand,M,100,0,15,15
Zaniyah,F,100,3669,0,3669
Tamarisk,F,100,14,0,14
Juaniqua,F,100,6,0,6
Viren,M,100,0,145,145
Quavius,M,100,0,5,5
Traevion,M,100,0,108,108
Shamane,F,100,23,0,23
Johnavan,M,100,0,41,41
Samanthia,F,100,492,0,492
Jakaira,F,100,28,0,28
Shaaliyah,F,100,5,0,5
Hadly,F,100,19,0,19
Yolotzin,F,100,50,0,50
Conell,M,100,0,34,34
Cleona,F,100,55,0,55
Katy,F,100,17356,5,17361
Shantanae,F,100,5,0,5
Amandalynn,F,100,81,0,81
Olusegun,M,100,0,77,77
Kinzie,F,100,1215,0,1215
Ashleyn,F,100,41,0,41
Kadian,F,65,82,44,126
Narquise,M,100,0,5,5
Karley,F,100,6743,0,6743
Hrithik,M,100,0,63,63
Cowan,M,100,0,140,140
Lowrey,M,100,0,5,5
Ellah,F,100,590,0,590
Babygirl,F,100,1723,6,1729
Juanfernando,M,100,0,5,5
Regginal,M,100,0,15,15
Suveer,M,100,0,6,6
Aeon,F,51,59,56,115
Naveah,F,100,738,0,738
Quincey,M,76,511,1585,2096
Shamecca,F,100,245,0,245
Benicio,M,100,0,1624,1624
Pietra,F,100,71,0,71
Preetham,M,100,0,6,6
Niaje,F,100,5,0,5
Tavon,M,98,78,3691,3769
Tessalynn,F,100,12,0,12
Selima,F,100,40,0,40
Clemmon,M,100,0,10,10
Kerrye,F,100,6,0,6
Dominque,F,62,3871,2353,6224
Leanor,F,100,51,0,51
Jaithen,M,100,0,5,5
Avera,F,100,11,0,11
Destyny,F,100,12,0,12
Xochithl,F,100,5,0,5
Maryjayne,F,100,91,0,91
Johnjack,M,100,0,5,5
Ianthia,F,100,6,0,6
Elisama,F,100,56,0,56
Malloy,M,100,0,25,25
Serafino,M,100,0,21,21
Myella,F,100,12,0,12
Zubayr,M,100,0,66,66
Zamariah,F,100,190,0,190
Ileene,F,100,139,0,139
Sarriah,F,100,34,0,34
Edem,M,100,0,55,55
Lannette,F,100,535,0,535
Corenthia,F,100,23,0,23
Kavita,F,100,769,0,769
Makhya,F,100,109,0,109
Doriann,F,100,334,0,334
Sharmon,F,98,427,7,434
Dewuan,M,100,0,7,7
Yovanka,F,100,28,0,28
Fatih,M,100,0,64,64
Copen,M,100,0,13,13
Lorijean,F,100,61,0,61
Emyiah,F,100,23,0,23
Kenrich,M,100,0,7,7
Juniper,F,99,2709,21,2730
Prezley,F,100,40,0,40
Casondra,F,100,1056,0,1056
Yoslan,M,100,0,7,7
Cleophas,M,100,0,284,284
Nieisha,F,100,13,0,13
Samie,F,60,120,80,200
Christel,F,100,3396,0,3396
Mikenzi,F,100,161,0,161
Roger,M,100,942,248642,249584
Javaris,M,100,0,1551,1551
Brissia,F,100,556,0,556
Zen,M,88,137,982,1119
Zhuri,F,100,37,0,37
Rogena,F,100,199,0,199
Garnie,M,100,0,32,32
Driss,M,100,0,17,17
Udana,F,100,30,0,30
Maleaha,F,100,145,0,145
Tiania,F,100,15,0,15
Lavonia,F,100,765,0,765
Kainon,M,100,0,26,26
Legolas,M,100,0,7,7
Ayanne,F,100,5,0,5
Aureo,M,100,0,5,5
Dijonnaise,F,100,28,0,28
Eldrich,M,100,0,5,5
Enchante,F,100,6,0,6
Lylie,F,100,51,0,51
Brier,M,65,196,362,558
Karoline,F,100,2555,0,2555
Sherron,F,79,1849,483,2332
Anam,F,100,512,0,512
Alerah,F,100,5,0,5
Tamaica,F,100,11,0,11
Cuahtemoc,M,100,0,5,5
Zonya,F,100,70,0,70
Aslee,F,100,5,0,5
Guy,M,100,130,49247,49377
Beeta,F,100,26,0,26
Mauricio,M,100,6,18850,18856
Marggie,F,100,5,0,5
Defne,F,100,295,0,295
Khamaria,F,100,52,0,52
Anaejah,F,100,11,0,11
Petr,M,100,0,87,87
Sheniya,F,100,95,0,95
Gretta,F,100,2270,0,2270
Nayson,M,100,0,49,49
Francessca,F,100,74,0,74
Salanda,F,100,5,0,5
Phinn,M,100,0,11,11
Jadore,F,89,465,60,525
Aleha,F,100,22,0,22
Teea,F,100,65,0,65
Elvert,M,100,0,71,71
Anthea,F,100,689,0,689
Bishoy,M,100,0,64,64
Anayia,F,100,135,0,135
Henok,M,100,0,216,216
Lasandra,F,100,1503,0,1503
Kerrie,F,99,8508,104,8612
Caylene,F,100,20,0,20
Wilhelmina,F,100,2386,0,2386
Malyia,F,100,57,0,57
Nyala,F,100,204,0,204
Madsion,F,100,24,0,24
Harshi,F,100,5,0,5
Merlon,M,100,0,40,40
Fayth,F,100,1684,0,1684
Lebrone,M,100,0,8,8
Erron,M,98,15,771,786
Aletha,F,100,3152,0,3152
Rambo,M,100,0,79,79
Jailene,F,100,2771,0,2771
Adessa,F,100,312,0,312
Saile,F,100,5,0,5
Oriana,F,100,2666,0,2666
Davens,M,100,0,5,5
Qualesha,F,100,5,0,5
Shadira,F,100,5,0,5
Cameisha,F,100,37,0,37
Morissa,F,100,196,0,196
Venice,F,93,1456,104,1560
Linn,F,50,657,653,1310
Hermanda,F,100,6,0,6
Fayte,F,100,11,0,11
Janitha,F,100,5,0,5
Bairo,M,100,0,11,11
Eloina,F,100,72,0,72
Onyka,F,100,5,0,5
Jahmarcus,M,100,0,14,14
Calel,M,100,0,73,73
Kynzleigh,F,100,64,0,64
Kemyra,F,100,88,0,88
Timothie,M,100,0,17,17
Tiesa,F,100,5,0,5
Nehemiyah,M,100,0,10,10
Lesleigh,F,100,463,0,463
Jaydynn,F,71,53,22,75
Kennisha,F,100,600,0,600
Cedria,F,100,38,0,38
Khristopher,M,100,0,2050,2050
Naleah,F,100,236,0,236
Ambrea,F,100,485,0,485
Elided,F,100,6,0,6
Nayloni,F,100,6,0,6
Wilhemina,F,100,468,0,468
Persis,F,100,61,0,61
Ashlen,F,99,978,13,991
Teckla,F,100,11,0,11
Qwenton,M,100,0,10,10
Vynessa,F,100,6,0,6
Norvel,M,100,0,211,211
Kimana,F,100,35,0,35
Eureka,F,99,793,5,798
Shifra,F,100,1183,0,1183
Ezzie,M,55,5,6,11
Sheldrick,M,100,0,35,35
Dawit,M,100,0,368,368
Allard,M,100,0,23,23
Ryah,F,100,684,0,684
Taijon,M,100,0,149,149
Bianco,F,89,71,9,80
Lillyen,F,100,68,0,68
Nisson,M,100,0,15,15
Kaimi,M,55,26,32,58
Jaylissa,F,100,54,0,54
Adrene,F,100,7,0,7
Belinda,F,100,67997,150,68147
Quron,M,100,0,306,306
Hateya,F,100,10,0,10
Sybastian,M,100,0,15,15
Laremy,M,100,0,24,24
Rotunda,F,100,104,0,104
Amonnie,F,100,11,0,11
Tyajah,F,100,43,0,43
Akim,M,100,0,546,546
Lanz,M,100,0,33,33
Yazmin,F,100,7827,7,7834
Nalyah,F,100,7,0,7
Dougals,M,100,0,47,47
Addilee,F,100,111,0,111
Patra,F,100,445,0,445
Madoka,F,100,20,0,20
Hildreth,F,100,20,0,20
Nickcole,F,100,127,0,127
Barney,M,100,22,5669,5691
Jaiquez,M,100,0,5,5
Zonnique,F,100,31,0,31
Shekinah,F,100,1841,0,1841
Mikia,F,100,678,0,678
Keiarah,F,100,105,0,105
Casidhe,F,100,11,0,11
Ghazi,M,100,0,115,115
Makoy,M,100,0,20,20
Daci,F,100,61,0,61
Dimitris,M,100,0,442,442
Franky,M,98,40,2420,2460
Dayshun,M,100,0,34,34
Toraino,M,100,0,40,40
Hyrum,M,100,0,2216,2216
Johnelle,F,97,378,13,391
Trowa,M,100,0,10,10
Siclaly,F,100,22,0,22
Juwaun,M,100,0,146,146
Khalia,F,100,2122,7,2129
Lakika,F,100,10,0,10
Shayane,F,100,6,0,6
Karsten,M,95,157,2727,2884
Denaisha,F,100,67,0,67
Curtia,F,100,10,0,10
Marquail,M,100,0,177,177
Yaicha,F,100,6,0,6
Zyreon,M,100,0,14,14
Roselee,F,100,333,0,333
Zaakir,M,100,0,37,37
Kadijatou,F,100,32,0,32
Mauresha,F,100,39,0,39
Brextyn,M,100,0,13,13
Doray,F,100,5,0,5
Fadima,F,100,14,0,14
Vin,M,100,0,146,146
Elsa,F,100,18654,16,18670
Cameran,M,53,781,871,1652
Kyralee,F,100,12,0,12
Denicia,F,100,257,0,257
Mikiya,F,100,314,0,314
Hasan,M,100,0,3720,3720
Rahneisha,F,100,9,0,9
Gilson,M,100,0,11,11
Makiesha,F,100,10,0,10
Kensie,F,100,652,0,652
Kaylannie,F,100,10,0,10
Jaszlyn,F,100,5,0,5
Koretta,F,100,14,0,14
Joseignacio,M,100,0,11,11
Shirlann,F,100,11,0,11
Rozie,F,100,11,0,11
Broch,M,100,0,30,30
Shantiece,F,100,5,0,5
Marquale,M,100,0,24,24
Kennon,M,99,20,1378,1398
Donnah,F,100,38,0,38
Emma,F,100,374584,607,375191
Michalina,F,100,83,0,83
Kearah,F,100,202,0,202
Grete,F,100,45,0,45
Rube,M,100,0,33,33
Xzaiden,M,100,0,12,12
Audio,M,100,0,6,6
Eilen,F,100,10,0,10
Yhael,M,100,0,11,11
Karyna,F,100,782,0,782
Lorrenda,F,100,5,0,5
Loron,M,100,0,32,32
Riky,M,100,0,35,35
Kannin,M,100,0,26,26
Szofia,F,100,5,0,5
Jamaa,M,100,0,13,13
Shanda,F,100,7971,0,7971
Lakyla,F,100,116,0,116
Jerrill,M,100,0,18,18
Lezlee,F,100,478,0,478
Keymarion,M,100,0,69,69
Wilmot,M,100,0,43,43
Meade,M,97,6,169,175
Dequan,M,100,5,3525,3530
Teffani,F,100,5,0,5
Jelica,F,100,13,0,13
Jaleeyah,F,100,141,0,141
Jaylen,M,88,3884,29615,33499
Jakalyn,F,100,55,0,55
Lanel,F,85,28,5,33
Zakhya,F,100,12,0,12
Heleyna,F,100,17,0,17
Timothhy,M,100,0,6,6
Sonoma,F,100,159,0,159
Tymetrius,M,100,0,5,5
Lashunti,F,100,5,0,5
Kairen,M,100,0,42,42
Clarisse,F,100,1038,0,1038
Taze,M,100,0,10,10
Meladee,F,100,38,0,38
Makensi,F,100,46,0,46
Kamiyah,F,100,2104,0,2104
Ceejay,M,100,0,203,203
Suze,F,100,6,0,6
Vanilla,F,100,29,0,29
Eliannie,F,100,15,0,15
Seandouglas,M,100,0,5,5
Andria,F,100,8503,27,8530
Talia,F,100,22380,5,22385
Aerionna,F,100,118,0,118
Toluwanimi,F,64,55,31,86
Kou,M,95,33,686,719
Genesa,F,100,33,0,33
Caellum,M,100,0,89,89
Twan,M,89,27,211,238
Marsalis,M,100,0,255,255
Jaeliah,F,100,5,0,5
Zekai,M,100,0,11,11
Rehab,F,100,15,0,15
Surveen,F,100,14,0,14
Jazira,F,100,168,0,168
Almeda,F,100,464,0,464
Laykin,F,97,314,11,325
Rokisha,F,100,41,0,41
Makaria,F,100,65,0,65
Ulizes,M,100,0,15,15
Analysia,F,100,213,0,213
Darquis,M,100,0,12,12
Sthepanie,F,100,5,0,5
Dejion,M,100,0,87,87
Shadana,F,100,109,0,109
Lincon,M,100,0,67,67
Hailea,F,100,328,0,328
Flavius,M,100,0,5,5
Zoravar,M,100,0,6,6
Haadi,M,100,0,131,131
Fitzpatrick,M,100,0,42,42
Thierry,M,97,21,635,656
Lakeesha,F,100,1370,0,1370
Avo,M,100,0,5,5
Ethelda,F,100,11,0,11
Kavion,M,100,0,902,902
Shevette,F,100,62,0,62
Domitilo,M,100,0,5,5
Bracyn,M,100,0,25,25
Twylah,F,100,17,0,17
Sadam,M,100,0,12,12
Matney,F,100,5,0,5
Seddrick,M,100,0,80,80
Zyia,F,100,81,0,81
Jenish,M,100,0,5,5
Shiena,F,100,10,0,10
Jabria,F,100,946,0,946
Emine,F,100,103,0,103
Lorn,M,100,0,329,329
Leniece,F,100,6,0,6
Marialys,F,100,7,0,7
Kharlie,F,100,42,0,42
Jayree,M,100,0,8,8
Dorisa,F,100,49,0,49
Kourtni,F,100,743,0,743
Everhett,M,100,0,60,60
Muath,M,100,0,54,54
Diahn,F,100,65,0,65
Mit,M,100,0,46,46
Chervon,F,100,10,0,10
Brieona,F,100,38,0,38
Laquan,M,91,217,2260,2477
Omaya,F,100,52,0,52
Nytia,F,100,28,0,28
Simar,F,77,150,46,196
Linkyn,M,95,5,88,93
Khristi,F,100,146,0,146
Azizah,F,100,111,0,111
Xzaviar,M,100,0,72,72
Farica,F,100,5,0,5
Cheyenne,F,96,64451,2625,67076
Lelan,M,100,0,450,450
Nakeena,F,100,5,0,5
Zhanna,F,100,81,0,81
Antarius,M,100,0,28,28
Anahie,F,100,11,0,11
Beyonce,F,100,1926,0,1926
Emanual,M,100,0,472,472
Destony,F,100,80,0,80
Raynia,F,100,23,0,23
Rostin,M,100,0,5,5
Ishmel,M,100,0,189,189
Traequan,M,100,0,6,6
Lindalee,F,100,146,0,146
Skyi,F,100,50,0,50
Marqueshia,F,100,52,0,52
Dzya,F,100,5,0,5
Tabrisha,F,100,10,0,10
Ailanny,F,100,6,0,6
Andranique,F,100,11,0,11
Jacquelle,F,100,7,0,7
Ujala,F,100,5,0,5
Vesna,F,100,228,0,228
Cathylee,F,100,5,0,5
Tanishia,F,100,563,0,563
Lashaw,F,50,5,5,10
Lyrics,F,100,43,0,43
Yeva,F,100,90,0,90
Ladrena,F,100,24,0,24
Rudolfo,M,100,0,1608,1608
Laisha,F,100,2275,0,2275
Quinessa,F,100,5,0,5
Ernan,M,100,0,306,306
Tenuun,M,100,0,11,11
Kezaria,F,100,27,0,27
Cacia,F,100,26,0,26
Jernee,F,100,86,0,86
Tammye,F,100,666,0,666
Einstein,M,100,0,5,5
Keystal,F,100,17,0,17
Liyam,M,100,0,7,7
Worth,M,100,0,453,453
Aviya,F,100,199,0,199
Jhaniyah,F,100,31,0,31
Javawn,M,100,0,5,5
Phillippe,M,100,0,196,196
Korvyn,M,100,0,5,5
Allisson,F,100,2120,0,2120
Jatavien,M,100,0,5,5
Hayzlee,F,100,29,0,29
Himanshu,M,100,0,25,25
Bettyanne,F,100,15,0,15
Meline,F,100,74,0,74
Chely,F,100,37,0,37
Aadhavan,M,100,0,19,19
Zamariyah,F,100,81,0,81
Quinita,F,100,117,0,117
Anjae,F,100,6,0,6
Antwine,M,100,0,489,489
Keiton,M,100,0,240,240
Kandon,M,100,0,118,118
Aian,M,100,0,5,5
Narisa,F,100,15,0,15
Taeden,M,100,0,70,70
Trynitee,F,100,59,0,59
Marsha,F,100,73633,190,73823
Jamena,F,100,5,0,5
Leshanta,F,100,5,0,5
Joyceann,F,100,114,0,114
Dwendolyn,F,100,6,0,6
Christoopher,M,100,0,6,6
Marifer,F,100,274,0,274
Zarhianna,F,100,5,0,5
Kieleigh,F,100,33,0,33
Dmarquis,M,100,0,5,5
Princie,F,100,9,0,9
Noelani,F,100,2405,0,2405
Talliyah,F,100,39,0,39
Akerria,F,100,10,0,10
Jetton,M,100,0,6,6
Anali,F,100,1460,0,1460
Estuardo,M,100,0,338,338
Mikhia,F,100,72,0,72
Sylvannah,F,100,5,0,5
Azoriah,F,100,6,0,6
Shaily,F,100,147,0,147
Ualani,F,100,5,0,5
Jaijuan,M,100,0,16,16
Chaquana,F,100,59,0,59
Khaylani,F,100,5,0,5
Bodi,M,100,0,242,242
Aralee,F,100,15,0,15
Tameer,M,100,0,18,18
Andrielle,F,100,51,0,51
Alexandru,M,100,0,449,449
Sharneice,F,100,56,0,56
Ishwaq,F,100,5,0,5
Mayolo,M,100,0,5,5
Ahlanna,F,100,30,0,30
Rudi,M,64,357,633,990
Tad,M,100,0,6324,6324
Tieraney,F,100,40,0,40
Dov,M,100,0,2140,2140
Corentin,M,100,0,5,5
Lavaris,M,100,0,185,185
Rodricas,M,100,0,5,5
Angelice,F,100,180,0,180
Jlon,M,100,0,67,67
Tina,F,100,282217,900,283117
Kostandinos,M,100,0,10,10
Marigene,F,100,36,0,36
Zhen,M,100,0,28,28
Kasey,F,74,31492,11260,42752
Lorie,F,100,21229,71,21300
Shamiya,F,100,1193,0,1193
Karlo,M,100,0,773,773
Soliman,M,100,0,22,22
Auric,M,100,0,6,6
Sammy,M,97,808,26174,26982
Ryman,M,100,0,28,28
Quaylan,M,100,0,5,5
Aleta,F,100,4064,0,4064
Jacquis,M,89,10,77,87
Montia,F,100,178,0,178
Shadrika,F,100,11,0,11
Barbaa,F,100,7,0,7
Camonte,M,100,0,6,6
Yago,M,100,0,129,129
Shacaria,F,100,5,0,5
Trella,F,100,227,0,227
Travontay,M,100,0,5,5
Tarini,F,100,104,0,104
Ceil,F,100,191,0,191
Pranay,M,100,0,364,364
Ravi,M,100,5,2618,2623
Angel,M,69,90930,205684,296614
Sharlonda,F,100,45,0,45
Shimeka,F,100,261,0,261
Keonni,F,100,11,0,11
Damiesha,F,100,6,0,6
Doyla,F,100,21,0,21
Yuxi,F,100,10,0,10
Dannel,M,85,20,114,134
Hero,M,57,115,155,270
Arath,M,100,0,876,876
Snowy,F,100,5,0,5
Kassidy,F,98,16387,291,16678
Joa,F,86,30,5,35
Antoinnette,F,100,22,0,22
Ajaysia,F,100,43,0,43
Nicky,M,78,1679,6003,7682
Karyne,F,100,16,0,16
Verlisa,F,100,62,0,62
Brelee,F,100,76,0,76
Angia,F,100,17,0,17
Soliel,F,100,59,0,59
Wynda,F,100,5,0,5
Leiloni,F,100,336,0,336
Avangeline,F,100,216,0,216
Kenedee,F,100,169,0,169
Izabel,F,100,2769,0,2769
Hassie,F,100,68,0,68
Leandre,M,99,15,1391,1406
Maryana,F,100,415,0,415
Oliyah,F,100,6,0,6
Jazzmun,F,100,6,0,6
Ilia,F,87,607,92,699
Zimaya,F,100,5,0,5
Maizah,F,100,8,0,8
Darrold,M,100,0,236,236
Dartez,M,100,0,5,5
Savahna,F,100,132,0,132
Jalanni,F,100,6,0,6
Shontal,F,100,22,0,22
Violette,F,100,1495,0,1495
Letita,F,100,96,0,96
Zanovia,F,100,42,0,42
Kalisse,F,100,6,0,6
Lyrix,F,67,10,5,15
Jiya,F,100,1175,0,1175
Aleen,F,100,831,0,831
Joselynn,F,100,1066,0,1066
Tangerla,F,100,11,0,11
Jeeyoung,F,100,5,0,5
Lilyani,F,100,21,0,21
Demarr,M,100,0,105,105
Oneika,F,100,94,0,94
Martelle,M,100,0,25,25
Seleah,F,100,13,0,13
Kahmia,F,100,11,0,11
Mckenze,F,100,74,0,74
Bryice,M,100,0,5,5
Jahaziah,M,100,0,12,12
Vincentmichael,M,100,0,6,6
Kimley,F,100,102,0,102
Kennae,F,100,6,0,6
Britta,F,100,3221,0,3221
Kentez,M,100,0,11,11
Prayer,F,100,35,0,35
Shaden,M,58,185,260,445
Jeydy,F,100,30,0,30
Yain,M,100,0,6,6
Hakan,M,100,0,244,244
Andrew,M,100,4116,1114087,1118203
Dierick,M,100,0,6,6
Starcia,F,100,5,0,5
Rosemary,F,100,60766,134,60900
Keeshawn,M,100,0,187,187
Millennia,F,100,54,0,54
Sylvana,F,100,676,0,676
Coreene,F,100,5,0,5
Havyn,F,93,538,43,581
Audee,F,100,10,0,10
Emayah,F,100,5,0,5
Delphina,F,100,408,0,408
Idolina,F,100,157,0,157
Allyse,F,100,699,0,699
Holmes,M,100,0,78,78
Dove,F,99,391,5,396
Danie,M,68,216,468,684
Paedyn,F,100,29,0,29
Nenad,M,100,0,43,43
Keshone,M,100,0,21,21
Yash,M,100,0,2076,2076
Shakierra,F,100,32,0,32
Kashyra,F,100,39,0,39
Terrilynn,F,100,411,0,411
Alionna,F,100,38,0,38
Tavera,F,100,5,0,5
Twig,M,100,0,5,5
Ericalynn,F,100,7,0,7
Shelice,F,100,11,0,11
Lien,F,99,505,6,511
Nicaela,F,100,15,0,15
Reginamarie,F,100,5,0,5
Romaldo,M,100,0,107,107
Danilee,F,100,16,0,16
Terrian,M,68,119,252,371
Darl,M,98,13,717,730
Nessa,F,100,697,0,697
Lareyna,F,100,46,0,46
Alexey,M,94,19,321,340
Jee,F,88,38,5,43
Rinor,M,100,0,5,5
Saudi,F,100,11,0,11
Jaidah,F,100,761,0,761
Penisimani,M,100,0,13,13
Zoua,F,100,142,0,142
Jacyon,M,100,0,17,17
Queshon,M,100,0,5,5
Adylinn,F,100,5,0,5
Trenity,F,97,667,23,690
Latea,F,100,43,0,43
Anistyn,F,100,545,0,545
Aniston,F,99,1507,19,1526
Rayfe,M,100,0,5,5
Ijanae,F,100,91,0,91
Eve,F,100,18040,0,18040
Jamiroquan,M,100,0,13,13
Simreet,F,100,5,0,5
Anitia,F,100,6,0,6
Kadidia,F,100,42,0,42
Gabi,F,100,169,0,169
Rucha,F,100,96,0,96
Alisiah,F,100,5,0,5
Charonda,F,100,187,0,187
Karam,M,100,0,572,572
Isidra,F,100,301,0,301
Debrorah,F,100,10,0,10
Ramadan,M,100,0,194,194
Marzetta,F,100,101,0,101
Marziya,F,100,7,0,7
Shajuanna,F,100,16,0,16
Elovie,F,100,7,0,7
Icsel,F,100,6,0,6
Mattilynn,F,100,174,0,174
Shealeigh,F,100,121,0,121
Marylouise,F,100,603,0,603
Marqueese,M,100,0,6,6
Skylir,F,100,16,0,16
Marzia,F,100,22,0,22
Lydian,F,100,123,0,123
Osiana,F,100,5,0,5
Tyleek,M,100,0,226,226
Mojtaba,M,100,0,5,5
Sheira,F,100,12,0,12
Juawana,F,100,11,0,11
Kellea,F,100,35,0,35
Tykwan,M,100,0,49,49
Kaetlin,F,100,120,0,120
Alajuwon,M,100,0,13,13
Eugine,M,100,0,5,5
Caya,F,100,146,0,146
Premiere,M,100,0,5,5
Ifeoma,F,100,339,0,339
Lenamarie,F,100,16,0,16
Neleigh,F,100,18,0,18
Damarii,M,100,0,20,20
Cathi,F,100,2341,0,2341
Rickayla,F,100,150,0,150
Keashawn,M,100,0,16,16
Richey,M,100,0,433,433
Joelina,F,100,15,0,15
Karmisha,F,100,5,0,5
Nethanel,M,100,0,42,42
Chimera,F,100,41,0,41
Danayla,F,100,27,0,27
Zyionna,F,100,35,0,35
Abduljaleel,M,100,0,5,5
Kazaria,F,100,55,0,55
Koyasha,F,100,7,0,7
Tarkesha,F,100,7,0,7
Jonteria,F,100,6,0,6
Lakey,F,100,5,0,5
Dago,M,100,0,94,94
Brekken,M,94,17,252,269
Genisys,F,100,6,0,6
Roosevelt,M,99,113,14916,15029
Siddhanth,M,100,0,112,112
Kyshawna,F,100,7,0,7
Noriyah,F,100,35,0,35
Neer,M,100,0,30,30
Oretta,F,100,30,0,30
Aquasha,F,100,5,0,5
Rafeeq,M,100,0,33,33
Yung,M,100,0,11,11
Miyla,F,100,5,0,5
Meraiah,F,100,38,0,38
Wachovia,F,100,7,0,7
Enessa,F,100,30,0,30
Gaither,M,100,0,127,127
Livie,F,100,177,0,177
Alcides,M,100,0,433,433
Cherette,F,100,15,0,15
Bhumika,F,100,23,0,23
Jovanda,F,100,18,0,18
Niger,F,69,25,11,36
Valri,F,100,36,0,36
Cinya,F,100,6,0,6
Litzy,F,100,5721,6,5727
Savea,F,100,14,0,14
Esmond,M,100,0,200,200
Gaosheng,F,100,11,0,11
Jaedalyn,F,100,5,0,5
Shamber,F,100,6,0,6
Jeremey,M,100,0,3365,3365
Djana,F,100,9,0,9
Jhade,F,100,87,0,87
Raihaan,M,100,0,5,5
Mylesha,F,100,17,0,17
Davielle,F,100,75,0,75
Brown,M,98,5,214,219
Lajayla,F,100,37,0,37
Adlina,F,100,5,0,5
Eslie,F,100,29,0,29
Ilianna,F,100,785,0,785
Earth,F,100,13,0,13
Natalina,F,100,289,0,289
Kyong,F,100,52,0,52
Pfeiffer,F,100,11,0,11
Latressa,F,100,290,0,290
Ashiya,F,100,404,0,404
Brixon,M,100,0,35,35
Tamirah,F,100,204,0,204
Zana,F,100,1462,0,1462
Erihanna,F,100,5,0,5
Cordarius,M,100,0,882,882
Laicey,F,100,18,0,18
Jamaica,F,98,1442,32,1474
Maghann,F,100,6,0,6
Sanin,M,100,0,6,6
Shindana,F,100,17,0,17
Kenechi,M,100,0,12,12
Courtnee,F,100,1594,8,1602
Afnan,F,83,320,65,385
Korianna,F,100,72,0,72
Katalin,F,100,394,0,394
Chrostopher,M,100,0,22,22
Cassidie,F,100,436,0,436
Deviana,F,100,14,0,14
Vernada,F,100,5,0,5
Kardale,M,100,0,5,5
Macenzi,F,100,6,0,6
Kechelle,F,100,6,0,6
Leihum,M,100,0,10,10
Madelys,F,100,5,0,5
Jesusantonio,M,100,0,46,46
Basmah,F,100,27,0,27
Ameilya,F,100,41,0,41
Siosaia,M,100,0,10,10
Rosalynd,F,100,65,0,65
Laurennicole,F,100,6,0,6
Loranda,F,100,97,0,97
Rasean,M,100,0,645,645
Janeli,F,100,392,0,392
Tawanne,F,100,5,0,5
Mizani,F,100,60,0,60
Jocelyne,F,100,3935,0,3935
Gaylan,M,88,41,301,342
Nairy,F,100,5,0,5
Macguire,M,100,0,71,71
Byson,M,100,0,28,28
Ahmir,M,100,5,1423,1428
Liat,F,100,412,0,412
Daijha,F,100,247,0,247
Lakeydra,F,100,5,0,5
Yeniel,M,100,0,22,22
Aneel,M,100,0,15,15
Tynija,F,100,5,0,5
Atisha,F,100,124,0,124
Eelyn,F,100,6,0,6
Arysta,F,100,5,0,5
Aarti,F,100,432,0,432
Nickolous,M,100,0,44,44
Johnecia,F,100,11,0,11
Shyree,F,100,55,0,55
Kreigh,M,100,0,13,13
Ethian,M,100,0,30,30
Yuria,F,100,13,0,13
Sheryle,F,100,893,0,893
Lameisha,F,100,184,0,184
Yoseph,M,100,0,731,731
Bash,M,100,0,5,5
Graviel,M,100,0,90,90
Joshuajohn,M,100,0,5,5
Tadeusz,M,100,0,163,163
Graves,M,100,0,16,16
Ashlynne,F,100,1451,0,1451
Sony,M,87,39,266,305
Princesa,F,100,329,0,329
Shelena,F,100,404,0,404
Chantile,F,100,5,0,5
Tiy,F,100,6,0,6
Redina,F,100,68,0,68
Davion,M,98,216,10584,10800
Dajhia,F,100,5,0,5
Tango,F,100,33,0,33
Darae,F,67,12,6,18
Tationa,F,100,157,0,157
Eluzer,M,100,0,151,151
Rutilio,M,100,0,61,61
Chrissy,F,100,4158,0,4158
Syliss,M,100,0,5,5
Vitorio,M,100,0,17,17
Eanna,F,100,41,0,41
Anagabriel,F,100,6,0,6
Mordche,M,100,0,103,103
Ginell,F,100,16,0,16
Sabryna,F,100,755,0,755
Remick,M,100,0,15,15
Jirah,F,88,166,22,188
Chonte,F,100,58,0,58
Mahoganey,F,100,10,0,10
Nickolos,M,100,0,56,56
Taleigh,F,100,66,0,66
Deedra,F,100,2097,0,2097
Creighton,M,100,11,2573,2584
Rontavis,M,100,0,5,5
Jossiel,M,100,0,19,19
Nooriya,F,100,5,0,5
Dajea,F,100,12,0,12
Rannon,M,100,0,21,21
Osmar,M,100,0,1654,1654
Avishek,M,100,0,5,5
Kayin,M,87,67,431,498
Serenitie,F,100,158,0,158
Bryenna,F,100,5,0,5
Robeert,M,100,0,16,16
Daquan,M,100,6,7381,7387
Aberham,M,100,0,20,20
Alicai,F,100,20,0,20
Northern,M,100,0,5,5
Tramya,F,100,103,0,103
Joas,M,100,0,146,146
Krishaan,M,100,0,7,7
Zyir,M,100,0,202,202
Kentwan,M,100,0,5,5
Tyrisha,F,100,262,0,262
Alexz,F,100,14,0,14
Vasken,M,100,0,5,5
Montzerrat,F,100,79,0,79
Darea,F,100,5,0,5
Taos,M,100,0,37,37
Braesyn,M,100,0,6,6
Avione,F,100,5,0,5
Tyhira,F,100,10,0,10
Jakiya,F,100,1208,0,1208
Ajaya,F,100,135,0,135
Corbin,M,98,498,28849,29347
Yuchen,M,85,6,35,41
Steffanie,F,100,2538,0,2538
Mindee,F,100,486,0,486
Cherisa,F,100,178,0,178
Eleesha,F,100,66,0,66
Alexandreia,F,100,5,0,5
Aarick,M,100,0,22,22
Amilya,F,100,496,0,496
Doloras,F,100,6,0,6
Dot,F,100,136,0,136
Olianna,F,100,5,0,5
Robrt,M,100,0,12,12
Kameal,F,100,5,0,5
Kemarrion,M,100,0,52,52
Kindrick,M,100,0,82,82
Bronco,M,100,0,55,55
Kamorian,M,100,0,9,9
Lavina,F,100,1866,0,1866
Charda,F,100,123,0,123
Danaija,F,100,67,0,67
Dima,F,79,223,60,283
Jacorri,M,100,0,17,17
Katee,F,100,631,0,631
Theodor,M,100,0,926,926
Tyreion,M,100,0,20,20
Raj,M,100,0,1872,1872
Mujtaba,M,100,0,239,239
Tes,F,100,5,0,5
Xinran,F,100,6,0,6
Ferry,M,62,10,16,26
Roneshia,F,100,257,0,257
Marianely,F,100,5,0,5
Lanett,F,100,130,0,130
Myrene,F,100,27,0,27
Tereva,F,100,11,0,11
Hyden,M,100,0,66,66
Megumi,F,100,523,0,523
Delorise,F,100,593,0,593
Luz,F,97,22657,592,23249
Mirisa,F,100,30,0,30
Khory,M,100,0,54,54
Tauras,M,100,0,10,10
Demetriss,F,100,27,0,27
Adjoa,F,100,93,0,93
Menyon,F,100,12,0,12
Lill,F,100,5,0,5
Xandrea,F,100,68,0,68
Bhuvan,M,100,0,31,31
Alshawn,M,100,0,11,11
Tremyah,F,100,7,0,7
Doddie,F,100,57,0,57
Jyheem,M,100,0,12,12
Variah,F,100,15,0,15
Ryane,F,93,783,58,841
Keyeria,F,100,27,0,27
Jendayi,F,100,124,0,124
Rianna,F,100,3508,0,3508
Zamyria,F,100,44,0,44
Sabria,F,100,896,0,896
Dywayne,M,100,0,37,37
Dominique,F,70,49654,21657,71311
Kerianna,F,100,127,0,127
Jeremiah,M,100,630,165667,166297
Brittnii,F,100,5,0,5
Kathran,F,100,5,0,5
Ashonna,F,100,17,0,17
Yeshayahu,M,100,0,21,21
Makaleb,M,100,0,6,6
Eion,M,100,0,440,440
Ethanpaul,M,100,0,6,6
Nichel,F,100,18,0,18
Nalayna,F,100,12,0,12
Raynen,M,100,0,26,26
Rangel,M,100,0,114,114
Dominica,F,100,1676,0,1676
Alekya,F,100,6,0,6
Dette,F,100,36,0,36
Relynn,F,100,5,0,5
Randa,F,100,3221,0,3221
Romana,F,100,838,0,838
Averianna,F,100,133,0,133
Quindarius,M,100,0,423,423
Sawana,F,100,10,0,10
Wadley,M,100,0,5,5
Jessca,F,100,5,0,5
Trill,M,100,0,5,5
Heylie,F,100,5,0,5
Trintyn,M,100,0,5,5
Djeneba,F,100,105,0,105
Mobolaji,M,100,0,5,5
Buel,M,100,0,120,120
Ervan,M,100,0,27,27
Avidan,M,100,0,40,40
Trichia,F,100,31,0,31
Hiep,M,100,0,120,120
Laurian,F,100,63,0,63
Espiridion,M,100,0,56,56
Portland,F,84,85,16,101
Abisola,F,100,80,0,80
Farron,M,84,109,567,676
Nalia,F,100,403,0,403
Neshia,F,100,81,0,81
Alidiya,F,100,5,0,5
Naisean,M,100,0,5,5
Keynon,M,100,0,51,51
Deshana,F,100,235,0,235
Pamla,F,100,663,0,663
Rosell,M,100,0,6,6
Kealii,M,100,0,198,198
Leighton,M,56,3854,4934,8788
Amirjon,M,100,0,12,12
Dai,M,64,64,115,179
Vinyette,F,100,7,0,7
Dalvyn,M,100,0,12,12
Lurae,F,100,59,0,59
Nial,M,100,0,56,56
Amareya,F,100,19,0,19
Arthena,F,100,12,0,12
Caleesha,F,100,17,0,17
Zyare,M,100,0,5,5
Deundre,M,100,0,280,280
Chirstina,F,100,313,0,313
Amicia,F,100,5,0,5
Caryn,F,100,11641,0,11641
Azuri,F,100,154,0,154
Zakarey,M,100,0,5,5
Amea,F,100,126,0,126
Lilliahna,F,100,72,0,72
Batya,F,100,480,0,480
Herminia,F,100,1531,0,1531
Myion,M,100,0,6,6
Lanedra,F,100,16,0,16
Delaine,F,94,1632,113,1745
Jeziyah,F,100,11,0,11
Alanood,F,100,8,0,8
Akshara,F,100,801,0,801
Seydi,F,100,36,0,36
Laszlo,M,100,0,744,744
Latunja,F,100,7,0,7
Schaun,M,100,0,44,44
Aeva,F,100,355,0,355
Abryelle,F,100,32,0,32
Reynaliz,F,100,7,0,7
Romas,M,100,0,38,38
Safiyya,F,100,69,0,69
Kengo,M,100,0,54,54
Tonja,F,100,6885,5,6890
Devoney,F,100,18,0,18
Keida,F,100,5,0,5
Vienna,F,100,2709,0,2709
Iyshia,F,100,5,0,5
Janyhia,F,100,5,0,5
Elliemae,F,100,98,0,98
Mystik,F,100,7,0,7
Shima,F,100,109,0,109
Pixley,F,100,5,0,5
Shuntay,F,100,114,0,114
Prisila,F,100,759,0,759
Lafonda,F,100,677,0,677
Autym,F,100,47,0,47
Dewayne,M,100,106,21695,21801
Jakobe,M,100,0,2949,2949
Jumalay,F,100,14,0,14
Franchesco,M,100,0,39,39
Rutha,F,100,502,0,502
Nadeya,F,100,24,0,24
Clarnce,M,100,0,127,127
Nciholas,M,100,0,8,8
Sioeli,M,100,0,5,5
Erendida,F,100,223,0,223
Ronasia,F,100,97,0,97
Damarcus,M,100,0,2926,2926
Trianna,F,100,423,0,423
Juba,M,100,0,12,12
Mehr,F,100,129,0,129
Derrious,M,100,0,91,91
Blaidyn,M,100,0,6,6
Rolf,M,100,0,1747,1747
Joslynn,F,100,2588,0,2588
Zidane,M,100,0,269,269
Pleshette,F,100,210,0,210
Fritha,F,100,5,0,5
Jenin,F,100,139,0,139
Takita,F,100,300,0,300
Guendolyn,F,100,5,0,5
Arlethe,F,100,22,0,22
Kemoria,F,100,31,0,31
Asleigh,F,100,12,0,12
Arieon,M,57,66,87,153
Nairi,F,100,170,0,170
Johandry,M,100,0,5,5
Tiran,M,100,0,81,81
Kerigan,F,100,429,0,429
Taelen,M,100,0,13,13
Daveona,F,100,26,0,26
Ariona,F,100,841,0,841
Deanta,M,100,0,94,94
Tylajah,F,100,15,0,15
Shirlean,F,100,221,0,221
Nallah,F,100,17,0,17
Shenell,F,100,624,0,624
Lionel,M,100,34,17521,17555
Kameron,M,88,3876,27247,31123
Kyrel,M,100,0,90,90
Taunie,F,100,5,0,5
Jimika,F,100,22,0,22
Jennel,F,100,270,0,270
Avalynn,F,100,1195,0,1195
Anniemae,F,100,18,0,18
Kota,M,94,24,370,394
Markos,M,100,0,809,809
Jett,M,97,282,10096,10378
Anwita,F,100,176,0,176
Estefhany,F,100,7,0,7
Lesheena,F,100,5,0,5
Rachard,M,100,0,103,103
Marypatricia,F,100,32,0,32
Makynleigh,F,100,45,0,45
Zalika,F,100,213,0,213
Ayreona,F,100,17,0,17
Tabia,F,100,171,0,171
Ayzha,F,100,34,0,34
Caliana,F,100,321,0,321
Camdin,M,100,0,227,227
Jinu,M,100,0,18,18
Nandni,F,100,5,0,5
Tangular,F,100,5,0,5
Sabella,F,100,660,0,660
Maximilion,M,100,0,5,5
Dayne,M,95,178,3426,3604
Sugeily,F,100,5,0,5
Raniyah,F,100,1342,0,1342
Abrah,F,100,22,0,22
Leonella,F,100,34,0,34
Greatness,M,100,0,6,6
Jakyrin,M,100,0,43,43
Ashkan,M,100,0,199,199
Revelle,M,100,0,10,10
Auri,F,96,234,10,244
Ieisha,F,100,798,0,798
Tashay,F,100,536,0,536
Denaya,F,100,276,0,276
Taydra,F,100,31,0,31
Radeen,M,100,0,5,5
Sayeed,M,100,0,85,85
Grettell,F,100,38,0,38
Allexus,F,100,212,0,212
Cashlin,F,53,16,14,30
Jethro,M,100,0,1563,1563
Yackov,M,100,0,5,5
Dalevon,M,100,0,5,5
Aalia,F,100,342,0,342
Takari,M,71,59,147,206
Sarina,F,100,8186,0,8186
Tiombe,F,100,100,0,100
Antaja,F,100,10,0,10
Kimoralee,F,100,10,0,10
Ronrico,M,100,0,194,194
Jazmynne,F,100,47,0,47
Rhylan,M,63,158,268,426
Devaki,F,100,10,0,10
Ariahnna,F,100,30,0,30
Brayant,M,100,0,281,281
Yoselin,F,100,5490,0,5490
Crisstopher,M,100,0,5,5
Heilyn,F,100,24,0,24
Yeni,F,100,438,0,438
Rekisha,F,100,66,0,66
Dryden,M,100,0,385,385
Hoor,F,100,20,0,20
Kristabel,F,100,10,0,10
Karaline,F,100,540,0,540
Laterrion,M,100,0,12,12
Paree,F,100,10,0,10
Kiany,F,100,44,0,44
Tydashia,F,100,5,0,5
Deng,M,100,0,218,218
Janivea,F,100,5,0,5
Sidea,F,100,13,0,13
Kaeliegh,F,100,17,0,17
Enesa,F,100,5,0,5
Latorsha,F,100,84,0,84
Aesa,F,100,10,0,10
Alekos,M,100,0,5,5
Vanissa,F,100,239,0,239
Binu,M,100,0,8,8
Leshaun,M,89,28,230,258
Alisher,M,100,0,11,11
Adelinah,F,100,11,0,11
Zackorie,M,100,0,5,5
Artelia,F,100,132,0,132
Adlean,F,100,5,0,5
Ercel,M,100,0,6,6
Aprillynn,F,100,12,0,12
Jylian,F,100,103,0,103
Riham,F,100,55,0,55
Tashiem,M,100,0,6,6
Kendrall,M,100,0,11,11
Ole,M,100,0,534,534
Hurman,M,100,0,6,6
Kaija,F,100,812,0,812
Alexas,F,100,786,0,786
Elpidia,F,100,11,0,11
Aldo,M,100,10,11973,11983
Jaems,M,100,0,47,47
Kahner,M,100,0,97,97
Grasha,F,100,5,0,5
Darek,M,100,0,1315,1315
Wesley,M,99,1812,154004,155816
Syria,F,100,497,0,497
Leeland,M,99,10,1690,1700
Imarion,M,100,0,39,39
Jmauri,M,100,0,17,17
Deepak,M,100,0,553,553
Yohanna,F,100,542,0,542
Weslie,M,58,172,237,409
Jalayne,F,100,74,0,74
Magdaleno,M,100,0,625,625
Sho,M,100,0,352,352
Cookie,F,100,451,0,451
Laylina,F,100,5,0,5
Logynn,F,100,23,0,23
Jahmiya,F,100,74,0,74
Tyyanna,F,100,37,0,37
Milianna,F,100,40,0,40
Tedd,M,100,0,1051,1051
Danetra,F,100,55,0,55
Marcelena,F,100,5,0,5
Janiaya,F,100,178,0,178
Arunima,F,100,16,0,16
Jazmia,F,100,41,0,41
Mahmood,M,100,0,278,278
Shatondra,F,100,11,0,11
Amberlyn,F,100,1373,0,1373
Samiaya,F,100,12,0,12
Luisgerardo,M,100,0,11,11
Stefon,M,100,0,1521,1521
Justyce,F,79,1692,446,2138
Jonella,F,100,82,0,82
Bryanah,F,100,118,0,118
Tavarous,M,100,0,28,28
Tasmia,F,100,47,0,47
Diara,F,100,590,0,590
Nabeela,F,100,36,0,36
Draken,M,100,0,137,137
Alieya,F,100,30,0,30
Jacody,M,100,0,75,75
Silva,F,100,584,0,584
Shatrice,F,100,33,0,33
Dyan,F,97,1733,61,1794
Woods,M,100,0,59,59
Sani,F,80,270,66,336
Shalisa,F,100,863,0,863
Linton,M,100,0,969,969
Yotam,M,100,0,117,117
Julienne,F,98,2004,32,2036
Melech,M,100,0,11,11
Gerie,F,100,22,0,22
Kenn,M,100,0,644,644
Aristide,M,100,0,11,11
Maxson,M,100,0,457,457
Muffy,F,100,6,0,6
Zeinab,F,100,1014,0,1014
Deimy,F,100,5,0,5
Claritsa,F,100,5,0,5
Karelis,F,100,29,0,29
Champagne,F,100,517,0,517
Santiana,F,100,60,0,60
Jillaine,F,100,202,0,202
Lajeune,F,100,29,0,29
Ebbony,F,100,18,0,18
Cecili,F,100,26,0,26
Virdiana,F,100,15,0,15
Plummer,M,100,0,54,54
Vanester,F,100,13,0,13
Danaiyah,F,100,5,0,5
Jahime,M,100,0,5,5
Remmington,M,71,74,181,255
Jeralyn,F,100,1042,0,1042
Dala,F,100,257,0,257
Derena,F,100,12,0,12
Alter,M,100,0,269,269
Malia,F,100,18799,0,18799
Dilia,F,100,178,0,178
Kayaan,M,100,0,30,30
Alannys,F,100,6,0,6
Branford,M,100,0,54,54
Gineva,F,100,5,0,5
Cornelieus,M,100,0,6,6
Zavion,M,100,0,2187,2187
Natisha,F,100,1861,0,1861
Jocelin,F,100,2463,0,2463
Shylah,F,100,1374,0,1374
Kenslea,F,100,13,0,13
Eirc,M,100,0,17,17
Darshil,M,100,0,16,16
Kabel,M,100,0,20,20
Annelise,F,100,4539,0,4539
Ladazia,F,100,6,0,6
Caezar,M,100,0,10,10
Megen,F,100,682,0,682
Zydia,F,100,5,0,5
Constance,F,100,64204,136,64340
Aapri,F,100,5,0,5
Dorri,F,100,155,0,155
Tyriona,F,100,5,0,5
Candise,F,100,1102,0,1102
Vola,F,100,20,0,20
Krystoffer,M,100,0,5,5
Malanna,F,100,13,0,13
Elven,M,100,0,44,44
Mykola,M,100,0,10,10
Indica,F,100,333,0,333
Debie,F,100,443,0,443
Omair,M,100,0,246,246
Jaquise,M,83,40,191,231
Arcilia,F,100,15,0,15
Manar,F,99,551,5,556
Marcene,F,100,470,0,470
Delaini,F,100,35,0,35
Voris,M,100,0,8,8
Avreet,F,100,5,0,5
Narumi,F,100,10,0,10
Avamae,F,100,57,0,57
Kayana,F,100,867,0,867
Deivi,M,100,0,56,56
Ain,F,100,18,0,18
Lazarria,F,100,11,0,11
Kristilyn,F,100,59,0,59
Tynaya,F,100,6,0,6
Symarah,F,100,5,0,5
Joele,F,100,21,0,21
Jarriet,M,100,0,5,5
Marnetta,F,100,54,0,54
Fatmir,M,100,0,18,18
Joynell,F,100,5,0,5
Chattie,F,100,5,0,5
Petter,M,100,0,38,38
Johnchristopher,M,100,0,118,118
Shandee,F,100,165,0,165
Matalynn,F,100,52,0,52
Jameswilliam,M,100,0,6,6
Trenidy,F,100,45,0,45
Mekael,M,100,0,27,27
James,M,100,12269,2805634,2817903
Kelston,M,100,0,40,40
Brex,M,100,0,20,20
Lotosha,F,100,6,0,6
Comari,M,100,0,11,11
Blerim,M,100,0,5,5
Zanetta,F,100,377,0,377
Markeda,F,100,175,0,175
Jacorey,M,100,0,1897,1897
Jevonda,F,100,5,0,5
Aashni,F,100,46,0,46
Evyenia,F,100,16,0,16
Abdimalik,M,100,0,141,141
Samijo,F,100,28,0,28
Liamjames,M,100,0,17,17
Jaderius,M,100,0,11,11
Mahlek,M,100,0,5,5
Delonta,M,100,0,350,350
Ismaila,M,100,0,37,37
Zyvion,M,100,0,5,5
Levonne,F,89,213,26,239
Juna,F,99,388,5,393
Makyah,F,94,632,43,675
Sherre,F,100,734,0,734
Theadore,M,100,0,1229,1229
Davida,F,100,3450,5,3455
Shunya,F,100,5,0,5
Jadarius,M,100,0,1277,1277
Tyquashia,F,100,16,0,16
Richer,M,100,0,20,20
Kashanna,F,100,53,0,53
Salonda,F,100,5,0,5
Ayela,F,100,9,0,9
Shavana,F,100,57,0,57
Amahni,F,100,30,0,30
Imalay,F,100,41,0,41
Muntas,F,100,25,0,25
Jigar,M,100,0,147,147
Tammica,F,100,25,0,25
Dyllyn,M,100,0,6,6
Marquiesha,F,100,30,0,30
Kisa,F,100,566,0,566
Zymirah,F,100,38,0,38
Phelicia,F,100,203,0,203
Ezekyel,M,100,0,5,5
Glendene,F,100,10,0,10
Kaliha,F,100,10,0,10
Lemarco,M,100,0,5,5
Alan,M,100,892,262905,263797
Channon,F,67,729,359,1088
Dquavion,M,100,0,5,5
Tammeria,F,100,10,0,10
Auset,F,100,74,0,74
Riana,F,100,1944,0,1944
Mac,M,100,15,4321,4336
Gella,F,100,5,0,5
Itzayanna,F,100,54,0,54
Mussie,M,100,0,41,41
Tadeja,F,100,5,0,5
Alaunna,F,100,11,0,11
Aaliyiah,F,100,31,0,31
Yentl,F,100,51,0,51
Jessalynn,F,100,730,0,730
Adiela,F,100,13,0,13
Darvin,M,100,0,2345,2345
Tyquez,M,100,0,253,253
Ashkii,M,100,0,17,17
Lilyauna,F,100,95,0,95
Dalmar,M,100,0,10,10
Trajan,M,100,0,661,661
Mirko,M,100,0,106,106
Movita,F,100,18,0,18
Ayzia,F,100,140,0,140
Carris,F,76,16,5,21
Rikkita,F,100,6,0,6
Henrey,M,100,0,5,5
Tymeek,M,100,0,21,21
Alijandra,F,100,29,0,29
Ea,F,100,11,0,11
Azilynn,F,100,5,0,5
Kharma,F,100,364,0,364
Beyonka,F,100,118,0,118
Serrenity,F,100,13,0,13
Davidmichael,M,100,0,148,148
Quaneka,F,100,15,0,15
Monyette,F,100,51,0,51
Paysleigh,F,100,16,0,16
Jesualdo,M,100,0,5,5
Kayleene,F,100,5,0,5
Saquoya,F,100,24,0,24
Laetyn,F,67,10,5,15
Spruha,F,100,18,0,18
Ihor,M,100,0,164,164
Tawatha,F,100,24,0,24
Zandra,F,100,3144,0,3144
Marthe,F,100,101,0,101
Revonda,F,100,602,0,602
Javant,M,100,0,17,17
Ardia,F,100,5,0,5
Yunnuen,F,100,5,0,5
Ivano,M,100,0,5,5
Alish,F,100,5,0,5
Dawanna,F,100,435,0,435
Naphtali,M,73,68,185,253
Shineka,F,100,150,0,150
Jonae,F,100,1005,0,1005
Taylyn,F,98,575,11,586
Clarenda,F,100,10,0,10
Jeramy,M,100,5,4417,4422
Delice,F,100,15,0,15
Ramsses,M,100,0,19,19
Elek,M,100,0,140,140
Kiearah,F,100,11,0,11
Jyl,F,100,384,0,384
Landa,F,100,511,0,511
Noma,F,100,196,0,196
Xaviea,F,100,5,0,5
Pratik,M,100,0,488,488
Anum,F,100,504,0,504
Laiylah,F,100,55,0,55
Trejaun,M,100,0,12,12
Ahnaf,M,100,0,201,201
Glenston,M,100,0,5,5
Sissy,F,100,698,0,698
Johnene,F,100,26,0,26
Brienna,F,100,1547,0,1547
Nicolasa,F,100,388,0,388
Kayjah,F,100,17,0,17
Adason,F,50,5,5,10
Najai,F,80,157,40,197
Zakiyyah,F,100,1127,0,1127
Cowen,M,100,0,159,159
Zairy,F,100,11,0,11
Valdez,M,100,0,258,258
Itayetzi,F,100,10,0,10
Karsynn,F,100,130,0,130
Thomasena,F,100,403,0,403
Kimothy,M,78,35,125,160
Sowsan,F,100,5,0,5
Anieya,F,100,73,0,73
Dalvon,M,100,0,22,22
Taeyon,M,100,0,11,11
Jahquan,M,100,0,280,280
Mackinzy,F,100,20,0,20
Clementeen,F,100,11,0,11
Lucio,M,100,0,4037,4037
Daviana,F,100,633,0,633
Kirat,F,100,19,0,19
Yamal,M,100,0,5,5
Tyshekia,F,100,5,0,5
Wyndy,F,100,28,0,28
Jomarie,F,99,425,5,430
Keifer,M,100,0,1108,1108
Liza,F,100,14381,14,14395
Sherylann,F,100,72,0,72
Lascelles,M,100,0,5,5
Coleman,M,100,24,10985,11009
Krystol,F,100,117,0,117
Farzan,M,100,0,20,20
Jerett,M,100,0,308,308
Ramen,M,100,0,15,15
Iona,F,100,1892,5,1897
Thyme,F,100,39,0,39
Kahliyah,F,100,130,0,130
Dniya,F,100,123,0,123
Dashawna,F,100,478,0,478
Tyreco,M,100,0,5,5
Nastasha,F,100,414,0,414
Barabara,F,100,119,0,119
Devanna,F,100,37,0,37
Margene,F,99,438,5,443
Trahern,M,100,0,11,11
Tanard,M,100,0,5,5
Matteen,M,100,0,11,11
Britni,F,100,4315,0,4315
Christianah,F,100,6,0,6
Dessica,F,100,7,0,7
Eja,F,100,45,0,45
Micala,F,100,373,0,373
Laporshe,F,100,21,0,21
Dicey,F,100,10,0,10
Danger,M,100,0,31,31
Shoneka,F,100,5,0,5
Cashen,M,100,0,24,24
Norrin,M,100,0,59,59
Cynthya,F,100,174,0,174
Quila,F,100,12,0,12
Cosby,M,100,0,29,29
Alayna,F,100,22034,0,22034
Dorette,F,100,205,0,205
Zhi,M,89,17,137,154
Jeyshangelise,F,100,8,0,8
Letrece,F,100,15,0,15
Keyshla,F,100,83,0,83
Anouk,F,100,256,0,256
Korianne,F,100,29,0,29
Verlan,M,100,0,72,72
Mileena,F,100,892,0,892
Ionna,F,100,199,0,199
Hayly,F,100,92,0,92
Darmani,M,100,0,10,10
Rahshan,M,100,0,11,11
Isacc,M,100,0,1716,1716
Keundre,M,100,0,45,45
Keelee,F,100,425,0,425
Ziera,F,100,18,0,18
Tyiesha,F,100,699,0,699
Jaruis,M,100,0,26,26
Niclaus,M,100,0,10,10
Yukti,F,100,5,0,5
Kohen,M,99,18,1887,1905
Shie,M,55,5,6,11
Mikye,M,100,0,17,17
Jaalen,M,100,0,34,34
Boback,M,100,0,6,6
Diandrea,F,100,30,0,30
Karl,M,99,810,69650,70460
Latarius,M,100,0,38,38
Casonya,F,100,51,0,51
Wendla,F,100,11,0,11
Amiri,M,82,110,501,611
Dahnya,F,100,12,0,12
Rohnda,F,100,54,0,54
Vereen,F,100,5,0,5
Padraic,M,100,0,931,931
Daishae,F,100,5,0,5
Aari,M,100,0,5,5
Ellys,F,100,16,0,16
Kynnidi,F,100,6,0,6
Teagen,M,51,522,551,1073
Xandria,F,100,682,0,682
Janayla,F,100,150,0,150
Amiree,F,100,69,0,69
Dnyia,F,100,5,0,5
Latiqua,F,100,58,0,58
Alva,F,55,2267,1818,4085
Schlonda,F,100,18,0,18
Asyah,F,100,175,0,175
Ziarra,F,100,19,0,19
Israyel,M,100,0,7,7
Adonya,F,100,14,0,14
Juliene,F,100,360,0,360
Taihlor,F,100,5,0,5
Presleigh,F,100,990,0,990
Lashara,F,100,357,0,357
Wisper,F,100,5,0,5
Khalif,M,100,0,1346,1346
Antinette,F,100,70,0,70
Zenab,F,100,157,0,157
Yordin,M,100,0,57,57
Ral,M,100,0,6,6
Sohrab,M,100,0,63,63
Nayo,F,100,16,0,16
Zolton,M,100,0,24,24
Johathan,M,100,0,1935,1935
Edge,M,100,0,58,58
Corbet,M,100,0,115,115
Shawnette,F,100,750,0,750
Isayah,M,100,0,621,621
Darrel,M,100,83,17921,18004
Jenene,F,100,467,0,467
Espyn,F,50,7,7,14
Rua,F,100,5,0,5
Mckenzye,F,100,147,0,147
Julien,M,98,172,8448,8620
Bashir,M,100,0,734,734
Ashleen,F,100,471,0,471
Horeb,M,100,0,5,5
Makei,M,100,0,22,22
Dhyey,M,100,0,13,13
Saaid,M,100,0,21,21
Shatoni,F,100,5,0,5
Aanisah,F,100,39,0,39
Shanne,F,54,43,37,80
Monquie,F,100,305,0,305
Chavie,F,100,93,0,93
Ravin,F,80,938,237,1175
Latascha,F,100,45,0,45
Loreda,F,100,29,0,29
Olympia,F,100,1661,0,1661
Luzmarie,F,100,39,0,39
Dannette,F,100,2032,0,2032
Milette,F,100,17,0,17
Chrisi,F,100,16,0,16
Damiso,M,100,0,11,11
Ashanni,F,100,6,0,6
Tiesha,F,100,2848,0,2848
Benje,M,100,0,5,5
Marterius,M,100,0,5,5
Nickalas,M,100,0,614,614
Jankarlo,M,100,0,12,12
Brondon,M,100,0,70,70
Kaliann,F,100,116,0,116
Janaii,F,100,19,0,19
Jamiere,M,100,0,213,213
Sujeiry,F,100,12,0,12
Evelinn,F,100,5,0,5
Tationna,F,100,151,0,151
Ourania,F,100,104,0,104
Travonne,M,100,0,117,117
Jasahn,M,100,0,6,6
Reeta,F,100,51,0,51
Enso,M,100,0,13,13
Somone,F,100,54,0,54
Argiro,F,100,5,0,5
Rikita,F,100,93,0,93
Jp,M,100,0,73,73
Majeed,M,100,0,37,37
Secilia,F,100,280,0,280
Dequanda,F,100,5,0,5
Belva,F,100,1236,0,1236
Gursimar,F,100,10,0,10
Khalen,M,96,5,134,139
Lanah,F,100,263,0,263
Romondo,M,100,0,28,28
Jaamal,M,100,0,81,81
Nelida,F,100,1420,0,1420
Tykisha,F,100,181,0,181
Avarose,F,100,162,0,162
Tyrec,M,100,0,58,58
Duane,M,99,390,70322,70712
Cotter,M,100,0,40,40
Leetha,F,100,9,0,9
Meghann,F,100,3788,0,3788
Lusiano,M,100,0,19,19
Shandale,F,96,109,5,114
Branyah,F,100,14,0,14
Kenzli,F,100,126,0,126
Shardul,M,100,0,5,5
Valkyrie,F,100,230,0,230
Berma,F,100,21,0,21
Kaeron,M,100,0,7,7
Marus,M,100,0,35,35
Shenda,F,100,10,0,10
Vitor,M,100,0,121,121
Avner,M,100,0,187,187
Cheniya,F,100,34,0,34
Rashaun,M,94,182,2851,3033
Ameire,M,100,0,5,5
Tabori,M,100,0,5,5
Lataysia,F,100,41,0,41
Jaydah,F,100,1120,0,1120
Harvard,M,100,0,94,94
Jahmal,M,100,0,1140,1140
Kelvis,M,100,0,125,125
Aletheia,F,100,350,0,350
Tyvonna,F,100,5,0,5
Sirron,M,100,0,181,181
Amyia,F,100,724,0,724
Adelaido,M,100,0,82,82
Cantrell,M,85,65,382,447
Layla,F,100,61907,73,61980
Trentan,M,100,0,134,134
Ebonii,F,100,11,0,11
Malya,F,100,174,0,174
Excel,F,54,7,6,13
Taqwan,M,100,0,5,5
Bexley,F,86,161,26,187
Jessyca,F,100,1279,0,1279
Yvaine,F,100,72,0,72
Jigme,M,100,0,5,5
Fares,M,100,0,589,589
Jaalah,F,100,26,0,26
Jorde,M,100,0,5,5
Arael,M,100,0,58,58
Mclane,M,94,5,77,82
Eleda,F,100,11,0,11
Mariagrazia,F,100,5,0,5
Jahvon,M,100,0,530,530
Pami,F,100,87,0,87
Teoman,M,100,0,34,34
Ermal,M,100,0,23,23
Shaleese,F,100,16,0,16
Alyzabeth,F,100,166,0,166
Eddiel,M,100,0,18,18
Drace,M,100,0,36,36
Imany,F,100,11,0,11
Evelia,F,100,1196,0,1196
Lynnie,F,90,151,16,167
Lindzi,F,100,46,0,46
Kenshin,M,100,0,217,217
Klare,F,100,44,0,44
Rosine,F,100,32,0,32
Taimur,M,100,0,45,45
Ilissa,F,100,249,0,249
Camalla,F,100,12,0,12
Kemper,M,90,114,994,1108
Kadar,M,100,0,137,137
Shaiquan,M,100,0,45,45
Angelinna,F,100,52,0,52
Ulrika,F,100,8,0,8
Tinisha,F,100,1145,0,1145
Mikale,M,89,39,317,356
Dalanee,F,100,5,0,5
Tola,F,79,22,6,28
Shawnece,F,100,18,0,18
Kathry,F,100,30,0,30
Leroi,M,100,0,127,127
Nimalan,M,100,0,5,5
Niala,F,100,102,0,102
Tonetta,F,100,321,0,321
Rajai,M,100,0,35,35
Dillonger,M,100,0,5,5
Aleana,F,100,664,0,664
Jainil,M,100,0,25,25
Raymen,M,100,0,33,33
Deniro,M,100,0,208,208
Marcjacob,M,100,0,18,18
Rhiyanna,F,100,30,0,30
Evelyna,F,100,128,0,128
Cherrise,F,100,105,0,105
Daniyel,M,100,0,25,25
Jamicah,M,100,0,95,95
Iman,F,83,4042,801,4843
Raffy,M,100,0,5,5
Duan,M,100,0,565,565
Jaqaun,M,100,0,6,6
Roise,F,100,34,0,34
Sharaven,F,100,5,0,5
Xaylie,F,100,5,0,5
Brenn,F,50,64,63,127
Kafi,F,100,106,0,106
Yishai,M,100,0,226,226
Dalys,F,71,17,7,24
Lillyian,F,100,72,0,72
Kirsha,F,100,47,0,47
Shimekia,F,100,5,0,5
Talise,F,100,283,0,283
Pessi,F,100,5,0,5
Loganjames,M,100,0,5,5
Lekeitha,F,100,18,0,18
Mareah,F,100,32,0,32
Jilliene,F,100,5,0,5
Christapher,M,100,0,679,679
Yaphet,M,98,5,216,221
Tailey,F,100,41,0,41
Jaycin,M,100,0,13,13
Jasmon,F,63,128,74,202
Kelvina,F,100,46,0,46
Latigra,F,100,22,0,22
Lashaunte,F,100,21,0,21
Aloma,F,100,247,0,247
Derlin,M,100,0,14,14
Marcelline,F,100,189,0,189
Niloofar,F,100,11,0,11
Measha,F,100,33,0,33
Yva,F,100,10,0,10
Tajanee,F,100,59,0,59
Seif,M,100,0,148,148
Monserrath,F,100,878,0,878
Karinne,F,100,277,0,277
Emmeline,F,100,2379,0,2379
Paulanne,F,100,22,0,22
Jeffifer,F,100,170,0,170
Eril,M,100,0,34,34
Anajah,F,100,295,0,295
Keitric,M,100,0,5,5
Sergiojr,M,100,0,10,10
Tymonte,M,100,0,5,5
Zheneavia,F,100,16,0,16
Yoshiki,M,100,0,22,22
Keyliana,F,100,5,0,5
Kynisha,F,100,80,0,80
Tenise,F,100,301,0,301
Dacion,M,100,0,18,18
Shatyra,F,100,204,0,204
Jazella,F,100,5,0,5
Lassandra,F,100,21,0,21
Jenine,F,100,2120,0,2120
Shelitha,F,100,86,0,86
Perlita,F,100,305,0,305
Athanasius,M,100,0,70,70
Santavia,F,100,5,0,5
Safee,M,100,0,5,5
Taleesa,F,100,22,0,22
Mikeyah,F,100,5,0,5
Amantha,F,100,158,0,158
Cyenthia,F,100,24,0,24
Garette,M,100,0,38,38
Zeeva,F,100,48,0,48
Pedrojr,M,100,0,5,5
Nataiya,F,100,31,0,31
Kinnidy,F,100,11,0,11
Johnathon,M,100,52,24345,24397
Kourtlynn,F,100,64,0,64
Dayamy,F,100,30,0,30
Aleah,F,100,10965,0,10965
Nateasha,F,100,10,0,10
Rodrica,F,100,13,0,13
Myasiah,F,100,30,0,30
Dal,M,100,0,322,322
Jamyr,M,100,0,11,11
Hindy,F,100,1161,0,1161
Nikira,F,100,105,0,105
Oluwatise,M,67,5,10,15
Skarlett,F,100,347,0,347
Eleanor,F,100,51589,19,51608
Aeriell,F,100,31,0,31
Alarie,F,100,13,0,13
Marenna,F,100,15,0,15
Tania,F,100,27062,60,27122
Mauricus,M,100,0,5,5
Livan,M,100,0,233,233
Shelley,F,99,69468,896,70364
Banan,M,100,0,5,5
Matt,M,100,5,19551,19556
Jillian,F,100,79199,227,79426
Lilijana,F,100,48,0,48
Ankoor,M,100,0,5,5
Naiya,F,100,1161,0,1161
Ronnia,F,100,19,0,19
Kanethia,F,100,11,0,11
Brinae,F,100,123,0,123
Jearld,M,100,0,223,223
Betzaira,F,100,89,0,89
Evanee,F,100,60,0,60
Quinette,F,100,189,0,189
Temikia,F,100,7,0,7
Teshena,F,100,5,0,5
Jaynia,F,100,89,0,89
Zalee,F,100,6,0,6
Tamrah,F,100,145,0,145
Mackai,M,100,0,6,6
Dhruti,F,100,62,0,62
Kalyn,F,95,7053,366,7419
Hutton,M,98,6,249,255
Tymira,F,100,82,0,82
Gislaine,F,100,12,0,12
Armonni,F,100,25,0,25
Adalynne,F,100,403,0,403
Jahlen,M,100,0,92,92
Sherrine,F,100,69,0,69
Anacecilia,F,100,52,0,52
Mulan,F,97,176,5,181
Danaysha,F,100,188,0,188
Cheval,M,100,0,6,6
Breshonna,F,100,10,0,10
Sharmane,F,100,330,0,330
Rajan,M,100,0,916,916
Candina,F,100,44,0,44
Burr,M,100,0,149,149
Alisynn,F,100,6,0,6
Shemita,F,100,5,0,5
Kaydian,M,100,0,6,6
Koula,F,100,11,0,11
Lilliann,F,100,751,0,751
Xzavian,M,100,0,271,271
Sunny,F,72,7109,2779,9888
Shakoria,F,100,5,0,5
Brooklee,F,100,114,0,114
Aysiah,F,100,190,0,190
Ahkeelah,F,100,6,0,6
Talijah,F,100,45,0,45
Quincy,M,88,2754,21119,23873
Anamile,F,100,5,0,5
Carryl,F,100,11,0,11
Diangela,F,100,6,0,6
Derrelle,M,100,0,36,36
Giovanii,M,100,0,6,6
Deroy,M,100,0,46,46
Andru,M,100,0,1093,1093
Marrisha,F,100,15,0,15
Aavion,M,100,0,17,17
Shaunie,F,100,78,0,78
Tearah,F,100,63,0,63
Bryiana,F,100,5,0,5
Abria,F,100,786,0,786
Maria,F,99,435731,3152,438883
Kierson,M,100,0,5,5
Shakeisha,F,100,197,0,197
Jaquese,M,72,31,79,110
Tonimarie,F,100,303,0,303
Chazman,M,100,0,7,7
Savilla,F,100,43,0,43
Kamielle,F,100,12,0,12
Chue,M,99,5,329,334
Kamily,F,100,20,0,20
Keandrea,F,100,322,0,322
Kaleen,F,100,732,0,732
Janelda,F,100,21,0,21
Rinad,F,100,26,0,26
Jkiyah,F,100,6,0,6
Shareece,F,100,144,0,144
Richar,M,100,0,301,301
Yoseline,F,100,759,0,759
Comer,M,100,0,117,117
Josphe,M,100,0,5,5
Leshell,F,100,26,0,26
Tressa,F,100,5136,0,5136
Kati,F,100,4707,0,4707
Yalini,F,100,7,0,7
Rebekha,F,100,73,0,73
Nourah,F,100,6,0,6
Jayd,F,75,316,106,422
Schuyler,M,75,1151,3392,4543
Leigha,F,100,5627,0,5627
Addaleigh,F,100,41,0,41
Roynesha,F,100,6,0,6
Chaqueta,F,100,12,0,12
Annemarie,F,100,10704,0,10704
Jebadiah,M,100,0,175,175
Raegan,F,99,13734,138,13872
Alberto,M,99,353,53098,53451
Takashi,M,100,0,298,298
Caelon,M,100,0,37,37
Rya,F,98,841,19,860
Amyla,F,100,173,0,173
Nomi,F,100,145,0,145
Marivell,F,100,5,0,5
Bryanna,F,100,17852,0,17852
Seeya,F,100,6,0,6
Dewyane,M,100,0,21,21
Johnice,F,100,214,0,214
Deadria,F,100,26,0,26
Shannondoah,F,100,11,0,11
Krystil,F,100,41,0,41
Javiana,F,100,72,0,72
Leniyah,F,100,184,0,184
Yashdeep,M,100,0,5,5
Lacie,F,100,9612,0,9612
Annalucia,F,100,79,0,79
Meina,F,100,11,0,11
Ksean,M,100,0,65,65
Mikaylyn,F,100,7,0,7
Sharleen,F,100,1844,0,1844
Aujane,F,100,11,0,11
Tashie,F,100,16,0,16
Ece,F,100,61,0,61
Elnaz,F,100,6,0,6
Jelesia,F,100,23,0,23
Cherel,F,100,16,0,16
Mama,F,100,23,0,23
Torita,F,100,5,0,5
Reshawn,M,91,43,411,454
Brunella,F,100,58,0,58
Anaelisa,F,100,12,0,12
Kalifornia,F,100,13,0,13
Oriane,F,100,16,0,16
Rabia,F,100,711,0,711
Edwrd,M,100,0,15,15
Rei,F,51,219,211,430
Azizjon,M,100,0,6,6
Belma,F,100,313,0,313
Michaelee,F,100,5,0,5
Swain,M,100,0,38,38
Denison,M,100,0,37,37
Glossie,F,100,5,0,5
Alexie,F,85,1440,256,1696
Cameon,M,100,0,5,5
Sederick,M,100,0,168,168
Eligio,M,100,0,1050,1050
Ladene,F,100,75,0,75
Tymaine,M,100,0,22,22
Thrisa,F,100,5,0,5
Walley,M,100,0,40,40
Sheray,F,100,151,0,151
Leath,F,100,6,0,6
Dalziel,M,100,0,12,12
Guenevere,F,100,162,0,162
Trelyn,M,100,0,108,108
Kalisa,F,100,399,0,399
Rudra,M,98,11,565,576
Queanna,F,100,11,0,11
Savayah,F,100,56,0,56
Indian,F,100,5,0,5
Daizy,F,100,549,0,549
Majur,M,100,0,5,5
Queshaun,M,100,0,5,5
Ernesto,M,100,121,36424,36545
Sohaib,M,100,0,230,230
Kiersen,F,100,10,0,10
Nashli,F,100,6,0,6
Makiley,F,100,5,0,5
Arretta,F,100,24,0,24
Sahvana,F,100,11,0,11
Laquel,F,100,5,0,5
Damarian,M,100,0,312,312
Caysey,M,100,0,5,5
Kylei,F,100,874,0,874
Aubreona,F,100,5,0,5
Askia,M,100,0,329,329
Kaelib,M,100,0,58,58
Charl,F,79,49,13,62
Rebeckah,F,100,647,0,647
Delphinia,F,100,16,0,16
Zien,M,100,0,31,31
Naama,F,100,210,0,210
Fatumo,F,100,5,0,5
Gibbs,M,100,0,38,38
Mearl,M,98,5,217,222
Biff,M,100,0,248,248
Stassa,F,100,6,0,6
Rosalva,F,100,2012,0,2012
Jamisa,F,100,26,0,26
Vrishank,M,100,0,77,77
Laylani,F,100,695,0,695
Kymorah,F,100,68,0,68
Laphonso,M,100,0,5,5
Deslie,F,100,7,0,7
Thaddis,M,100,0,10,10
Codyjames,M,100,0,23,23
Annmari,F,100,5,0,5
Santanna,F,93,785,55,840
Ahmire,M,100,0,18,18
Azella,F,100,8,0,8
Iggy,M,100,0,5,5
Tavonte,M,100,0,131,131
Farwa,F,100,6,0,6
Derris,M,100,0,415,415
Vonisha,F,100,5,0,5
Rudine,F,100,93,0,93
Anderew,M,100,0,10,10
Mahalya,F,100,6,0,6
Artem,M,100,0,465,465
Mirnes,M,100,0,5,5
Deolinda,F,100,16,0,16
Nisan,M,100,0,5,5
Nicoletta,F,100,1147,0,1147
Kymeshia,F,100,5,0,5
Kayel,M,100,0,18,18
Nikeita,F,100,12,0,12
Ronnal,M,100,0,11,11
Galadriel,F,100,168,0,168
Angelynn,F,100,541,0,541
Nevaen,F,100,82,0,82
Maliik,M,100,0,93,93
Alexina,F,100,114,0,114
Lawna,F,100,16,0,16
Keeshia,F,100,68,0,68
Juleeanna,F,100,5,0,5
Satoshi,M,100,0,138,138
Rayden,M,94,186,2696,2882
Hal,M,100,0,8543,8543
Lashawn,F,71,7309,2983,10292
Shaunielle,F,100,5,0,5
Samiyha,F,100,13,0,13
Raeleigh,F,100,1115,0,1115
Antonis,M,100,0,72,72
Keyajah,F,100,5,0,5
Innaya,F,100,6,0,6
Prabhas,M,100,0,5,5
Kamin,M,100,0,63,63
Cyanna,F,100,325,0,325
Cortny,F,100,197,0,197
Mguadalupe,F,100,5,0,5
Zhia,F,100,22,0,22
Taneice,F,100,5,0,5
Christerpher,M,100,0,276,276
Samanyu,M,100,0,129,129
Cayslee,F,100,5,0,5
Sincerely,F,100,6,0,6
Raisha,F,100,142,0,142
Azucena,F,100,3298,0,3298
Rigo,M,100,0,1500,1500
Akida,M,74,15,42,57
Eathen,M,100,0,346,346
Jaten,M,100,0,10,10
Daje,F,100,87,0,87
Wrett,M,100,0,6,6
Tristanjames,M,100,0,5,5
Akiana,F,100,6,0,6
Talayia,F,100,100,0,100
Altarik,M,100,0,5,5
Labarron,M,100,0,179,179
Paolina,F,100,138,0,138
Nesa,F,100,95,0,95
Refugio,M,94,126,2134,2260
Tamyah,F,100,332,0,332
Denaria,F,100,26,0,26
Aiyla,F,100,108,0,108
Toinette,F,100,449,0,449
Shanga,M,88,5,36,41
Tristany,F,100,31,0,31
Wenona,F,100,655,0,655
Rosealina,F,100,6,0,6
Shadoe,M,73,68,187,255
Adalyn,F,100,10642,0,10642
Charniqua,F,100,29,0,29
Daneika,F,100,10,0,10
Shulem,M,100,0,863,863
Ellisa,F,100,804,0,804
Draylon,M,100,0,157,157
Kaison,M,100,5,1288,1293
Devvon,M,92,5,59,64
Laria,F,100,128,0,128
Grantley,M,100,0,54,54
Tahitia,F,100,44,0,44
Tanairi,F,100,203,0,203
Hanaa,F,100,263,0,263
Asya,F,100,1813,0,1813
El,M,100,0,148,148
Krisanne,F,100,297,0,297
Arthuro,M,100,0,328,328
Aleia,F,100,1280,0,1280
Dyana,F,100,1733,0,1733
Phalynn,F,100,5,0,5
Donata,F,100,351,0,351
Cassandra,F,100,162605,377,162982
Johniah,F,100,11,0,11
Yuriah,F,51,28,27,55
Meriann,F,100,15,0,15
Leonhard,M,100,0,5,5
Darel,M,100,5,1336,1341
Raekwan,M,100,0,68,68
Krisana,F,100,6,0,6
Nicholus,M,100,0,748,748
Yatziry,F,100,337,0,337
Gudrun,F,100,26,0,26
Jaxun,M,100,0,6,6
Myley,F,100,143,0,143
Subrenia,F,100,18,0,18
Kainoa,M,98,27,1655,1682
Aldana,F,100,22,0,22
Savya,F,50,5,5,10
Tessah,F,100,232,0,232
Tovan,M,100,0,5,5
Deroderick,M,100,0,5,5
Dazlyn,F,100,6,0,6
Tanelle,F,100,58,0,58
Sadarius,M,100,0,146,146
Kassara,F,100,5,0,5
Brina,F,100,1241,5,1246
Tanav,M,100,0,114,114
Devohn,M,100,0,46,46
Crystil,F,100,11,0,11
Grainne,F,100,87,0,87
Zerlene,F,100,5,0,5
Gotti,M,100,0,73,73
Jaffet,M,100,0,26,26
Norah,F,100,13337,23,13360
Lita,F,100,2688,0,2688
Lorianna,F,100,334,0,334
Zillah,F,100,125,0,125
Jestyn,M,100,0,5,5
Mylee,F,100,3331,0,3331
Brandea,F,100,5,0,5
Mckinzey,F,100,177,0,177
Dache,F,100,23,0,23
Kashley,F,100,11,0,11
Shwanda,F,100,133,0,133
Aydrianna,F,100,27,0,27
Candelario,M,100,0,1409,1409
Templeton,M,100,0,11,11
Korwin,M,100,0,10,10
Jadenn,M,88,5,35,40
Yaffa,F,100,325,0,325
Lylith,F,100,36,0,36
Neydi,F,100,37,0,37
Treyshon,M,100,0,62,62
Dakwon,M,100,0,89,89
Omunique,F,100,134,0,134
Sindia,F,100,192,0,192
Sevanna,F,100,173,0,173
Sophiaisabelle,F,100,5,0,5
Aini,F,100,5,0,5
Shakeem,M,100,0,728,728
Jyrah,F,100,75,0,75
Mishal,F,97,146,5,151
Anton,M,100,21,13375,13396
Ehtan,M,100,0,142,142
Melford,M,100,0,241,241
Gae,F,100,288,0,288
Milisia,F,100,5,0,5
Jeason,M,100,0,10,10
Dorielle,F,100,5,0,5
Osei,M,100,0,197,197
Decca,F,100,5,0,5
Davasha,F,100,5,0,5
Ahliya,F,100,64,0,64
Areil,F,100,298,0,298
Lohgan,F,53,36,32,68
Shreen,F,100,11,0,11
Jarrit,M,100,0,10,10
Zelie,F,100,156,0,156
Neyla,F,100,250,0,250
Wacey,M,100,0,278,278
Tracina,F,100,103,0,103
Johnneisha,F,100,5,0,5
Johnasia,F,100,121,0,121
Delann,F,100,11,0,11
Kaveion,M,100,0,25,25
Amatullah,F,100,241,0,241
Danesha,F,100,1290,0,1290
Blissany,F,100,11,0,11
Jadalee,F,100,110,0,110
Claren,F,100,20,0,20
Coetta,F,100,33,0,33
Addi,F,100,304,0,304
Kaelyne,F,100,5,0,5
Hedgar,M,100,0,7,7
Aidann,M,100,0,10,10
Shadee,F,55,91,73,164
Derringer,M,100,0,16,16
Shealey,F,100,10,0,10
Harvey,M,100,144,33097,33241
Chaquanna,F,100,5,0,5
Stiven,M,100,0,136,136
Ritzy,F,100,5,0,5
Gagandeep,M,72,50,129,179
Trinika,F,100,79,0,79
Denali,F,72,956,368,1324
Williamson,M,100,0,63,63
Kanasia,F,100,122,0,122
Darianne,F,100,175,0,175
Gwendalin,F,100,15,0,15
Vuong,M,100,0,169,169
Ladasha,F,100,316,0,316
Selassie,M,100,0,43,43
Najier,M,100,0,11,11
Elby,M,100,0,24,24
Karian,F,100,41,0,41
Senyah,F,100,6,0,6
Danykah,F,100,5,0,5
Sharbel,M,100,0,46,46
Alissabeth,F,100,10,0,10
Nalana,F,100,12,0,12
Dean,M,99,861,122199,123060
Jamaiah,F,100,15,0,15
Victoriarose,F,100,20,0,20
Drayk,M,100,0,87,87
Hyde,M,100,0,110,110
Randen,M,100,0,268,268
Donathon,M,100,0,15,15
Indalecio,M,100,0,113,113
Sheron,F,86,2286,379,2665
Khamilla,F,100,8,0,8
Raphiel,M,100,0,53,53
Jabina,F,100,7,0,7
Jantsen,M,100,0,5,5
Aubyn,F,100,37,0,37
Judy,F,100,187647,523,188170
Sumpter,M,100,0,5,5
Layssa,F,100,16,0,16
Zakharia,F,100,15,0,15
Znya,F,100,69,0,69
Aalaya,F,100,111,0,111
Cathlena,F,100,10,0,10
Zykei,M,100,0,5,5
Cielo,F,98,2453,39,2492
Shronda,F,100,497,0,497
Aahan,M,100,0,165,165
Nakylah,F,100,33,0,33
Caroletta,F,100,15,0,15
Yajat,M,100,0,15,15
Dashya,F,100,12,0,12
Giann,M,100,0,64,64
Saham,F,100,5,0,5
Creede,M,100,0,15,15
Selene,F,100,5782,5,5787
Deeda,F,100,5,0,5
Nasheka,F,100,38,0,38
Creston,M,100,0,552,552
Kaitlin,F,100,56678,75,56753
Thomisha,F,100,7,0,7
Moesha,F,100,1067,0,1067
Avia,F,100,942,0,942
Tristine,F,97,189,5,194
Adryauna,F,100,5,0,5
Quantavious,M,100,0,475,475
Kyl,M,100,0,81,81
Garson,M,100,0,39,39
Riesa,F,100,10,0,10
Krystine,F,100,907,0,907
Torria,F,100,181,0,181
Jaymez,M,100,0,11,11
Shannelle,F,100,190,0,190
Astaria,F,100,55,0,55
Vahid,M,100,0,22,22
Jehovany,M,100,0,5,5
Calyse,F,100,48,0,48
Arvin,M,100,0,2425,2425
Lakyra,F,100,316,0,316
Yanitzia,F,100,26,0,26
Haamid,M,100,0,6,6
Fionna,F,100,567,0,567
Promiss,F,100,58,0,58
Leinaala,F,100,68,0,68
Yanalis,F,100,5,0,5
Dock,M,100,0,784,784
Toddy,M,100,0,70,70
Maley,F,100,145,0,145
Oesha,F,100,5,0,5
Gionnie,M,100,0,24,24
Kentley,F,60,58,39,97
Ixzel,F,100,13,0,13
Rhoda,F,100,7215,0,7215
Andreaus,M,100,0,39,39
Kaysaan,M,100,0,5,5
Lorin,F,51,2540,2478,5018
Kosha,F,100,113,0,113
Kailianna,F,100,6,0,6
Zofia,F,100,1071,0,1071
Rydon,M,100,0,6,6
Gianny,F,51,147,144,291
Claudelle,F,100,20,0,20
Beate,F,100,10,0,10
Nasyr,M,100,0,26,26
Kaladin,M,100,0,26,26
Kieshawn,M,100,0,40,40
Arlind,M,100,0,145,145
Taneyah,F,100,50,0,50
Jafet,M,100,0,950,950
Aleem,M,100,0,408,408
Keiko,F,100,770,0,770
Arsenia,F,100,15,0,15
Sharhonda,F,100,1333,0,1333
Nyaisha,F,100,123,0,123
Zadon,M,100,0,10,10
Luana,F,100,2475,0,2475
Tishayla,F,100,5,0,5
Kiley,F,94,17755,1092,18847
Jontel,M,61,20,31,51
Laporsche,F,100,118,0,118
Felinda,F,100,5,0,5
Cindie,F,100,998,0,998
Loir,F,100,10,0,10
Tawny,F,100,4169,0,4169
Corabella,F,100,22,0,22
Nyla,F,100,13316,0,13316
Ashauria,F,100,10,0,10
Myianna,F,100,10,0,10
Makira,F,100,187,0,187
Melodie,F,100,8931,0,8931
Abisai,M,98,13,763,776
Keiwan,M,100,0,25,25
Dhwani,F,100,55,0,55
Delvonta,M,100,0,38,38
Shelsie,F,100,88,0,88
Kellylynn,F,100,10,0,10
Taci,F,100,146,0,146
Lailey,F,100,37,0,37
Marvi,F,100,5,0,5
Zedekiah,M,100,0,368,368
Iean,M,100,0,5,5
Kijah,F,100,44,0,44
Dayris,F,100,9,0,9
Azyria,F,100,103,0,103
Jhoseline,F,100,35,0,35
Kameran,M,68,186,389,575
Standly,M,100,0,21,21
Makynzee,F,100,136,0,136
Tawauna,F,100,6,0,6
Stephanne,F,100,92,0,92
Toria,F,100,1112,0,1112
Ishmail,M,100,0,208,208
Renso,M,100,0,64,64
Valleria,F,100,12,0,12
Tell,M,100,0,158,158
Nyshae,F,100,5,0,5
Jhonae,F,100,5,0,5
Beata,F,100,587,0,587
Babbette,F,100,120,0,120
Dewitt,M,100,0,2008,2008
Adelade,F,100,39,0,39
Matthewjoseph,M,100,0,18,18
Jorrie,F,100,5,0,5
Jemelle,M,100,0,30,30
Tamie,F,100,3224,0,3224
Francella,F,100,153,0,153
Alaina,F,100,33551,6,33557
Ryasia,F,100,11,0,11
Jannene,F,100,10,0,10
Rosela,F,100,24,0,24
Hajara,F,100,5,0,5
Millicent,F,100,4589,0,4589
Queta,F,100,6,0,6
Taymur,M,100,0,6,6
Beyoncee,F,100,5,0,5
Tymon,M,100,0,435,435
Jarriel,M,100,0,68,68
Malala,F,100,20,0,20
Melissasue,F,100,17,0,17
Taranika,F,100,21,0,21
Lavonta,M,96,11,302,313
Firas,M,100,0,351,351
Chauntel,F,100,497,0,497
Dajahnae,F,100,63,0,63
Jeany,F,100,126,0,126
Mikal,M,85,532,3009,3541
Anjennette,F,100,5,0,5
Marky,M,100,0,83,83
Delenn,F,100,84,0,84
Anjeliett,F,100,7,0,7
Hope,F,100,72263,181,72444
Bariah,F,100,13,0,13
Shamonda,F,100,31,0,31
Tameya,F,100,185,0,185
Marjani,F,100,98,0,98
Christiananthon,M,100,0,12,12
Rotonya,F,100,8,0,8
Jamianne,F,100,6,0,6
Wellington,M,100,0,1058,1058
Suzy,F,100,3465,0,3465
Akeshia,F,100,48,0,48
Eloyce,F,100,5,0,5
Kamrin,M,70,416,950,1366
Vianny,F,100,106,0,106
Markala,F,100,120,0,120
Snigdha,F,100,207,0,207
Abdulnasir,M,100,0,5,5
Brennen,M,98,178,8299,8477
Caitelyn,F,100,5,0,5
Perman,M,100,0,7,7
Ruven,M,100,0,101,101
Keymonte,M,100,0,20,20
Waynard,M,100,0,5,5
Brin,F,91,360,37,397
Lakiaya,F,100,5,0,5
Makinze,F,100,141,0,141
Darquez,M,100,0,12,12
Jhiya,F,100,5,0,5
Dnaya,F,100,25,0,25
Taetum,F,89,82,10,92
Teniesha,F,100,49,0,49
Temidayo,M,77,10,33,43
Gavien,M,100,0,5,5
Keshonna,F,100,124,0,124
Waver,F,100,7,0,7
Pui,F,100,10,0,10
Mordcha,M,100,0,26,26
Lisset,F,100,1417,0,1417
Jasim,M,100,0,180,180
Aneyah,F,100,71,0,71
Agee,M,100,0,10,10
Rubenia,F,100,5,0,5
Yulie,F,100,33,0,33
Chaitan,M,100,0,6,6
Eriani,F,100,5,0,5
Marlee,F,99,10104,85,10189
Shequana,F,100,31,0,31
Kenzleigh,F,100,259,0,259
Keilani,F,100,1768,0,1768
Sarinah,F,100,56,0,56
Bevely,F,100,95,0,95
Sherma,F,100,120,0,120
Sheila,F,100,188591,502,189093
Timberley,F,100,6,0,6
Chrissi,F,100,76,0,76
Ulysees,M,100,0,109,109
Milissia,F,100,36,0,36
Stpehen,M,100,0,49,49
Jahmiere,M,100,0,48,48
Amorah,F,100,116,0,116
Tyrand,M,100,0,6,6
Lillyn,F,100,69,0,69
Inga,F,100,2238,0,2238
Anelia,F,100,121,0,121
Jamesthomas,M,100,0,20,20
Chairity,F,100,10,0,10
Deelynn,F,100,5,0,5
Ilyn,F,100,56,0,56
Eiman,F,100,91,0,91
Quilla,F,84,26,5,31
Vukasin,M,100,0,5,5
Jacobs,M,100,0,58,58
Anyssa,F,100,1918,0,1918
Zeni,F,100,45,0,45
Anh,F,69,1337,589,1926
Haly,F,100,117,0,117
Jahmeel,M,100,0,16,16
Jahmeek,M,100,0,65,65
Zuheily,F,100,10,0,10
Andriette,F,100,15,0,15
Maylene,F,100,761,0,761
Shahiem,M,100,0,71,71
Joellyn,F,100,655,0,655
Valencia,F,100,10197,11,10208
Agapita,F,100,19,0,19
Hemant,M,100,0,22,22
Daasia,F,100,10,0,10
Yuna,F,100,1060,0,1060
Temperance,F,100,2016,0,2016
Artherine,F,100,5,0,5
Vernesta,F,100,7,0,7
Kamille,F,100,3732,0,3732
Isiac,M,100,0,153,153
Gram,M,100,0,241,241
Montavius,M,100,0,349,349
Renatha,F,100,40,0,40
Lakisha,F,100,12301,12,12313
Keiara,F,100,1464,0,1464
Eilonwy,F,100,10,0,10
Hermela,F,100,190,0,190
Kashius,M,100,0,77,77
Jenrri,M,100,0,11,11
Ace,M,100,10,5682,5692
Quinnetta,F,100,85,0,85
Alafia,F,100,5,0,5
Mellodee,F,100,5,0,5
Arafat,M,100,0,82,82
Graceann,F,100,804,0,804
Jud,M,100,0,406,406
Amani,F,82,8753,1894,10647
Adyant,M,100,0,16,16
Fransisca,F,100,218,0,218
Kemond,M,100,0,74,74
Jacobrobert,M,100,0,6,6
Yomtov,M,100,0,9,9
Danica,F,100,13935,0,13935
Cherolyn,F,100,41,0,41
Marhonda,F,100,12,0,12
Nikhila,F,100,52,0,52
Omayra,F,100,812,0,812
Yaasmeen,F,100,18,0,18
Zikiya,F,100,5,0,5
Hallah,F,100,14,0,14
Omeed,M,100,0,282,282
Ringo,M,100,0,203,203
Loriell,F,100,5,0,5
Shaunette,F,100,154,0,154
Jenia,F,100,391,0,391
Destannie,F,100,20,0,20
Rashid,M,100,0,2157,2157
Shaquanda,F,100,691,0,691
Harmonei,F,100,17,0,17
Shakara,F,100,896,0,896
Ritchey,M,100,0,19,19
Leidy,F,100,572,0,572
Kinzer,M,100,0,10,10
Lilibeth,F,100,1314,0,1314
Jazyiah,F,100,74,0,74
Zackariya,M,100,0,20,20
Camelia,F,100,1979,0,1979
Shynese,F,100,12,0,12
Nakeysha,F,100,118,0,118
Kotaro,M,100,0,140,140
Mounia,F,100,5,0,5
Lucious,M,100,0,1749,1749
Hannahmarie,F,100,202,0,202
Avori,F,100,15,0,15
Malkah,F,100,17,0,17
Arelene,F,100,33,0,33
Lital,F,100,23,0,23
Inesh,M,100,0,48,48
Kiersta,F,100,22,0,22
Nilyn,F,100,5,0,5
Ahnika,F,100,208,0,208
Armonnie,F,100,5,0,5
Kynna,F,100,18,0,18
Keimya,F,100,111,0,111
Hermonie,F,100,16,0,16
Denette,F,100,682,0,682
Trinidie,F,100,5,0,5
Leanndra,F,100,128,0,128
Pattii,F,100,6,0,6
Sumra,F,100,5,0,5
Massimo,M,100,0,2096,2096
Taeja,F,100,127,0,127
Mhia,F,100,48,0,48
Ingri,F,100,128,0,128
Jaaliyah,F,100,255,0,255
Jalun,M,100,0,25,25
Kiyarah,F,100,5,0,5
Cathlene,F,100,728,0,728
Tashika,F,100,569,0,569
Chameka,F,100,193,0,193
Shyron,M,100,0,55,55
Hilaria,F,100,334,0,334
Taher,M,100,0,175,175
Dekira,F,100,21,0,21
Jacyion,M,100,0,6,6
Parvin,M,100,0,17,17
Yamilee,F,100,62,0,62
Melah,F,100,129,0,129
Trinket,F,100,16,0,16
Walkidia,F,100,5,0,5
Avellina,F,100,5,0,5
Patrick,M,100,2423,573927,576350
Trelen,M,100,0,8,8
Brenden,M,100,42,24282,24324
Kweli,M,94,11,188,199
Neiko,M,100,0,471,471
Arionne,F,100,180,0,180
Trusha,F,100,5,0,5
Davlyn,F,100,5,0,5
Aribelle,F,100,44,0,44
Caprica,F,100,22,0,22
Tajahnae,F,100,41,0,41
Hartford,M,100,0,64,64
Taray,M,100,0,92,92
Abryella,F,100,12,0,12
Samit,M,100,0,77,77
Johnston,M,100,0,350,350
Lagail,F,100,12,0,12
Sheriel,F,100,5,0,5
Fe,F,100,73,0,73
Laurenelizabeth,F,100,5,0,5
Janeene,F,100,180,0,180
Pearlene,F,100,471,0,471
Quali,M,100,0,6,6
Valyssa,F,100,5,0,5
Danan,M,100,0,43,43
Solene,F,100,44,0,44
Tarcha,F,100,17,0,17
Artan,M,100,0,50,50
Keshay,F,100,58,0,58
Maile,F,100,3259,0,3259
Kiriana,F,100,74,0,74
Aesop,M,100,0,12,12
Cadence,F,94,16720,1152,17872
Kalilah,F,100,318,0,318
Morgan,F,85,205463,34877,240340
Marlenny,F,100,5,0,5
Anastashia,F,100,308,0,308
Zanyah,F,100,354,0,354
Adriell,M,100,0,44,44
Quadrell,M,100,0,13,13
Zixuan,M,57,13,17,30
Ilee,F,100,100,0,100
Sebastiaan,M,100,0,35,35
Lyllian,F,100,468,0,468
Persia,F,100,644,0,644
Makaylia,F,100,216,0,216
Jaylamarie,F,100,6,0,6
Eulalio,M,100,0,857,857
Arcadio,M,100,0,785,785
Corwyn,M,100,0,425,425
Phylicia,F,100,2380,0,2380
Imo,F,79,19,5,24
Takella,F,100,5,0,5
Claudina,F,100,239,0,239
Isobella,F,100,175,0,175
Arlandus,M,100,0,10,10
Durene,F,100,59,0,59
Solymar,F,100,166,0,166
Kentrina,F,100,6,0,6
Tshombe,M,100,0,42,42
Marlyss,F,100,7,0,7
Deina,F,100,94,0,94
Sharrel,F,100,15,0,15
Remeka,F,100,5,0,5
Ancika,F,100,5,0,5
Wanette,F,100,74,0,74
Trayvon,M,100,0,2860,2860
Sharry,F,100,678,0,678
Mataya,F,100,983,0,983
Anitrea,F,100,5,0,5
Shadaja,F,100,35,0,35
Trissa,F,100,213,0,213
Nishant,M,100,0,560,560
Yannely,F,100,71,0,71
Jolette,F,100,622,0,622
Dariell,M,71,10,24,34
Ethann,M,100,0,42,42
Zahyrah,F,100,5,0,5
Tajuan,M,99,7,634,641
Teandria,F,100,5,0,5
Kaydnce,F,100,5,0,5
Anneelise,F,100,10,0,10
Louvella,F,100,18,0,18
Gardiner,M,100,0,69,69
Ibette,F,100,13,0,13
Genene,F,100,391,0,391
Lex,M,100,0,2491,2491
Raynold,M,100,0,187,187
Deuntray,M,100,0,6,6
Reedy,M,100,0,6,6
Shawonda,F,100,123,0,123
Nysir,M,100,0,182,182
Indasia,F,100,8,0,8
Demetrous,M,100,0,35,35
Loranzo,M,100,0,95,95
Linah,F,100,49,0,49
Lourd,F,100,6,0,6
Kizer,M,100,0,64,64
Aquilla,F,95,588,28,616
Shelvia,F,100,76,0,76
Jeannine,F,100,15239,0,15239
Jaymesha,F,100,7,0,7
Gardenia,F,100,965,0,965
Andralyn,F,100,40,0,40
Boedy,M,100,0,50,50
Tela,F,99,661,7,668
Ferryn,F,100,7,0,7
Adlynn,F,100,55,0,55
Brooklin,F,100,1742,5,1747
Dillin,M,100,0,529,529
Donaciano,M,100,0,296,296
Lynnita,F,100,60,0,60
Yajaida,F,100,7,0,7
Justo,M,100,0,1225,1225
Montrel,M,100,0,908,908
Macgregor,M,100,0,246,246
Falina,F,100,50,0,50
Bea,F,100,616,0,616
Georgette,F,100,7645,0,7645
Annamarie,F,100,9388,0,9388
Nyra,F,100,409,0,409
Kayannah,F,100,5,0,5
Oleatha,F,100,11,0,11
Calirae,F,100,9,0,9
Seamus,M,100,0,5904,5904
Mirren,F,100,35,0,35
Heidie,F,100,389,0,389
Shaunta,F,97,1193,37,1230
Jutta,F,100,33,0,33
Ronniya,F,100,5,0,5
Kevinn,M,100,0,24,24
Payzley,F,100,10,0,10
Kaylissa,F,100,39,0,39
Salsabil,F,100,21,0,21
Saretta,F,100,74,0,74
Shashi,M,100,0,5,5
Enzlie,F,100,6,0,6
Jevaun,M,100,0,68,68
Brilen,M,100,0,5,5
Mileah,F,100,289,0,289
Bayro,M,100,0,26,26
Martavis,M,100,0,281,281
Cayli,F,100,383,0,383
Aisia,F,100,83,0,83
Nykeemah,F,100,12,0,12
Damianna,F,100,16,0,16
Jayveon,M,100,0,914,914
Camaro,F,59,19,13,32
Shabina,F,100,5,0,5
Mylaya,F,100,9,0,9
Cherrita,F,100,47,0,47
Iwona,F,100,33,0,33
Jaleeza,F,100,33,0,33
Leenah,F,100,101,0,101
Oakes,M,100,0,28,28
Malaila,F,100,18,0,18
Nacho,M,100,0,24,24
Quantavius,M,100,0,265,265
Quamar,M,100,0,40,40
Arlo,M,98,67,3491,3558
Tylayah,F,100,11,0,11
Hiyab,F,85,60,11,71
Dayquon,M,100,0,35,35
Shenae,F,100,333,0,333
Joelene,F,100,918,0,918
Gem,F,100,100,0,100
Geneses,F,100,22,0,22
Schawn,M,100,0,66,66
Marzena,F,100,18,0,18
Labraya,F,100,5,0,5
Samella,F,100,227,0,227
Pattina,F,100,6,0,6
Eythen,M,100,0,5,5
Billiejoe,F,100,6,0,6
Keantae,M,100,0,20,20
Walik,M,100,0,10,10
Rigsby,M,100,0,11,11
Shirla,F,100,76,0,76
Elon,M,72,379,999,1378
Amolika,F,100,5,0,5
Valecia,F,100,434,0,434
Mingus,M,100,0,5,5
Shatora,F,100,119,0,119
Nicholad,M,100,0,51,51
Abdikhaliq,M,100,0,5,5
Jetson,M,100,0,111,111
Shaleya,F,100,38,0,38
Robertanthony,M,100,0,25,25
Maryeileen,F,100,10,0,10
Lyzandra,F,100,5,0,5
Emond,M,100,0,16,16
Alandus,M,100,0,16,16
Dorethea,F,100,446,0,446
Jaheir,M,100,0,28,28
Annettee,F,100,42,0,42
Anglique,F,100,43,0,43
Jamarl,M,100,0,129,129
Thailen,M,100,0,5,5
Jionnie,M,100,0,7,7
Someeka,F,100,7,0,7
Travys,M,100,0,34,34
Shirlon,F,100,15,0,15
Nieshia,F,100,161,0,161
Celie,F,100,195,0,195
Daequon,M,100,0,52,52
Nivaan,M,100,0,72,72
Arlene,F,100,46847,71,46918
Leevon,M,100,0,55,55
Cortlen,M,100,0,27,27
Dorisann,F,100,18,0,18
Rashya,F,100,21,0,21
Jadein,M,100,0,18,18
Chanston,M,100,0,25,25
Ebay,M,100,0,12,12
Jymere,M,100,0,51,51
Thuong,F,84,37,7,44
Manogna,F,100,5,0,5
Jerrelle,M,100,0,74,74
Rayelle,F,100,187,0,187
Shaneiqua,F,100,50,0,50
Dantae,M,100,0,478,478
Hanai,F,100,5,0,5
Carmi,F,84,51,10,61
Theodric,M,100,0,22,22
Jarail,M,100,0,5,5
Darshae,F,100,31,0,31
Jalene,F,94,1079,67,1146
Tsion,F,83,184,37,221
Lalitha,F,100,65,0,65
Delsha,F,100,5,0,5
Tanyanika,F,100,49,0,49
Brock,M,100,75,38219,38294
Fauzia,F,100,11,0,11
Jamise,F,100,151,0,151
Reyah,F,100,74,0,74
Carroll,M,80,2028,8324,10352
Olayinka,F,58,61,44,105
Rashiya,F,100,79,0,79
Stedmon,M,100,0,31,31
Striker,M,100,0,16,16
Meena,F,99,1124,12,1136
Tammylynn,F,100,29,0,29
Jazzi,F,100,27,0,27
Jamiyla,F,100,68,0,68
Holland,F,73,3253,1221,4474
Callisa,F,100,7,0,7
Elijahwon,M,100,0,18,18
Lailamarie,F,100,7,0,7
Venica,F,100,11,0,11
Jacolyn,F,100,256,0,256
Huey,M,100,0,2286,2286
Romelda,F,100,10,0,10
Larnell,M,100,0,757,757
Astride,F,100,6,0,6
Norene,F,100,1164,0,1164
Deaquan,M,100,0,13,13
Kolson,M,100,0,242,242
Tajanea,F,100,18,0,18
Cortasia,F,100,75,0,75
Ghulam,M,100,0,10,10
Ye,F,62,16,10,26
Sheritha,F,100,124,0,124
Caitilyn,F,100,5,0,5
Azury,F,100,5,0,5
Jemima,F,100,918,0,918
Izeck,M,100,0,16,16
Kahekili,M,100,0,22,22
Breuna,F,100,156,0,156
Zade,M,99,12,892,904
Rickie,M,92,1369,14899,16268
Brisha,F,100,83,0,83
Cherika,F,100,286,0,286
Kohlson,M,100,0,14,14
Karmelo,M,100,0,520,520
Mylie,F,100,1512,0,1512
Lindey,F,100,209,0,209
Indya,F,100,1346,0,1346
Serai,F,100,37,0,37
Legrande,M,100,0,25,25
Elliah,F,100,24,0,24
Latondra,F,100,174,0,174
Laquann,M,100,0,42,42
Tameka,F,100,12724,41,12765
Tyronza,F,95,108,6,114
Trevian,M,100,0,417,417
Miliano,M,100,0,38,38
Alyanah,F,100,88,0,88
Asael,M,100,0,1065,1065
Shamoni,F,100,30,0,30
Larmar,M,100,0,41,41
Yuridiana,F,100,103,0,103
Briseis,F,100,839,0,839
Rayfus,M,100,0,42,42
Dennia,F,100,20,0,20
Sharease,F,100,12,0,12
Amin,M,100,0,2446,2446
Eathyn,M,100,0,23,23
Birche,M,100,0,5,5
Zettie,F,97,153,5,158
Laylaa,F,100,83,0,83
Pixie,F,100,456,0,456
Maymunah,F,100,29,0,29
Jda,F,100,54,0,54
Danayshia,F,100,9,0,9
Jubilee,F,100,1569,6,1575
Ritter,M,100,0,53,53
Schmeka,F,100,10,0,10
Vionette,F,100,5,0,5
Jasmynne,F,100,37,0,37
Shalako,M,100,0,6,6
Tya,F,100,749,0,749
Warrenetta,F,100,6,0,6
Raghib,M,100,0,20,20
Giuseppi,M,100,0,7,7
Teuta,F,100,43,0,43
Sahrye,F,100,5,0,5
Tramond,M,100,0,67,67
Tanaja,F,100,276,0,276
Shasta,F,100,4198,15,4213
Towonda,F,100,11,0,11
Ashly,F,99,10746,122,10868
Julious,M,100,0,617,617
Nayara,F,100,173,0,173
Josealejandro,M,100,0,39,39
Racer,M,100,0,79,79
Verlia,F,100,8,0,8
Martina,F,100,13057,40,13097
Mary,F,100,1337729,4486,1342215
Khamren,M,100,0,45,45
Leta,F,100,3327,0,3327
Ewen,M,100,0,85,85
Maddilyn,F,100,607,0,607
Kearney,M,61,52,81,133
Halleigh,F,100,225,0,225
Kember,F,100,157,0,157
Addison,F,91,97466,10030,107496
Tieshia,F,100,192,0,192
Zekiah,M,63,82,141,223
Amaad,M,100,0,50,50
Temira,F,100,11,0,11
Karigan,F,100,272,0,272
Koltan,M,100,0,202,202
Pino,M,100,0,10,10
Dayany,F,100,35,0,35
Syndey,F,100,318,0,318
Kerisa,F,100,55,0,55
Trinite,F,100,11,0,11
Italee,F,100,19,0,19
Loui,M,100,0,59,59
Carri,F,100,3454,0,3454
Naftuli,M,100,0,349,349
Deisi,F,100,569,0,569
Xzaveon,M,100,0,40,40
Rolan,M,100,0,521,521
Nocona,M,65,6,11,17
Cheo,M,100,0,102,102
Rihab,F,100,5,0,5
Bethsheba,F,100,5,0,5
Nasere,M,100,0,10,10
Jildardo,M,100,0,15,15
Jovar,M,100,0,12,12
Corda,M,63,7,12,19
Chantee,F,100,291,0,291
Suzana,F,100,1099,0,1099
Jaylana,F,100,19,0,19
Nasheema,F,100,23,0,23
Arvester,M,100,0,12,12
Veola,F,100,218,0,218
Keyonta,M,68,102,219,321
Takiara,F,100,20,0,20
Amesha,F,100,323,0,323
Katasha,F,100,417,0,417
Derrike,M,100,0,55,55
Johnai,F,100,10,0,10
Febe,F,100,193,0,193
Jahaan,M,94,5,78,83
Moo,M,56,24,31,55
Basilia,F,100,81,0,81
Jaleaha,F,100,38,0,38
Skylair,F,100,10,0,10
Radhames,M,100,0,49,49
Yahani,F,100,5,0,5
Damonn,M,100,0,22,22
Ryel,M,71,6,15,21
Wassillie,M,100,0,8,8
Rayyaan,M,100,0,23,23
Khristina,F,100,1243,0,1243
Michaelynn,F,100,15,0,15
Jaaziel,M,98,5,291,296
Lisia,F,100,191,0,191
Dreyton,M,100,0,257,257
Krithi,F,100,131,0,131
Vester,M,92,46,504,550
Joanah,F,100,10,0,10
Kennady,F,100,1413,0,1413
Cristino,M,100,0,305,305
Pegeen,F,100,194,0,194
Cuauhtemoc,M,100,0,1051,1051
Takoya,F,100,105,0,105
Henson,M,100,0,191,191
Joretta,F,100,329,0,329
Jazarion,M,100,0,40,40
Martiza,F,100,293,0,293
Mailia,F,100,11,0,11
Tonta,F,100,8,0,8
Cherline,F,100,12,0,12
Mikenzy,F,100,38,0,38
Marylynn,F,100,1556,0,1556
Keyshia,F,100,253,0,253
Jonnika,F,100,10,0,10
Emaria,F,100,35,0,35
Abriah,F,100,30,0,30
Karnell,M,100,0,154,154
Eleri,F,100,149,0,149
Daijon,M,99,5,621,626
Nydasia,F,100,7,0,7
Caffey,F,100,5,0,5
Silence,F,100,9,0,9
Yalena,F,100,113,0,113
Kevork,M,100,0,82,82
Betzabet,F,100,29,0,29
Kymera,F,100,6,0,6
Irian,F,100,15,0,15
Lincey,F,100,11,0,11
Micale,M,71,6,15,21
Dobbie,M,69,5,11,16
Shamanique,F,100,5,0,5
Jonathaon,M,100,0,5,5
Amariona,F,100,195,0,195
Roseanna,F,100,4039,0,4039
Zabrian,M,100,0,12,12
Keneen,M,100,0,10,10
Bashar,M,100,0,290,290
Macin,M,100,0,58,58
Latefia,F,100,6,0,6
Deontee,M,100,0,6,6
Yewon,F,100,5,0,5
Tamiesha,F,100,17,0,17
Eyob,M,100,0,148,148
Meet,M,100,0,91,91
Peytyn,F,100,205,0,205
Picabo,F,100,5,0,5
Fatou,F,100,764,0,764
Allondra,F,100,40,0,40
Sehana,F,100,5,0,5
Dekeisha,F,100,40,0,40
Taneha,F,100,42,0,42
Kana,F,97,691,18,709
Lorimar,F,100,28,0,28
Briggitte,F,100,91,0,91
Senada,F,100,15,0,15
Lailaa,F,100,42,0,42
Cole,M,100,423,121434,121857
Elayiah,F,100,5,0,5
Niria,F,100,32,0,32
Douglas,M,100,1377,423158,424535
Amayrany,F,100,106,0,106
Neshelle,F,100,10,0,10
Latonga,F,100,128,0,128
Blakley,F,83,243,49,292
Marlette,F,100,233,0,233
Barbare,F,100,5,0,5
Aaria,F,100,157,0,157
Kory,M,92,1206,13768,14974
Judson,M,100,0,6941,6941
Shantania,F,100,10,0,10
Damyla,F,100,34,0,34
Delee,F,100,39,0,39
Taara,F,100,17,0,17
Tryniti,F,100,147,0,147
Ayal,M,100,0,30,30
Aala,F,100,64,0,64
Bethenia,F,100,5,0,5
Shamarion,M,98,5,266,271
Aianna,F,100,53,0,53
Oneill,M,100,0,50,50
Khaleedah,F,100,11,0,11
Kamarien,M,100,0,28,28
Sandrah,F,100,12,0,12
Brecklynn,F,100,83,0,83
Rigina,F,100,7,0,7
Emerald,F,98,5996,105,6101
Amahd,M,100,0,82,82
Kally,F,100,1249,5,1254
Luckas,M,100,0,33,33
Inaky,M,100,0,29,29
Dezarea,F,100,27,0,27
Svannah,F,100,12,0,12
Cristo,M,100,0,1020,1020
Julisia,F,100,41,0,41
Trishanna,F,100,15,0,15
Suzi,F,100,1079,0,1079
Generoso,M,100,0,17,17
Xinia,F,100,6,0,6
Jaylannie,F,100,28,0,28
Bartlett,M,100,0,279,279
Josann,F,100,10,0,10
Borach,M,100,0,15,15
Olisha,F,100,25,0,25
Lacreasha,F,100,122,0,122
Normajean,F,100,170,0,170
Rohman,M,100,0,5,5
Berg,M,100,0,6,6
Mecca,F,93,1833,148,1981
Gaetana,F,100,186,0,186
Niaira,F,100,5,0,5
Gust,M,100,0,276,276
Amariae,M,100,0,5,5
Nikayla,F,100,1099,0,1099
Pranaya,F,100,22,0,22
Jemale,M,100,0,24,24
Jaliayah,F,100,17,0,17
Annalyssa,F,100,252,0,252
Jaunte,M,100,0,5,5
Breniyah,F,100,109,0,109
Niley,F,100,47,0,47
Galit,F,100,107,0,107
Gurveer,M,100,0,113,113
Dalton,M,100,363,72272,72635
Lavontay,M,100,0,98,98
Deamonte,M,100,0,154,154
Aalyia,F,100,5,0,5
Koda,M,91,144,1544,1688
Jetziel,M,100,0,8,8
Zamaree,M,100,0,10,10
Sawan,M,100,0,6,6
Cullin,M,100,0,359,359
Jabar,M,100,0,420,420
Javas,M,100,0,16,16
Akeam,M,100,0,5,5
Dalee,F,100,11,0,11
Amisadai,F,96,121,5,126
Micole,F,100,577,0,577
Glendalee,F,100,5,0,5
Archer,M,98,90,5434,5524
Dalani,F,100,136,0,136
Rauri,F,100,12,0,12
Zawdie,M,100,0,5,5
Cazzie,M,100,0,17,17
Avenir,M,100,0,164,164
Kaylanii,F,100,7,0,7
Mania,F,100,18,0,18
Lusia,F,100,209,0,209
Tikeisha,F,100,21,0,21
Ayline,F,100,307,0,307
Lewis,M,99,314,52991,53305
Awesome,M,100,0,27,27
Sherriel,F,100,20,0,20
Taunia,F,100,264,0,264
Nocole,F,100,176,0,176
Corrinne,F,100,1125,0,1125
Kailiyah,F,100,37,0,37
Baseemah,F,100,28,0,28
Tamario,M,100,0,93,93
Caral,F,100,23,0,23
Bernetha,F,100,95,0,95
Emmet,M,100,0,2539,2539
Junko,F,100,105,0,105
Darlita,F,100,5,0,5
Caitie,F,100,28,0,28
Lazarion,M,100,0,6,6
Hammad,M,100,0,336,336
Jonothan,M,100,0,877,877
Brinklee,F,100,105,0,105
Zakiya,F,100,2854,0,2854
Debbi,F,100,2880,0,2880
Malikye,M,100,0,242,242
Kallen,M,82,269,1239,1508
Estanislao,M,100,0,137,137
Markeitha,F,100,29,0,29
Imberly,F,100,74,0,74
Daizha,F,100,170,0,170
Dekhari,M,100,0,26,26
Bernal,M,100,0,26,26
Souriya,M,100,0,6,6
Elene,F,100,465,0,465
Jainaba,F,100,21,0,21
Ziel,M,52,12,13,25
Eriella,F,100,11,0,11
Laquella,F,100,6,0,6
Dianara,F,100,72,0,72
Juleana,F,100,24,0,24
Deidre,F,100,14035,11,14046
Fread,M,100,0,5,5
Odetta,F,100,227,0,227
Brezhane,F,100,6,0,6
Sukhdeep,M,79,10,37,47
Wilem,M,100,0,5,5
Lonna,F,100,2450,0,2450
Emonni,F,100,83,0,83
Riliegh,F,100,7,0,7
Yerick,M,100,0,124,124
Clester,M,100,0,10,10
Arihan,M,100,0,18,18
Lelar,F,100,16,0,16
Brandonn,M,100,0,122,122
Bania,F,100,32,0,32
Andrella,F,100,35,0,35
Nance,F,100,323,0,323
Neci,F,100,8,0,8
Sterling,M,91,1908,19769,21677
Dennisha,F,100,252,0,252
Bix,M,100,0,16,16
Shelbee,F,100,572,0,572
Dotsy,F,100,8,0,8
Yuze,M,100,0,6,6
Cyion,M,100,0,6,6
Janada,F,100,6,0,6
Zyniya,F,100,22,0,22
Tahjmir,M,100,0,11,11
Danien,M,100,0,15,15
Shaneil,F,100,175,0,175
Chaniqua,F,100,197,0,197
Mahadev,M,100,0,5,5
Diasy,F,100,24,0,24
Rosaire,M,100,0,5,5
Stamatia,F,100,86,0,86
Angeleta,F,100,13,0,13
Rayanthony,M,100,0,36,36
Thommas,M,100,0,12,12
Labron,M,100,0,395,395
Sarahbeth,F,100,204,0,204
Crystol,F,100,208,0,208
Cayne,M,100,0,254,254
Djibril,M,100,0,190,190
Zivon,M,100,0,10,10
Kaidenn,M,100,0,5,5
Lorria,F,100,16,0,16
Nafeesah,F,100,201,0,201
Semira,F,100,360,0,360
Maleiyah,F,100,58,0,58
Melvinia,F,100,83,0,83
Cheree,F,100,2018,0,2018
Daylan,M,96,84,2056,2140
Juriana,F,100,5,0,5
Nakeema,F,100,49,0,49
Latony,M,100,0,11,11
Myresha,F,100,17,0,17
Armend,M,100,0,58,58
Melecio,M,100,0,341,341
Angelin,F,100,489,0,489
Labradford,M,100,0,81,81
Britley,F,100,136,0,136
Jurlean,F,100,5,0,5
Tahliyah,F,100,62,0,62
Laure,F,100,1549,0,1549
Pratham,M,100,0,311,311
Kamyla,F,100,482,0,482
Georgine,F,100,958,0,958
Salise,F,100,6,0,6
Aleph,M,100,0,40,40
Anvika,F,100,105,0,105
Phaedra,F,100,1644,0,1644
Lyvette,F,100,7,0,7
Trishia,F,100,701,0,701
Sarahanne,F,100,262,0,262
Citlaly,F,100,2409,0,2409
Kellye,F,100,2347,0,2347
Atrayu,M,100,0,27,27
Fritzie,F,100,25,0,25
Eriyana,F,100,156,0,156
Anida,F,100,82,0,82
Ebonye,F,100,106,0,106
Covy,M,100,0,5,5
Hasim,M,100,0,11,11
Saly,F,100,30,0,30
Kayden,M,84,6552,33773,40325
Levita,F,100,183,0,183
Quovadis,F,100,16,0,16
Admire,F,100,51,0,51
Toshiki,M,100,0,5,5
Shameeka,F,100,936,0,936
Decima,F,100,5,0,5
Uraina,F,100,35,0,35
Marynell,F,100,43,0,43
Antionne,M,100,0,222,222
Arielmarie,F,100,7,0,7
Zyaire,M,78,432,1573,2005
Guilianna,F,100,150,0,150
Ellyn,F,100,2762,0,2762
Verlene,F,100,612,0,612
Youseph,M,100,0,6,6
Ulus,M,100,0,15,15
Kelci,F,100,2290,0,2290
Zakarian,M,100,0,10,10
Josheua,M,100,0,6,6
Kadi,F,100,880,0,880
Annaliesa,F,100,79,0,79
Jazzma,F,100,57,0,57
Cape,M,100,0,6,6
Tianna,F,100,11975,0,11975
Kambrie,F,100,604,0,604
Sharonann,F,100,28,0,28
Juliea,F,100,40,0,40
Tyreise,M,100,0,7,7
Spyros,M,100,0,102,102
Jeovana,F,100,11,0,11
Tayesha,F,100,5,0,5
Kilyn,F,91,113,11,124
Jahel,M,96,5,119,124
Allory,F,100,15,0,15
Morrighan,F,100,37,0,37
Maquetta,F,100,5,0,5
Lizeht,F,100,5,0,5
Marlaina,F,100,1280,0,1280
Jaceon,M,100,0,365,365
Jazemine,F,100,10,0,10
Dalanna,F,100,15,0,15
Allisa,F,100,1329,0,1329
Roberson,M,100,0,13,13
Kerron,M,100,0,224,224
Andols,M,100,0,5,5
Gwennyth,F,100,48,0,48
Narine,F,100,48,0,48
Taydon,M,100,0,72,72
Kmauri,M,100,0,5,5
Duvid,M,100,0,126,126
Avonlea,F,100,648,0,648
Jyasia,F,100,91,0,91
Dynetta,F,100,22,0,22
Daxx,M,100,0,130,130
Medrick,M,100,0,17,17
Hariklia,F,100,21,0,21
Lavenia,F,100,568,0,568
Caedance,F,100,27,0,27
Venita,F,100,3324,0,3324
Tay,M,75,50,147,197
Ojay,M,100,0,19,19
Wakia,F,100,6,0,6
Tondalaya,F,100,184,0,184
Jandiel,M,100,0,97,97
Najaah,F,100,10,0,10
Meshia,F,100,216,0,216
Carlyssa,F,100,33,0,33
Khelsey,F,100,25,0,25
Bettey,F,100,11,0,11
Johney,M,100,0,485,485
Geoffory,M,100,0,6,6
Zendra,F,100,20,0,20
Tempy,F,100,5,0,5
Salmah,F,100,30,0,30
Teiara,F,100,121,0,121
Gi,F,100,5,0,5
Mcclellan,M,100,0,17,17
Chrisandra,F,100,277,0,277
Alaya,F,100,3524,0,3524
Kathelene,F,100,40,0,40
Jenevive,F,100,5,0,5
Jaryah,F,100,77,0,77
Prapti,F,100,34,0,34
Falone,F,100,6,0,6
Jasan,M,100,0,193,193
Dhatri,F,100,12,0,12
Jozlin,F,100,72,0,72
Kortnie,F,100,760,0,760
Mishea,F,100,6,0,6
Jyhiem,M,100,0,5,5
Hassanatou,F,100,11,0,11
Lakerria,F,100,41,0,41
Evelena,F,100,255,0,255
Thomasa,F,100,271,0,271
Carleta,F,100,85,0,85
Yuki,F,63,749,437,1186
Taylene,F,100,5,0,5
Ciella,F,100,37,0,37
Rida,F,95,742,43,785
Nunzio,M,100,0,456,456
Drayvin,M,100,0,46,46
Keaston,M,100,0,177,177
Sariana,F,100,54,0,54
Annetta,F,100,3676,0,3676
Vrunda,F,100,6,0,6
Clinique,F,100,41,0,41
Tailon,M,100,0,5,5
Lilybeth,F,100,349,0,349
Jhonathan,M,100,0,773,773
Elliyah,F,100,98,0,98
Zayuri,F,100,46,0,46
Ka,F,86,781,131,912
Mitzie,F,100,1174,0,1174
Cassendra,F,100,7,0,7
Windsor,M,61,137,210,347
Amazing,F,100,102,0,102
Brittian,M,75,26,78,104
Elayah,F,100,112,0,112
Tranisha,F,100,189,0,189
Linly,F,100,5,0,5
Jayleen,F,97,7327,192,7519
Nadeen,F,100,1016,0,1016
Tyneal,F,100,5,0,5
Eriana,F,100,913,0,913
Valleri,F,100,76,0,76
Lettica,F,100,15,0,15
Merryn,F,100,102,0,102
Elliot,M,92,2547,29321,31868
Charlyze,F,100,34,0,34
Peyson,F,58,83,59,142
Shekeria,F,100,38,0,38
Abrahan,M,100,0,908,908
Noralee,F,100,132,0,132
Antorria,F,100,5,0,5
Neidi,F,100,10,0,10
Ayse,F,100,400,0,400
Koffi,M,100,0,10,10
Hamdaan,M,100,0,10,10
Miyani,F,100,58,0,58
Stephanye,F,100,175,0,175
Tasiya,F,100,8,0,8
Alrick,M,100,0,122,122
Brynja,F,100,91,0,91
Glennell,F,100,5,0,5
Jarvous,M,100,0,7,7
Suraiyah,F,100,5,0,5
Annasha,F,100,5,0,5
Sameer,M,100,0,2690,2690
Jayseon,M,100,0,39,39
Devun,M,100,0,69,69
Jaleel,M,99,24,3897,3921
Lanyra,F,100,5,0,5
Marlo,F,72,6027,2399,8426
Helane,F,100,124,0,124
Ataya,F,100,88,0,88
Mariahlynn,F,100,6,0,6
Britthany,F,100,22,0,22
Sedale,M,100,0,108,108
Desyre,F,100,120,0,120
Beanna,F,100,23,0,23
Jeneca,F,100,18,0,18
Gwenith,F,100,144,0,144
Keshanda,F,100,27,0,27
Mackensie,F,99,841,5,846
Mackenley,F,100,5,0,5
Britannica,F,100,20,0,20
Tamiika,F,100,5,0,5
Naleia,F,100,15,0,15
Vanshika,F,100,191,0,191
Chauna,F,100,248,0,248
Tamesa,F,100,24,0,24
Aniket,M,100,0,267,267
Tanasia,F,100,1199,0,1199
Tzipora,F,100,813,0,813
Sarahmarie,F,100,176,0,176
Juandavid,M,100,0,153,153
Chananya,M,100,0,71,71
Annalyss,F,100,5,0,5
Alyla,F,100,82,0,82
Elenor,F,100,408,0,408
Antawan,M,100,0,198,198
Issabelle,F,100,170,0,170
Rovenia,F,100,10,0,10
Addsion,F,100,5,0,5
Jonathna,M,100,0,5,5
Maurece,M,100,0,5,5
Kru,M,100,0,83,83
Aaditri,F,100,26,0,26
Vishrut,M,100,0,10,10
Jasire,M,100,0,40,40
Rickford,M,100,0,18,18
Lamell,M,100,0,42,42
Rakita,F,100,42,0,42
Trevun,M,100,0,5,5
Laureana,F,100,10,0,10
Dontez,M,100,0,907,907
Cristal,F,100,15145,55,15200
Deidria,F,100,18,0,18
Mykaela,F,100,1019,0,1019
Tasheyana,F,100,5,0,5
Sophie,F,100,61913,43,61956
Ranzino,M,100,0,5,5
Shakeera,F,100,154,0,154
Madie,F,100,311,0,311
Zachry,M,100,0,946,946
Anaveah,F,100,19,0,19
Brishawn,M,100,0,11,11
Dieynaba,F,100,13,0,13
Ephrata,F,100,35,0,35
Winni,F,100,103,0,103
Joletta,F,100,205,0,205
Shariya,F,100,289,0,289
Dishaun,M,100,0,5,5
Gerid,M,100,0,11,11
Adayah,F,100,123,0,123
Ryosuke,M,100,0,125,125
Zephaniah,M,88,254,1872,2126
Joniah,F,100,112,0,112
Cyrell,M,100,0,10,10
Anntonette,F,100,92,0,92
Lyall,M,100,0,63,63
Tsering,F,76,72,23,95
Ceandre,M,100,0,5,5
Jayger,M,100,0,23,23
Kemberley,F,100,39,0,39
Shemara,F,100,5,0,5
Cruz,M,90,1924,16673,18597
Adelayde,F,100,38,0,38
Kashes,M,100,0,5,5
Kennethia,F,100,230,0,230
Maliza,F,100,11,0,11
Clorissa,F,100,402,0,402
Yudany,F,100,28,0,28
Stefanee,F,100,203,0,203
Alaire,F,100,23,0,23
Dzyre,F,100,55,0,55
Kayela,F,100,345,0,345
Anaria,F,100,219,0,219
Illia,F,100,5,0,5
Ellouise,F,100,95,0,95
Zkye,M,100,0,5,5
Dayana,F,100,9712,0,9712
Ericca,F,100,580,0,580
Malav,M,100,0,5,5
Alecea,F,100,124,0,124
Chesley,M,62,563,922,1485
Kierney,F,100,35,0,35
Barnetta,F,100,30,0,30
Chayah,F,100,73,0,73
Denorris,M,100,0,201,201
Kshaun,M,100,0,34,34
Kealohilani,F,100,88,0,88
Sofian,M,100,0,52,52
Emmitte,M,100,0,10,10
Tornell,M,100,0,5,5
Correna,F,100,309,0,309
Xuan,F,93,230,17,247
Janisia,F,100,5,0,5
Elenore,F,100,226,0,226
Arabia,F,100,305,0,305
Leverette,M,100,0,5,5
Samika,F,100,279,0,279
Umeki,F,100,17,0,17
Kendrianna,F,100,28,0,28
Dreona,F,100,10,0,10
Uziah,M,100,0,93,93
Shirrell,F,100,68,0,68
Tokala,M,100,0,5,5
Mckinsie,F,100,16,0,16
Drewcilla,F,100,20,0,20
Alexiss,F,96,528,20,548
Shanye,F,100,5,0,5
Tonyua,F,100,6,0,6
Antria,F,100,8,0,8
Roneil,M,100,0,5,5
Tilmon,M,100,0,122,122
Reylene,F,100,100,0,100
Zhyier,M,100,0,5,5
Laryiah,F,100,30,0,30
Nakeba,F,100,20,0,20
Liliane,F,100,492,0,492
Stanesha,F,100,10,0,10
Lenise,F,100,813,0,813
Jimena,F,100,9746,8,9754
Atwood,M,100,0,35,35
Damitrius,M,100,0,6,6
Dayqwan,M,100,0,5,5
Rus,F,58,15,11,26
Labreya,F,100,5,0,5
Durane,M,100,0,6,6
Jenean,F,100,683,0,683
Lisete,F,100,8,0,8
Sumaiyah,F,100,269,0,269
Khandis,F,100,5,0,5
Shivonne,F,100,117,0,117
Machaela,F,100,419,0,419
Nelsi,F,100,20,0,20
Moayed,M,100,0,7,7
Kimona,F,100,11,0,11
Sook,F,100,6,0,6
Juarez,M,100,0,27,27
Kasadie,F,100,5,0,5
Issaic,M,100,0,77,77
Garrus,M,100,0,24,24
Sam,M,99,578,41017,41595
Iyaad,M,100,0,11,11
Kapree,F,100,45,0,45
Daxia,F,100,6,0,6
Montico,M,100,0,5,5
Makynze,F,100,40,0,40
Maite,F,100,2565,0,2565
Jedadiah,M,100,0,515,515
Yvonna,F,100,824,0,824
Briasia,F,100,570,0,570
Nadalia,F,100,5,0,5
Tameyah,F,100,76,0,76
Gaines,M,100,0,583,583
Zerlina,F,100,58,0,58
Emiliann,F,100,5,0,5
Kourtnee,F,100,633,0,633
Quantay,M,100,0,71,71
Griselle,F,100,373,0,373
Relonda,F,100,11,0,11
Anat,F,100,50,0,50
Taneesha,F,100,525,0,525
Dailani,F,100,8,0,8
Isidor,M,100,0,39,39
Sibi,M,100,0,5,5
Montavia,F,100,53,0,53
Nasif,M,100,0,57,57
Kvion,M,100,0,78,78
Kala,F,99,7421,92,7513
Attiya,F,100,10,0,10
Zeola,F,100,42,0,42
Yaned,F,100,5,0,5
Delshawn,M,100,0,307,307
Rivaldo,M,100,0,215,215
Michealene,F,100,5,0,5
Gabrael,M,100,0,46,46
Yandiel,M,100,0,201,201
Llanet,F,100,5,0,5
Erique,M,100,0,259,259
Christopheranth,M,100,0,6,6
Doak,M,100,0,153,153
Retia,F,100,55,0,55
Sophya,F,100,422,0,422
Rooke,M,100,0,7,7
Anastin,F,100,20,0,20
Tawyna,F,100,100,0,100
Donicio,M,100,0,11,11
Tapasya,F,100,5,0,5
Bartek,M,100,0,59,59
Delray,M,100,0,396,396
Brittnea,F,100,38,0,38
Nylasia,F,100,53,0,53
Marge,F,100,710,0,710
Agigail,F,100,21,0,21
Marideth,F,100,11,0,11
Ares,M,97,39,1452,1491
Lysbeth,F,100,51,0,51
Shemuel,M,100,0,66,66
Akinola,M,100,0,15,15
Andrenique,F,100,12,0,12
Alaze,F,100,84,0,84
Yulianna,F,100,951,0,951
Raiyne,F,100,12,0,12
Keyra,F,100,741,0,741
Noya,F,100,145,0,145
Iliani,F,100,42,0,42
Peria,F,100,5,0,5
Kashawna,F,100,200,0,200
Maysam,F,100,28,0,28
Hardik,M,100,0,24,24
Fruma,F,100,128,0,128
Keeyon,M,100,0,83,83
Afif,M,100,0,10,10
Shakeen,M,100,0,10,10
Rockland,M,100,0,133,133
Ivett,F,100,620,0,620
Nileah,F,100,6,0,6
Laprecious,F,100,208,0,208
Severino,M,100,0,131,131
Latricha,F,100,14,0,14
Crysal,F,100,38,0,38
Ladaysia,F,100,5,0,5
Tywanda,F,100,547,0,547
Franki,F,92,853,73,926
Hillard,M,100,0,475,475
Dinise,F,100,5,0,5
Jayvonne,M,100,0,36,36
Naoh,M,100,0,7,7
Domenick,M,100,0,2647,2647
Talaja,F,100,9,0,9
Lindie,F,100,370,0,370
Sisley,F,100,6,0,6
Shawndell,M,64,146,258,404
Keyshana,F,100,5,0,5
Zaafir,M,100,0,5,5
Marcius,M,100,0,14,14
Makahla,F,100,107,0,107
Eliran,M,100,0,29,29
Lorry,F,90,957,106,1063
Rhet,M,100,0,140,140
Avaley,F,100,31,0,31
Ahja,F,100,107,0,107
Armahn,M,100,0,34,34
Kongcheng,M,100,0,18,18
Fairen,F,100,13,0,13
Whitleigh,F,100,59,0,59
Gautam,M,100,0,574,574
Elleny,F,100,5,0,5
Kirstopher,M,100,0,6,6
Zakai,M,99,5,779,784
Chares,M,100,0,53,53
Muzette,F,100,10,0,10
Barrick,M,100,0,22,22
Kaydince,F,100,310,0,310
Ryiah,F,100,40,0,40
Empriss,F,100,32,0,32
Allie,F,98,27547,638,28185
Geradette,F,100,16,0,16
Saleha,F,100,85,0,85
Jazlen,F,100,79,0,79
Devani,F,100,310,0,310
Roswell,M,100,0,295,295
Jaiheem,M,100,0,5,5
Naobi,F,100,5,0,5
Sherrell,F,95,2430,120,2550
Quantavia,F,100,78,0,78
Marcusanthony,M,100,0,11,11
Marrianne,F,100,231,0,231
Mandria,F,100,19,0,19
Charyn,F,100,31,0,31
Exiquio,M,100,0,10,10
Cary,M,81,4545,19373,23918
Myka,F,89,2031,256,2287
Dymphna,F,100,93,0,93
Emiley,F,100,1625,0,1625
Takiyla,F,100,5,0,5
Kin,M,97,6,225,231
Kaulana,M,96,6,132,138
Emmalei,F,100,42,0,42
Prerna,F,100,73,0,73
Breeleigh,F,100,18,0,18
Lenus,M,100,0,5,5
Zacheriah,M,100,0,598,598
Cytlalli,F,100,5,0,5
Izac,M,100,0,643,643
Aleyssa,F,100,8,0,8
Porchae,F,100,7,0,7
Nilene,F,100,5,0,5
Solveig,F,100,398,0,398
Deatta,F,100,5,0,5
Aeleen,F,100,15,0,15
Austinjohn,M,100,0,11,11
Yarissa,F,100,183,0,183
Brielle,F,100,22283,0,22283
Meleni,F,100,86,0,86
Tionnie,F,100,34,0,34
Ryanchristian,M,100,0,5,5
Alyssum,F,100,15,0,15
Lilyen,F,100,40,0,40
Lanoris,M,100,0,7,7
Trevious,M,100,0,81,81
Zenai,F,100,10,0,10
Mickel,M,97,47,1689,1736
Roddrick,M,100,0,822,822
Katya,F,100,2569,0,2569
Shikha,F,100,252,0,252
Yovana,F,100,455,0,455
Khailil,M,100,0,10,10
Earlina,F,100,6,0,6
Ceria,F,100,104,0,104
Nequan,M,100,0,34,34
Gailon,M,100,0,5,5
Miangel,F,100,667,0,667
Marytza,F,100,93,0,93
Rupert,M,100,0,1517,1517
Brittanie,F,100,4716,0,4716
Tannie,F,92,69,6,75
Seba,F,100,54,0,54
Levii,M,100,0,58,58
Zev,M,100,0,2700,2700
Ayondela,F,100,5,0,5
Traivon,M,100,0,240,240
Masiya,F,92,59,5,64
Sherren,F,100,20,0,20
Malak,F,95,2324,133,2457
Ikeya,F,100,102,0,102
Fender,M,100,0,39,39
Lanease,F,100,7,0,7
Daekwan,M,100,0,5,5
Lesli,F,100,5577,0,5577
Marquitte,F,100,6,0,6
Demariyon,M,100,0,17,17
Nickalos,M,100,0,265,265
Ronta,M,100,0,12,12
Julana,F,100,28,0,28
Chelse,F,100,838,0,838
Siaka,M,100,0,11,11
Ginine,F,100,6,0,6
Mytchell,M,100,0,5,5
Octavion,M,100,0,167,167
Tyven,M,100,0,13,13
Tyrell,M,99,145,14653,14798
Lisanne,F,100,408,0,408
Lev,M,99,13,935,948
Drenna,F,100,16,0,16
Katelen,F,100,221,0,221
Algia,M,100,0,5,5
Berrett,M,100,0,6,6
Heidimarie,F,100,5,0,5
Hilmer,M,100,0,5,5
Cyerra,F,100,296,0,296
Jamayra,F,100,27,0,27
Caliee,F,100,5,0,5
Taylur,F,100,17,0,17
Latric,F,100,5,0,5
Chrysanthe,F,100,10,0,10
Eashan,M,100,0,167,167
Alisyn,F,100,607,0,607
Batsheva,F,100,1276,0,1276
Azhar,M,71,68,167,235
Lakayla,F,100,1236,0,1236
Latashi,F,100,6,0,6
Kadelyn,F,100,62,0,62
Neika,F,100,51,0,51
Alveda,F,100,32,0,32
Haris,M,100,0,1163,1163
Tashaye,F,100,11,0,11
Zahmari,M,100,0,30,30
Malanni,F,100,10,0,10
Dilver,M,100,0,5,5
Monaye,F,100,65,0,65
Najeeb,M,100,0,210,210
Aminna,F,100,5,0,5
Camillemarie,F,100,5,0,5
Jacelynn,F,100,535,0,535
Korilyn,F,100,5,0,5
Adharsh,M,100,0,16,16
Arcenia,F,100,21,0,21
Nickea,F,100,19,0,19
Raydin,M,100,0,75,75
Yolander,F,100,269,0,269
Janeeka,F,100,22,0,22
Lexany,F,100,66,0,66
Damyia,F,100,139,0,139
Vesper,F,100,213,0,213
Doral,M,71,36,88,124
Jowharah,F,100,5,0,5
Arne,M,100,0,1238,1238
Alexanne,F,100,32,0,32
Ifetayo,F,100,19,0,19
Kaleeya,F,100,56,0,56
Besart,M,100,0,10,10
Cristopher,M,100,0,10193,10193
Jobeth,F,100,478,0,478
Rasmine,F,100,5,0,5
Henrique,M,100,0,401,401
Kimbel,M,100,0,11,11
Shinika,F,100,167,0,167
Deserey,F,100,28,0,28
Paidyn,F,100,32,0,32
Nadean,F,100,446,0,446
Shakyla,F,100,353,0,353
Hassanah,F,100,12,0,12
Teddie,M,55,534,653,1187
Jcyon,M,100,0,11,11
Rajuan,M,100,0,20,20
Cassell,M,100,0,35,35
Gaylynne,F,100,6,0,6
Noemi,F,100,17892,69,17961
Mazon,M,100,0,10,10
Bersain,M,100,0,7,7
Cristela,F,100,551,0,551
Zayen,M,100,0,19,19
Zyniah,F,100,153,0,153
Tytan,M,100,0,541,541
Treniti,F,100,38,0,38
Aubriona,F,100,33,0,33
Suchir,M,100,0,55,55
Kylianne,F,100,41,0,41
Brennyn,F,52,128,118,246
Leather,F,100,36,0,36
Ang,M,100,0,6,6
Shavera,F,100,5,0,5
Zaydee,F,100,128,0,128
Karene,F,100,344,0,344
Ambriah,F,100,29,0,29
Kalyna,F,100,159,0,159
Dijuan,M,100,0,66,66
Kerah,F,100,187,0,187
Elester,M,100,0,108,108
Nahum,M,100,0,1521,1521
Cynthiaa,F,100,5,0,5
Shaneal,F,100,62,0,62
Trooper,M,100,0,64,64
Sheikh,M,96,10,256,266
Tylis,M,100,0,5,5
Linnea,F,100,6605,0,6605
Mariarosa,F,100,11,0,11
Kaisin,M,100,0,5,5
Kleigh,F,100,252,0,252
Dack,M,100,0,50,50
Koalton,M,100,0,6,6
Leeandre,M,100,0,56,56
Chezaray,M,100,0,5,5
Devanti,M,100,0,5,5
Abdullatif,M,100,0,28,28
Reylynn,F,100,31,0,31
Dilayla,F,100,16,0,16
Bang,M,100,0,5,5
Dabin,M,100,0,5,5
Katerine,F,100,838,0,838
Mikisha,F,100,101,0,101
Anhad,M,100,0,24,24
Shamra,F,100,202,0,202
Jhanelle,F,100,16,0,16
Phallen,F,100,5,0,5
Peretz,M,100,0,41,41
Whittaker,M,100,0,90,90
Quontavious,M,100,0,20,20
Nikoloz,M,100,0,52,52
Velta,F,100,163,0,163
Kimberlin,F,100,1033,0,1033
Naylie,F,100,5,0,5
Keilon,M,100,0,193,193
Marguerit,F,100,7,0,7
Sharail,F,100,5,0,5
Jancey,F,100,10,0,10
Nahin,M,100,0,12,12
Jamarrie,M,100,0,37,37
Felicia,F,100,86129,279,86408
Nannetta,F,100,17,0,17
Albi,M,100,0,91,91
Trevohn,M,100,0,16,16
Arnie,M,99,16,1089,1105
Jadyne,F,54,26,22,48
Shinji,M,100,0,28,28
Issam,M,100,0,126,126
Jesie,F,60,32,21,53
Nashiya,F,100,83,0,83
Jakendrick,M,100,0,31,31
Surrey,F,100,10,0,10
Anvesha,F,100,17,0,17
Lathomas,M,100,0,5,5
Julitta,F,100,5,0,5
Sharold,F,100,6,0,6
Jaiylah,F,100,16,0,16
Ibraheem,M,100,0,991,991
Lenah,F,100,120,0,120
Jniah,F,100,29,0,29
Elethia,F,100,10,0,10
Somiyah,F,100,19,0,19
Willies,M,100,0,5,5
Jevaeh,F,100,68,0,68
Eniola,F,87,169,25,194
Evonny,F,100,17,0,17
Sundeep,M,98,5,248,253
Taraneh,F,100,110,0,110
Pake,M,100,0,46,46
Nantambu,M,100,0,6,6
Audley,M,100,0,195,195
Andriy,M,100,0,128,128
Maleyna,F,100,35,0,35
Alichia,F,100,151,0,151
Benhamin,M,100,0,18,18
Yassin,M,98,13,633,646
Margretta,F,100,254,0,254
Duwaine,M,100,0,10,10
Yusof,M,100,0,6,6
Brogan,M,82,714,3269,3983
Leonna,F,100,1000,0,1000
Chukwuma,M,100,0,173,173
Windle,M,100,0,79,79
Venora,F,100,42,0,42
Melisa,F,100,18435,10,18445
Tylea,F,100,184,0,184
Raychele,F,100,10,0,10
Zam,M,100,0,11,11
Ronnella,F,100,5,0,5
Santario,M,100,0,20,20
Adrika,F,100,7,0,7
Deunta,M,100,0,136,136
Daemyn,M,100,0,104,104
Felishia,F,100,331,0,331
Makynzie,F,100,599,0,599
Chaston,M,100,0,469,469
Chase,M,98,3265,144564,147829
Tysean,M,100,0,893,893
Eleno,M,100,0,279,279
Jasmina,F,100,922,0,922
Jaharie,M,100,0,20,20
Aleyza,F,100,40,0,40
Kyeon,M,100,0,21,21
Jayline,F,99,713,5,718
Gunnison,M,100,0,49,49
Camorra,F,100,6,0,6
Kemiya,F,100,246,0,246
Oval,M,100,0,11,11
Ahmira,F,100,67,0,67
Orbelin,M,100,0,10,10
Constantine,M,99,26,3418,3444
Aynsley,F,100,373,0,373
Daliyah,F,100,651,0,651
Unica,F,100,37,0,37
Josely,F,100,60,0,60
Ninive,F,100,29,0,29
Kachina,F,100,296,0,296
Linh,F,87,1369,213,1582
Aryella,F,100,104,0,104
Katen,F,100,48,0,48
Zimere,M,100,0,62,62
Adalid,M,90,11,99,110
Jaliene,F,100,6,0,6
Lindsi,F,100,776,0,776
Cacee,F,100,29,0,29
Chelia,F,100,12,0,12
Raffael,M,100,0,50,50
Jadae,F,100,167,0,167
Jaylann,F,100,11,0,11
Anella,F,100,159,0,159
Shanee,F,100,1503,0,1503
Quanterius,M,100,0,15,15
Vennis,M,100,0,5,5
Taiah,F,100,34,0,34
Naraya,F,100,64,0,64
Lovann,F,100,8,0,8
Kameil,F,100,11,0,11
Alcina,F,100,5,0,5
Cind,F,100,5,0,5
Kristal,F,100,11834,0,11834
Bessie,F,100,11109,10,11119
Azareyah,F,100,6,0,6
Chudney,F,94,76,5,81
Shanyn,F,100,262,0,262
Sharlet,F,100,447,0,447
Fallen,F,100,64,0,64
Michaellee,M,100,0,21,21
Matrix,M,100,0,47,47
Chela,F,100,474,0,474
Carmesia,F,100,5,0,5
Minda,F,100,1137,0,1137
Dnya,F,100,70,0,70
Jozzlynn,F,100,17,0,17
Deepti,F,100,148,0,148
Brittani,F,100,11685,22,11707
Shylyn,F,100,60,0,60
Adriano,M,100,0,1833,1833
Lavarus,M,100,0,20,20
Antuan,M,100,0,1236,1236
Kristyle,F,100,15,0,15
Markeas,M,100,0,5,5
Chaitra,F,100,90,0,90
Kaleigha,F,100,558,0,558
Maylasia,F,100,21,0,21
Kadeeja,F,100,48,0,48
Selinna,F,100,11,0,11
Stas,M,100,0,14,14
Madisen,F,100,4782,0,4782
Kamarin,F,100,21,0,21
Bobbijo,F,100,1230,0,1230
Kaeleah,F,100,7,0,7
Tommas,M,100,0,47,47
Yailine,F,100,72,0,72
Halana,F,100,142,0,142
Ivyonna,F,100,262,0,262
Chanceler,M,100,0,128,128
Yael,F,54,3044,2604,5648
Simaya,F,100,147,0,147
Zamorion,M,100,0,6,6
Girolamo,M,100,0,47,47
Michaia,F,100,5,0,5
Ismet,M,100,0,10,10
Ranita,F,100,450,0,450
Narcissa,F,100,32,0,32
Faraday,F,100,15,0,15
Lamontray,M,100,0,5,5
Keng,M,100,0,429,429
Whitnei,F,100,31,0,31
Rahab,F,100,15,0,15
Ajahni,M,100,0,72,72
Cairon,M,100,0,28,28
Mekhya,F,100,11,0,11
Makinleigh,F,100,28,0,28
Colburn,M,100,0,130,130
Davarus,M,100,0,5,5
Jasheem,M,100,0,10,10
Jeyden,M,100,0,289,289
Eavan,F,96,147,6,153
Kelvon,M,100,0,298,298
Zyren,M,100,0,84,84
Aubreeanna,F,100,20,0,20
Dalis,F,98,215,5,220
Juanito,M,100,0,902,902
Aprile,F,100,476,0,476
Dennielle,F,100,20,0,20
Yates,M,100,0,151,151
Helana,F,100,495,0,495
Chadarius,M,100,0,6,6
Lorrine,F,100,398,0,398
Alexeus,F,100,5,0,5
Maridel,F,100,7,0,7
Joaquin,M,100,53,22567,22620
Hamir,M,100,0,18,18
Malk,F,100,9,0,9
Yesemia,F,100,14,0,14
Che,M,84,363,1932,2295
Azmeer,M,100,0,5,5
Magnolia,F,100,3077,0,3077
Sharnel,F,100,31,0,31
Devonae,F,100,5,0,5
Valda,F,100,673,0,673
Kwamaine,M,100,0,135,135
Bayliegh,F,100,5,0,5
Jahnari,F,79,19,5,24
Serenidy,F,100,199,0,199
Marlinda,F,100,517,0,517
Cyasia,F,100,20,0,20
Tezra,F,100,56,0,56
Joellie,F,100,31,0,31
Teegan,M,51,1055,1092,2147
Jazer,M,100,0,42,42
Trellis,F,72,224,87,311
Jacey,F,94,6837,407,7244
Chancee,F,100,7,0,7
Ruthel,F,100,5,0,5
Nahja,F,100,58,0,58
Tasani,F,100,5,0,5
Denilson,M,100,0,567,567
Shadrick,M,100,0,522,522
Javiera,F,100,57,0,57
Kovu,M,100,0,6,6
Caroyn,F,100,5,0,5
Nicoleanne,F,100,33,0,33
Denmark,M,100,0,5,5
Lareshia,F,100,15,0,15
Alayssa,F,100,75,0,75
Caci,F,100,111,0,111
Margaret,F,100,357759,941,358700
Itzia,F,100,305,0,305
Sandi,F,100,8665,21,8686
Meyly,F,100,5,0,5
Rashon,M,94,118,1736,1854
Alvida,F,100,6,0,6
Trula,F,100,324,0,324
Esenia,F,100,5,0,5
Esperanza,F,100,12815,15,12830
Ashiah,F,100,68,0,68
Giacomo,M,100,0,1275,1275
Adreonna,F,100,176,0,176
Cyane,F,100,7,0,7
Truman,M,100,0,5610,5610
Cheniqua,F,100,59,0,59
Tyshira,F,100,23,0,23
See,F,100,395,0,395
Jabrayden,M,100,0,5,5
Alycee,F,100,5,0,5
Bernitha,F,100,15,0,15
Jerrilynn,F,100,240,0,240
Mileya,F,100,10,0,10
Abygayle,F,100,137,0,137
Mirannda,F,100,11,0,11
Meshalia,F,100,7,0,7
Haleem,M,100,0,153,153
Panyia,F,100,5,0,5
Cott,M,100,0,30,30
Fredasia,F,100,6,0,6
Jazzae,F,100,5,0,5
Jareth,M,98,32,1372,1404
Errick,M,100,0,1288,1288
Trinady,F,100,160,0,160
Enylah,F,100,7,0,7
Tasia,F,100,3995,0,3995
Aulani,F,100,345,0,345
Sienne,F,100,5,0,5
Betsi,F,100,143,0,143
Nicos,M,100,0,36,36
Deliah,F,100,797,0,797
Elizabethgrace,F,100,5,0,5
Kaden,M,98,990,52622,53612
Quent,M,100,0,46,46
Shawntrell,F,86,51,8,59
Quinden,M,100,0,16,16
Chrislyn,F,100,489,0,489
Takesha,F,100,977,0,977
Obra,M,100,0,16,16
Kawsar,F,100,6,0,6
Andressa,F,100,29,0,29
Ronneshia,F,100,28,0,28
Rhylin,F,69,77,34,111
Cambrey,F,100,82,0,82
Brittnee,F,100,2822,0,2822
Teneisha,F,100,430,0,430
Jacklin,F,100,759,0,759
Brancon,M,100,0,7,7
Promyse,F,100,207,0,207
Rodrique,M,100,0,18,18
Fabianna,F,100,143,0,143
Loralei,F,100,1055,0,1055
Arli,F,100,74,0,74
Bentyn,M,100,0,28,28
Amylia,F,100,190,0,190
Kenya,F,92,23169,2089,25258
Joshawa,M,100,0,508,508
Roanin,M,100,0,37,37
Analecia,F,100,39,0,39
Brenan,M,100,0,778,778
Tanikqua,F,100,18,0,18
Kajun,F,100,5,0,5
Toderick,M,100,0,26,26
Jaythan,M,100,0,601,601
Bodyn,M,100,0,24,24
Jamontae,M,100,0,209,209
Leonia,F,100,303,0,303
Carrey,F,89,47,6,53
Nakeyta,F,100,5,0,5
Ezmerelda,F,100,27,0,27
Kolbyn,M,100,0,7,7
Tycie,F,100,31,0,31
Pegi,F,100,123,0,123
Saanvika,F,100,50,0,50
Raaga,F,100,52,0,52
Andron,M,100,0,65,65
Kalie,F,100,4940,0,4940
Ahna,F,100,848,0,848
Karenn,F,100,20,0,20
Virsaviya,F,100,5,0,5
Evenny,F,100,6,0,6
Jocalynn,F,100,18,0,18
Teegen,M,100,0,17,17
Akbar,M,100,0,472,472
Joo,F,67,10,5,15
Radu,M,100,0,25,25
Eman,F,91,1613,157,1770
Samtha,F,100,6,0,6
Yacine,M,57,46,60,106
Wladimir,M,100,0,11,11
Chrisann,F,100,425,0,425
Sedrick,M,100,0,3322,3322
Ladamien,M,100,0,70,70
Shamaya,F,100,750,0,750
Josias,M,100,0,1604,1604
Kamecia,F,100,39,0,39
Raenada,F,100,5,0,5
Etasha,F,100,6,0,6
Marietta,F,100,4999,0,4999
Colleena,F,100,62,0,62
Braiden,M,98,152,6192,6344
Kazia,F,100,312,0,312
Aisea,M,100,0,68,68
Keally,F,100,5,0,5
Antorio,M,100,0,24,24
Conn,M,100,0,83,83
Sherran,F,100,101,0,101
Kreshnik,M,100,0,5,5
Mashawna,F,100,11,0,11
Isaac,M,100,622,218657,219279
Aydia,F,100,81,0,81
Anzal,F,100,65,0,65
Deaneen,F,100,5,0,5
Ariq,M,100,0,90,90
Zeek,M,100,0,92,92
Ivann,M,100,0,148,148
Abrea,F,100,179,0,179
Borden,M,100,0,36,36
Ashantay,F,100,35,0,35
Niall,M,100,0,1222,1222
Aneatra,F,100,41,0,41
Kyvion,M,100,0,5,5
Aeris,F,100,1004,0,1004
Briahnna,F,100,178,0,178
Samiyah,F,100,3256,0,3256
Alean,F,100,168,0,168
Jamesena,F,100,10,0,10
Xairexis,F,100,11,0,11
Jacin,M,100,0,19,19
Janelle,F,100,48649,86,48735
Kashe,F,62,40,25,65
Alexias,F,100,154,0,154
Munachimso,F,64,46,26,72
Henryk,M,100,0,78,78
Oscarjr,M,100,0,5,5
Keyla,F,100,6155,0,6155
Analynn,F,100,217,0,217
Naiyana,F,100,57,0,57
Nayelle,F,100,11,0,11
Geraldean,F,100,115,0,115
Megyn,F,100,414,0,414
Janeshia,F,100,162,0,162
Alexandar,M,100,0,623,623
Ashauntae,F,100,5,0,5
Jerrel,M,100,5,1521,1526
Frances,F,99,107962,1187,109149
Jakayah,F,100,25,0,25
Nicki,F,96,5314,244,5558
Tashel,F,100,5,0,5
Keylin,F,71,564,227,791
Kanaiyah,F,100,5,0,5
Anoushka,F,100,532,0,532
Ireanna,F,100,92,0,92
Dema,F,100,211,0,211
Marceen,F,100,5,0,5
Nitoya,F,100,5,0,5
Marisela,F,100,9833,29,9862
Saranna,F,100,10,0,10
Aneka,F,100,306,0,306
Tanzim,M,100,0,12,12
Anairis,F,100,124,0,124
Kaye,F,100,6802,33,6835
Myesha,F,100,3358,0,3358
Charel,F,100,29,0,29
Legion,M,100,0,144,144
Breseis,F,100,26,0,26
Halas,M,100,0,8,8
Patriciaann,F,100,224,0,224
Nicholaos,M,100,0,120,120
Kyren,M,96,66,1601,1667
Aiyani,F,100,6,0,6
Kynlea,F,100,84,0,84
Mccrae,M,100,0,74,74
Aloria,F,100,67,0,67
Mays,M,77,11,36,47
Macaiah,F,86,64,10,74
Kitwana,M,100,0,16,16
Jakeith,M,100,0,43,43
Demetria,F,99,10297,141,10438
Kelliann,F,100,665,0,665
Khyson,M,100,0,27,27
Ashtun,M,100,0,37,37
Cleve,M,100,0,1718,1718
Isiah,M,100,11,17920,17931
Karimah,F,100,545,0,545
Stephne,F,100,11,0,11
Adraya,F,100,17,0,17
Zahmere,M,100,0,11,11
Lavasha,F,100,44,0,44
Nayala,F,100,5,0,5
Jhena,F,100,5,0,5
Lynnex,F,100,28,0,28
Terrick,M,100,0,790,790
Kishon,M,93,20,256,276
Arias,M,82,36,163,199
Evamarie,F,100,763,0,763
Elaura,F,100,74,0,74
Rianshi,F,100,5,0,5
Adrienna,F,100,768,0,768
Lindel,M,95,6,109,115
Lexia,F,100,680,0,680
Behati,F,100,15,0,15
Lavondra,F,100,26,0,26
Donavin,M,100,0,2100,2100
Praise,F,76,425,132,557
Lashanda,F,100,4674,0,4674
Mikhiya,F,100,5,0,5
Rawland,M,100,0,5,5
Merial,F,100,5,0,5
Serana,F,100,8,0,8
Keymi,F,100,5,0,5
Glenwood,M,100,0,721,721
Devondrick,M,100,0,11,11
Nigiel,M,100,0,5,5
Jerimy,M,100,0,751,751
Elijay,M,100,0,5,5
Alexisrose,F,100,7,0,7
Georga,F,100,39,0,39
Ireal,F,100,5,0,5
Dyamon,F,100,64,0,64
Rayana,F,100,882,0,882
Biancca,F,100,25,0,25
Reco,M,100,0,1177,1177
Gevorg,M,100,0,60,60
Zada,F,100,1216,0,1216
Tyron,M,100,16,7049,7065
Ilima,F,100,30,0,30
Dalane,F,100,5,0,5
Coalton,M,100,0,127,127
Ciprian,M,100,0,6,6
Tassy,F,100,27,0,27
Elliett,F,100,23,0,23
Antanika,F,100,6,0,6
Natelie,F,100,138,0,138
Yelisey,M,100,0,5,5
Ladessa,F,100,19,0,19
Rhaelynn,F,100,8,0,8
Keemon,M,100,0,5,5
Dakesha,F,100,11,0,11
Mariola,F,100,15,0,15
Melssia,F,100,5,0,5
Allina,F,100,230,0,230
Mona,F,100,27483,10,27493
Kynnleigh,F,100,10,0,10
Meleigha,F,100,30,0,30
Octavius,M,99,15,2827,2842
Tracie,F,99,32381,218,32599
Yesley,F,100,5,0,5
Dashone,M,100,0,46,46
Eidel,F,100,5,0,5
Embree,F,100,154,0,154
Gariella,F,100,12,0,12
Sumeja,F,100,10,0,10
Alysah,F,100,163,0,163
Onesty,F,100,109,0,109
Shanai,F,100,387,0,387
Lasana,M,100,0,11,11
Antanay,F,100,17,0,17
Strummer,M,100,0,67,67
Tammara,F,100,2500,0,2500
Shadrach,M,100,0,617,617
Mila,F,100,17069,13,17082
Cherylle,F,100,27,0,27
Brecklin,F,100,6,0,6
Rickell,F,100,159,0,159
Jonluc,M,100,0,57,57
Clhoe,F,100,6,0,6
Jessicaann,F,100,181,0,181
Yaasir,M,100,0,58,58
Anslea,F,100,25,0,25
Jakyla,F,100,706,0,706
Alexous,F,100,5,0,5
Jordana,F,100,2953,0,2953
Kailar,M,100,0,5,5
Jauron,M,100,0,56,56
Trenicia,F,100,17,0,17
Elton,M,100,12,9060,9072
Rumeal,M,100,0,73,73
Leonilda,F,100,5,0,5
Umekia,F,100,15,0,15
Kewania,F,100,5,0,5
Banyon,M,100,0,5,5
Selby,M,54,234,271,505
Sachin,M,100,0,1172,1172
Ganesh,M,100,0,265,265
Adrienne,F,99,56604,375,56979
Tajaun,M,100,0,22,22
Natan,M,100,0,966,966
Crystal,F,100,322781,1169,323950
Antyone,M,100,0,5,5
Sapphira,F,100,381,0,381
Brizeyda,F,100,172,0,172
Siri,F,100,2148,0,2148
Bond,M,96,6,142,148
Deotis,M,100,0,5,5
Phoenyx,F,68,229,106,335
Vikrant,M,100,0,154,154
Marialice,F,100,88,0,88
Shaylei,F,100,37,0,37
Davionne,M,71,68,169,237
Hopie,F,100,83,0,83
Leha,F,100,54,0,54
Shanethia,F,100,24,0,24
Nitisha,F,100,59,0,59
Ellika,F,100,8,0,8
Keijah,F,100,6,0,6
Llewelyn,M,100,0,44,44
Jabri,M,92,16,191,207
Traeven,M,100,0,5,5
Emone,F,92,55,5,60
Lamar,M,97,743,23912,24655
Jayelynn,F,100,50,0,50
Ruchita,F,100,5,0,5
Neilpatrick,M,100,0,15,15
Bozena,F,100,40,0,40
Shadow,M,53,399,458,857
Assma,F,100,5,0,5
Freesia,F,100,7,0,7
Anelisa,F,100,52,0,52
Charlanda,F,100,10,0,10
Marx,M,100,0,192,192
Draidyn,M,100,0,6,6
Doraly,F,100,12,0,12
Arwen,F,100,1727,0,1727
Gracilynn,F,100,5,0,5
Saanvi,F,100,2189,0,2189
Margaet,F,100,5,0,5
Alezia,F,100,6,0,6
Veverly,F,100,132,0,132
Jafeth,M,100,0,132,132
Dayah,F,100,22,0,22
Necole,F,100,1346,0,1346
Raydell,M,100,0,145,145
Rachael,F,100,77808,181,77989
Banx,M,100,0,17,17
Reine,F,100,270,0,270
England,F,91,122,12,134
Letia,F,100,379,0,379
Ioma,F,100,6,0,6
Jesiree,F,100,7,0,7
Jizele,F,100,13,0,13
Natarshia,F,100,5,0,5
Nedra,F,100,3402,0,3402
Jinelle,F,100,159,0,159
Cashel,M,100,0,149,149
Jaleela,F,100,5,0,5
Dawnee,F,100,12,0,12
Daniette,F,100,5,0,5
Matther,M,100,0,69,69
Edouard,M,100,0,350,350
Alonnah,F,100,200,0,200
Symaya,F,100,5,0,5
Prince,M,99,148,9945,10093
Shiara,F,100,59,0,59
Notnamed,M,53,643,722,1365
Reygan,F,100,281,0,281
Cherrilyn,F,100,10,0,10
Kellsi,F,100,18,0,18
Ayleena,F,100,5,0,5
Ge,M,91,5,51,56
Aalliyah,F,100,164,0,164
Daneida,F,100,19,0,19
Ehron,M,100,0,13,13
Maraiya,F,100,29,0,29
Jennings,M,93,94,1348,1442
Renauda,F,100,15,0,15
Tejan,M,100,0,41,41
Gurney,M,100,0,149,149
Micaella,F,100,286,0,286
Kadia,F,100,135,0,135
Cindel,F,100,198,0,198
Renezmae,F,100,45,0,45
Merly,F,100,187,0,187
Kadajah,F,100,76,0,76
Tonilynn,F,100,71,0,71
Mija,F,100,156,0,156
Hiral,F,100,89,0,89
Alfred,M,99,456,75138,75594
Mirinda,F,100,320,0,320
Mariadelcarmen,F,100,480,0,480
Kaelyn,F,99,12746,69,12815
Sophelia,F,100,35,0,35
Sylar,M,96,24,521,545
Zharick,F,100,29,0,29
Idalys,F,100,158,0,158
Tahitoa,M,100,0,5,5
Quin,M,79,350,1299,1649
Shalan,F,96,112,5,117
Sommar,F,100,32,0,32
Michell,F,93,6863,548,7411
Benjimen,M,100,0,212,212
Noralyn,F,100,61,0,61
Imonie,F,100,95,0,95
Eriks,M,100,0,41,41
Byran,M,100,0,1354,1354
Teffanie,F,100,6,0,6
Denashia,F,100,50,0,50
Marqis,M,100,0,5,5
Cord,M,100,0,1609,1609
Deqa,F,100,5,0,5
Esquire,M,100,0,15,15
Valeta,F,100,210,0,210
Vali,F,95,102,5,107
Statia,F,100,5,0,5
Traquez,M,100,0,5,5
Karmindy,F,100,5,0,5
Malicah,M,100,0,22,22
Leslianne,F,100,10,0,10
Rithika,F,100,320,0,320
Jaici,F,100,21,0,21
Ansonia,F,100,14,0,14
Lakinia,F,100,5,0,5
Chantell,F,100,3473,5,3478
Savonte,M,100,0,47,47
Demontra,M,100,0,58,58
Vaun,M,100,0,54,54
Kelanie,F,100,21,0,21
Garyson,M,100,0,36,36
Padyn,F,100,5,0,5
Annakaren,F,100,45,0,45
Akyah,F,100,94,0,94
Marcuss,M,100,0,16,16
Sanantha,F,100,26,0,26
Kol,M,100,0,116,116
Ladasia,F,100,239,0,239
Savonia,F,100,6,0,6
Jolecia,F,100,5,0,5
Susann,F,100,1910,0,1910
Hastings,M,58,5,7,12
Atlai,M,100,0,42,42
Rammy,M,100,0,10,10
Shaneya,F,100,60,0,60
Josuha,M,100,0,281,281
Markal,M,100,0,44,44
Janetzy,F,100,51,0,51
Konstantin,M,100,0,340,340
Latoye,F,100,11,0,11
Avereigh,F,100,37,0,37
Charlesha,F,100,41,0,41
Stepahnie,F,100,396,0,396
Jontavion,M,100,0,19,19
Dama,F,100,149,0,149
Riken,M,100,0,6,6
Dodger,M,100,0,60,60
Nakeshia,F,100,450,0,450
Tachara,F,100,5,0,5
Lakitha,F,100,84,0,84
Ashanta,F,99,597,6,603
Tyzir,M,100,0,5,5
Reta,F,100,2253,0,2253
Jeycob,M,100,0,12,12
Gitta,F,100,10,0,10
Devonya,F,100,41,0,41
Caribe,M,100,0,20,20
Jasai,M,98,5,204,209
Olutosin,F,100,7,0,7
Chelsei,F,100,161,0,161
Natiana,F,100,11,0,11
Isarael,M,100,0,5,5
Iftu,F,100,5,0,5
Sanibel,F,100,5,0,5
Starlette,F,100,594,0,594
Addilynne,F,100,52,0,52
Kollins,F,89,99,12,111
Ethaniel,M,100,0,714,714
Shontavius,M,100,0,5,5
Dayan,M,62,180,292,472
Newt,M,100,0,130,130
Asahi,M,100,0,12,12
Jadha,F,100,5,0,5
Lanford,M,100,0,16,16
Hallie,F,99,18821,184,19005
Angelie,F,100,1688,0,1688
Bashy,F,100,6,0,6
Turia,F,100,11,0,11
Lorre,F,100,398,0,398
Kymya,F,100,6,0,6
Saiya,F,100,231,0,231
Birdena,F,100,54,0,54
Mcclain,M,92,26,306,332
Jedediah,M,100,0,2730,2730
Timar,M,100,0,5,5
Yaricza,F,100,45,0,45
Kamaiya,F,100,135,0,135
Capone,M,100,0,156,156
Jamesley,M,100,0,17,17
Zionna,F,100,508,0,508
Zadan,M,100,0,27,27
Press,M,100,0,26,26
Clover,F,99,1778,11,1789
Macintyre,M,100,0,57,57
Stacy,F,89,161414,20276,181690
Shuna,F,100,108,0,108
Connolly,F,50,5,5,10
Crystalina,F,100,59,0,59
Anessa,F,100,2420,0,2420
Dagon,M,100,0,167,167
Nerik,M,100,0,35,35
Aquia,F,100,25,0,25
Iaan,M,100,0,55,55
Hagar,F,100,111,0,111
Jacquetta,F,100,1361,0,1361
Korrine,F,100,505,0,505
Debrajo,F,100,11,0,11
Patrycia,F,100,48,0,48
Khaled,M,100,0,1647,1647
Ahmiyah,F,100,140,0,140
Rumana,F,100,10,0,10
Mariah,F,100,99811,182,99993
Guinnevere,F,100,20,0,20
Balke,M,100,0,21,21
Naden,M,100,0,22,22
Abelardo,M,100,0,3326,3326
Anhtony,M,100,0,16,16
Tajanay,F,100,108,0,108
Siane,F,100,23,0,23
Kimarion,M,100,0,62,62
Tamera,F,100,13795,0,13795
Nagela,F,100,5,0,5
Tymeshia,F,100,71,0,71
Kohlman,M,100,0,25,25
Brytni,F,100,141,0,141
Sylvi,F,100,42,0,42
Campton,M,100,0,5,5
Rupinder,F,100,37,0,37
Darivs,M,100,0,67,67
Katrisha,F,100,191,0,191
Hanan,F,94,1456,96,1552
Zhamir,M,100,0,68,68
Djuna,F,100,352,0,352
Charlei,F,100,82,0,82
Elizabethanne,F,100,81,0,81
Dianny,F,100,28,0,28
Shallin,F,100,11,0,11
Shreshta,F,100,44,0,44
Luzero,F,100,11,0,11
Rakyla,F,100,15,0,15
Yeili,F,100,45,0,45
Kaydence,F,98,12345,294,12639
Zelphia,F,100,62,0,62
Kahliah,F,100,24,0,24
Semih,M,100,0,35,35
Haziq,M,100,0,5,5
Cassina,F,100,5,0,5
Jasere,M,100,0,5,5
Elemer,M,100,0,5,5
Keye,M,100,0,5,5
Marsia,F,100,115,0,115
Carlesia,F,100,22,0,22
Mikol,M,100,0,50,50
Lujane,F,100,44,0,44
Maesha,F,100,11,0,11
Katryna,F,100,831,0,831
Brylie,F,100,1524,5,1529
Jacaury,M,100,0,5,5
Sair,M,100,0,101,101
Asija,F,100,34,0,34
Arquan,M,100,0,5,5
Jimmiah,F,100,7,0,7
Fillmore,M,100,0,6,6
Chyler,F,81,223,52,275
Mynesha,F,100,34,0,34
Jaquori,M,100,0,29,29
Tyarra,F,100,63,0,63
Katrinamarie,F,100,15,0,15
Burna,F,100,30,0,30
Libna,F,100,12,0,12
Jaquelinee,F,100,6,0,6
Deysia,F,100,10,0,10
Niamalika,F,100,10,0,10
Yerika,F,100,11,0,11
Dmontae,M,100,0,28,28
Teneesha,F,100,5,0,5
Derwood,M,100,0,253,253
Nalayiah,F,100,5,0,5
Jeremaine,M,100,0,207,207
Ladajah,F,100,76,0,76
Curties,M,100,0,10,10
Kinny,M,100,0,20,20
Essie,F,96,4088,157,4245
Aysu,F,100,5,0,5
Niela,F,100,50,0,50
Keaysia,F,100,5,0,5
Jahdon,M,100,0,6,6
Murjani,F,100,24,0,24
Shayn,M,100,0,438,438
Truett,M,100,0,1074,1074
Gaelyn,F,100,64,0,64
Prudence,F,100,2201,0,2201
Summerlyn,F,100,176,0,176
Priti,F,100,259,0,259
Sheleah,F,100,12,0,12
Ismar,M,89,11,88,99
Britny,F,100,1877,0,1877
Derya,F,100,130,0,130
Flem,M,100,0,15,15
Nasiriyah,F,100,15,0,15
Loronda,F,100,10,0,10
Nirali,F,100,321,0,321
Shyniece,F,100,95,0,95
Chauncy,M,97,33,1036,1069
Farai,M,100,0,6,6
Capri,F,98,2654,52,2706
Shalyce,F,100,39,0,39
Aadon,M,100,0,100,100
Jannai,F,100,10,0,10
Larene,F,100,248,0,248
Caricia,F,100,25,0,25
Jerni,F,100,89,0,89
Juliya,F,100,182,0,182
Jakye,M,100,0,220,220
Jaslene,F,100,2679,0,2679
Dedrah,F,100,5,0,5
Ilwad,F,100,10,0,10
Kamyria,F,100,45,0,45
Jeseca,F,100,10,0,10
Naohmi,F,100,5,0,5
Madylin,F,100,506,0,506
Schanelle,F,100,5,0,5
Latefa,F,100,28,0,28
Raulie,M,100,0,5,5
Rhyon,M,76,7,22,29
Ronnel,M,100,0,230,230
Shwana,F,100,21,0,21
Isra,F,100,753,0,753
Adym,M,100,0,5,5
Azaylea,F,100,48,0,48
Tauna,F,100,626,0,626
Kavon,M,98,41,2353,2394
Sayra,F,100,1297,0,1297
Jaymes,M,98,40,2111,2151
Kalonie,F,100,5,0,5
Herlin,M,100,0,26,26
Alnisa,F,100,280,0,280
Oday,M,100,0,18,18
Jyotsna,F,100,34,0,34
Renesmee,F,100,427,0,427
Ikeem,M,100,0,315,315
Maybell,F,100,129,0,129
Tioni,F,100,10,0,10
Deetya,F,100,167,0,167
Hansika,F,100,183,0,183
Deyonna,F,100,357,0,357
Kailyne,F,100,49,0,49
Sanjana,F,100,1974,0,1974
Stepphanie,F,100,5,0,5
Taleeya,F,100,79,0,79
Abigayle,F,100,5630,5,5635
Adrius,M,100,0,18,18
Aiyannah,F,100,123,0,123
Arihanna,F,100,546,0,546
Traiten,M,100,0,6,6
Shaiana,F,100,16,0,16
Aadison,F,100,11,0,11
Basimah,F,100,5,0,5
Primus,M,100,0,80,80
Jamori,M,100,0,159,159
Yosheka,F,100,5,0,5
Marjo,F,100,67,0,67
Kristoff,M,100,0,369,369
Valeriy,M,100,0,21,21
Camirah,F,100,6,0,6
Deeandre,M,100,0,5,5
Antonne,M,100,0,11,11
Emelynn,F,100,52,0,52
Christinemarie,F,100,26,0,26
Romella,F,100,10,0,10
Xanthe,F,100,266,0,266
Aaser,M,100,0,5,5
Breilynn,F,100,5,0,5
Ambrianna,F,100,43,0,43
Colline,F,100,6,0,6
Swanzetta,F,100,34,0,34
Pius,M,100,0,95,95
Jehad,M,100,0,174,174
Ogechi,F,100,269,0,269
Amadis,F,100,59,0,59
Shaunise,F,100,41,0,41
Gibson,M,97,94,3076,3170
Katrea,F,100,5,0,5
Terris,M,85,138,799,937
Jomei,M,100,0,5,5
Joshuwa,M,100,0,393,393
Katai,M,100,0,41,41
Zhymir,M,100,0,7,7
Maisyn,F,89,170,20,190
Liam,M,100,233,137176,137409
Buz,M,100,0,33,33
Kenedie,F,100,139,0,139
Lawonda,F,100,307,0,307
Stephina,F,100,31,0,31
Kjersten,F,100,305,0,305
Tomia,F,100,201,0,201
Tyreke,M,100,0,1260,1260
Lamin,M,100,0,168,168
Emmeri,F,100,26,0,26
Kamyri,F,100,27,0,27
Crandon,M,100,0,6,6
Emmauel,M,100,0,60,60
Juanisha,F,100,174,0,174
Hana,F,100,8871,6,8877
Christropher,M,100,0,315,315
Taylorann,F,100,271,0,271
Keerica,F,100,40,0,40
Brendyn,M,100,0,1212,1212
Tamayah,F,100,16,0,16
Dicki,F,100,5,0,5
Marcusjames,M,100,0,5,5
Zackie,M,100,0,16,16
Costa,M,100,0,121,121
Kleopatra,F,100,5,0,5
Myann,F,100,5,0,5
Shundell,M,100,0,6,6
Laritza,F,100,254,0,254
Mystica,F,100,41,0,41
Aaishah,F,100,18,0,18
Atosha,F,100,17,0,17
Kavalli,M,100,0,6,6
Nayomi,F,100,694,0,694
Tykeriah,F,100,5,0,5
Bellina,F,100,83,0,83
Jannet,F,100,2072,0,2072
Kayleh,F,100,5,0,5
Niamora,F,100,10,0,10
Koji,M,100,0,391,391
Gator,M,100,0,10,10
Wilbert,M,100,46,13042,13088
Bettzy,F,100,5,0,5
Banisha,F,100,5,0,5
Thaiden,M,100,0,12,12
Lionell,M,100,0,1233,1233
Shrita,F,100,47,0,47
Graden,M,100,0,534,534
Rayonia,F,100,5,0,5
Jenniferlee,F,100,24,0,24
Samanvitha,F,100,34,0,34
Yanique,F,100,355,0,355
Symantha,F,100,595,0,595
Phylisha,F,100,135,0,135
Jsaon,M,100,0,115,115
Daejanae,F,100,36,0,36
Shikeria,F,100,5,0,5
Michuel,M,100,0,5,5
Tyronda,F,100,540,0,540
Yitong,F,100,7,0,7
Toneesha,F,100,5,0,5
Corita,F,100,107,0,107
Paetynn,F,100,28,0,28
Destiney,F,100,7408,0,7408
Ayeh,F,100,10,0,10
Amanita,F,100,5,0,5
Cambree,F,100,1396,0,1396
Latoyria,F,100,17,0,17
Danyca,F,100,10,0,10
Vladislava,F,100,5,0,5
Saela,F,100,5,0,5
Franclin,M,100,0,5,5
Tonyetta,F,100,94,0,94
Kadarion,M,100,0,15,15
Karneshia,F,100,17,0,17
Davyen,M,100,0,13,13
Felyx,M,100,0,5,5
Emillia,F,100,139,0,139
Jassmine,F,100,481,0,481
Inett,F,100,5,0,5
Lilliaunna,F,100,10,0,10
Dishon,M,100,0,318,318
Jolyne,F,100,158,0,158
Sharyl,F,100,2020,0,2020
Laleta,F,100,5,0,5
Mcneal,M,100,0,5,5
Khameron,M,100,0,131,131
Timikia,F,100,32,0,32
Tyrome,M,100,0,883,883
Jomara,F,100,35,0,35
Estefanya,F,100,5,0,5
Amberann,F,100,6,0,6
Mong,M,84,18,92,110
Araminta,F,100,66,0,66
Saima,F,100,419,0,419
Samanntha,F,100,21,0,21
Tilon,M,100,0,5,5
Sugey,F,100,366,0,366
Luigy,M,100,0,12,12
Joshuacaleb,M,100,0,11,11
Eillen,F,100,6,0,6
Janyia,F,100,693,0,693
Tomora,F,100,5,0,5
Daleisha,F,100,15,0,15
Natea,F,100,26,0,26
Aroara,F,100,13,0,13
Anaih,F,100,64,0,64
Duvon,M,100,0,31,31
Aadyn,M,96,16,387,403
Trevante,M,100,0,194,194
Alexnader,M,100,0,36,36
Edwena,F,100,72,0,72
Chic,M,100,0,5,5
Fallan,F,100,128,0,128
Kilik,M,100,0,34,34
Maesen,F,50,5,5,10
Mahdee,M,100,0,18,18
Kaylah,F,100,5777,0,5777
Gavvin,M,100,0,6,6
Sabrynn,F,100,5,0,5
Akea,F,100,43,0,43
Jadd,M,100,0,57,57
Aleyshka,F,100,16,0,16
Nezar,M,100,0,145,145
Natayla,F,100,64,0,64
Kiwanna,F,100,98,0,98
Keyonie,F,100,15,0,15
Sharrief,M,100,0,10,10
Adem,M,100,0,768,768
Naadir,M,100,0,22,22
Saed,M,100,0,157,157
Chazlyn,F,100,97,0,97
Brithany,F,100,479,0,479
Eliott,M,100,0,1297,1297
Kasem,M,100,0,58,58
Jerlene,F,100,219,0,219
Deandria,F,100,685,0,685
Racie,F,100,11,0,11
Zaheer,M,100,0,148,148
Lamauri,M,100,0,7,7
Lorilee,F,100,771,0,771
Kenneth,M,100,3493,794273,797766
Climmie,M,55,51,62,113
Kaileigh,F,100,2289,0,2289
Laquasha,F,100,433,0,433
Lukyan,M,100,0,6,6
Phenicia,F,100,26,0,26
Daleysi,F,100,5,0,5
Tavarion,M,100,0,107,107
Deseray,F,100,705,0,705
Locklynn,F,100,22,0,22
Ngai,M,100,0,66,66
Clemence,F,84,36,7,43
Kensey,F,99,812,5,817
Earlena,F,100,71,0,71
Ameet,M,100,0,70,70
Funmilayo,F,100,10,0,10
Kamoree,F,100,23,0,23
Krisia,F,100,17,0,17
Liliya,F,100,366,0,366
Shuntae,F,100,144,0,144
Addisun,F,100,11,0,11
Mailen,F,100,156,0,156
Warne,M,100,0,6,6
Niyanah,F,100,7,0,7
Siovhan,F,100,5,0,5
Jowan,M,100,0,144,144
Renasha,F,100,5,0,5
Alizah,F,99,668,5,673
Dorrance,M,100,0,33,33
Ayeesha,F,100,29,0,29
Desaree,F,100,673,0,673
Coletta,F,100,675,0,675
Suzannah,F,100,1612,0,1612
Reinalda,F,100,11,0,11
Dustion,M,100,0,5,5
Aissa,F,100,590,0,590
Illeana,F,100,320,0,320
Dequincy,M,100,0,355,355
Laquanna,F,100,273,0,273
Sabreana,F,100,6,0,6
Kadrien,M,100,0,20,20
Ceylin,F,100,60,0,60
Ganelle,F,100,5,0,5
Jaelea,F,100,5,0,5
Fiffany,F,100,6,0,6
Brigette,F,100,5577,0,5577
Donnamae,F,100,26,0,26
Marshana,F,100,25,0,25
Kashina,F,100,104,0,104
Sukhraj,M,100,0,69,69
Janiera,F,100,6,0,6
Anegla,F,100,35,0,35
Gabby,F,98,661,16,677
Mikkel,M,97,24,686,710
Rochelle,F,99,38983,280,39263
Rosealyn,F,100,25,0,25
Dhyaan,M,100,0,6,6
Lourdes,F,99,13295,69,13364
Kentrel,M,100,0,306,306
Gustabo,M,100,0,402,402
Indea,F,100,77,0,77
Deizel,M,100,0,6,6
Jeralynn,F,100,100,0,100
Markice,M,100,0,120,120
Tangenika,F,100,5,0,5
Hether,F,100,364,0,364
Roniqua,F,100,67,0,67
Gisella,F,100,1124,0,1124
Lamare,M,100,0,32,32
Brigham,M,100,0,2357,2357
Alannis,F,100,171,0,171
Miste,F,100,30,0,30
Sheperd,M,100,0,5,5
Leesa,F,100,4071,0,4071
Maseo,M,100,0,7,7
Sariya,F,100,970,0,970
Ladaija,F,100,61,0,61
Parveen,F,100,33,0,33
Kaveon,M,100,0,290,290
Samarie,F,100,120,0,120
Raeann,F,100,3583,0,3583
Alaria,F,100,60,0,60
Mynasia,F,100,5,0,5
Camari,M,60,559,822,1381
Samiyyah,F,100,148,0,148
Hind,F,100,124,0,124
Tychell,F,100,10,0,10
Aishe,F,100,5,0,5
Rihansh,M,100,0,5,5
Ameriana,F,100,5,0,5
Adelmira,F,100,10,0,10
Gianella,F,100,496,0,496
Graziana,F,100,5,0,5
Deontra,M,88,18,135,153
Julienna,F,100,18,0,18
Imagin,F,100,50,0,50
Mahogany,F,100,3206,0,3206
Haevynn,F,100,5,0,5
Yefri,M,100,0,36,36
Javari,M,100,0,787,787
Clayvon,M,100,0,63,63
Ravonda,F,100,86,0,86
Markallen,M,100,0,10,10
Ildiko,F,100,55,0,55
Terrice,F,50,15,15,30
Joslene,F,100,6,0,6
Trude,F,100,188,0,188
Evea,F,100,30,0,30
Hakeim,M,100,0,29,29
Vitaliy,M,100,0,337,337
Dequane,M,100,0,67,67
Saratha,F,100,5,0,5
Waconda,F,100,5,0,5
Timmey,M,100,0,83,83
Jeese,M,100,0,12,12
Kamara,F,99,1513,12,1525
Edy,M,73,174,482,656
Natika,F,100,293,0,293
Adreena,F,100,103,0,103
Rosolino,M,100,0,5,5
Yareli,F,100,6650,0,6650
Damarieon,M,100,0,6,6
Hamilton,M,100,0,3411,3411
Benicia,F,100,119,0,119
Cuba,M,54,23,27,50
Triena,F,100,25,0,25
Gerimiah,M,100,0,15,15
Devonti,M,100,0,18,18
Stefany,F,100,3676,0,3676
Orvell,M,100,0,6,6
Yiyi,F,100,6,0,6
Ames,M,100,0,725,725
Pravin,M,100,0,57,57
Divya,F,99,2232,16,2248
Daton,M,100,0,88,88
Jiles,M,100,0,240,240
Willistine,F,100,39,0,39
Marquet,M,100,0,194,194
Maluhia,F,100,5,0,5
Allizzon,F,100,25,0,25
Emmerich,M,100,0,61,61
Tarana,F,100,31,0,31
Renasia,F,100,27,0,27
Briasha,F,100,30,0,30
Delaysia,F,100,38,0,38
Kapone,M,100,0,12,12
Humayra,F,100,10,0,10
Matricia,F,100,58,0,58
Marilynn,F,100,4938,0,4938
Deetra,F,100,178,0,178
Prisca,F,100,339,0,339
Bekham,M,100,0,13,13
Jeremias,M,100,0,2404,2404
Macenzie,F,100,329,0,329
Toyia,F,100,565,0,565
Hudhayfah,M,100,0,5,5
Linnie,F,78,966,267,1233
Marquevious,M,100,0,5,5
Akanni,M,100,0,11,11
Elaysha,F,100,151,0,151
Emmersen,F,100,117,0,117
Jaterra,F,100,11,0,11
Lillyona,F,100,118,0,118
Destinae,F,100,73,0,73
Quanterra,F,100,7,0,7
Kaylup,M,100,0,21,21
Ahvianna,F,100,5,0,5
Arelli,F,100,33,0,33
Cliona,F,100,15,0,15
Devale,M,100,0,15,15
Sheley,F,100,32,0,32
Lakrista,F,100,57,0,57
Reford,M,100,0,10,10
Niam,M,100,0,302,302
Donal,M,100,5,1467,1472
Saevon,M,100,0,17,17
Nalayah,F,100,222,0,222
Teniqua,F,100,125,0,125
Klohee,F,100,7,0,7
Luzdary,F,100,15,0,15
Kenyan,M,99,10,798,808
Phazon,M,100,0,5,5
Mikkia,F,100,11,0,11
Nekedra,F,100,15,0,15
Markevia,F,100,57,0,57
Tanaysia,F,100,148,0,148
Germar,M,100,0,12,12
Sashia,F,100,100,0,100
Lenoris,M,100,0,15,15
Kaziyah,F,100,122,0,122
Glady,F,100,138,0,138
Laryan,M,100,0,26,26
Cerrie,F,100,6,0,6
Marcal,M,100,0,38,38
Tyeson,M,100,0,188,188
Damius,M,100,0,26,26
Madyn,F,100,176,0,176
Alexanndra,F,100,7,0,7
Adira,F,100,350,0,350
Keather,F,100,28,0,28
Baeli,F,100,50,0,50
Zafiro,F,100,45,0,45
Lochlainn,M,100,0,5,5
Shalondra,F,100,134,0,134
Bridgete,F,100,28,0,28
Rosilynn,F,100,10,0,10
Lennard,M,100,0,732,732
Ehaan,M,100,0,17,17
Sibel,F,100,195,0,195
Vinod,M,100,0,154,154
Khya,F,100,283,0,283
Anghel,M,100,0,6,6
Timiyah,F,100,153,0,153
Macaden,M,100,0,12,12
Jailyn,F,86,3870,630,4500
Javontaye,M,100,0,5,5
Cristhian,M,100,0,899,899
Santez,M,100,0,68,68
Hemanth,M,100,0,21,21
Mardella,F,100,85,0,85
Ashyia,F,100,134,0,134
Taddeo,M,100,0,5,5
Geraud,M,100,0,16,16
Shalaundra,F,100,5,0,5
Ayde,F,100,276,0,276
Baha,M,100,0,11,11
Zebulon,M,100,0,1798,1798
Katurah,F,100,253,0,253
Gryffin,M,100,0,284,284
Burrell,M,100,0,346,346
Marianne,F,100,41648,43,41691
Quashawna,F,100,14,0,14
Blayr,F,100,6,0,6
Divesh,M,100,0,6,6
Joshuajames,M,100,0,93,93
Dimarcus,M,100,0,7,7
Geovanna,F,100,639,0,639
Glen,M,99,412,67583,67995
Kinsington,F,100,6,0,6
Kateleigh,F,100,16,0,16
Aubrelle,F,100,5,0,5
Taidyn,M,100,0,19,19
Minjoon,M,100,0,5,5
Joleen,F,100,5620,0,5620
Kajuana,F,100,118,0,118
Daynesha,F,100,11,0,11
Racen,M,100,0,5,5
Theresaann,F,100,41,0,41
Sharnise,F,100,119,0,119
Kooper,M,92,160,1834,1994
Wing,M,82,22,97,119
Iskandar,M,100,0,5,5
Codie,M,61,1608,2493,4101
Jeraldean,F,100,5,0,5
Piyush,M,100,0,29,29
Denetris,F,100,5,0,5
Mccaela,F,100,20,0,20
Kishia,F,100,273,0,273
Tamim,M,100,0,181,181
Sisilia,F,100,40,0,40
Envyi,F,100,6,0,6
Eudy,M,100,0,5,5
Takoma,M,100,0,21,21
Quanya,F,100,5,0,5
Chanelle,F,100,4757,0,4757
Danielynn,F,100,7,0,7
Abhi,M,100,0,205,205
Shenandoah,F,74,319,112,431
Rishad,M,100,0,56,56
Annaclaire,F,100,309,0,309
Jamalachi,M,100,0,5,5
Dawton,M,100,0,29,29
Jacen,M,100,0,1713,1713
Bimal,M,100,0,6,6
Keah,F,100,138,0,138
Lillyann,F,100,1564,0,1564
Dejanna,F,100,28,0,28
Ndya,F,100,16,0,16
Luma,F,100,85,0,85
Luster,M,100,0,256,256
Demitra,F,100,591,0,591
Haniyah,F,100,208,0,208
Shastina,F,100,90,0,90
Jibrail,M,100,0,17,17
Spiridon,M,100,0,15,15
Gricel,F,100,275,0,275
Tysie,F,100,18,0,18
Chealsea,F,100,225,0,225
Akierra,F,100,8,0,8
Anishka,F,100,221,0,221
Mycayla,F,100,20,0,20
Mariame,F,100,194,0,194
Ovadia,M,100,0,30,30
Adiya,F,100,119,0,119
Marte,M,79,35,128,163
Ritwik,M,100,0,30,30
Artra,F,100,5,0,5
Ceniya,F,100,105,0,105
Mcquade,M,100,0,5,5
Jamane,M,100,0,41,41
Bikram,M,100,0,5,5
Danise,F,100,801,0,801
Zarriyah,F,100,33,0,33
Zaryia,F,100,62,0,62
Lasanya,F,100,15,0,15
Gaozong,F,100,16,0,16
Xao,M,100,0,27,27
Maykel,M,100,0,32,32
Celyna,F,100,51,0,51
Cotina,F,100,243,0,243
Tracylynn,F,100,15,0,15
Ciane,F,100,6,0,6
Lataja,F,100,105,0,105
Gavriel,M,100,5,1120,1125
Mikinley,F,100,44,0,44
Ascencion,M,100,0,319,319
Chena,F,100,150,0,150
Damishia,F,100,5,0,5
Coe,M,100,0,101,101
Satsuki,F,100,25,0,25
Treasea,F,100,29,0,29
Lujuan,F,100,5,0,5
Shameta,F,100,6,0,6
Altina,F,100,56,0,56
Delrita,F,100,17,0,17
Yao,M,100,0,75,75
Majorie,F,100,397,0,397
Arieah,F,100,6,0,6
Shaqueda,F,100,5,0,5
Keyo,M,100,0,15,15
Perla,F,100,17735,30,17765
Gretel,F,100,849,0,849
Shirli,F,100,5,0,5
Ferol,F,100,28,0,28
Aztlan,M,100,0,76,76
Tenneal,F,100,8,0,8
Kyshana,F,100,5,0,5
Kimberyl,F,100,5,0,5
Kelan,M,100,0,1500,1500
Mariette,F,100,543,0,543
Dinari,M,100,0,141,141
Acire,F,100,65,0,65
Myphuong,F,100,5,0,5
Amiera,F,100,113,0,113
Yoshika,F,100,81,0,81
Krimson,F,95,86,5,91
Jamielle,F,100,5,0,5
Lova,F,100,26,0,26
Paxston,M,100,0,5,5
Shaketa,F,100,375,0,375
Scoey,M,100,0,22,22
Cortlan,M,100,0,103,103
Preeti,F,100,360,0,360
Abeer,F,97,498,17,515
Kevonte,M,100,0,631,631
Thursa,F,100,5,0,5
Arianamarie,F,100,5,0,5
Loa,F,100,168,0,168
Tallula,F,100,87,0,87
Chancellor,M,100,0,2007,2007
Sarvesh,M,100,0,178,178
Phalen,M,54,18,21,39
Mayme,F,100,520,0,520
Darnella,F,100,583,0,583
Chyenne,F,100,1342,5,1347
Citali,F,100,15,0,15
Avon,M,72,255,670,925
Lalani,F,100,185,0,185
Bradie,F,77,436,129,565
Beverlyn,F,100,399,0,399
Adesh,M,100,0,23,23
Jorah,F,84,36,7,43
Britteny,F,100,1450,0,1450
Emilene,F,100,67,0,67
Tyrionna,F,100,46,0,46
Demeca,F,100,11,0,11
Khiyan,M,100,0,47,47
Azurae,F,100,5,0,5
Amarina,F,100,5,0,5
Tommie,M,73,5133,14236,19369
Kamon,M,100,0,261,261
Merari,F,99,1142,16,1158
Narah,F,100,26,0,26
Emmelyn,F,100,246,0,246
Julliette,F,100,80,0,80
Jordai,F,100,6,0,6
Christmas,F,100,148,0,148
Caralee,F,100,664,0,664
Faduma,F,100,179,0,179
Makaylynn,F,100,140,0,140
Chamberlyn,F,100,7,0,7
Maquan,M,100,0,13,13
Shyah,F,96,117,5,122
Alyssya,F,100,6,0,6
Keaunna,F,100,67,0,67
Yanelys,F,100,35,0,35
Gerrilynn,F,100,11,0,11
Rhian,F,88,685,97,782
Yashima,F,100,6,0,6
Rayshelle,F,100,6,0,6
Shawntella,F,100,10,0,10
Elijha,M,100,0,672,672
Jevan,M,100,0,367,367
Aurielle,F,100,550,0,550
Elson,M,100,0,647,647
Tashira,F,100,366,0,366
Milta,F,100,137,0,137
Jianna,F,100,1904,0,1904
Kadin,M,96,178,4649,4827
Sati,F,100,17,0,17
Jerimey,M,100,0,81,81
Aaya,F,100,38,0,38
Devunta,M,100,0,6,6
Zamauri,M,91,6,59,65
Sarea,F,100,91,0,91
Caren,F,100,8252,0,8252
Tierrah,F,100,103,0,103
Delone,M,88,5,36,41
Naszire,M,100,0,6,6
Lillymay,F,100,5,0,5
Keicha,F,100,60,0,60
Arnise,F,100,5,0,5
Suneel,M,100,0,10,10
Dmitry,M,100,0,383,383
Royel,M,79,5,19,24
Elsia,F,100,43,0,43
Salam,F,72,205,78,283
Nayab,F,100,65,0,65
Kaylani,F,100,1908,0,1908
Janess,F,100,12,0,12
Colt,M,100,11,12396,12407
Garran,M,100,0,11,11
Abhiram,M,100,0,635,635
Shawneen,F,100,123,0,123
Leicia,F,100,5,0,5
Diva,F,100,469,0,469
Dalicia,F,100,180,0,180
Idrees,M,100,0,214,214
Isis,F,100,10710,12,10722
Brookes,M,66,44,84,128
Edid,F,100,24,0,24
Jonita,F,100,684,0,684
Taija,F,100,785,0,785
Endora,F,100,109,0,109
Rilei,F,100,57,0,57
Dale,M,93,13348,165157,178505
Aniyah,F,100,20313,5,20318
Anabella,F,100,4844,0,4844
Oleda,F,100,16,0,16
Toliver,M,100,0,25,25
Kamlyn,F,100,28,0,28
Demorea,M,100,0,12,12
Shaleta,F,100,107,0,107
Isaic,M,100,0,163,163
Sylvanna,F,100,237,0,237
Brittnay,F,100,1619,0,1619
Tselane,F,100,10,0,10
Dorice,F,100,378,0,378
Kasidee,F,100,206,0,206
Jakhya,F,100,54,0,54
Sharvon,F,100,26,0,26
Nikiya,F,100,575,0,575
Laurieanne,F,100,63,0,63
Virdie,F,100,6,0,6
Lynsy,F,100,41,0,41
Madelinn,F,100,51,0,51
Stann,M,100,0,5,5
Rishawn,M,100,0,137,137
Thyda,F,100,19,0,19
Donitta,F,100,16,0,16
Quatesha,F,100,36,0,36
Vicente,M,100,0,15102,15102
Anyston,F,100,18,0,18
Persephany,F,100,11,0,11
Saran,F,97,555,19,574
Jaydalin,F,100,15,0,15
Shanisa,F,100,24,0,24
Xianna,F,100,135,0,135
Olumide,M,100,0,115,115
Amiriah,F,100,16,0,16
Nikelle,F,100,112,0,112
Kristi,F,100,75636,138,75774
Marvelle,M,63,36,62,98
Aahaan,M,100,0,12,12
Tyrelle,M,98,16,763,779
Mckye,M,100,0,12,12
Cindra,F,100,545,0,545
Zakry,M,100,0,244,244
Kalif,M,100,0,380,380
Jah,M,100,0,169,169
Jetzabel,F,100,39,0,39
Jeraldyn,F,100,6,0,6
Kailye,F,100,21,0,21
Darvens,M,100,0,5,5
Jermery,M,100,0,110,110
Traxton,M,100,0,86,86
Zacchary,M,100,0,138,138
Leita,F,100,220,0,220
Rolinda,F,100,409,0,409
Kamia,F,100,1204,0,1204
Mairani,F,100,54,0,54
Roderrick,M,100,0,46,46
Kenlynn,F,100,49,0,49
Nazeef,M,100,0,15,15
Zigmond,M,100,0,5,5
Olinda,F,100,387,0,387
Rhia,F,100,93,0,93
Gurneet,F,100,56,0,56
Qiana,F,100,2538,0,2538
Miyu,F,100,164,0,164
Akeia,F,100,183,0,183
Danell,F,76,1234,386,1620
Ray,M,99,1156,80982,82138
Wilsie,F,100,6,0,6
Seray,F,100,5,0,5
Dominck,M,100,0,15,15
Naibe,F,100,22,0,22
Liloa,M,100,0,5,5
Raiesha,F,100,6,0,6
Rinka,F,100,15,0,15
Dyman,F,100,16,0,16
Onathan,M,100,0,47,47
Latonia,F,100,5093,16,5109
Jerae,F,91,61,6,67
Shauntice,F,100,26,0,26
Karrena,F,100,11,0,11
Alanis,F,100,2267,0,2267
Delcia,F,100,66,0,66
Joud,F,80,88,22,110
Angelis,F,92,416,35,451
Rinya,F,100,5,0,5
Adebisi,F,100,10,0,10
Kelianne,F,100,6,0,6
Darbie,F,100,391,0,391
Cogan,M,100,0,47,47
Sharmeen,F,100,58,0,58
Anirudh,M,100,0,1146,1146
Waad,F,100,18,0,18
Jaliza,F,100,101,0,101
Yaden,M,100,0,50,50
Dequantae,M,100,0,12,12
Djavon,M,100,0,5,5
Janalis,F,100,5,0,5
Nijah,F,89,1122,142,1264
Latrell,M,87,525,3370,3895
Darcee,F,100,518,0,518
Yarisley,F,100,5,0,5
Jaleesha,F,100,51,0,51
Caylon,M,95,12,226,238
Magalene,F,100,83,0,83
Madinah,F,100,166,0,166
Jayceyon,M,100,0,13,13
Nali,F,100,23,0,23
Araz,M,100,0,5,5
Lanekia,F,100,5,0,5
Katha,F,100,243,0,243
Markasia,F,100,66,0,66
Sarra,F,100,627,0,627
Adilene,F,100,4685,7,4692
Zaniiya,F,100,5,0,5
Toynelle,F,100,6,0,6
Heili,F,100,5,0,5
Llona,F,100,7,0,7
Jazmyne,F,100,4910,0,4910
Trang,F,99,955,8,963
Jazzlyn,F,100,2664,0,2664
Adylene,F,100,248,0,248
Navie,F,100,83,0,83
Kujtim,M,100,0,16,16
Jasenia,F,100,144,0,144
Hajun,M,100,0,7,7
Dalesha,F,100,63,0,63
Anri,M,100,0,5,5
Jakea,F,100,25,0,25
Parleen,F,100,5,0,5
Hadleyann,F,100,5,0,5
Keaghlan,F,100,7,0,7
Mumina,F,100,25,0,25
Tikina,F,100,7,0,7
Leylan,M,100,0,5,5
Faya,F,100,6,0,6
Tiffiany,F,100,838,0,838
Garrion,M,100,0,19,19
Tyrun,M,100,0,10,10
Eray,M,100,0,19,19
Siobhain,F,100,22,0,22
Gecenia,F,100,5,0,5
Tynell,M,100,0,112,112
Telise,F,100,5,0,5
Abdulsamad,M,100,0,5,5
Deelan,M,100,0,7,7
Okey,M,100,0,310,310
Lastasia,F,100,5,0,5
Quwanna,F,100,6,0,6
Glyndia,F,100,5,0,5
Maja,F,100,1529,0,1529
Theressa,F,100,1256,0,1256
Jocko,M,100,0,5,5
Cher,F,94,1687,110,1797
Casta,F,100,6,0,6
Rana,F,98,3878,72,3950
Maiza,F,100,10,0,10
Chistine,F,100,68,0,68
Robson,M,100,0,106,106
Vernis,M,88,6,43,49
Claron,M,100,0,5,5
Tripp,M,100,0,3164,3164
Aizleigh,F,100,5,0,5
Ishman,M,100,0,6,6
Johntavius,M,100,0,83,83
Keatin,M,100,0,75,75
Pala,F,100,18,0,18
Moutaz,M,100,0,5,5
Kattie,F,100,2303,0,2303
Luren,F,100,5,0,5
Eryx,M,100,0,57,57
Seton,M,79,10,38,48
Chelbe,F,100,11,0,11
Jovaan,M,100,0,5,5
Tarita,F,100,363,0,363
Tashera,F,100,121,0,121
Yehuda,M,100,0,4690,4690
Shanequa,F,100,1874,0,1874
Bennie,M,92,1618,17925,19543
Darrell,M,99,847,121622,122469
Shakiah,F,100,157,0,157
Deby,F,100,258,0,258
Nichollette,F,100,25,0,25
Cristen,F,95,2630,126,2756
Cesar,M,100,315,67233,67548
Mekeia,F,100,5,0,5
Akhir,M,100,0,16,16
Muzzammil,M,100,0,19,19
Ellin,F,100,161,0,161
Chatoya,F,100,19,0,19
Sidi,M,100,0,86,86
Brett,M,98,3245,155801,159046
Chantra,F,65,35,19,54
Kamaryn,F,100,123,0,123
Yowanda,F,100,23,0,23
Kanysha,F,100,12,0,12
Latiah,F,100,15,0,15
Maygan,F,100,607,0,607
Raianne,F,100,20,0,20
Riki,F,72,1078,415,1493
Trey,M,100,97,35865,35962
Wakefield,M,100,0,5,5
Akintunde,M,100,0,27,27
Tajay,M,86,10,64,74
Jakhiya,F,100,71,0,71
Laurenmarie,F,100,23,0,23
Maximillien,M,100,0,6,6
Goldie,F,98,3824,61,3885
Nataleah,F,100,57,0,57
Keawe,M,100,0,94,94
Jehna,F,100,17,0,17
Shakeithia,F,100,17,0,17
Bradden,M,100,0,101,101
Rintaro,M,100,0,15,15
Amillia,F,100,412,0,412
Filbert,M,100,0,197,197
Sirius,M,100,0,229,229
Demarqus,M,100,0,58,58
Nikkeya,F,100,16,0,16
Shakiea,F,100,21,0,21
Leighan,F,100,22,0,22
Veralee,F,100,17,0,17
Kaleisha,F,100,149,0,149
Stori,F,100,471,0,471
Triston,M,97,274,10494,10768
Allana,F,100,2484,0,2484
Herlinda,F,100,2511,0,2511
Ollice,M,100,0,5,5
Richardine,F,100,38,0,38
Eriannah,F,100,5,0,5
Lyniyah,F,100,18,0,18
Jacqueze,M,100,0,5,5
Therron,M,100,0,234,234
Alece,F,100,84,0,84
Affinity,F,100,5,0,5
Chana,F,100,9835,0,9835
Taimane,F,100,109,0,109
Jerauld,M,100,0,27,27
Lyanne,F,100,373,0,373
Kambel,F,100,10,0,10
Ayvani,F,100,5,0,5
Hasin,M,100,0,5,5
Neola,F,100,34,0,34
Makalah,F,100,629,0,629
Holley,F,99,3928,57,3985
Dysen,M,100,0,78,78
Taheem,M,100,0,209,209
Estelle,F,100,6581,0,6581
Laudan,F,100,5,0,5
Deonka,F,100,34,0,34
Joleta,F,100,31,0,31
Ezmariah,F,100,11,0,11
Kiyra,F,100,88,0,88
Basia,F,100,349,0,349
Jatorian,M,100,0,62,62
Kennedie,F,100,1124,0,1124
Atiana,F,100,500,0,500
Keaira,F,100,1783,0,1783
Ej,M,100,0,186,186
Estephen,M,100,0,30,30
Tyvone,M,100,0,25,25
Bluma,F,100,193,0,193
Merilyn,F,100,739,0,739
Nelsa,F,100,33,0,33
Tamboura,M,71,5,12,17
Mamoun,M,100,0,22,22
Thomasenia,F,100,32,0,32
Stratos,M,100,0,5,5
Snyder,M,100,0,89,89
Deklynn,F,100,44,0,44
Lindaa,F,100,5,0,5
Eames,M,100,0,44,44
Jeriyah,F,100,127,0,127
Mirriam,F,100,66,0,66
Antavia,F,100,182,0,182
Husam,M,100,0,343,343
Zeus,M,100,0,934,934
Luisana,F,100,517,0,517
Sarde,F,100,31,0,31
Azuriah,M,100,0,50,50
Crayton,M,100,0,401,401
Zanteria,F,100,5,0,5
Laven,M,100,0,11,11
Nixzaliz,F,100,7,0,7
Rozanna,F,100,341,0,341
Shynell,F,100,10,0,10
Darquisha,F,100,5,0,5
Kamien,M,100,0,6,6
Takeara,F,100,5,0,5
Jaterrion,M,100,0,35,35
Alancia,F,100,9,0,9
Jaswiry,F,100,7,0,7
Floy,F,95,242,13,255
Lennyn,M,60,44,65,109
Nanetta,F,100,176,0,176
Muskaan,F,100,260,0,260
Kasi,F,99,2215,26,2241
Leocadia,F,100,5,0,5
Deyvon,M,100,0,51,51
Pranith,M,100,0,14,14
Tenicia,F,100,139,0,139
Reyan,M,93,10,126,136
Elliauna,F,100,13,0,13
Maureen,F,100,99359,238,99597
Yecica,F,100,48,0,48
Amaire,M,100,0,6,6
Khash,M,100,0,5,5
Fantashia,F,100,120,0,120
Linaya,F,100,53,0,53
Anferny,M,100,0,18,18
Seletha,F,100,55,0,55
Kayvin,M,100,0,27,27
Shandy,F,86,728,115,843
Luara,F,100,61,0,61
Makensley,F,100,21,0,21
Gradyn,M,100,0,185,185
Evaly,F,100,23,0,23
Atreal,M,100,0,16,16
Raina,F,100,8975,0,8975
Jadavion,M,100,0,66,66
Emytt,M,100,0,5,5
Tangla,F,100,36,0,36
Brittlee,F,100,13,0,13
Metta,F,100,171,0,171
Rajohn,M,100,0,85,85
Chanae,F,100,406,0,406
Eleyana,F,100,5,0,5
Jayleah,F,100,110,0,110
Lachara,F,100,5,0,5
Inasia,F,100,27,0,27
Yanichel,F,100,11,0,11
Keiyonna,F,100,29,0,29
Naheem,M,100,0,319,319
Ersilia,F,100,5,0,5
Sravan,M,100,0,7,7
Khyree,M,99,10,784,794
Lexandria,F,100,5,0,5
Ronniece,F,100,5,0,5
Exzander,M,100,0,5,5
Saraly,F,100,16,0,16
Maricela,F,100,12346,56,12402
Rossmary,F,100,5,0,5
Rayelynn,F,100,49,0,49
Jabrae,M,100,0,5,5
Ayanda,F,100,6,0,6
Montavious,M,100,0,861,861
Dev,M,100,0,1861,1861
Rukiya,F,100,282,0,282
Makail,M,100,0,144,144
Saleta,F,100,20,0,20
Viridiana,F,100,4004,5,4009
Gaynel,F,100,98,0,98
Trystian,M,100,0,167,167
Raana,F,100,5,0,5
Je,M,100,0,10,10
Jaiwan,M,100,0,6,6
Sheenah,F,100,86,0,86
Rajesh,M,100,0,683,683
Donne,F,61,90,58,148
Tenaja,F,100,29,0,29
Chrsitine,F,100,11,0,11
Sheyann,F,100,120,0,120
Lienna,F,100,5,0,5
Marcita,F,100,39,0,39
Tijuana,F,100,1336,0,1336
Ricoh,M,100,0,7,7
Skylette,F,100,7,0,7
Laynah,F,100,19,0,19
Charilyn,F,100,5,0,5
Kamellia,F,100,6,0,6
Berkleigh,F,100,163,0,163
Mclaren,M,100,0,37,37
Neylan,F,58,43,31,74
Shakethia,F,100,15,0,15
Akari,F,71,414,166,580
Aleecia,F,100,599,0,599
Jorgie,F,100,23,0,23
Satomi,F,100,63,0,63
Auttumn,F,100,5,0,5
Fatimazahra,F,100,31,0,31
Parmida,F,100,21,0,21
Perrion,M,100,0,167,167
Velena,F,100,56,0,56
Shellby,F,100,481,0,481
Vallon,F,69,22,10,32
Toie,F,100,6,0,6
Baruch,M,100,0,1324,1324
Alphonsus,M,100,0,42,42
Amera,F,100,764,0,764
Jazahria,F,100,13,0,13
Maribelle,F,100,618,0,618
Scarleth,F,100,326,0,326
Rafia,F,100,94,0,94
Sallyanne,F,100,68,0,68
Annan,M,100,0,26,26
Manual,M,100,0,524,524
Kemaree,M,100,0,16,16
Chanya,F,100,187,0,187
Hunter,M,95,10634,204084,214718
Labrian,M,100,0,105,105
Reggie,M,97,293,9846,10139
Antravion,M,100,0,5,5
Addeson,F,100,10,0,10
Marykathleen,F,100,83,0,83
Taneiqua,F,100,5,0,5
Izrael,M,100,0,557,557
Latha,F,100,32,0,32
Sydnii,F,100,6,0,6
Daylene,F,100,474,0,474
Mickaila,F,100,23,0,23
Sachelle,F,100,6,0,6
Kennay,F,100,5,0,5
Riti,F,100,78,0,78
Cathan,M,100,0,87,87
Mazie,F,100,1974,0,1974
Salli,F,100,533,0,533
Ruqaiyah,F,100,45,0,45
Talyn,F,52,731,676,1407
Kaila,F,100,13195,0,13195
Kathreen,F,100,241,0,241
Tahra,F,100,147,0,147
Calin,M,80,223,892,1115
Spontaneous,F,100,6,0,6
Sahvanna,F,100,159,0,159
Danilo,M,100,0,2578,2578
Dewain,M,100,0,371,371
Brynlie,F,100,485,0,485
Lecedric,M,100,0,16,16
Geral,M,62,46,76,122
Rokia,F,100,83,0,83
Artavious,M,100,0,423,423
Jazzmond,F,100,5,0,5
Keydan,M,100,0,20,20
Haseena,F,100,10,0,10
Deryk,M,100,0,719,719
Chervonne,F,100,7,0,7
Zethan,M,100,0,52,52
Orlie,M,100,0,29,29
Genavive,F,100,84,0,84
Modupeoluwa,F,100,5,0,5
Candee,F,100,813,0,813
Deshelia,F,100,24,0,24
Priscille,F,100,43,0,43
Elisey,M,100,0,24,24
Topanga,F,100,468,0,468
Thade,M,100,0,27,27
Alyssaann,F,100,23,0,23
Nimat,F,100,11,0,11
Eldena,F,100,7,0,7
Sohail,M,100,0,345,345
Jibri,M,100,0,247,247
Ilianne,F,100,5,0,5
Alysen,F,100,418,0,418
Chardai,F,100,127,0,127
Milayah,F,100,83,0,83
Aquita,F,100,67,0,67
Myosha,F,100,102,0,102
Heith,M,100,0,572,572
Jesmin,F,100,12,0,12
Osmin,M,100,0,386,386
Khol,M,100,0,20,20
Nadasia,F,100,11,0,11
Dooley,M,100,0,5,5
Kaillou,M,100,0,25,25
Jerik,M,100,0,159,159
Neghan,F,100,5,0,5
Twyman,M,100,0,7,7
Reanna,F,100,5389,0,5389
Kamela,F,100,695,0,695
Eliajah,M,100,0,52,52
Cornel,M,100,0,870,870
Yeidy,F,100,5,0,5
Elvedin,M,100,0,12,12
Wanona,F,100,52,0,52
Reid,M,98,593,25224,25817
Golden,M,68,411,859,1270
Braxtan,M,100,0,26,26
Krisalynn,F,100,25,0,25
Acxel,M,100,0,196,196
Khriz,M,100,0,178,178
Trenny,F,100,33,0,33
Tarnisha,F,100,397,0,397
Jailynn,F,97,1689,44,1733
Baber,M,100,0,6,6
Ean,M,100,0,4848,4848
Jaeshawn,M,100,0,138,138
Paisyn,F,100,115,0,115
Suhaan,M,100,0,101,101
Suhur,F,100,5,0,5
Elliya,F,100,13,0,13
Shameik,M,100,0,5,5
Kynsey,F,100,23,0,23
Hamlet,M,100,0,156,156
Cedriana,F,100,32,0,32
Dusten,M,100,0,1350,1350
Kaitland,F,100,218,0,218
Nakedra,F,100,33,0,33
Jude,M,95,1530,26388,27918
Khamyah,F,100,31,0,31
Shadon,F,57,44,33,77
Valerian,M,100,0,58,58
Yakina,F,100,10,0,10
Mansoor,M,100,0,236,236
Mardarius,M,100,0,32,32
Jowanda,F,100,114,0,114
Elahni,F,100,11,0,11
Sophyia,F,100,6,0,6
Paityn,F,99,3730,24,3754
Garcia,M,91,36,366,402
Natacha,F,100,1360,0,1360
Jadius,M,100,0,6,6
Ngozichukwu,F,100,5,0,5
Kadezha,F,100,5,0,5
Mordekai,M,100,0,13,13
Jaquez,M,100,0,1915,1915
Alixzandria,F,100,6,0,6
Mikaylie,F,100,27,0,27
Treyden,M,100,0,361,361
Jalexia,F,100,143,0,143
Maddy,F,100,481,0,481
Mikalla,F,100,16,0,16
Gedeon,M,100,0,74,74
Yacov,M,100,0,28,28
Laricka,F,100,5,0,5
Uthman,M,100,0,130,130
Carmelyn,F,100,8,0,8
Jhanae,F,100,133,0,133
Thomasina,F,100,2393,0,2393
Airianna,F,100,476,0,476
Adrielle,F,100,628,0,628
Nayvi,F,100,5,0,5
Tishawna,F,100,78,0,78
Keyari,F,96,117,5,122
Quaneeka,F,100,5,0,5
Murali,M,100,0,5,5
Sisqo,M,100,0,9,9
Boran,M,100,0,7,7
Melissaann,F,100,197,0,197
Angell,F,78,453,128,581
Tequela,F,100,5,0,5
Thrisha,F,100,18,0,18
Capricia,F,100,267,0,267
Zaniyha,F,100,33,0,33
Chandlar,F,62,93,56,149
Reiana,F,100,74,0,74
Romelo,M,100,0,629,629
Sherna,F,100,21,0,21
Adalen,F,100,25,0,25
Jahia,F,100,22,0,22
Danautica,F,100,5,0,5
Emalea,F,100,112,0,112
Ryanjoseph,M,100,0,29,29
Dwright,M,100,0,29,29
Wayna,F,100,44,0,44
Rae,F,97,11345,309,11654
Aristidis,M,100,0,63,63
Twilia,F,100,71,0,71
Rowe,M,100,0,76,76
Yurani,F,100,5,0,5
Nephateria,F,100,21,0,21
Ixchel,F,100,700,0,700
Leena,F,100,3421,0,3421
Mckinnon,M,94,5,76,81
Tysha,F,100,853,0,853
Kenichi,M,100,0,90,90
Cielita,F,100,31,0,31
Mekkhi,M,100,0,6,6
Gweneth,F,100,679,0,679
Malaiyah,F,100,131,0,131
Chellsey,F,100,52,0,52
Sayid,M,100,0,129,129
Maryhelen,F,100,625,0,625
Gadge,M,100,0,159,159
Sherwanda,F,100,58,0,58
Jiwon,F,100,20,0,20
Tanvi,F,100,1586,0,1586
Oluseun,M,100,0,5,5
Tylar,M,57,1112,1498,2610
Fritz,M,100,0,3200,3200
Ann,F,100,220635,599,221234
Coleby,M,100,0,225,225
Bravery,M,86,5,30,35
Billy,M,99,2224,179937,182161
Kawhi,M,100,0,32,32
Iysha,F,100,92,0,92
Giang,M,84,12,63,75
Anana,F,100,22,0,22
Andreyah,F,100,52,0,52
Shantell,F,99,5022,26,5048
Rusbel,M,100,0,47,47
Brittni,F,100,5985,6,5991
Decole,F,100,5,0,5
Zakoria,F,100,17,0,17
Muzammil,M,100,0,92,92
Athaniel,M,100,0,23,23
Rexanna,F,100,102,0,102
Katriena,F,100,12,0,12
Jamily,F,100,6,0,6
Anderia,F,100,106,0,106
Nannette,F,100,4548,0,4548
Naylani,F,100,201,0,201
Lauretta,F,100,2487,0,2487
Daryell,M,100,0,8,8
Cabrielle,F,100,21,0,21
Alona,F,100,2254,0,2254
Myria,F,100,482,0,482
Desirrae,F,100,6,0,6
Heraldo,M,100,0,38,38
Thurza,F,100,5,0,5
Alyiana,F,100,19,0,19
Raedon,M,100,0,5,5
Marlean,F,100,78,0,78
Viveca,F,100,413,0,413
Georgan,F,100,11,0,11
Hodari,M,100,0,75,75
Magenta,F,100,191,0,191
Marian,F,99,31302,302,31604
Nakila,F,100,16,0,16
Zadin,M,100,0,82,82
Shallyn,F,100,85,0,85
Esmerie,F,100,11,0,11
Alexyss,F,100,535,0,535
Graham,M,100,113,31146,31259
Ariano,M,100,0,23,23
Antoino,M,100,0,505,505
Dejanay,F,100,201,0,201
Earsel,M,100,0,5,5
Zeidan,M,100,0,5,5
Fahtima,F,100,6,0,6
Sarhiya,F,100,6,0,6
Magean,F,100,20,0,20
Sanaiyah,F,100,110,0,110
Tadan,M,100,0,114,114
Keivonte,M,100,0,8,8
Iyan,M,100,0,202,202
Jiro,M,100,0,114,114
Charliene,F,100,25,0,25
Caanan,M,100,0,24,24
Alyra,F,100,153,0,153
Zamzam,F,100,163,0,163
Rohin,M,100,0,313,313
Sherquita,F,100,5,0,5
Bedar,F,100,5,0,5
Diavionne,F,100,16,0,16
Merril,M,70,55,128,183
Tyre,M,97,50,1859,1909
Jazzanae,F,100,5,0,5
Natheniel,M,100,0,10,10
Sreshta,F,100,82,0,82
Joette,F,100,1632,0,1632
Susan,F,100,861919,1927,863846
Maryjean,F,100,655,0,655
Delance,M,100,0,95,95
Janiyla,F,100,209,0,209
Guinn,M,100,0,11,11
Knightley,F,69,22,10,32
Nakaria,F,100,12,0,12
Demosthenes,M,100,0,22,22
Dantrel,M,100,0,19,19
Ova,M,61,16,25,41
Quaneisha,F,100,354,0,354
Ageliki,F,100,11,0,11
Mishaun,M,100,0,14,14
Yeraldine,F,100,81,0,81
Aranxa,F,100,16,0,16
Horlando,M,100,0,18,18
Waldine,F,100,10,0,10
Katarzyna,F,100,681,0,681
Tiffancy,F,100,48,0,48
Alvion,M,100,0,16,16
Jaziah,M,53,587,662,1249
Dajoure,M,100,0,5,5
Tulani,F,100,63,0,63
Zendy,F,100,5,0,5
Yuleimy,F,100,20,0,20
Tyrianne,F,100,7,0,7
Vasu,M,100,0,57,57
Haruko,F,100,5,0,5
Kimaree,F,100,14,0,14
Shontavia,F,100,261,0,261
Derome,M,100,0,11,11
Nancianne,F,100,5,0,5
Shaquette,F,100,15,0,15
Thearthur,M,100,0,5,5
Camen,M,85,10,55,65
Lyandra,F,100,31,0,31
Zeilin,F,100,6,0,6
Dianney,F,100,8,0,8
Hend,F,100,54,0,54
Noey,M,100,0,29,29
Maliky,M,100,0,46,46
Airica,F,100,141,0,141
Giovonni,M,100,0,885,885
Legina,F,100,43,0,43
Cianne,F,100,46,0,46
Braelan,M,100,0,32,32
Nikhia,F,100,12,0,12
Jetaime,F,100,135,0,135
Tatanishia,F,100,5,0,5
Etonya,F,100,5,0,5
Kairyn,M,78,10,35,45
Alexionna,F,100,10,0,10
Jasonpaul,M,100,0,5,5
Zakyla,F,100,127,0,127
Alvetta,F,100,35,0,35
Marquil,M,100,0,53,53
Treyvian,M,100,0,37,37
Carmino,M,100,0,5,5
Lemya,F,100,62,0,62
Yumeka,F,100,46,0,46
Kysia,F,100,5,0,5
Tyiona,F,100,33,0,33
Abelina,F,100,328,0,328
Alantra,F,100,64,0,64
Lluviana,F,100,6,0,6
Tarasha,F,100,52,0,52
Shameerah,F,100,10,0,10
Pat,M,59,8457,12036,20493
Aneiya,F,100,6,0,6
Helina,F,100,390,0,390
Aliesha,F,100,852,0,852
Shaynee,F,100,58,0,58
Shardae,F,100,1399,0,1399
Bretton,M,100,0,993,993
Solmari,F,100,12,0,12
Maliha,F,100,938,0,938
Ryesha,F,100,41,0,41
Kenecia,F,100,68,0,68
Briani,F,100,145,0,145
Reiko,F,97,431,12,443
Zarra,F,100,27,0,27
Tujuan,M,100,0,5,5
Jameion,M,100,0,24,24
Tashard,M,100,0,6,6
Cherith,F,100,515,0,515
Janelys,F,100,213,0,213
Ordie,M,100,0,5,5
Hisham,M,100,0,641,641
Tristina,F,100,437,0,437
Byra,F,100,5,0,5
Kaylin,F,97,16583,509,17092
Darr,M,100,0,52,52
Orryn,M,100,0,5,5
Helayna,F,100,266,0,266
Sanja,F,100,122,0,122
Pavlos,M,100,0,92,92
Kahlyn,F,100,161,0,161
Briela,F,100,21,0,21
Matej,M,100,0,89,89
Kymm,F,100,49,0,49
Tamonica,F,100,39,0,39
Henach,M,100,0,6,6
Andrene,F,100,25,0,25
Devyn,F,54,7041,6000,13041
Yudelka,F,100,29,0,29
Lis,F,100,269,0,269
Grimm,M,100,0,12,12
Cheyeanne,F,100,145,0,145
Apryl,F,100,2884,0,2884
Alenna,F,100,303,0,303
Daxtin,M,100,0,51,51
Evynne,F,100,37,0,37
Kreelynn,F,100,5,0,5
Bill,M,100,108,58279,58387
Heahter,F,100,14,0,14
Karlisha,F,100,156,0,156
Coalson,M,100,0,5,5
Marinn,F,100,26,0,26
Thalamus,M,100,0,15,15
Flicia,F,100,5,0,5
Bodan,M,100,0,5,5
Jimmie,M,91,4105,39264,43369
Rubyrose,F,100,5,0,5
Janina,F,100,2234,0,2234
Karlee,F,100,10914,0,10914
Arian,M,74,1311,3690,5001
Eslem,F,100,5,0,5
Jaquanna,F,100,185,0,185
Mollyanne,F,100,26,0,26
Celeena,F,100,18,0,18
Reinna,F,100,5,0,5
Shulamit,F,100,86,0,86
Dalesa,F,100,5,0,5
Nonah,F,100,5,0,5
Avi,M,89,395,3133,3528
Katheryne,F,100,1345,0,1345
Shreeya,F,100,445,0,445
Olufemi,M,100,0,345,345
Kaynon,M,100,0,14,14
Tierria,F,100,78,0,78
Asiane,F,100,5,0,5
Secia,F,100,6,0,6
Uilani,F,100,97,0,97
Kuiana,F,100,10,0,10
Lunda,F,100,11,0,11
Julixa,F,100,5,0,5
Lional,M,100,0,84,84
Vivie,F,100,24,0,24
Sahri,F,100,6,0,6
Levarr,M,100,0,14,14
Araiya,F,100,102,0,102
Jerrold,M,100,0,5040,5040
Kyer,M,100,0,5,5
Salamasina,F,100,17,0,17
Nolon,M,100,0,27,27
Cotie,F,51,18,17,35
Lerry,M,100,0,49,49
Sheriff,M,100,0,85,85
Antwonette,F,100,114,0,114
Sanders,M,99,6,1024,1030
Keeng,M,100,0,6,6
Donica,F,100,802,0,802
Baylan,M,100,0,26,26
Richa,F,100,618,0,618
Sireen,F,100,133,0,133
Oliver,M,100,219,76246,76465
Eliam,M,100,0,432,432
Londynmarie,F,100,6,0,6
Anjaly,F,100,7,0,7
Shayndel,F,100,5,0,5
Cyndie,F,100,531,0,531
Cheris,F,100,149,0,149
Mahlena,F,100,5,0,5
Elmira,F,100,713,0,713
Shy,F,93,366,26,392
Machell,F,100,520,0,520
Dontasia,F,100,127,0,127
Kalexy,F,100,5,0,5
Saribel,F,100,22,0,22
Ariannie,F,100,79,0,79
Judylynn,F,100,5,0,5
Liad,M,100,0,50,50
Lux,F,80,621,153,774
Nataile,F,100,5,0,5
Eugen,M,100,0,68,68
Demaj,M,100,0,26,26
Breilyn,F,100,23,0,23
Ash,M,97,26,738,764
Mylynn,F,100,60,0,60
Dally,F,100,139,0,139
Nusaibah,F,100,20,0,20
Wrenna,F,100,43,0,43
Rahshon,M,100,0,18,18
Guadlupe,F,61,27,17,44
Geovanny,M,100,0,2319,2319
Sharisa,F,100,103,0,103
Shaelynne,F,100,38,0,38
Ephrim,M,100,0,5,5
Youssif,M,100,0,21,21
Nazier,M,100,0,371,371
Ilyas,M,100,0,835,835
Jatniel,M,100,0,141,141
Wilma,F,100,19423,55,19478
Ayotunde,M,100,0,23,23
Carisma,F,100,494,0,494
Suezanne,F,100,8,0,8
Daunte,M,100,0,1452,1452
Elizebath,F,100,38,0,38
Christena,F,100,1384,0,1384
Samayiah,F,100,12,0,12
Ayjah,F,100,83,0,83
Marcelia,F,100,91,0,91
Aleeshia,F,100,6,0,6
Shreyansh,M,100,0,82,82
Shanez,F,100,5,0,5
Knoxley,M,100,0,6,6
Chrisangel,M,100,0,80,80
Paislynn,F,100,26,0,26
Briyona,F,100,47,0,47
Jhonna,F,100,5,0,5
Dhvani,F,100,19,0,19
Chesky,M,100,0,206,206
Termain,M,100,0,11,11
Rolin,M,100,0,138,138
Zamanta,F,100,15,0,15
Tianny,F,100,5,0,5
Lekeshia,F,100,404,0,404
Markida,F,100,33,0,33
Donnis,F,57,347,259,606
Phinnaeus,M,100,0,13,13
Samayia,F,100,15,0,15
Wynonia,F,100,41,0,41
Trendarius,M,100,0,5,5
Ronn,M,100,0,593,593
Diem,F,92,413,37,450
Rekiya,F,100,12,0,12
Dekyra,F,100,27,0,27
Koray,M,100,0,94,94
Debroh,F,100,65,0,65
Tanicha,F,100,5,0,5
Kanaja,F,100,5,0,5
Jamellah,F,100,22,0,22
Olene,F,100,68,0,68
Yamira,F,100,155,0,155
Kaomi,F,100,20,0,20
Shaketia,F,100,30,0,30
Laylonie,F,100,86,0,86
Konda,F,100,36,0,36
Brigitte,F,100,8344,0,8344
Natrone,M,100,0,35,35
Emaline,F,100,624,0,624
Royale,F,55,299,244,543
Zobia,F,100,21,0,21
Joaopaulo,M,100,0,11,11
Lisi,F,100,24,0,24
Lytisha,F,100,16,0,16
Jequarius,M,100,0,6,6
Nastasia,F,100,451,0,451
Deegan,M,100,0,2143,2143
Jacan,M,100,0,15,15
Asaun,M,100,0,18,18
Aditya,M,100,5,4202,4207
Atalie,F,100,560,0,560
Charea,F,100,11,0,11
Lamiya,F,100,570,0,570
Mckaylen,F,100,6,0,6
Rodrigues,M,100,0,105,105
Luretha,F,100,176,0,176
Van,M,93,1228,16396,17624
Vershawn,M,94,5,80,85
Coston,M,100,0,24,24
Amarieon,M,100,0,12,12
Analyah,F,100,62,0,62
Jzabehl,F,100,6,0,6
Detric,M,99,5,415,420
Aayushi,F,100,195,0,195
Jaanvi,F,100,88,0,88
Shereka,F,100,501,0,501
Vihaa,F,100,6,0,6
Tybee,F,100,17,0,17
Michelin,F,100,20,0,20
Josse,M,100,0,10,10
Harvel,M,100,0,41,41
Betti,F,100,395,0,395
Jimmya,F,100,28,0,28
Chalen,M,100,0,31,31
Jaell,M,100,0,5,5
Denver,M,89,988,8130,9118
Emran,M,100,0,204,204
Rhaegan,F,100,39,0,39
Satvika,F,100,36,0,36
Michelli,F,100,18,0,18
Kelsy,F,99,2979,39,3018
Anthia,F,100,36,0,36
Maricrus,F,100,5,0,5
Aubrina,F,100,74,0,74
Bud,M,100,0,2705,2705
Cici,F,100,63,0,63
Adomas,M,100,0,6,6
Daye,F,100,10,0,10
Didra,F,100,5,0,5
Jahod,M,100,0,41,41
Nicci,F,100,273,0,273
Chada,F,100,5,0,5
Anglie,F,100,45,0,45
Kasaan,M,100,0,30,30
Nelah,F,100,25,0,25
Corren,F,83,25,5,30
Travyon,M,100,0,26,26
Francisc,M,100,0,8,8
Antion,M,100,0,190,190
Fredine,F,100,5,0,5
Esveidy,F,100,53,0,53
Trekwon,M,100,0,11,11
Bryonna,F,100,851,0,851
Chezare,M,75,5,15,20
Heinz,M,100,0,396,396
Shaista,F,100,10,0,10
Yohanan,M,100,0,28,28
Yalexa,F,100,112,0,112
Tamerah,F,100,30,0,30
Doneen,F,100,59,0,59
Miamour,F,100,5,0,5
Patrik,M,100,0,617,617
Greidi,F,100,5,0,5
Markhia,F,100,18,0,18
Antanisha,F,100,102,0,102
Jackelyn,F,100,3623,0,3623
Sereina,F,100,5,0,5
Cierria,F,100,128,0,128
Carlisia,F,100,61,0,61
Leshly,F,100,29,0,29
Jamonica,F,100,246,0,246
Katine,F,100,31,0,31
Lucyna,F,100,8,0,8
Shaenna,F,100,6,0,6
Race,M,100,0,1265,1265
Raela,F,100,133,0,133
Zyere,M,100,0,150,150
Bich,F,100,142,0,142
Keisha,F,100,21745,44,21789
Prenell,M,100,0,16,16
Gailynn,F,100,5,0,5
Yianna,F,100,65,0,65
Chaquille,M,81,5,22,27
Evoleht,F,100,60,0,60
Anneisha,F,100,20,0,20
Lanye,F,100,5,0,5
Exar,M,100,0,5,5
Seandre,M,100,0,5,5
Nakieya,F,100,5,0,5
Nikkole,F,100,829,0,829
Aley,F,85,33,6,39
Jansen,M,89,209,1650,1859
Jihaad,M,100,0,68,68
Airlie,F,100,33,0,33
Alexxes,F,100,5,0,5
Madelina,F,100,226,0,226
Nevina,F,100,39,0,39
Rounak,M,100,0,11,11
Ladonna,F,100,16481,0,16481
Decola,F,100,11,0,11
Kijuan,M,100,0,297,297
Crystl,F,100,27,0,27
Khrystin,F,100,12,0,12
Garine,F,100,5,0,5
Sykora,F,100,6,0,6
Andamo,M,100,0,15,15
Antwyne,M,100,0,64,64
Janicka,F,100,10,0,10
Davyan,M,100,0,24,24
Anacani,F,100,33,0,33
Dominisha,F,100,58,0,58
Lawence,M,100,0,36,36
Amidala,F,100,7,0,7
Sharonne,F,100,196,0,196
Vasilike,F,100,13,0,13
Gearald,M,100,0,16,16
Levell,M,100,0,530,530
Aury,F,95,87,5,92
Zaydien,M,100,0,11,11
Paley,F,100,17,0,17
Adnaan,M,100,0,37,37
Coben,M,100,0,114,114
Karise,F,100,23,0,23
Petey,M,100,0,26,26
Jiovani,M,100,0,433,433
Telly,M,95,82,1481,1563
Cevin,M,100,0,240,240
Bjorn,M,100,0,2360,2360
Chrishawna,F,100,81,0,81
Brendalynn,F,100,28,0,28
Kailiah,F,100,5,0,5
Lewyn,M,100,0,6,6
Sharianne,F,100,8,0,8
Bryauna,F,100,104,0,104
Jerricca,F,100,6,0,6
Natina,F,100,179,0,179
Anniya,F,100,206,0,206
Corielle,F,100,25,0,25
Marquiz,M,100,0,125,125
Jacquie,F,100,1044,0,1044
Kingsly,M,100,0,35,35
Abi,F,95,448,22,470
Pejmon,M,100,0,6,6
Braniah,F,100,34,0,34
Abdulbasit,M,100,0,13,13
Corvette,F,100,80,0,80
Ariabella,F,100,53,0,53
Vondella,F,100,8,0,8
Akeeyla,F,100,7,0,7
Ingemar,M,100,0,21,21
Lamecia,F,100,22,0,22
Javarius,M,100,0,757,757
Giuseppe,M,100,0,4706,4706
Shelane,F,100,23,0,23
Dearie,F,100,30,0,30
Kylynne,F,100,44,0,44
Shamarra,F,100,101,0,101
Issak,M,100,0,402,402
Shalyn,F,100,1952,0,1952
Kirolos,M,100,0,23,23
Oladimeji,M,100,0,33,33
Kariana,F,100,420,0,420
Khail,M,100,0,25,25
Chalise,F,100,222,0,222
Cleora,F,100,95,0,95
Arrietty,F,100,30,0,30
Genesse,F,100,11,0,11
Vonessa,F,100,5,0,5
Marsadie,F,100,5,0,5
Gerhard,M,100,0,811,811
Larecia,F,100,5,0,5
Raymone,M,100,0,625,625
Merianne,F,100,48,0,48
Laylie,F,100,39,0,39
Princecharles,M,100,0,5,5
Kimary,F,100,18,0,18
Lekisha,F,100,914,0,914
Damiyan,M,100,0,6,6
Nando,M,100,0,11,11
Daire,M,90,6,55,61
Arit,F,100,11,0,11
Truitt,M,100,0,651,651
Phalon,F,71,37,15,52
Crystall,F,100,408,0,408
Keathan,M,100,0,5,5
Fuad,M,100,0,393,393
Stoy,M,100,0,7,7
Greisy,F,100,8,0,8
Josabeth,F,100,17,0,17
Breyer,M,92,7,84,91
Lieselotte,F,100,5,0,5
Friend,M,100,0,5,5
Oluwaferanmi,M,71,12,30,42
Altonia,M,58,5,7,12
Jesara,F,100,5,0,5
Devlin,M,95,158,2913,3071
Margot,F,100,7281,0,7281
Manique,F,100,16,0,16
Dvid,M,100,0,288,288
Lavida,F,100,111,0,111
Lenville,M,100,0,18,18
Pariss,F,97,169,5,174
Casin,M,100,0,78,78
Melonye,F,100,10,0,10
Halli,F,100,1226,0,1226
Joana,F,100,6869,0,6869
Estefanie,F,100,504,0,504
Camdon,M,100,0,748,748
Bronsyn,M,100,0,33,33
Adra,F,100,320,0,320
Malari,F,100,35,0,35
Hollye,F,100,445,0,445
Arun,M,100,0,1246,1246
Ajayla,F,100,200,0,200
Lancer,M,100,0,186,186
Tynese,F,100,11,0,11
Virigina,F,100,6,0,6
Osker,M,100,0,10,10
Steffon,M,100,0,800,800
Charny,F,100,18,0,18
Jeriana,F,100,6,0,6
Lachaundra,F,100,10,0,10
Hashim,M,100,0,1236,1236
Randilee,F,100,31,0,31
Sarha,F,100,428,0,428
Makeya,F,100,96,0,96
Banesa,F,100,514,0,514
Gladie,F,100,5,0,5
Whitt,M,100,0,123,123
Nzinga,F,100,279,0,279
Eustolia,F,100,57,0,57
Rayhona,F,100,5,0,5
Eziyah,F,100,5,0,5
Carmine,M,96,240,5960,6200
Abilene,F,100,813,0,813
Laif,M,100,0,22,22
Leal,F,100,23,0,23
Turquoise,F,100,539,0,539
Laneya,F,100,114,0,114
Myanah,F,100,16,0,16
Trena,F,100,4684,0,4684
Kellee,F,100,3698,16,3714
Lakita,F,100,1628,0,1628
Ignacia,F,100,292,0,292
Rennie,M,60,437,669,1106
Clellan,M,100,0,5,5
Rosan,F,100,65,0,65
Valincia,F,100,63,0,63
Basha,F,100,156,0,156
Evilin,F,100,5,0,5
Johntell,M,100,0,6,6
Roniece,F,100,28,0,28
Marylou,F,100,5456,0,5456
Siddhi,F,100,246,0,246
Elijahh,M,100,0,10,10
Nura,F,100,401,0,401
Jenniver,F,100,36,0,36
Kamonte,M,100,0,88,88
Dangela,F,100,366,0,366
Inas,F,100,66,0,66
Carling,F,100,132,0,132
Reiya,F,100,5,0,5
Mehakpreet,F,100,15,0,15
Nosson,M,100,0,490,490
Sirena,F,100,2673,0,2673
Elizaberh,F,100,5,0,5
Franey,F,100,10,0,10
Gillie,M,67,11,22,33
Briunna,F,100,115,0,115
Moniesha,F,100,34,0,34
Chedva,F,100,35,0,35
Tacoma,M,81,42,176,218
Taralynn,F,100,396,0,396
Jaelianna,F,100,19,0,19
Saidy,F,100,202,0,202
Dantavius,M,100,0,36,36
Habeba,F,100,6,0,6
Bartu,M,100,0,5,5
Adryanah,F,100,5,0,5
Teka,F,100,236,0,236
Sharik,F,100,15,0,15
Jandi,F,100,155,0,155
Kaydra,F,100,132,0,132
Tiffnay,F,100,67,0,67
Fallou,M,100,0,78,78
Mandell,M,100,0,276,276
Fasha,F,100,11,0,11
Seng,M,74,84,239,323
Amand,F,100,181,0,181
Markael,M,100,0,38,38
Bryent,M,100,0,32,32
Masin,M,100,0,228,228
Ernestine,F,100,10437,16,10453
Shalaka,F,100,5,0,5
Yexalen,F,100,64,0,64
Cozette,F,100,901,0,901
Zehra,F,100,482,0,482
Izzabellah,F,100,11,0,11
Azareel,M,100,0,13,13
Verron,M,100,0,17,17
Klowey,F,100,5,0,5
Tramone,M,100,0,29,29
Quantis,M,100,0,5,5
Shaquail,F,100,25,0,25
Andrienne,F,100,308,0,308
Lataska,F,100,6,0,6
Edyta,F,100,10,0,10
Davionte,M,100,0,101,101
Katiuscia,F,100,5,0,5
Wylen,M,100,0,6,6
Jody,F,64,54035,30189,84224
Twilight,F,100,18,0,18
Jeanasia,F,100,6,0,6
Rickeisha,F,100,36,0,36
Livian,F,100,94,0,94
Romunda,F,100,54,0,54
Irah,M,55,5,6,11
Tanea,F,100,739,0,739
Kaliym,M,100,0,6,6
Dayvonne,M,100,0,5,5
Tyler,M,97,15845,569367,585212
Arlice,F,100,5,0,5
Tanai,F,100,134,0,134
Kulsum,F,100,39,0,39
Wakil,M,100,0,10,10
Georgemichael,M,100,0,17,17
Christany,F,100,22,0,22
Novalie,F,100,128,0,128
Shedricka,F,100,5,0,5
Zanthia,F,100,12,0,12
Teagan,F,78,14248,4020,18268
Eriane,F,100,23,0,23
Zadkiel,M,100,0,118,118
Kaaliyah,F,100,294,0,294
Oluwabukola,F,100,5,0,5
Bily,M,100,0,10,10
Shenaye,F,100,10,0,10
Alissha,F,100,27,0,27
Fariza,F,100,13,0,13
Leilonie,F,100,5,0,5
Chaketa,F,100,17,0,17
Kapil,M,100,0,134,134
Swayne,M,100,0,5,5
Jazae,F,100,63,0,63
Yumalay,F,100,75,0,75
Alfornia,M,100,0,11,11
Renwick,M,100,0,512,512
Adielle,F,100,10,0,10
Emraan,M,100,0,11,11
Kingsolomon,M,100,0,17,17
Malary,F,100,123,0,123
Satvik,M,100,0,320,320
Neima,F,89,41,5,46
Glo,F,100,5,0,5
Carilee,F,100,14,0,14
Skie,F,100,263,0,263
Jardin,F,58,7,5,12
Rowland,M,100,0,1534,1534
Cameka,F,100,66,0,66
Antigone,F,100,319,0,319
Tatyiana,F,100,47,0,47
Kosuke,M,100,0,46,46
Lochlann,M,100,0,122,122
Ostap,M,100,0,5,5
Jakeline,F,100,568,0,568
Taijanae,F,100,6,0,6
Alberta,F,100,9377,36,9413
Amarrie,F,100,28,0,28
Freedia,F,100,5,0,5
Jamey,M,69,2904,6505,9409
Jabary,M,100,0,11,11
Aanchal,F,100,67,0,67
Shanaya,F,100,1493,0,1493
Sioux,F,100,29,0,29
Riece,M,68,10,21,31
Dexten,M,100,0,8,8
Wilhemena,F,100,6,0,6
Gracie,F,100,47931,33,47964
Jwan,M,87,20,136,156
Bionce,F,100,8,0,8
Kaliece,F,100,5,0,5
Kyree,M,86,588,3750,4338
Mylei,F,100,157,0,157
Javeed,M,100,0,5,5
Trevelle,M,100,0,168,168
Dublyn,F,100,5,0,5
Fotima,F,100,12,0,12
Alywin,M,100,0,5,5
Blayz,M,100,0,45,45
Kanaria,F,100,23,0,23
Jazzmin,F,100,2176,0,2176
Kaido,M,100,0,5,5
Deaundrey,M,100,0,17,17
Sheletha,F,100,128,0,128
Tionne,F,89,680,80,760
Leiliany,F,100,6,0,6
Haileah,F,100,5,0,5
Tempie,F,100,326,0,326
Mackson,M,100,0,45,45
Leanard,M,100,0,102,102
Javetta,F,100,22,0,22
Won,M,100,0,97,97
Layland,M,100,0,5,5
Criselda,F,100,1530,0,1530
Connor,M,99,1485,183682,185167
Dontravius,M,100,0,20,20
Candi,F,100,7145,0,7145
Ezekiel,M,100,7,27925,27932
Snezhana,F,100,10,0,10
Dmario,M,100,0,411,411
Hulen,M,100,0,49,49
Shauntia,F,100,273,0,273
Vernelda,F,100,5,0,5
Krystah,F,100,10,0,10
Andranik,M,100,0,149,149
Diann,F,100,8080,0,8080
Macio,M,100,0,140,140
Ellyot,F,100,5,0,5
Korvin,M,100,0,131,131
Rosaura,F,100,2173,0,2173
Draike,M,100,0,5,5
Rejino,M,100,0,6,6
Madai,F,100,482,0,482
Sidny,F,100,57,0,57
Tanyika,F,100,70,0,70
Fatimat,F,100,5,0,5
Kebra,F,100,77,0,77
Girtha,F,100,28,0,28
Nashoba,M,100,0,26,26
Josecruz,M,100,0,21,21
Evanny,F,100,102,0,102
Zelina,F,100,163,0,163
Dmiracle,F,100,5,0,5
Derita,F,100,61,0,61
Kimberlei,F,100,18,0,18
Samul,M,100,0,23,23
Anastaisa,F,100,76,0,76
Felicie,F,100,30,0,30
Ashae,F,100,36,0,36
Meadow,F,100,4893,0,4893
Tearza,F,100,30,0,30
Waden,M,100,0,23,23
Starlisa,F,100,5,0,5
Jonia,F,100,95,0,95
Billal,M,100,0,137,137
Glendaly,F,100,49,0,49
Nikitta,F,100,64,0,64
Destiany,F,100,5,0,5
Klaire,F,100,1041,0,1041
Fatmeh,F,100,21,0,21
Damean,M,100,0,458,458
Jolesa,F,100,6,0,6
Meryem,F,100,288,0,288
Lehi,M,100,0,276,276
Sumi,F,100,73,0,73
Twina,F,100,7,0,7
Durrell,M,100,0,1647,1647
Betsaida,F,100,713,0,713
Tomekia,F,100,709,0,709
Mojolaoluwa,F,100,10,0,10
Devery,M,76,82,265,347
Shaquandra,F,100,169,0,169
Oluwatimileyin,M,100,0,46,46
Duuna,F,100,9,0,9
Jauier,M,100,0,5,5
Carise,F,100,15,0,15
Lashune,F,100,8,0,8
Dagger,M,100,0,5,5
Adaisia,F,100,7,0,7
Caia,F,100,357,0,357
Breslynn,F,100,10,0,10
Cid,M,100,0,170,170
Makari,M,83,72,362,434
Cande,F,100,71,0,71
Mikiyah,F,100,367,0,367
Henrika,F,100,13,0,13
Samanta,F,100,1637,0,1637
Erbey,M,100,0,10,10
Qusai,M,100,0,82,82
Daquon,M,100,0,491,491
Elisandro,M,100,0,272,272
Anyia,F,100,777,0,777
Tajha,F,100,75,0,75
Tunisha,F,100,301,0,301
Lorenna,F,100,120,0,120
Cherylynn,F,100,202,0,202
Clea,F,100,483,0,483
Dearrius,M,100,0,55,55
Atlas,M,98,34,1524,1558
Therasa,F,100,136,0,136
Davanna,F,100,91,0,91
Tanajah,F,100,289,0,289
Fulgencio,M,100,0,22,22
Abrum,M,100,0,39,39
Saad,M,100,0,1777,1777
Aubriahna,F,100,7,0,7
Rometta,F,100,16,0,16
Mauer,M,100,0,12,12
Tanaysha,F,100,142,0,142
Lilianna,F,100,5041,0,5041
Narell,M,100,0,5,5
Sophiya,F,100,168,0,168
Joy,F,99,93313,917,94230
Asteria,F,100,6,0,6
Yasmiin,F,100,5,0,5
Evianna,F,100,275,0,275
Caedon,M,100,0,350,350
Hayliee,F,100,5,0,5
Haidar,M,100,0,145,145
Kwante,M,100,0,18,18
Tiffanny,F,100,374,0,374
Nyshia,F,100,53,0,53
Bailynn,F,100,88,0,88
Novalyn,F,100,16,0,16
Drason,M,100,0,15,15
Pader,F,100,17,0,17
Shaquayla,F,100,114,0,114
Chasity,F,100,23521,23,23544
Zenaiya,F,100,5,0,5
Shafton,M,100,0,16,16
Teaira,F,100,1145,0,1145
Talbot,M,96,11,279,290
Cornell,M,99,118,8645,8763
Hina,F,100,576,0,576
Linsay,F,100,667,0,667
Eulanda,F,100,131,0,131
Carilla,F,100,11,0,11
Samil,M,100,0,64,64
Yakelin,F,100,479,0,479
Alexea,F,100,213,0,213
Chesna,F,100,45,0,45
Casheena,F,100,6,0,6
Bianica,F,100,33,0,33
Kiamani,F,100,12,0,12
Farran,F,100,74,0,74
Matilyn,F,100,707,0,707
Antionett,F,100,16,0,16
Francyne,F,100,77,0,77
Dinesh,M,100,0,167,167
Davar,M,100,0,12,12
Kehara,F,100,5,0,5
Kyrus,M,100,0,56,56
Kerrell,M,100,0,5,5
Danek,M,100,0,30,30
Mikayla,F,100,50041,11,50052
Beresford,M,100,0,5,5
Amiaha,F,100,5,0,5
Nehemia,M,100,0,35,35
Lanty,M,100,0,5,5
Lexes,F,100,36,0,36
Ivonn,F,100,7,0,7
Jabrail,M,100,0,12,12
Zaccheus,M,100,0,442,442
Latreva,F,100,22,0,22
Hawraa,F,100,68,0,68
Telethia,F,100,18,0,18
Catheryne,F,100,144,0,144
Yvone,F,100,139,0,139
Zabrina,F,100,1266,0,1266
Averie,F,98,6256,143,6399
Cairah,F,100,5,0,5
Reshaunda,F,100,5,0,5
Ahlia,F,100,132,0,132
Jaquia,F,100,70,0,70
Sreeja,F,100,107,0,107
Nayaliz,F,100,17,0,17
Rahkim,M,100,0,85,85
Kayeloni,F,100,22,0,22
Anwitha,F,100,75,0,75
Jentrie,F,100,25,0,25
Rhealynn,F,100,71,0,71
Herika,F,100,5,0,5
Sumayah,F,100,401,0,401
Rayette,F,100,130,0,130
Waldron,M,100,0,13,13
Tarrence,M,100,0,775,775
Hebron,M,80,5,20,25
Janika,F,100,749,0,749
Johnnathan,M,100,0,283,283
Vaya,F,100,29,0,29
Terina,F,100,1148,0,1148
Wilder,M,97,31,1073,1104
Moris,M,100,0,147,147
Raynav,M,100,0,11,11
Luisdiego,M,100,0,7,7
Saevion,M,100,0,25,25
Lakeyn,F,100,30,0,30
Derck,M,100,0,23,23
Babatunde,M,100,0,344,344
Daizhaun,M,100,0,7,7
Lekia,F,100,213,0,213
Judye,F,100,32,0,32
Kadijha,F,100,23,0,23
Noelany,F,100,5,0,5
Lanaya,F,100,1142,0,1142
Ginelie,F,100,12,0,12
Reia,F,100,75,0,75
Emmory,F,100,73,0,73
Danka,F,100,5,0,5
Shiniqua,F,100,95,0,95
Akaisha,F,100,63,0,63
Hykeem,M,100,0,249,249
Nakiria,F,100,5,0,5
Shaya,M,51,727,745,1472
Alayzhia,F,100,7,0,7
Rebakah,F,100,128,0,128
Heloisa,F,100,5,0,5
Joneshia,F,100,52,0,52
Summaya,F,100,7,0,7
Ashantii,F,100,21,0,21
Deneise,F,100,278,0,278
Zyashia,F,100,6,0,6
Havilland,F,100,7,0,7
Rachelleanne,F,100,5,0,5
Asser,M,100,0,24,24
Cherisse,F,100,1064,0,1064
Jennea,F,100,78,0,78
Arnez,M,99,5,446,451
Clarica,F,100,11,0,11
Aalap,M,100,0,6,6
Jackleen,F,100,48,0,48
Khalika,F,100,7,0,7
Jallisa,F,100,33,0,33
Nasire,M,100,0,75,75
Natalea,F,100,232,0,232
Wylean,F,100,5,0,5
Tshwanda,F,100,9,0,9
Donnitta,F,100,6,0,6
Raisah,F,100,6,0,6
Demeatra,F,100,5,0,5
Piersen,M,100,0,23,23
Nessie,F,100,5,0,5
Fionn,M,100,0,354,354
Isahias,M,100,0,11,11
Viviann,F,100,350,0,350
Heitor,M,100,0,6,6
Jeromi,M,100,0,40,40
Emauni,F,100,17,0,17
Jakhyla,F,100,11,0,11
Dairo,M,100,0,20,20
Jaisy,F,100,6,0,6
Luu,M,100,0,5,5
Mileigh,F,100,191,0,191
Breyan,M,67,10,20,30
Evely,F,100,179,0,179
Jaier,M,100,0,14,14
Othel,M,100,0,70,70
Kaori,F,94,687,44,731
Emilie,F,100,17609,7,17616
Zarella,F,100,6,0,6
Chien,M,100,0,5,5
Rodson,M,100,0,5,5
Halaina,F,100,109,0,109
Maanya,F,100,176,0,176
Lakeema,F,100,35,0,35
Lorii,F,100,16,0,16
Arno,M,100,0,519,519
Llewellyn,M,98,30,1287,1317
Saryn,F,100,207,0,207
Reynol,M,100,0,74,74
Pakou,F,100,148,0,148
Quency,M,100,0,127,127
Clovia,F,100,78,0,78
Synclaire,F,100,29,0,29
Kinze,F,100,79,0,79
Xaveria,F,100,14,0,14
Haeven,F,91,105,10,115
Amire,M,85,83,454,537
Chaunice,F,100,70,0,70
Esti,F,100,61,0,61
Hinatea,F,100,6,0,6
Samaree,F,100,28,0,28
Aldemar,M,100,0,5,5
Evalena,F,100,206,0,206
Juella,F,100,5,0,5
Caydence,F,95,2575,142,2717
Sopath,M,100,0,5,5
Aries,M,58,1352,1876,3228
Keiona,F,100,854,0,854
Nneoma,F,100,183,0,183
Natania,F,100,525,0,525
Celinda,F,100,964,0,964
Sabina,F,100,4836,0,4836
Ellesyn,F,100,27,0,27
Juanda,F,100,233,0,233
Tazaya,F,100,5,0,5
Jamece,F,100,5,0,5
Artricia,F,100,11,0,11
Channen,M,100,0,16,16
Mairyn,F,100,129,0,129
Vananh,F,100,10,0,10
Mandela,M,100,0,137,137
Zeddie,M,100,0,5,5
Rosaelia,F,100,28,0,28
Summar,F,100,311,0,311
Ted,M,100,63,39413,39476
Everlie,F,100,86,0,86
Lesieli,F,100,78,0,78
Hartlynn,F,100,29,0,29
Myran,M,93,5,71,76
Atzin,M,82,22,97,119
Dimonique,F,100,68,0,68
Clotilda,F,100,15,0,15
Shenina,F,100,5,0,5
Slayton,M,100,0,284,284
Kamuri,M,100,0,6,6
Emerito,M,100,0,11,11
Nehemie,F,100,199,0,199
Shawday,F,100,10,0,10
Mitzi,F,100,11046,0,11046
Oluwafisayo,F,100,5,0,5
Alhasan,M,100,0,33,33
Charika,F,100,69,0,69
Marayah,F,100,272,0,272
Marzavion,M,100,0,5,5
Zahari,F,61,71,46,117
Erfan,M,100,0,6,6
Quaniqua,F,100,26,0,26
Kija,F,100,30,0,30
Bayron,M,100,0,997,997
Quenton,M,100,0,2697,2697
Matti,F,92,523,47,570
Eliborio,M,100,0,5,5
Dwaylon,M,100,0,20,20
Kyus,M,100,0,10,10
Kamahl,M,100,0,5,5
Hamida,F,100,50,0,50
Shatica,F,100,11,0,11
Breely,F,100,107,0,107
Briandra,F,100,5,0,5
Arhaan,M,100,0,186,186
Emila,F,100,53,0,53
Lillyonna,F,100,168,0,168
Kayse,F,97,410,11,421
Zarina,F,100,867,0,867
Nyiana,F,100,5,0,5
Britanie,F,100,423,0,423
Eirini,F,100,16,0,16
Javia,F,100,232,0,232
Talandra,F,100,6,0,6
Crayson,M,100,0,6,6
Basilisa,F,100,5,0,5
Marzella,F,100,130,0,130
Dianelys,F,100,111,0,111
Roaa,F,100,14,0,14
Ziven,M,100,0,30,30
Stephe,M,100,0,16,16
Derinda,F,100,379,0,379
Makyiah,F,100,168,0,168
Jerzi,F,100,273,0,273
Tomothy,M,100,0,119,119
Levinia,F,100,11,0,11
Kien,M,100,0,337,337
Jodette,F,100,132,0,132
Diyan,M,100,0,13,13
Jamariea,M,100,0,6,6
Swetha,F,100,311,0,311
Yazan,M,100,0,832,832
Bethony,F,100,18,0,18
Sahas,M,100,0,121,121
Jenalis,F,100,16,0,16
Vivy,F,100,6,0,6
Ansen,M,100,0,157,157
Larona,F,100,39,0,39
Nevaya,F,100,192,0,192
Kelisha,F,100,405,0,405
Shermon,M,100,0,129,129
Nykeria,F,100,457,0,457
Saraiah,F,100,163,0,163
Miquela,F,100,360,0,360
Neville,M,100,0,1427,1427
Markesha,F,100,998,0,998
Xola,F,100,20,0,20
Silvanna,F,100,55,0,55
Lucymarie,F,100,5,0,5
Mariany,F,100,48,0,48
Shaleesa,F,100,17,0,17
Yasuri,F,100,41,0,41
Vivien,F,100,3080,0,3080
Vasil,M,100,0,10,10
Mckinnley,F,82,296,67,363
Shaneika,F,100,549,0,549
Chandlor,M,100,0,95,95
Nattiel,M,100,0,10,10
Mayrani,F,100,127,0,127
Khaleigh,F,100,17,0,17
Trema,F,100,6,0,6
Rakesh,M,100,0,439,439
Kierston,F,98,815,13,828
Rizza,F,100,6,0,6
Ynhi,F,100,6,0,6
Jisiah,M,100,0,11,11
Reeya,F,100,160,0,160
Glora,F,100,78,0,78
Dajiah,F,100,75,0,75
Ryananthony,M,100,0,25,25
Bubber,M,100,0,5,5
Latwon,M,100,0,6,6
Murphee,F,100,6,0,6
Tatiayana,F,100,5,0,5
Zeandre,M,100,0,49,49
Belton,M,100,0,311,311
Monnie,F,71,336,136,472
Edwana,F,100,12,0,12
Manjot,M,60,95,141,236
Johnluis,M,100,0,5,5
Kennedii,F,100,24,0,24
Nikaiyah,F,100,10,0,10
Louretta,F,100,63,0,63
Jacobryan,M,100,0,5,5
Xyliah,F,100,6,0,6
Syana,F,100,54,0,54
Fatin,F,86,59,10,69
Aleahya,F,100,16,0,16
Reagin,F,100,41,0,41
Lanson,M,100,0,85,85
Esra,F,100,276,0,276
Breccan,M,100,0,124,124
Ajada,F,100,53,0,53
Maxum,M,100,0,89,89
Ramatoulie,F,100,5,0,5
Jontyler,M,100,0,7,7
Carnesha,F,100,143,0,143
Zenani,F,100,8,0,8
Nicayla,F,100,8,0,8
Jakobee,M,100,0,58,58
Ruben,M,99,563,90484,91047
Dmitri,M,100,0,1811,1811
Ronishia,F,100,10,0,10
Jahira,F,100,324,0,324
Taboris,M,100,0,31,31
Cahill,M,100,0,16,16
Melina,F,100,14463,0,14463
Malanie,F,100,620,0,620
Chassidy,F,100,3201,0,3201
Britnie,F,100,958,0,958
Telesforo,M,100,0,113,113
Dariann,F,100,136,0,136
Kaiann,F,100,6,0,6
Jamesmichael,M,100,0,339,339
Branly,M,100,0,11,11
Analuiza,F,100,35,0,35
Sherdina,F,100,15,0,15
Morad,M,100,0,127,127
Gwendalynn,F,100,196,0,196
Javoni,M,95,10,187,197
Jakalia,F,100,6,0,6
Srinidhi,F,100,333,0,333
Prentice,M,99,28,2259,2287
Shamekia,F,100,947,0,947
Mizan,F,50,6,6,12
Pamela,F,100,517863,1209,519072
Kodjo,M,100,0,5,5
Antwaan,M,100,0,30,30
Bettejo,F,100,5,0,5
Mandrel,M,100,0,6,6
Annessia,F,100,11,0,11
Tor,M,100,0,763,763
Kita,F,100,164,0,164
Jehieli,F,100,82,0,82
Taigan,F,92,56,5,61
Tra,M,97,7,241,248
Jacarria,F,100,5,0,5
Lameeka,F,100,63,0,63
Demitrios,M,100,0,109,109
Kumari,F,77,103,31,134
Anahya,F,100,12,0,12
Sumire,F,100,45,0,45
Keiairra,F,100,5,0,5
Mitzy,F,100,1146,0,1146
Kaylamarie,F,100,329,0,329
Mahawa,F,100,17,0,17
Chesleigh,F,100,6,0,6
Priyanka,F,100,1592,0,1592
Fanta,F,100,866,0,866
Maxima,F,100,28,0,28
Josephin,F,100,5,0,5
Ragene,F,83,45,9,54
Treana,F,100,312,0,312
Pacha,F,100,7,0,7
Bonnibel,F,100,5,0,5
Anjanae,F,100,125,0,125
Eduardo,M,100,433,95493,95926
Lapriest,M,100,0,6,6
Mikka,F,100,510,0,510
Yaireth,F,100,26,0,26
Marieda,F,100,5,0,5
Cj,M,90,126,1076,1202
Cresta,F,100,236,0,236
Steeler,M,100,0,11,11
Shabri,F,100,10,0,10
Austinmichael,M,100,0,33,33
Sheniyah,F,100,22,0,22
Glema,F,100,15,0,15
Alhakim,M,100,0,5,5
Toyya,F,100,22,0,22
Zamiere,M,100,0,5,5
Marcellus,M,100,5,5049,5054
Cabrina,F,100,324,0,324
Tadesha,F,100,5,0,5
Jamine,F,70,324,137,461
Daquavious,M,100,0,42,42
Sanjuanita,F,100,3175,0,3175
Evilyn,F,100,20,0,20
Shonelle,F,100,22,0,22
Alilia,F,100,21,0,21
Tudy,F,100,5,0,5
Deztinee,F,100,75,0,75
Marabella,F,100,80,0,80
Stefone,M,100,0,53,53
Ceanna,F,100,600,0,600
Amenda,F,100,317,0,317
Cristyn,F,100,275,0,275
Jerit,M,100,0,37,37
Arthurene,F,100,7,0,7
Batul,F,100,73,0,73
Montaye,M,100,0,5,5
Lucius,M,100,0,3767,3767
Amarien,M,100,0,82,82
Leeyana,F,100,22,0,22
Dahani,M,100,0,30,30
Demitrious,M,100,0,84,84
Yeicelyn,F,100,5,0,5
Danaira,F,100,5,0,5
Janieya,F,100,39,0,39
Kingstin,M,100,0,101,101
Jocelyn,F,100,95778,345,96123
Jaeona,F,100,6,0,6
Jerriona,F,100,5,0,5
Wallace,M,99,129,22613,22742
Lennora,F,100,6,0,6
Taeyang,M,100,0,5,5
Arainna,F,100,10,0,10
Addam,M,100,0,714,714
Braniya,F,100,217,0,217
Tashiyah,F,100,23,0,23
Codey,M,99,28,3125,3153
Inbar,F,100,20,0,20
Troyal,M,100,0,7,7
Dustinjames,M,100,0,5,5
Chanet,F,100,5,0,5
Johnah,F,100,7,0,7
Mekai,M,100,0,348,348
Markyia,F,100,5,0,5
Quintoria,F,100,38,0,38
Evelean,F,100,11,0,11
Naida,F,100,695,0,695
Jamekia,F,100,258,0,258
Hiroyuki,M,100,0,45,45
Terah,F,97,1345,43,1388
Willo,F,100,105,0,105
Williamhenry,M,100,0,5,5
Infinity,F,100,627,0,627
Deni,F,81,603,138,741
Ocasio,M,100,0,5,5
Lazlo,M,100,0,73,73
Wyonna,F,100,28,0,28
Kyliee,F,100,400,0,400
Tiya,F,100,607,0,607
Nallely,F,100,2691,0,2691
Keyson,M,100,0,35,35
Eraina,F,100,242,0,242
Aarini,F,100,68,0,68
Layleen,F,100,26,0,26
Rumi,M,53,86,97,183
Krisann,F,100,436,0,436
Yolandia,F,100,18,0,18
Tonesia,F,100,12,0,12
Adien,M,100,0,344,344
Kiler,M,100,0,5,5
Wendi,F,100,14357,0,14357
Yazleemar,F,100,28,0,28
Gregson,M,100,0,5,5
Cynnthia,F,100,6,0,6
Genelle,F,100,1088,0,1088
Anetha,F,100,50,0,50
Waren,M,100,0,10,10
Fracisco,M,100,0,7,7
Lexianna,F,100,86,0,86
Marcelus,M,100,0,256,256
Shedrick,M,100,0,2101,2101
Abayomi,M,100,0,215,215
Khara,F,100,633,0,633
Krystena,F,100,92,0,92
Randle,M,100,7,1990,1997
Meyli,F,100,53,0,53
Elam,M,100,0,1364,1364
Laurencio,M,100,0,30,30
Mher,M,100,0,15,15
Avita,F,100,55,0,55
Lashawnna,F,100,75,0,75
Burnice,M,73,101,270,371
Wanika,F,100,46,0,46
Jenniferrose,F,100,10,0,10
Arnes,M,100,0,27,27
Amhad,M,100,0,5,5
Stefane,F,100,32,0,32
Jeannean,F,100,47,0,47
Sosaia,M,100,0,72,72
Chelcia,F,100,20,0,20
Mireyah,F,100,61,0,61
Surenity,F,100,36,0,36
Zylas,M,100,0,5,5
Alle,F,100,145,0,145
Eya,F,100,6,0,6
Rohail,M,100,0,95,95
Kalifa,F,100,81,0,81
Kenyce,F,100,5,0,5
Kimyra,F,100,57,0,57
Samarra,F,100,365,0,365
Reylan,M,100,0,34,34
Kamiah,F,100,1012,0,1012
Taniela,M,100,0,96,96
Kamden,M,93,426,5874,6300
Levity,F,100,5,0,5
Leanny,F,100,112,0,112
Vriti,F,100,6,0,6
Oluwabusola,F,100,5,0,5
Brandonjames,M,100,0,21,21
Jalyse,F,100,53,0,53
Zoely,F,100,14,0,14
Nathaneil,M,100,0,404,404
Christy,F,99,96184,955,97139
Gabrielah,F,100,5,0,5
Naneka,F,100,5,0,5
Vannak,M,100,0,50,50
Krillin,M,100,0,5,5
Aaniyah,F,100,1026,0,1026
Mahogani,F,100,208,0,208
Jeramya,M,100,0,6,6
Malachy,M,100,0,451,451
Regeina,F,100,22,0,22
Kalik,M,100,0,191,191
Omaris,F,100,7,0,7
Makini,F,100,56,0,56
Chelsen,F,100,5,0,5
Geneve,F,100,146,0,146
Sathvik,M,100,0,382,382
Yubal,M,100,0,7,7
Tejuana,F,100,23,0,23
Alinea,F,100,5,0,5
Bereniz,F,100,56,0,56
Pellegrino,M,100,0,5,5
Yaila,F,100,20,0,20
Malekia,F,100,10,0,10
Jalie,F,100,275,0,275
Shynise,F,100,6,0,6
Zipporah,F,100,1795,0,1795
Alius,M,100,0,30,30
Mckeever,M,100,0,5,5
Jorey,M,89,25,213,238
Jacaree,M,100,0,21,21
Portia,F,100,7963,8,7971
Sharalee,F,100,94,0,94
Genesha,F,100,26,0,26
Gustav,M,100,0,1285,1285
Donnasia,F,100,17,0,17
Darshawn,M,100,0,155,155
Reginald,M,99,729,91693,92422
Kaniece,F,100,12,0,12
Rhiannan,F,100,171,0,171
Dijoun,M,100,0,6,6
Eliot,M,94,341,5399,5740
Mikaella,F,100,481,0,481
Kaara,F,100,13,0,13
Kynslea,F,100,6,0,6
Naveena,F,100,78,0,78
Geriah,F,100,15,0,15
Heathr,F,100,36,0,36
Taahira,F,100,54,0,54
Krishanda,F,100,18,0,18
Keshawn,M,94,342,5333,5675
Zackeriah,M,100,0,89,89
Zila,F,100,32,0,32
Tatiara,F,100,10,0,10
Trudell,F,100,12,0,12
Jiannah,F,100,22,0,22
Zariya,F,100,1100,0,1100
Delcenia,F,100,33,0,33
Donice,F,100,316,0,316
Dezhane,F,100,110,0,110
Vent,M,100,0,14,14
Gaolee,F,100,5,0,5
Beka,M,100,0,24,24
Misha,F,90,3293,355,3648
Makale,M,100,0,195,195
Selven,M,100,0,5,5
Dominyc,M,100,0,17,17
Antoneshia,F,100,6,0,6
Deaires,M,100,0,15,15
Hezzie,M,100,0,24,24
Lestine,F,100,114,0,114
Jazharia,F,100,5,0,5
Aquetzalli,F,100,19,0,19
Meerab,F,100,59,0,59
Ikeam,M,100,0,5,5
Wasif,M,100,0,95,95
Trig,M,100,0,132,132
Jennavecia,F,100,231,0,231
Shamecia,F,100,16,0,16
Beauen,M,100,0,6,6
Rizal,M,100,0,5,5
Evolette,F,100,121,0,121
Alyshea,F,100,33,0,33
Qadirah,F,100,40,0,40
Khoa,M,100,0,648,648
Niyahna,F,100,6,0,6
Ashir,M,100,0,62,62
Potter,F,100,5,0,5
Jamere,M,98,22,1301,1323
Stephenie,F,100,5493,0,5493
Titana,F,100,25,0,25
Bedford,M,100,0,248,248
Mckalee,F,100,10,0,10
Enemencio,M,100,0,5,5
Makiyha,F,100,22,0,22
Yarilyn,F,100,7,0,7
Machia,F,100,11,0,11
Kayatana,F,100,13,0,13
Tikeria,F,100,5,0,5
Lasheila,F,100,10,0,10
Janora,F,100,33,0,33
Shontae,F,99,842,10,852
Lenia,F,100,124,0,124
Dereginald,M,100,0,5,5
Terryann,F,100,112,0,112
Josanna,F,100,76,0,76
Wilde,M,100,0,16,16
Rheta,F,100,233,0,233
Quynh,F,100,251,0,251
Johan,M,100,40,8758,8798
Reva,F,100,5158,0,5158
Dermont,M,100,0,10,10
Racheal,F,100,9864,0,9864
Monyea,F,100,13,0,13
Lileana,F,100,36,0,36
Shaquasia,F,100,208,0,208
Gana,F,100,29,0,29
Michaelthomas,M,100,0,27,27
Jaronn,M,100,0,10,10
Raenesha,F,100,20,0,20
Jamaar,M,100,0,587,587
Amouri,M,74,5,14,19
Zayonna,F,100,78,0,78
Muranda,F,100,66,0,66
Antwoinette,F,100,11,0,11
Charlas,M,100,0,15,15
Makailah,F,100,474,0,474
Tonea,F,100,65,0,65
Queshawn,M,100,0,53,53
Brailyn,F,75,687,226,913
Avrum,M,100,0,301,301
Malikiya,F,100,5,0,5
Marcquise,M,100,0,38,38
Castiel,M,99,10,727,737
Jatavius,M,100,0,276,276
Tyreek,M,100,0,2015,2015
Ramire,M,100,0,11,11
Maxsim,M,100,0,37,37
Abid,M,100,0,303,303
Emanie,F,100,167,0,167
Jesselyn,F,100,481,0,481
Tomeika,F,100,252,0,252
Rwan,F,100,25,0,25
Kylianna,F,100,32,0,32
Aralyn,F,100,564,0,564
Chrishay,F,100,10,0,10
Ericjames,M,100,0,5,5
Jillena,F,100,35,0,35
Otavious,M,100,0,5,5
Cavanaugh,M,100,0,32,32
Pinchus,M,100,0,450,450
Daleisa,F,100,42,0,42
Labryant,M,100,0,23,23
Deevon,M,100,0,10,10
Takeela,F,100,47,0,47
Keana,F,100,2508,0,2508
Keshera,F,100,5,0,5
Yomaira,F,100,451,0,451
Rayda,F,100,5,0,5
Jemarr,M,100,0,6,6
Londynn,F,100,1071,0,1071
Mate,M,100,0,42,42
Anallely,F,100,209,0,209
Kizzy,F,99,2312,12,2324
Jayshawn,M,100,0,1419,1419
Travor,M,100,0,109,109
Bartosz,M,100,0,226,226
Lurlie,F,100,5,0,5
Anuhya,F,100,35,0,35
Nicoli,M,88,42,320,362
Woody,M,100,0,2496,2496
Timmyah,F,100,5,0,5
Nashana,F,100,21,0,21
Aerick,M,100,0,49,49
Tagen,M,60,99,146,245
Shairon,F,100,5,0,5
Nickell,F,100,11,0,11
Emalyne,F,100,14,0,14
Connan,M,100,0,5,5
Danahi,F,100,44,0,44
Shalaine,F,100,116,0,116
Janiel,M,74,187,536,723
Deovian,F,100,5,0,5
Immanuel,M,100,0,4036,4036
Corteze,M,100,0,6,6
Mueez,M,100,0,11,11
Wisam,M,100,0,183,183
Kylii,F,100,54,0,54
Maewyn,F,100,9,0,9
Ramos,M,100,0,39,39
Timmiah,F,100,5,0,5
Courtneyann,F,100,11,0,11
Saif,M,100,0,1360,1360
Jourdon,M,90,16,144,160
Damascus,M,100,0,88,88
Ceandra,F,100,12,0,12
Valerio,M,100,0,307,307
Yaileen,F,100,225,0,225
Mycheal,M,100,0,96,96
Zanique,F,100,21,0,21
Melesia,F,100,38,0,38
Tiffay,F,100,139,0,139
Legend,M,88,326,2461,2787
Rikke,F,100,16,0,16
Zakaree,M,100,0,51,51
Jayzion,M,100,0,26,26
Lennox,M,82,576,2557,3133
Ithzel,F,100,150,0,150
Vinessa,F,100,362,0,362
Tyneasha,F,100,7,0,7
Kellene,F,100,425,0,425
Selenia,F,100,434,0,434
Brierra,F,100,34,0,34
Lajuana,F,100,1422,0,1422
Karenza,F,100,12,0,12
Jenyah,F,100,29,0,29
Nilson,M,100,0,248,248
Shanissa,F,100,12,0,12
Vasudev,M,100,0,10,10
Irihanna,F,100,28,0,28
Bubba,M,100,0,470,470
Trinyti,F,100,19,0,19
Sanjita,F,100,19,0,19
Sunjai,F,100,23,0,23
Timberly,F,100,896,0,896
Hahna,F,100,6,0,6
Helia,F,100,53,0,53
Tilghman,M,100,0,12,12
Imogene,F,100,1872,0,1872
Eduarda,F,100,115,0,115
Vaneshia,F,100,53,0,53
Valetina,F,100,5,0,5
Mahliyah,F,100,18,0,18
Jaquira,F,100,37,0,37
Zakya,F,100,168,0,168
Joniel,M,100,0,327,327
Aira,F,100,235,0,235
Mourad,M,100,0,69,69
Dakkota,M,87,6,41,47
Jayqwan,M,100,0,11,11
Zyasia,F,100,481,0,481
Nuh,M,100,0,90,90
Zuly,F,100,360,0,360
Talli,F,100,139,0,139
Zaeem,M,100,0,126,126
Anice,F,100,229,0,229
Baeleigh,F,100,104,0,104
Damber,F,100,38,0,38
Amillion,F,67,149,73,222
Wendell,M,99,321,27982,28303
Jovana,F,100,1835,0,1835
Zackarey,M,100,0,63,63
Jebria,F,100,15,0,15
Natthan,M,100,0,29,29
Wakisha,F,100,86,0,86
Anansa,F,100,22,0,22
Sury,F,100,620,0,620
Hedy,F,100,977,0,977
Orlandrea,F,100,8,0,8
Elver,M,97,5,158,163
Tyheshia,F,100,5,0,5
Tajiri,M,100,0,26,26
Caitlain,F,100,84,0,84
Keandre,M,100,9,2535,2544
Jaque,M,85,23,135,158
Olan,M,100,0,817,817
Natron,M,100,0,47,47
Dayamin,F,100,25,0,25
Niomi,F,100,704,0,704
Nikkisha,F,100,51,0,51
Grabriela,F,100,37,0,37
Mailee,F,100,465,0,465
Devi,F,100,670,0,670
Lajohn,M,100,0,37,37
Jeiza,F,100,12,0,12
Annettia,F,100,6,0,6
Shah,M,98,5,302,307
Maryeli,F,100,14,0,14
Phyillis,F,100,60,0,60
Pollyann,F,100,81,0,81
Jiaya,F,100,11,0,11
Tzurty,F,100,18,0,18
Maisen,M,75,54,160,214
Keiundra,F,100,6,0,6
Carely,F,100,102,0,102
Elion,M,100,0,48,48
Jakelle,F,100,5,0,5
Stphanie,F,100,40,0,40
Kallina,F,100,6,0,6
Sevaeh,F,100,27,0,27
Dashawnna,F,100,20,0,20
Deshawnna,F,100,13,0,13
Valarie,F,100,16944,0,16944
Sayumi,F,100,24,0,24
Evgenia,F,100,55,0,55
Keenin,M,100,0,5,5
Johnatha,M,100,0,57,57
Yaleiza,F,100,6,0,6
Jaykwan,M,100,0,5,5
Debbie,F,100,183671,434,184105
Gatlyn,M,100,0,87,87
Seanan,M,100,0,18,18
Armod,M,100,0,10,10
Ania,F,100,2493,0,2493
Shaquara,F,100,12,0,12
Zubin,M,100,0,295,295
Maialen,F,100,5,0,5
Chenika,F,100,81,0,81
Amay,M,100,0,77,77
Rizwan,M,100,0,336,336
Marji,F,100,124,0,124
Jemini,F,81,43,10,53
Jamarien,M,100,0,161,161
Laresha,F,100,250,0,250
Java,M,54,17,20,37
Arlondo,M,100,0,10,10
Sanchez,M,98,17,880,897
Renda,F,100,966,0,966
Darence,M,100,0,19,19
Shields,M,100,0,5,5
Anshika,F,100,229,0,229
Atheer,F,100,5,0,5
Treisa,F,100,15,0,15
Phinehas,M,100,0,199,199
Elyn,F,97,387,11,398
Xxavier,M,100,0,105,105
Tiayanna,F,100,5,0,5
Joevanny,M,100,0,23,23
Tarik,M,100,11,3704,3715
Kynia,F,100,52,0,52
Carin,F,100,4279,0,4279
Aalexus,F,100,6,0,6
Giahnna,F,100,15,0,15
Alydia,F,100,415,0,415
Snapper,M,100,0,24,24
Ravon,M,76,264,826,1090
Lyndal,M,73,67,179,246
Calli,F,100,3920,0,3920
Janaa,F,100,52,0,52
Iahn,M,100,0,6,6
Gunnar,M,100,6,11097,11103
Guillermo,M,100,74,25822,25896
Kenishia,F,100,84,0,84
Sherle,F,100,51,0,51
Shalayna,F,100,97,0,97
Corneal,M,100,0,22,22
Emileah,F,100,39,0,39
Jaynelle,F,100,38,0,38
Cherese,F,100,757,0,757
Uchenna,M,67,185,371,556
Issiac,M,100,0,105,105
Lezlie,F,100,2286,0,2286
Mairi,F,100,230,0,230
Katika,F,100,39,0,39
Kenlie,F,100,423,0,423
Stepahanie,F,100,6,0,6
Jaccari,M,100,0,11,11
Navonte,M,100,0,10,10
Hardeep,M,74,25,72,97
Souleymane,M,100,0,265,265
Xeryus,M,100,0,12,12
Kahleel,M,100,0,211,211
Zelig,M,100,0,94,94
Wednesday,F,100,831,0,831
Raymir,M,100,0,38,38
Advit,M,100,0,19,19
Shamor,M,100,0,8,8
Mabelene,F,100,30,0,30
Kahana,F,100,7,0,7
Shellee,F,100,853,0,853
Isaias,M,100,0,11444,11444
Randilyn,F,100,96,0,96
Chadley,M,100,0,417,417
Frederic,M,100,0,5960,5960
Yathziri,F,100,11,0,11
Ketta,F,100,5,0,5
Argyro,F,100,5,0,5
Bridy,F,100,6,0,6
Nyleigh,F,100,7,0,7
Sahari,F,100,23,0,23
Yashaswini,F,100,6,0,6
Ayssa,F,100,161,0,161
Chamarion,M,100,0,5,5
Murleen,F,100,11,0,11
Thurman,M,100,0,4921,4921
Rhapsody,F,100,76,0,76
Milove,F,100,21,0,21
Maribela,F,100,28,0,28
Ghali,M,100,0,46,46
Dushawn,M,98,11,435,446
Keyonnie,F,100,18,0,18
Laziah,F,100,10,0,10
Raamond,M,100,0,6,6
Persaus,F,100,8,0,8
Ronette,F,100,918,0,918
Jaydenlee,M,100,0,11,11
Sheryce,F,100,19,0,19
Deymar,M,100,0,13,13
Mashaun,M,100,0,24,24
Cymande,M,100,0,9,9
Matas,M,100,0,102,102
Tynley,F,100,29,0,29
Javonda,F,100,278,0,278
Kassadie,F,100,87,0,87
Shaquesha,F,100,57,0,57
Adiel,M,93,82,1166,1248
Layken,F,87,565,83,648
Orlean,F,100,43,0,43
Candys,F,100,5,0,5
Earica,F,100,37,0,37
Qualon,M,100,0,19,19
Daviyana,F,100,5,0,5
Terryonna,F,100,17,0,17
Kyeem,M,100,0,13,13
Kristianna,F,100,1051,0,1051
Khanye,M,100,0,34,34
Ijana,F,100,5,0,5
Osirys,F,100,10,0,10
Blaize,M,89,154,1277,1431
Nikhilesh,M,100,0,5,5
Heer,F,100,113,0,113
Levorne,M,100,0,5,5
Tiam,M,100,0,17,17
Sarissa,F,100,108,0,108
Mordchai,M,100,0,5,5
Sirgio,M,100,0,5,5
Soroosh,M,100,0,6,6
Tamyka,F,100,136,0,136
Mayrim,F,100,51,0,51
Nelitza,F,100,5,0,5
Garnetta,F,100,232,0,232
Jodena,F,100,5,0,5
Bob,M,100,66,30033,30099
Ashmit,M,100,0,44,44
Delani,F,98,982,15,997
Jonam,M,100,0,6,6
Melkin,M,100,0,15,15
Pailyn,F,100,84,0,84
Madhuri,F,100,58,0,58
Shritha,F,100,47,0,47
Cythnia,F,100,108,0,108
Oda,F,77,24,7,31
Morley,M,75,22,67,89
Iasia,F,100,405,0,405
Xabriel,M,100,0,5,5
Liahona,F,100,17,0,17
Bellarose,F,100,332,0,332
Deterrius,M,100,0,23,23
Janaiyah,F,100,137,0,137
Harut,M,100,0,33,33
Sibyl,F,100,910,0,910
Anaka,F,100,262,0,262
Oswaldo,M,100,0,5267,5267
Georgana,F,100,141,0,141
Jerrae,F,100,5,0,5
Trysta,F,100,354,0,354
Deztini,F,100,26,0,26
Toba,F,100,237,0,237
Alvi,M,100,0,29,29
Giselda,F,100,21,0,21
Vee,F,92,60,5,65
Jumoke,M,100,0,15,15
Deniya,F,100,329,0,329
Mmary,F,100,5,0,5
Yaniv,M,100,0,215,215
Reny,M,65,6,11,17
Venus,F,99,7455,38,7493
Khamar,M,100,0,51,51
Jadora,F,100,25,0,25
Andersson,M,100,0,53,53
Coleton,M,100,0,2679,2679
Sheilia,F,100,315,0,315
Ilise,F,100,49,0,49
Genevieve,F,100,33874,12,33886
Zayland,M,100,0,5,5
Anasol,F,100,12,0,12
Olman,M,100,0,85,85
The,M,100,0,5,5
Shalayla,F,100,28,0,28
Alysianna,F,100,12,0,12
Josielyn,F,100,17,0,17
Ruthell,F,100,20,0,20
Icholas,M,100,0,70,70
Joziyah,M,100,0,49,49
Mirabel,F,100,394,0,394
Kamryne,F,100,5,0,5
Elmo,M,100,0,1513,1513
Shirline,F,100,78,0,78
Antoinne,M,100,0,384,384
Allysan,F,100,18,0,18
Kastiel,M,100,0,30,30
Suvali,F,100,7,0,7
Jaelinn,F,100,15,0,15
Lailoni,F,100,183,0,183
Kelby,M,73,1379,3721,5100
Evangeline,F,100,13410,0,13410
Tieshka,F,100,7,0,7
Jasmyn,F,100,5545,0,5545
Ashelly,F,100,32,0,32
Jontre,M,100,0,12,12
Otisha,F,100,160,0,160
Taia,F,100,506,0,506
Abriele,F,100,5,0,5
Mcclane,M,100,0,6,6
Arleth,F,100,2463,0,2463
Myesia,F,100,5,0,5
Sofiarose,F,100,13,0,13
Jarrot,M,100,0,11,11
Deshanna,F,100,339,0,339
Phillisha,F,100,11,0,11
Keesean,M,100,0,15,15
Nyeem,M,100,0,255,255
Lissa,F,100,3689,0,3689
Kemberlyn,F,100,5,0,5
Tliyah,F,100,6,0,6
Tanaia,F,100,80,0,80
Ayak,F,100,22,0,22
Annaleise,F,100,343,0,343
Marshia,F,100,201,0,201
Kelbie,F,100,213,0,213
Giustina,F,100,16,0,16
Shatay,F,100,5,0,5
Kendralyn,F,100,23,0,23
Amere,M,83,125,592,717
Taciana,F,100,5,0,5
Janal,F,93,69,5,74
Mikiel,M,100,0,58,58
Granvil,M,100,0,6,6
Saadiq,M,100,0,326,326
Azaila,F,100,20,0,20
Ezykiel,M,100,0,16,16
Monque,F,100,60,0,60
Bevan,M,88,66,476,542
Makhy,M,100,0,16,16
Emmalene,F,100,184,0,184
Desira,F,100,221,0,221
Yariah,F,100,93,0,93
Zaen,M,100,0,6,6
Hezikiah,M,100,0,22,22
Danayara,F,100,6,0,6
Gilana,F,100,27,0,27
Claudie,M,61,297,458,755
Jazyriah,F,100,16,0,16
Marcellene,F,100,10,0,10
Carver,M,100,0,1457,1457
Teiah,F,100,11,0,11
Rizelle,F,100,5,0,5
Kinslie,F,100,140,0,140
Mahal,F,100,6,0,6
Joycee,F,100,41,0,41
Chance,M,98,1074,42238,43312
Philistine,F,100,5,0,5
Aison,M,100,0,68,68
Airin,F,86,31,5,36
Elijaah,M,100,0,24,24
Kager,M,100,0,5,5
Devanshi,F,100,101,0,101
Ovie,M,100,0,76,76
Vasily,M,100,0,56,56
Lilyaunna,F,100,5,0,5
Akosua,F,100,288,0,288
Aleksia,F,100,188,0,188
Jesua,M,100,0,102,102
Abduallah,M,100,0,27,27
Jaymir,M,100,0,107,107
Maxx,M,99,37,2902,2939
Latishia,F,100,645,0,645
Okalani,F,100,12,0,12
Gyan,M,100,0,120,120
Eshita,F,100,14,0,14
Mascen,M,100,0,5,5
Suzanna,F,100,7994,0,7994
Reshma,F,100,441,0,441
Neala,F,100,394,0,394
Deljuan,M,100,0,28,28
Lessli,F,100,24,0,24
Teoni,F,100,15,0,15
Eliud,M,100,0,1261,1261
Annalisha,F,100,20,0,20
Deonni,F,100,21,0,21
Jumana,F,100,335,0,335
Belverly,F,100,5,0,5
Shakema,F,100,434,0,434
Lanissa,F,100,92,0,92
Angellie,F,100,13,0,13
Lilyana,F,100,5915,0,5915
Yvan,M,99,5,370,375
Arlett,F,100,513,0,513
Mare,M,100,0,323,323
Fizza,F,100,106,0,106
Dorjan,M,100,0,15,15
Moshe,M,100,21,11340,11361
Sambo,M,100,0,11,11
Rahson,M,100,0,11,11
Chistina,F,100,282,0,282
Luay,M,100,0,78,78
Stefhanie,F,100,128,0,128
Kartika,F,100,13,0,13
Jaiheim,M,100,0,8,8
Kiko,M,63,34,58,92
Berline,F,100,82,0,82
Tomara,F,100,400,0,400
Harshdeep,M,100,0,21,21
Stephanos,M,100,0,95,95
Zekiel,M,100,0,227,227
Revathi,F,100,6,0,6
Quang,M,100,0,710,710
Adden,M,100,0,103,103
Nitai,M,100,0,19,19
Kalimah,F,100,164,0,164
Navaiah,F,100,8,0,8
Kyoka,F,100,11,0,11
Sayeh,F,100,18,0,18
Jarhonda,F,100,14,0,14
Layman,M,100,0,52,52
Clorise,F,100,5,0,5
Govanni,M,100,0,239,239
Dalyssa,F,100,10,0,10
Audriella,F,100,40,0,40
Eder,M,100,0,2201,2201
Jocilyn,F,100,347,0,347
Dermarr,M,100,0,5,5
Annalynne,F,100,101,0,101
Jazai,M,100,0,5,5
Autumnrose,F,100,68,0,68
Yushin,M,100,0,5,5
Mykia,F,100,901,0,901
Abegail,F,100,478,0,478
Corinthian,M,78,185,646,831
Magno,M,100,0,17,17
Nataria,F,100,7,0,7
Letoria,F,100,49,0,49
Kelcie,F,99,3069,37,3106
Cecille,F,100,281,0,281
Zyeer,M,100,0,5,5
Tyzjuan,M,100,0,10,10
Jeily,F,100,157,0,157
Ladarrion,M,100,0,154,154
Abin,M,100,0,10,10
Lyric,F,83,11893,2477,14370
Tynique,F,100,16,0,16
Alissah,F,100,140,0,140
Kobey,M,100,0,544,544
Chatney,F,100,26,0,26
Valory,F,100,246,0,246
Cathaleen,F,100,220,0,220
Breahnna,F,100,16,0,16
Donterrious,M,100,0,33,33
Coralis,F,100,25,0,25
Raun,M,100,0,129,129
Miyonna,F,100,196,0,196
Kayna,F,100,207,0,207
Yuuna,F,100,5,0,5
Vernon,M,99,425,52571,52996
Omran,M,100,0,57,57
Keirya,F,100,5,0,5
Tiffy,F,100,24,0,24
Kahealani,F,100,319,0,319
Adebola,F,78,35,10,45
Xiomar,M,100,0,48,48
Lashawda,F,100,10,0,10
Lurlean,F,100,21,0,21
Sabha,F,100,5,0,5
Tzippy,F,100,105,0,105
Madellyne,F,100,5,0,5
Dazmon,M,100,0,20,20
Roneka,F,100,134,0,134
Caraleigh,F,100,17,0,17
Denequa,F,100,21,0,21
Chachi,M,100,0,9,9
Malaka,F,100,142,0,142
Waleska,F,100,470,0,470
Oaklynn,F,100,85,0,85
Bryianna,F,100,11,0,11
Raelle,F,100,181,0,181
Kobyn,M,100,0,65,65
Zitlally,F,100,54,0,54
Yulemni,F,100,11,0,11
Tiriq,M,100,0,6,6
Sadye,F,100,376,0,376
Ritta,F,100,66,0,66
Carlia,F,100,124,0,124
Alezander,M,100,0,126,126
Kashena,F,100,84,0,84
Brie,F,100,2490,0,2490
Tamra,F,100,13335,5,13340
Lynnis,F,100,9,0,9
Mercedys,F,100,6,0,6
Precyous,F,100,5,0,5
Cornelius,M,99,264,19596,19860
Meraris,F,100,6,0,6
Mellisha,F,100,5,0,5
Schane,M,100,0,6,6
Onisha,F,100,89,0,89
Zykerriah,F,100,6,0,6
Loeta,F,100,15,0,15
Vandell,M,100,0,81,81
Shellbe,F,100,5,0,5
Clarnece,M,100,0,6,6
Hamid,M,100,0,715,715
Fransico,M,100,0,739,739
Euriel,M,100,0,5,5
Denea,F,100,376,0,376
Dellareese,F,100,11,0,11
Parrish,M,86,426,2533,2959
Devereaux,M,95,6,107,113
Zebariah,M,100,0,5,5
Ananias,M,100,0,328,328
Loleatta,F,100,5,0,5
Dammion,M,100,0,16,16
Cynthia,F,100,631848,1786,633634
Toben,M,100,0,116,116
Yerelin,F,100,7,0,7
Rahmya,F,100,15,0,15
Jamiah,F,86,1905,302,2207
Bert,M,99,53,9581,9634
Etoya,F,100,31,0,31
Christylee,F,100,5,0,5
Breasha,F,100,54,0,54
Gerrad,M,100,0,321,321
Jayce,M,94,1191,17161,18352
Renella,F,100,106,0,106
Ihuoma,F,100,5,0,5
Nthan,M,100,0,5,5
Timmy,M,99,168,24600,24768
Delainie,F,100,82,0,82
Eileigh,F,100,10,0,10
Lorayne,F,100,238,0,238
Teina,F,100,30,0,30
Atreu,M,100,0,5,5
Jacenta,F,100,44,0,44
Latesha,F,100,3109,0,3109
Emilyann,F,100,555,0,555
Nada,F,100,2719,0,2719
Muaaz,M,100,0,37,37
Marlissa,F,100,420,0,420
Abdu,M,100,0,32,32
Fayrene,F,100,75,0,75
Trai,M,100,0,257,257
Brittnei,F,100,128,0,128
Daltin,M,100,0,193,193
Gladis,F,100,1640,0,1640
Jossilynn,F,100,5,0,5
Rosely,F,100,192,0,192
Salmaan,M,100,0,162,162
Leshon,M,74,28,80,108
Breaira,F,100,10,0,10
Daruis,M,100,0,180,180
Sarin,F,92,123,11,134
Juanice,F,100,174,0,174
Alicja,F,100,276,0,276
Rasaun,M,100,0,54,54
Xzariah,F,100,8,0,8
Eliese,F,100,66,0,66
Marae,F,100,202,0,202
Heliana,F,100,35,0,35
Malan,F,96,109,5,114
Gorman,M,100,0,137,137
Kron,M,100,0,112,112
Shawnah,F,100,39,0,39
Delando,M,100,0,147,147
Caros,M,100,0,17,17
Ladaisha,F,100,336,0,336
Yridiana,F,100,5,0,5
Ofelia,F,100,4553,0,4553
Ferlin,M,100,0,257,257
Syre,M,100,0,132,132
Jamarae,M,100,0,6,6
Desirre,F,100,111,0,111
Janeth,F,100,3619,0,3619
Yanisa,F,100,62,0,62
Natricia,F,100,15,0,15
Aldona,F,100,97,0,97
Tysheanna,F,100,12,0,12
Adolf,M,100,0,229,229
Joannette,F,100,10,0,10
Brookelle,F,100,93,0,93
Marqwan,M,100,0,7,7
Sahniya,F,100,38,0,38
Blaise,M,93,475,5943,6418
Aysa,F,98,220,5,225
Elane,F,100,450,0,450
Taelee,F,100,5,0,5
Myrakle,F,100,118,0,118
Danieal,F,62,29,18,47
Jaquille,M,100,0,134,134
Keondray,M,100,0,5,5
Nicoya,F,100,64,0,64
Dichelle,F,100,18,0,18
Brandee,F,100,5447,0,5447
Keyanda,F,100,27,0,27
Marvie,F,86,50,8,58
Yeneisy,F,100,33,0,33
Lakeishia,F,100,121,0,121
Jaeceion,M,100,0,5,5
Tahani,F,100,282,0,282
Demonde,M,100,0,5,5
Amrita,F,100,943,0,943
Jerry,M,99,5083,334682,339765
Lemichael,M,100,0,32,32
Toccara,F,99,966,14,980
Ekene,M,54,16,19,35
Nadeja,F,100,35,0,35
Jaclynne,F,100,149,0,149
Stelios,M,100,0,154,154
Timmi,F,100,124,0,124
Fergus,M,100,0,295,295
Nakayia,F,100,5,0,5
Gayna,F,100,89,0,89
Shaketha,F,100,91,0,91
Korrah,F,100,29,0,29
Jacquitta,F,100,11,0,11
Jossy,F,100,5,0,5
Fendi,F,100,100,0,100
Chaffee,F,50,5,5,10
Quintion,M,100,0,5,5
Aiyanna,F,100,3220,0,3220
Tajianna,F,100,5,0,5
Kadasha,F,100,35,0,35
Keri,F,99,31786,324,32110
Therman,M,100,0,610,610
Lamari,M,64,129,225,354
Cassiah,F,100,25,0,25
Angeleigh,F,100,58,0,58
Reiden,M,100,0,29,29
Joetta,F,100,2214,0,2214
Dannaly,F,100,12,0,12
Eon,M,100,0,267,267
Arieal,F,100,401,0,401
Rubymae,F,100,11,0,11
Iyannah,F,100,363,0,363
Kamekia,F,100,11,0,11
Srijan,M,100,0,114,114
Brandt,M,99,38,5188,5226
Rina,F,100,3459,0,3459
Gabriana,F,100,300,0,300
Sismai,F,100,17,0,17
Rayshonda,F,100,55,0,55
Antojuan,M,100,0,5,5
Akiria,F,100,39,0,39
Takera,F,100,280,0,280
Sebrinia,F,100,5,0,5
Jerimya,M,100,0,20,20
Brezlynn,F,100,12,0,12
Dagmar,F,100,475,0,475
Semeko,F,100,6,0,6
Allexandra,F,100,25,0,25
Bindy,F,100,16,0,16
Tyneisha,F,100,613,0,613
Wonda,F,100,1265,0,1265
Shadreka,F,100,22,0,22
Baeden,M,100,0,5,5
Haidee,F,100,533,0,533
Neyda,F,100,656,0,656
Jayquin,M,100,0,5,5
Satyam,M,100,0,16,16
Rainelle,F,100,102,0,102
Chardell,F,100,11,0,11
Sheera,F,100,133,0,133
Rowynn,F,100,136,0,136
Vyom,M,100,0,145,145
Kodee,F,50,279,276,555
Fransisco,M,100,0,2436,2436
Ishya,F,100,24,0,24
Louellen,F,100,102,0,102
Tresia,F,100,438,0,438
Rowdy,M,100,5,3056,3061
Chaeden,M,100,0,5,5
Stavroula,F,100,423,0,423
Sangita,F,100,84,0,84
Jahtavious,M,100,0,7,7
Shaconda,F,100,85,0,85
Laylah,F,100,3738,0,3738
Jeston,M,100,0,425,425
Allianna,F,100,294,0,294
Harding,M,100,0,133,133
Alfretta,F,100,22,0,22
Jacieon,M,100,0,16,16
Tammera,F,100,1338,0,1338
Stacie,F,100,38746,194,38940
Bryah,F,100,114,0,114
Maasai,M,100,0,21,21
Advith,M,100,0,27,27
Matthrew,M,100,0,5,5
Royann,F,100,69,0,69
Gerin,M,100,0,5,5
Lynley,F,100,643,0,643
Rhianon,F,100,355,0,355
Deericka,F,100,49,0,49
Bransen,M,100,0,540,540
Lanesa,F,100,5,0,5
Juliet,F,100,21364,0,21364
Joanetta,F,100,28,0,28
Kanitha,F,100,30,0,30
Whitni,F,100,333,0,333
Medin,M,100,0,5,5
Ruthann,F,100,3484,0,3484
Ariah,F,99,3438,21,3459
Taira,F,100,1007,0,1007
Chalita,F,100,28,0,28
Shanesa,F,100,5,0,5
Alfanette,F,100,5,0,5
Kashka,F,57,16,12,28
Markco,M,100,0,6,6
Marinella,F,100,12,0,12
Areanna,F,100,610,0,610
Parrie,F,100,5,0,5
Senetra,F,100,78,0,78
Sinay,F,100,55,0,55
Jessimar,F,100,5,0,5
Michaeline,F,100,466,0,466
Montana,F,70,6856,2965,9821
Daisey,F,100,1340,0,1340
Mercedeez,F,100,20,0,20
Caelie,F,100,95,0,95
Normie,F,100,5,0,5
Witten,M,100,0,206,206
Brandonray,M,100,0,5,5
Janael,F,100,5,0,5
Tedrina,F,100,6,0,6
Kari,F,99,58150,623,58773
Danashia,F,100,158,0,158
Temisha,F,100,104,0,104
Azani,F,100,42,0,42
Dechen,F,100,11,0,11
Elnathan,M,100,0,173,173
Juwon,M,100,0,325,325
Vinda,F,100,21,0,21
Alyha,F,100,73,0,73
Tyquita,F,100,5,0,5
Brettany,F,100,133,0,133
Jerin,M,91,54,530,584
Jeniah,F,100,412,0,412
Elim,M,57,92,120,212
Shaque,F,100,12,0,12
Kamillah,F,100,188,0,188
Nakoa,M,98,5,311,316
Asaf,M,100,0,251,251
Tahira,F,100,1046,0,1046
Odalyz,F,100,17,0,17
Heylen,F,100,5,0,5
Jaselyn,F,100,326,0,326
Farhana,F,100,231,0,231
Pelagia,F,100,5,0,5
Lynleigh,F,100,156,0,156
Mallina,F,100,5,0,5
Deneen,F,100,3597,7,3604
Matviy,M,100,0,20,20
Chazmon,M,100,0,13,13
Lorinza,M,100,0,5,5
Nasario,M,100,0,328,328
Maika,F,65,348,186,534
Nyasia,F,100,4766,0,4766
Nakevia,F,100,5,0,5
Rashade,M,100,0,5,5
Catena,F,100,28,0,28
Caitylyn,F,100,5,0,5
Zariel,F,90,147,16,163
Mahin,M,89,16,133,149
Matai,M,100,0,277,277
Kasmin,F,100,6,0,6
Georganne,F,100,729,0,729
Laurajean,F,100,101,0,101
Ahmaj,M,100,0,10,10
Katierra,F,100,5,0,5
Ronni,F,98,2804,55,2859
Alizander,M,100,0,6,6
Chamara,F,100,76,0,76
Toshi,F,100,35,0,35
Talus,M,100,0,36,36
Rubyanne,F,100,10,0,10
Taler,F,93,68,5,73
Jochelle,F,100,6,0,6
Matayo,M,100,0,43,43
Wadia,F,100,5,0,5
Junell,F,100,170,0,170
Josmar,M,100,0,528,528
Izzabella,F,100,1520,0,1520
Jaylia,F,100,179,0,179
Maiti,F,100,5,0,5
Jaquoya,F,100,6,0,6
Nickisha,F,100,55,0,55
Delimar,F,100,23,0,23
Japleen,F,100,55,0,55
Collene,F,100,700,0,700
Lashada,F,100,11,0,11
Ladeana,F,100,280,0,280
Mckinzley,F,100,8,0,8
Royer,M,100,0,194,194
Noralba,F,100,21,0,21
Shayla,F,100,28766,17,28783
Delanie,F,100,3708,0,3708
Synceir,M,100,0,5,5
Meshayla,F,100,29,0,29
Eymi,F,100,148,0,148
Ottmar,M,100,0,13,13
Kardell,M,100,0,100,100
Sachit,M,100,0,52,52
Leonore,F,100,395,0,395
Sarn,M,100,0,5,5
Shaddix,M,100,0,19,19
Nkechi,F,100,167,0,167
Emaree,F,100,107,0,107
Daysha,F,100,2364,0,2364
Corion,M,100,0,296,296
Clarine,F,100,210,0,210
Infantof,F,54,67,57,124
Josceline,F,100,77,0,77
Skeet,M,100,0,29,29
Ubaldo,M,100,0,1756,1756
Chellsie,F,100,70,0,70
Pollyanna,F,100,655,0,655
Tyhir,M,100,0,66,66
Kaylany,F,100,41,0,41
Natale,M,52,371,395,766
Daleon,M,100,0,94,94
Arnella,F,100,77,0,77
Amilyah,F,100,147,0,147
Ellasyn,F,100,277,0,277
Ajsha,F,100,5,0,5
Esther,F,100,69608,199,69807
Chaselynn,F,100,59,0,59
Dayren,M,100,0,12,12
Jontavia,F,100,74,0,74
Jaser,M,100,0,59,59
Mugilan,M,100,0,5,5
Ibis,F,83,57,12,69
Jakeyla,F,100,27,0,27
Ilenna,F,100,5,0,5
Jamaile,M,100,0,5,5
Elaisa,F,100,6,0,6
Shalamar,F,74,234,83,317
Vonnette,F,100,5,0,5
Kashauna,F,100,79,0,79
Kaliyah,F,100,6545,5,6550
Jhared,M,100,0,45,45
Aisja,F,100,5,0,5
Donyetta,F,100,103,0,103
Gannyn,M,100,0,7,7
Timarie,F,100,74,0,74
Seila,F,100,48,0,48
Lafreda,F,100,106,0,106
Kente,M,100,0,55,55
Jacquiline,F,100,628,0,628
Reice,M,94,7,112,119
Tederick,M,100,0,11,11
Jyah,F,100,22,0,22
Jumel,M,100,0,19,19
Kimberlea,F,100,531,0,531
Soobin,F,100,5,0,5
Marcandrew,M,100,0,6,6
Izellah,F,100,42,0,42
Stuti,F,100,204,0,204
Kaname,F,100,5,0,5
Mattheq,M,100,0,5,5
Emeric,M,100,0,177,177
Sachary,F,50,5,5,10
Lasheryl,F,100,5,0,5
Tymika,F,100,116,0,116
Taborah,F,100,5,0,5
Shallah,M,100,0,18,18
Ryle,M,88,35,250,285
Lynsie,F,100,961,0,961
Bram,M,100,0,1021,1021
Kayvonna,F,100,5,0,5
Swayzi,F,100,7,0,7
Henon,M,100,0,5,5
Bradleigh,F,96,251,11,262
Ladarrin,M,100,0,12,12
Satchel,M,100,0,515,515
Cleofas,M,100,0,73,73
Antonieo,M,100,0,10,10
Vitani,F,100,5,0,5
Synquis,F,100,26,0,26
Arianne,F,100,3566,0,3566
Keino,M,100,0,89,89
Akieba,F,100,6,0,6
Sarp,M,100,0,52,52
Elisebeth,F,100,21,0,21
Ameya,F,71,438,183,621
Kazz,M,100,0,5,5
Tayleah,F,100,5,0,5
Marvell,M,97,30,986,1016
Harsimran,F,75,94,32,126
Hakeem,M,100,0,4274,4274
Nevada,F,69,1409,636,2045
Deny,M,100,0,140,140
Labrandon,M,100,0,211,211
Christof,M,100,0,54,54
Ezara,F,100,6,0,6
Driscoll,M,100,0,5,5
Yaniris,F,100,108,0,108
Thisbe,F,100,7,0,7
Chou,M,100,0,60,60
Chaddrick,M,100,0,333,333
Koley,F,100,6,0,6
Preslynn,F,100,30,0,30
Salisha,F,100,82,0,82
Analisa,F,100,3463,0,3463
Sunya,F,100,77,0,77
Atiba,M,99,5,367,372
Haydee,F,100,3030,0,3030
Jlen,M,100,0,88,88
Nanda,F,93,65,5,70
Lejla,F,100,620,0,620
Della,F,100,15249,0,15249
Lucyann,F,100,88,0,88
Shaianne,F,100,433,0,433
Keris,F,100,50,0,50
Adalinda,F,100,10,0,10
Genesiss,F,100,31,0,31
Maheen,F,99,498,6,504
Treyana,F,100,71,0,71
Dinetta,F,100,34,0,34
Jazzmaine,F,100,5,0,5
Bandon,M,100,0,61,61
Pamala,F,100,6343,0,6343
Bricola,F,100,5,0,5
Flechia,F,100,5,0,5
Gareth,M,100,5,3031,3036
Dezeree,F,100,54,0,54
Elisabel,F,100,112,0,112
Treymon,M,100,0,50,50
Meriah,F,100,850,0,850
Jahongir,M,100,0,10,10
Dareona,F,100,5,0,5
Isoke,F,100,6,0,6
Koleman,M,100,0,159,159
Tacha,F,100,63,0,63
Billyjack,M,100,0,79,79
Nadja,F,100,1017,0,1017
Arcadia,F,100,385,0,385
Anayelli,F,100,50,0,50
Devona,F,100,2175,0,2175
Saiyan,M,100,0,15,15
Latreese,F,100,49,0,49
Nandy,F,100,27,0,27
Criscia,F,100,6,0,6
Xamara,F,100,5,0,5
Irby,M,100,0,261,261
Katrina,F,100,98393,238,98631
Derrianna,F,100,46,0,46
Riddik,M,100,0,58,58
Shyrell,F,100,12,0,12
Tavione,M,100,0,23,23
Macaela,F,100,325,0,325
Erma,F,100,7173,5,7178
Jakira,F,100,1148,0,1148
Mataia,F,100,13,0,13
Chukwudi,M,100,0,170,170
Dominek,M,77,5,17,22
Yurie,F,100,12,0,12
Warfield,M,100,0,5,5
Tigh,M,100,0,34,34
Xuxa,F,100,29,0,29
Sabelle,F,100,17,0,17
Nikolett,F,100,10,0,10
Dubois,M,100,0,22,22
Layvonne,F,100,5,0,5
Gurjeet,M,100,0,5,5
Yichen,M,67,21,42,63
Alandrea,F,100,47,0,47
Tatum,F,84,17047,3169,20216
Allaura,F,100,31,0,31
Mame,F,100,300,0,300
Twana,F,100,2169,0,2169
Jacquelen,F,100,8,0,8
Aurther,M,100,0,67,67
Elizibeth,F,100,197,0,197
Anthoy,M,100,0,31,31
Montravius,M,100,0,7,7
Alvita,F,100,270,0,270
Amiliyah,F,100,8,0,8
Anneleise,F,100,40,0,40
Izyck,M,100,0,7,7
Giobany,M,100,0,5,5
Flores,M,100,0,14,14
Zyrhiana,F,100,6,0,6
Vail,F,68,73,34,107
Lorcan,M,100,0,131,131
Owynn,M,95,5,88,93
Wilmon,M,100,0,62,62
Tahlor,F,100,80,0,80
Edina,F,100,454,0,454
Catarina,F,100,2208,0,2208
Maddison,F,100,15728,47,15775
Attalie,F,100,19,0,19
Latoshia,F,100,1057,0,1057
Sabrie,F,100,106,0,106
Brilynn,F,99,530,5,535
Jezelle,F,100,290,0,290
Audresha,F,100,18,0,18
Jaron,M,100,48,10395,10443
Jolanta,F,100,57,0,57
Arayah,F,100,544,0,544
Zionah,F,100,101,0,101
Timeca,F,100,24,0,24
Neda,F,100,1413,0,1413
Deacon,M,100,0,5110,5110
Deyante,M,100,0,5,5
Laketra,F,100,146,0,146
Keshuna,F,100,30,0,30
Denett,F,100,13,0,13
Jayonah,F,100,6,0,6
Arkayla,F,100,6,0,6
Kenyen,M,100,0,216,216
Ruwaida,F,100,22,0,22
Betty,F,100,163285,574,163859
Nawar,F,100,5,0,5
Jenne,F,100,506,0,506
Zoriyah,F,100,44,0,44
Anuhea,F,100,279,0,279
Calise,F,100,306,0,306
Lakelsha,F,100,6,0,6
Liberty,F,99,10141,114,10255
Clanton,M,100,0,13,13
Kirstina,F,100,126,0,126
Waheed,M,100,0,52,52
Nikte,F,100,10,0,10
Bailee,F,98,11972,216,12188
Candence,F,100,148,0,148
Cheylyn,F,100,5,0,5
Amarian,M,100,0,283,283
Lareina,F,100,525,0,525
Romiya,F,100,12,0,12
Anniston,F,100,1512,0,1512
Bailor,M,100,0,13,13
Rashada,F,100,172,0,172
Mahendra,M,100,0,21,21
Nicohle,F,100,15,0,15
Sanija,F,100,18,0,18
Chantella,F,100,105,0,105
Barnet,M,100,0,35,35
Annmarie,F,100,16212,0,16212
Benjemin,M,100,0,13,13
Destinii,F,100,30,0,30
Deith,M,100,0,6,6
Zayid,M,100,0,21,21
Jesseray,M,100,0,22,22
Dasanii,F,100,5,0,5
Tarrell,M,99,11,745,756
Caretta,F,100,47,0,47
Neyzer,M,100,0,11,11
Jahlil,M,100,0,1564,1564
Dary,M,85,24,133,157
Breannia,F,100,49,0,49
Kotomi,F,100,5,0,5
Dayvon,M,100,0,1336,1336
Demonie,M,89,6,47,53
Mckennah,F,100,440,0,440
Javarrius,M,100,0,17,17
Corelle,F,100,5,0,5
Lazerrick,M,100,0,23,23
Rickard,M,100,0,389,389
Azreal,M,100,0,78,78
Ezariah,M,63,33,56,89
Tkya,F,100,11,0,11
Missouri,F,100,91,0,91
Maielle,F,100,14,0,14
Maxim,M,100,6,4723,4729
Mukhtar,M,100,0,76,76
Adamina,F,100,20,0,20
Nylee,F,100,110,0,110
Virgin,F,86,30,5,35
Runako,M,85,5,28,33
Krystallyn,F,100,10,0,10
Rahela,F,100,6,0,6
Orna,F,100,37,0,37
Hanna,F,100,33958,115,34073
Marlenee,F,100,11,0,11
Feride,F,100,5,0,5
Izen,M,100,0,48,48
Quenette,F,100,5,0,5
Analicia,F,100,1712,0,1712
Rashena,F,100,62,0,62
Marchell,F,100,578,0,578
Markki,F,100,5,0,5
Ranny,M,97,5,154,159
Edana,F,100,219,0,219
Dayahna,F,100,6,0,6
Edwardjames,M,100,0,6,6
Jhet,M,100,0,12,12
Jasmynn,F,100,292,0,292
Morgann,F,100,738,0,738
Zakir,M,100,0,348,348
Chrysander,M,100,0,11,11
Mateos,M,100,0,11,11
Dartha,F,100,29,0,29
Cayley,F,100,1093,0,1093
Frona,F,100,41,0,41
Jalise,F,100,252,0,252
Rhonna,F,100,153,0,153
Kenethia,F,100,19,0,19
Teddra,F,100,6,0,6
Montique,F,55,41,34,75
Adanelly,F,100,28,0,28
Valentia,F,100,10,0,10
Kotina,F,100,20,0,20
Alynnah,F,100,10,0,10
Shakarra,F,100,29,0,29
Haily,F,100,2880,0,2880
Tahitha,F,100,5,0,5
Erkan,M,100,0,5,5
Aaronjosh,M,100,0,5,5
Audery,F,100,241,0,241
Synthia,F,100,2188,0,2188
Minesha,F,100,11,0,11
Laytona,F,100,16,0,16
Tonyette,F,100,16,0,16
Briele,F,100,80,0,80
Genessys,F,100,15,0,15
Demira,F,100,47,0,47
Manijah,F,100,14,0,14
Dede,F,100,1452,0,1452
Heathre,F,100,6,0,6
Mirella,F,100,2883,0,2883
Vidit,M,100,0,40,40
Kadison,F,57,8,6,14
Floris,F,100,37,0,37
Timaya,F,100,218,0,218
Ramika,F,100,35,0,35
Lashika,F,100,156,0,156
Braedin,M,100,0,143,143
Shondra,F,100,1228,0,1228
Vol,M,100,0,5,5
Gleason,M,100,0,49,49
Ahzir,M,100,0,21,21
Aadhav,M,100,0,102,102
Mikasia,F,100,11,0,11
Loise,F,100,135,0,135
Chanceller,M,100,0,23,23
Sharen,F,100,2075,0,2075
Janisha,F,100,912,0,912
Lydon,M,100,0,200,200
Jaleek,M,100,0,28,28
Naidaly,F,100,6,0,6
Kabrina,F,100,435,0,435
Estefani,F,100,3975,16,3991
Elidet,F,100,5,0,5
Teila,F,100,310,0,310
Arleena,F,100,6,0,6
Tondria,F,100,6,0,6
Darann,F,100,6,0,6
Kidist,F,100,16,0,16
Tywonda,F,100,5,0,5
Devell,M,100,0,181,181
Saleisha,F,100,24,0,24
Fatme,F,100,36,0,36
Mareshah,F,100,32,0,32
Aiza,F,100,709,0,709
Raniesha,F,100,50,0,50
Cevon,M,100,0,27,27
Allayne,F,100,5,0,5
Jadiah,M,59,26,38,64
Zaon,M,100,0,5,5
Valli,F,100,578,0,578
Clavin,M,100,0,88,88
Nicolis,M,100,0,141,141
Toyin,F,100,18,0,18
Evins,M,100,0,5,5
Cassie,F,99,37980,191,38171
Callaway,M,51,164,168,332
Keiji,M,100,0,91,91
Ziv,M,100,0,120,120
Aaliayah,F,100,124,0,124
Lisel,F,100,89,0,89
Nilo,M,100,0,143,143
Mironda,F,100,41,0,41
Obaida,M,100,0,6,6
Ubah,F,100,48,0,48
Aakilah,F,100,18,0,18
Mairlyn,F,100,42,0,42
Shirita,F,100,41,0,41
Kima,F,100,277,0,277
Momina,F,100,123,0,123
Axcel,M,100,0,241,241
Jessilyn,F,100,609,0,609
Jessielynn,F,100,7,0,7
Mykira,F,100,87,0,87
Quantre,M,100,0,10,10
Nevon,M,100,0,48,48
Evonte,M,100,0,63,63
Donnye,M,100,0,5,5
Mimma,F,100,11,0,11
Ekta,F,100,112,0,112
Coulson,M,100,0,155,155
Calan,M,97,20,564,584
Sharol,F,100,569,0,569
Dredyn,M,100,0,128,128
Iolanda,F,100,7,0,7
Armeda,F,100,42,0,42
Jakerah,F,100,10,0,10
Andreaz,M,100,0,23,23
Laurens,M,100,0,82,82
Link,M,100,0,868,868
Vane,M,100,0,11,11
Nayari,F,100,33,0,33
Raelie,F,100,65,0,65
Severina,F,100,19,0,19
Cianny,F,100,10,0,10
Elisandra,F,100,154,0,154
Emilo,M,100,0,151,151
Nikisha,F,100,1166,0,1166
Elaf,F,100,27,0,27
Deronte,M,100,0,74,74
Tresea,F,100,384,0,384
Metthew,M,100,0,21,21
Monee,F,100,451,0,451
Aiman,M,76,83,261,344
Izzah,F,100,58,0,58
Jahneil,M,100,0,5,5
Ruchika,F,100,39,0,39
Hewan,F,100,25,0,25
Makaya,F,100,870,0,870
Chad,M,100,1039,238049,239088
Makson,M,100,0,15,15
Gigi,F,100,3661,0,3661
Raymonte,M,100,0,11,11
Cheli,F,100,10,0,10
Sadhana,F,100,155,0,155
Ilhana,F,100,5,0,5
Jayant,M,100,0,126,126
Alathea,F,100,33,0,33
Rishab,M,100,0,527,527
Wren,F,84,2501,487,2988
Kashanda,F,100,41,0,41
Zerelda,F,100,10,0,10
Bentzion,M,100,0,278,278
Carmen,F,94,100239,6920,107159
Yeruchem,M,100,0,6,6
Nawfal,M,100,0,5,5
Myniah,F,100,23,0,23
Shanik,F,100,206,0,206
Damareion,M,100,0,5,5
Hyon,M,100,0,5,5
Larkin,F,54,1212,1018,2230
Seabrook,M,100,0,5,5
Maiya,F,100,3354,0,3354
Hada,F,100,5,0,5
Rayisha,F,100,7,0,7
Kashya,F,100,19,0,19
Prutha,F,100,5,0,5
Michalah,F,100,32,0,32
Ereny,F,100,6,0,6
Cherisha,F,100,6,0,6
Natonia,F,100,28,0,28
Devarion,M,100,0,63,63
Nijash,M,100,0,6,6
Levertis,M,100,0,5,5
Robbins,M,100,0,5,5
Dayse,F,100,7,0,7
Elius,M,100,0,29,29
Jazmaine,F,100,179,0,179
Jhovana,F,100,24,0,24
Lamonda,F,100,72,0,72
Corderia,M,100,0,7,7
Rosco,M,100,0,355,355
Berrie,F,100,5,0,5
Christain,M,87,305,1989,2294
Sherrone,F,100,6,0,6
Birute,F,100,23,0,23
Qaasim,M,100,0,19,19
Dahja,F,100,29,0,29
Stcy,F,100,5,0,5
Glendel,M,100,0,12,12
Nivedha,F,100,33,0,33
Jariya,F,100,188,0,188
Deleen,F,100,12,0,12
Tasherra,F,100,7,0,7
Kianny,F,100,31,0,31
Thonda,F,100,26,0,26
Keivon,M,100,0,422,422
Renida,F,100,5,0,5
Manaure,M,100,0,5,5
Zakye,M,100,0,60,60
Keyanah,F,100,117,0,117
Gy,M,100,0,5,5
Rodrion,M,100,0,5,5
Markell,M,95,219,3887,4106
Reginique,F,100,5,0,5
Devaj,M,100,0,13,13
Deserae,F,100,1322,0,1322
Sherkita,F,100,5,0,5
Dynastie,F,100,66,0,66
Rhyley,F,62,30,18,48
Michealangelo,M,100,0,11,11
Odelia,F,100,828,0,828
Quanique,F,100,30,0,30
Erleen,F,100,43,0,43
Desirey,F,100,279,0,279
Katavia,F,100,33,0,33
Alexader,M,100,0,25,25
Deavian,F,100,56,0,56
Christopehr,M,100,0,15,15
Dywanna,F,100,6,0,6
Acelin,M,83,19,93,112
Vasanth,M,100,0,15,15
Charlyn,F,100,1295,0,1295
Krisstopher,M,100,0,10,10
Zealan,M,100,0,5,5
Itzae,M,82,43,191,234
Somnang,M,100,0,62,62
Lamonte,M,100,0,2864,2864
Champion,M,100,0,199,199
Antoniya,F,100,52,0,52
Alexzandria,F,100,1596,0,1596
Denena,F,100,5,0,5
Apsara,F,100,18,0,18
Jeyla,F,100,173,0,173
Valeri,F,100,1760,0,1760
Tonni,F,100,251,0,251
Jonpatrick,M,100,0,14,14
Charla,F,100,6825,0,6825
Kenidee,F,100,240,0,240
Srivar,M,100,0,5,5
Aletris,F,100,6,0,6
Jabora,F,100,5,0,5
Elianis,F,100,51,0,51
Sudie,F,100,295,0,295
Juda,M,85,37,216,253
Kaliff,M,100,0,11,11
Zamare,M,100,0,12,12
Anterria,F,100,10,0,10
Jerell,M,100,5,1549,1554
Kollyns,F,100,62,0,62
Denesia,F,100,71,0,71
Adbeel,M,100,0,5,5
Cordalro,M,100,0,10,10
Tyshonna,F,100,37,0,37
Makiy,M,100,0,6,6
Dasie,F,100,27,0,27
Abie,M,80,57,224,281
Bibiano,M,100,0,10,10
Cherae,F,100,183,0,183
Rajon,M,100,0,664,664
Markevis,M,100,0,53,53
Quintavious,M,100,0,758,758
Dashana,F,100,198,0,198
Markwilliam,M,100,0,5,5
Jermeisha,F,100,29,0,29
Morene,F,100,30,0,30
Loujean,F,100,11,0,11
Rystal,F,100,33,0,33
Saory,F,100,59,0,59
Sotiris,M,100,0,5,5
Tammany,F,100,6,0,6
Erasmo,M,100,0,2908,2908
Varnell,M,76,21,67,88
Tambi,F,100,177,0,177
Taneicia,F,100,5,0,5
Ahriah,F,100,6,0,6
Shaparis,F,100,25,0,25
Airika,F,100,173,0,173
Dawyn,F,100,12,0,12
Caress,F,100,209,0,209
Lynnzie,F,100,85,0,85
Graciana,F,100,245,0,245
Inmer,M,100,0,57,57
Nason,M,100,0,380,380
Camisa,F,100,10,0,10
Alray,M,100,0,5,5
Rorey,M,63,53,92,145
Severo,M,100,0,792,792
Sureya,F,100,22,0,22
Allisia,F,100,44,0,44
Lorelai,F,100,3475,0,3475
Rondalyn,F,100,136,0,136
Deshaunta,F,100,6,0,6
Charliyah,F,100,10,0,10
Keya,F,100,1640,0,1640
Sandral,F,100,11,0,11
Monic,F,100,509,0,509
Burton,M,100,5,5934,5939
Jacqlene,F,100,10,0,10
Elease,F,100,626,0,626
Emyri,F,100,5,0,5
Ketra,F,100,255,0,255
Clinton,M,100,293,65051,65344
Naudica,F,100,17,0,17
Lerone,M,100,0,401,401
Imena,F,100,15,0,15
Dayl,F,50,5,5,10
Tavionna,F,100,78,0,78
Inessa,F,100,424,0,424
Hassaan,M,100,0,94,94
Nimco,F,100,57,0,57
Charitie,F,100,116,0,116
Margeaux,F,100,658,0,658
Tannin,M,100,0,11,11
Jonce,M,100,0,6,6
Shikeem,M,100,0,24,24
Georgiaann,F,100,11,0,11
Kamilo,M,100,0,97,97
Uriah,M,92,632,6820,7452
Kemyia,F,100,47,0,47
Kingsten,M,100,0,209,209
Eyvone,F,100,12,0,12
Haby,F,100,20,0,20
Kiira,F,100,108,0,108
Ammerie,F,100,10,0,10
Feleshia,F,100,128,0,128
Greyce,F,100,5,0,5
Victorina,F,100,61,0,61
Becket,M,100,0,251,251
Izariah,F,100,27,0,27
Emory,M,67,3279,6733,10012
Viraaj,M,100,0,105,105
Jemeria,F,100,6,0,6
Deqwan,M,100,0,48,48
Gracelynd,F,100,5,0,5
Anndria,F,100,35,0,35
Cyndra,F,100,72,0,72
Pertina,F,100,11,0,11
Donitra,F,100,6,0,6
Donoven,M,100,0,360,360
Latecha,F,100,18,0,18
Linken,M,100,0,208,208
Zakayla,F,100,317,0,317
Norine,F,100,1575,0,1575
Jaidin,M,59,189,276,465
Omareon,M,100,0,37,37
Eimear,F,100,5,0,5
Oshawn,M,100,0,17,17
Jimalee,F,100,5,0,5
Quynhnhu,F,100,12,0,12
Latyna,F,100,5,0,5
Egidio,M,100,0,5,5
Naina,F,100,398,0,398
Genera,F,100,26,0,26
Aayliah,F,100,76,0,76
Jaaden,M,100,0,33,33
Janaeyah,F,100,9,0,9
Nathenial,M,100,0,42,42
Yufei,F,100,11,0,11
Miquisha,F,100,5,0,5
Malori,F,100,723,0,723
Jaylisa,F,100,24,0,24
Arilyn,F,100,255,0,255
Tillman,M,100,0,1328,1328
Timisha,F,100,295,0,295
Lakeena,F,100,71,0,71
Yvelisse,F,100,33,0,33
Avahlyn,F,100,5,0,5
Dayzee,F,100,69,0,69
Dametre,M,100,0,5,5
Rosene,F,100,162,0,162
Tenya,F,100,82,0,82
Anisty,F,100,42,0,42
Mucaad,M,100,0,6,6
Katieanne,F,100,10,0,10
Chastin,M,76,126,393,519
Maleika,F,100,29,0,29
Kynedi,F,100,184,0,184
Naryah,F,100,241,0,241
Dazja,F,100,60,0,60
Odester,F,100,16,0,16
Marquessa,F,100,18,0,18
Jezer,M,100,0,16,16
Miavictoria,F,100,5,0,5
Noland,M,100,0,1107,1107
Jorrin,M,100,0,16,16
Shatisha,F,100,163,0,163
Shundarius,M,100,0,10,10
Willfredo,M,100,0,5,5
Artemisia,F,100,38,0,38
Reino,M,100,0,37,37
Wilfrid,M,100,0,152,152
Lavorn,F,50,5,5,10
Chrishea,F,100,5,0,5
Brandonlee,M,100,0,222,222
Lacole,F,100,297,0,297
Jonluca,M,100,0,5,5
Eilene,F,100,808,0,808
Daniqua,F,100,186,0,186
Abijah,M,84,42,226,268
Adreyona,F,100,5,0,5
Myda,F,100,58,0,58
Kindal,F,100,298,0,298
Bernon,M,100,0,20,20
Teyanna,F,100,469,0,469
Quatashia,F,100,5,0,5
Hilarie,F,100,749,0,749
Damecia,F,100,17,0,17
Adaya,F,100,578,0,578
Madelyn,F,100,65635,33,65668
Yarell,M,100,0,5,5
Ghala,F,100,12,0,12
Natessa,F,100,27,0,27
Kihry,M,100,0,6,6
Rosia,F,100,558,0,558
Lexy,F,100,2414,0,2414
Cutberto,M,100,0,82,82
Fiana,F,100,68,0,68
Shamela,F,100,105,0,105
Ketha,F,100,18,0,18
Tyreec,M,100,0,5,5
Tyquasha,F,100,55,0,55
Galin,M,100,0,11,11
Kaite,F,100,31,0,31
Princetyn,M,100,0,7,7
Bhavi,F,100,11,0,11
Tanishi,F,100,54,0,54
Millianna,F,100,32,0,32
Myana,F,100,407,0,407
Lamis,F,100,96,0,96
Shen,M,100,0,43,43
Erubey,M,100,0,50,50
Arvelle,M,100,0,5,5
Latavian,M,100,0,50,50
Makye,M,100,0,291,291
Hela,F,100,22,0,22
Latonna,F,100,44,0,44
Kinkade,M,100,0,17,17
Darrion,M,96,149,3952,4101
Jacquelene,F,100,864,0,864
Krissa,F,100,889,0,889
Genoveva,F,100,1152,0,1152
Victorhugo,M,100,0,126,126
Hilaire,F,100,19,0,19
Melicent,F,100,10,0,10
Lastar,F,100,38,0,38
Sherrylynn,F,100,38,0,38
Lysandra,F,100,650,0,650
Sirayah,F,100,5,0,5
Jamielyn,F,100,252,0,252
Iancarlo,M,100,0,32,32
Katrinia,F,100,489,0,489
Oral,M,98,11,686,697
Larose,F,100,96,0,96
Ahva,F,100,12,0,12
Jeg,M,100,0,5,5
Darsi,F,100,105,0,105
Kinzley,F,100,789,0,789
Elpida,F,100,22,0,22
Tiegen,M,100,0,11,11
Dallan,M,100,0,617,617
Kadance,F,98,739,17,756
Kayleigh,F,100,27146,7,27153
Brystle,F,100,12,0,12
Guner,M,100,0,22,22
Kassandra,F,100,30751,16,30767
Madelane,F,100,5,0,5
Junichi,M,100,0,18,18
Alcario,M,100,0,45,45
Uvaldo,M,100,0,486,486
Goodman,M,100,0,5,5
Jaquilyn,F,100,5,0,5
Shacori,F,100,6,0,6
Nevil,M,100,0,5,5
Aaradhana,F,100,17,0,17
Osmund,M,100,0,13,13
Reika,F,100,86,0,86
Kwang,M,100,0,5,5
Anjelique,F,100,242,0,242
Tierny,F,100,30,0,30
Aaraiz,M,100,0,6,6
Everlene,F,100,67,0,67
Deavante,M,100,0,5,5
Elworth,M,100,0,5,5
Franke,M,100,0,57,57
Kristalynn,F,100,142,0,142
Bedelia,F,100,33,0,33
Jennia,F,100,56,0,56
Kendryck,M,100,0,48,48
Nalijah,F,100,24,0,24
Lagenia,F,100,16,0,16
Starleen,F,100,75,0,75
Lachundra,F,100,5,0,5
Rozilyn,F,100,13,0,13
Jabarri,M,100,0,247,247
Jermarkus,M,100,0,7,7
Fanon,M,100,0,5,5
Beneta,F,100,23,0,23
Mikei,M,100,0,5,5
Moni,F,100,59,0,59
Symeon,M,100,0,157,157
Jammel,M,100,0,35,35
Tigerlilly,F,100,10,0,10
Kirstin,F,100,8715,0,8715
Syl,M,100,0,5,5
Camiesha,F,100,5,0,5
Dion,M,94,1116,16573,17689
Boon,M,100,0,5,5
Akia,F,94,1514,89,1603
Ronmel,M,100,0,5,5
Yarizel,F,100,5,0,5
Kimarie,F,100,168,0,168
Heera,F,100,11,0,11
Sophiarose,F,100,90,0,90
Lowanna,F,100,35,0,35
Lajuanda,F,100,82,0,82
Shamirra,F,100,23,0,23
Carlleen,F,100,5,0,5
Samiya,F,100,2824,0,2824
Isaam,M,100,0,6,6
Shellie,F,98,9169,213,9382
Moran,F,100,5,0,5
Bashira,F,100,6,0,6
Olivine,F,100,22,0,22
Ellyne,F,100,7,0,7
Calyn,F,90,645,70,715
Keimoni,M,60,17,25,42
Yazmarie,F,100,10,0,10
Takara,F,100,1372,0,1372
Reyner,M,100,0,5,5
Janusz,M,100,0,5,5
Mayghan,F,100,5,0,5
Tahia,F,100,49,0,49
Karle,F,73,94,34,128
Montelle,M,100,0,18,18
Lakischa,F,100,14,0,14
Skyeler,F,50,116,115,231
Akansha,F,100,55,0,55
Delynne,F,100,35,0,35
Oumy,F,100,21,0,21
Turi,F,79,19,5,24
Siddalee,F,100,123,0,123
Anye,F,100,119,0,119
Nurul,F,100,13,0,13
Mckinly,F,100,30,0,30
Dmaya,F,100,35,0,35
Teaire,F,100,15,0,15
Ayzel,F,100,6,0,6
Dafne,F,100,1913,0,1913
Hery,M,100,0,5,5
Leahana,F,100,32,0,32
Tamya,F,100,2565,0,2565
Obianuju,F,100,22,0,22
Akeem,M,100,0,5409,5409
Dailan,M,100,0,108,108
Jalynne,F,100,262,0,262
Shreyaan,M,100,0,16,16
Endrew,M,100,0,5,5
Antanesha,F,100,45,0,45
Takesia,F,100,11,0,11
Malykai,M,100,0,28,28
Kejuana,F,100,35,0,35
Abdihamid,M,100,0,5,5
Nanako,F,100,61,0,61
Ferrie,F,100,6,0,6
Kathlin,F,100,12,0,12
Aleksei,M,96,12,315,327
Roshell,F,98,588,12,600
Vernestine,F,100,74,0,74
Nashaley,F,100,5,0,5
Hadar,F,100,156,0,156
Jaid,F,97,168,5,173
Mataio,M,100,0,79,79
Kamell,M,100,0,17,17
Mirlene,F,100,5,0,5
Kha,M,95,5,88,93
Aamia,F,100,11,0,11
Elaisha,F,100,90,0,90
Ryanpaul,M,100,0,5,5
Kerlyn,F,100,17,0,17
Eleecia,F,100,5,0,5
Izak,M,100,0,1475,1475
Samhith,M,100,0,28,28
Minhchau,F,100,16,0,16
Winrey,F,100,5,0,5
Makani,M,87,29,191,220
Idalee,F,100,19,0,19
Alprentice,M,100,0,17,17
Velma,F,100,12541,15,12556
Shakerra,F,100,287,0,287
Jammy,M,72,130,332,462
Christelle,F,100,821,0,821
Navar,M,100,0,36,36
Skyy,F,93,1328,107,1435
Zakkariah,M,100,0,6,6
Eliyas,M,100,0,142,142
Skylarrae,F,100,5,0,5
Kayser,M,100,0,15,15
Khalid,M,100,0,5494,5494
Jerl,M,100,0,74,74
Jadzia,F,100,439,0,439
Jameel,M,99,18,2692,2710
Jizell,F,100,19,0,19
Marleigh,F,100,2609,0,2609
Jalae,F,100,13,0,13
Najiyah,F,100,76,0,76
Thaila,F,100,92,0,92
Sekai,M,51,63,65,128
Hashem,M,100,0,294,294
Taimoor,M,100,0,5,5
Autume,F,100,11,0,11
Taminka,F,100,11,0,11
Skila,F,100,69,0,69
Jhenifer,F,100,5,0,5
Brenya,F,100,170,0,170
Annelys,F,100,5,0,5
Brynesha,F,100,15,0,15
Carlecia,F,100,27,0,27
Cattalaya,F,100,5,0,5
Marim,F,100,21,0,21
Krissandra,F,100,59,0,59
Chayenne,F,100,51,0,51
Charvey,F,100,5,0,5
Sedina,F,100,38,0,38
Jaidlyn,F,100,11,0,11
Zyhaire,M,100,0,7,7
Rudolf,M,100,0,1061,1061
Spiro,M,100,0,660,660
Juliyah,F,100,93,0,93
Turkesa,F,100,19,0,19
Shogo,M,100,0,83,83
Min,M,62,233,375,608
Karys,F,100,405,0,405
Hailley,F,100,450,0,450
Aubray,F,100,18,0,18
Jaliek,M,100,0,6,6
Lashaunta,F,100,78,0,78
Eryka,F,100,1127,0,1127
Daeon,M,100,0,25,25
Minjae,M,100,0,6,6
Deida,F,100,10,0,10
Anterius,M,100,0,11,11
Chenae,F,100,110,0,110
Roylene,F,100,179,0,179
Shantasha,F,100,13,0,13
Shawnya,F,100,141,0,141
Fawnia,F,100,17,0,17
Kauai,M,100,0,5,5
Colin,M,100,430,114830,115260
Naajia,F,100,10,0,10
Raahul,M,100,0,5,5
Lokesh,M,100,0,22,22
Elesia,F,100,323,0,323
Corny,M,100,0,6,6
Myliyah,F,100,117,0,117
Kiheem,M,100,0,5,5
Maylynn,F,100,361,0,361
Hud,M,100,0,40,40
Halcyon,F,100,10,0,10
Arland,M,99,5,471,476
Gittle,F,100,5,0,5
Brewer,M,100,0,283,283
Ani,F,100,2356,5,2361
Mariaguadalupe,F,100,752,0,752
Kyanah,F,100,36,0,36
Kathy,F,100,296850,661,297511
Ferrell,M,99,5,778,783
Jerniyah,F,100,52,0,52
Demarean,M,100,0,5,5
Kiyrah,F,100,10,0,10
Satin,F,100,373,0,373
Makaylen,F,100,95,0,95
Jahlique,M,100,0,5,5
Ajahnay,F,100,5,0,5
Jenaliz,F,100,11,0,11
Naura,F,100,5,0,5
Alistar,M,100,0,49,49
Suean,F,100,6,0,6
Annamary,F,100,107,0,107
Issei,M,100,0,6,6
Tilden,M,97,15,559,574
Thanhtruc,F,100,5,0,5
Alarick,M,100,0,10,10
Arshi,F,100,67,0,67
Zhanae,F,100,124,0,124
Dafnne,F,100,7,0,7
Auburn,F,83,947,196,1143
Tavara,F,100,39,0,39
Joquita,F,100,21,0,21
Rocklan,M,100,0,10,10
Rik,M,100,0,277,277
Arizona,F,91,1019,102,1121
Barb,F,100,3646,0,3646
Seniah,F,100,73,0,73
Jerilyn,F,100,3685,0,3685
Jazael,M,100,0,31,31
Daelin,M,86,51,324,375
Righteous,M,94,5,78,83
Corry,M,87,306,2064,2370
Jua,M,100,0,20,20
Gyzelle,F,100,51,0,51
Kianalee,F,100,7,0,7
Zorah,F,100,170,0,170
Suraya,F,100,433,0,433
Nekeia,F,100,53,0,53
Bennita,F,100,47,0,47
Whisper,F,100,682,0,682
Lilliyan,F,100,10,0,10
Hilinai,F,100,41,0,41
Zaakirah,F,100,69,0,69
Ursula,F,100,9109,0,9109
Arbrielle,F,100,6,0,6
Johnney,M,100,0,556,556
Llasmin,F,100,47,0,47
Jamerio,M,100,0,20,20
Gweneviere,F,100,16,0,16
Tabathe,F,100,5,0,5
Quantella,F,100,24,0,24
Cannie,F,100,16,0,16
Antoneisha,F,100,6,0,6
Delaura,F,100,10,0,10
Flynt,M,100,0,35,35
Lajaya,F,100,17,0,17
Kyaisha,F,100,6,0,6
Malaney,F,100,72,0,72
Tykeira,F,100,40,0,40
Lillard,M,100,0,45,45
Vanesa,F,100,6190,5,6195
Zahro,F,100,5,0,5
Sharian,F,100,33,0,33
Lynken,M,100,0,20,20
Terrica,F,100,1406,0,1406
Ivary,F,100,5,0,5
Geoffry,M,100,0,647,647
Artishia,F,100,10,0,10
Nivayah,F,100,10,0,10
Katyria,F,100,15,0,15
Bocephus,M,100,0,35,35
Meggie,F,100,509,0,509
Kammie,F,100,840,0,840
Kiwane,M,100,0,47,47
Flozell,M,100,0,5,5
Sherricka,F,100,57,0,57
Niles,M,100,0,2619,2619
Desiraee,F,100,6,0,6
Jowel,M,100,0,65,65
Xinyue,F,100,7,0,7
Cazden,M,100,0,10,10
Alinne,F,100,48,0,48
Anthonymichael,M,100,0,79,79
Des,M,55,5,6,11
Keiryn,F,100,42,0,42
Rocko,M,100,0,122,122
Aluna,F,100,29,0,29
Carlotta,F,100,3717,0,3717
Riccardo,M,100,0,1374,1374
Kynadee,F,100,198,0,198
Lezette,F,100,56,0,56
Sharman,F,97,850,23,873
Nijel,M,100,0,297,297
Liera,F,100,6,0,6
Deira,F,100,73,0,73
Antasia,F,100,381,0,381
Henrine,F,100,15,0,15
Senator,M,100,0,16,16
Tomias,M,100,0,11,11
Shaad,M,100,0,5,5
Jabrea,F,100,282,0,282
Jacoy,M,100,0,13,13
Mertis,F,100,29,0,29
Dusean,M,100,0,12,12
Cearia,F,100,41,0,41
Afshan,F,100,41,0,41
Kessiah,F,100,40,0,40
Quaysean,M,100,0,11,11
Matigan,F,100,44,0,44
Aruthur,M,100,0,5,5
Gualberto,M,100,0,291,291
Manvik,M,100,0,24,24
Elainah,F,100,89,0,89
Hanadi,F,100,112,0,112
Jordahn,F,100,5,0,5
Kippie,F,75,33,11,44
Cortes,M,100,0,21,21
Yahmir,M,100,0,71,71
Kylina,F,100,50,0,50
Demetrio,M,100,0,2183,2183
Zniah,F,100,5,0,5
Arla,F,100,869,0,869
Camica,F,100,11,0,11
Aloni,F,100,300,0,300
Donise,F,100,325,0,325
Courage,M,87,19,131,150
Sharde,F,100,978,0,978
Azirah,F,100,21,0,21
Omario,M,100,0,51,51
Tante,F,100,11,0,11
Jolynn,F,100,4047,0,4047
Shalane,F,100,429,0,429
Aideen,F,74,97,34,131
Kiswanna,F,100,5,0,5
Candye,F,100,11,0,11
Huckston,M,100,0,6,6
Laurenz,M,100,0,28,28
Mithra,F,100,65,0,65
Christopherjr,M,100,0,5,5
Marinette,F,100,5,0,5
Jorn,M,100,0,6,6
Taegen,F,68,144,68,212
Sawanda,F,100,8,0,8
Sayquan,M,100,0,44,44
Cedell,M,100,0,23,23
Stokely,M,100,0,11,11
Erim,F,100,5,0,5
Marijayne,F,100,56,0,56
Darlyn,F,98,1281,21,1302
Charlz,M,100,0,5,5
Amaryss,F,100,10,0,10
Beverlin,F,100,5,0,5
Mindy,F,100,41550,67,41617
Shakeria,F,100,999,0,999
Aniysa,F,100,5,0,5
Merrissa,F,100,177,0,177
Suhad,F,100,8,0,8
Siani,F,100,953,0,953
Khaleah,F,100,264,0,264
Emilda,F,100,5,0,5
Carolene,F,100,285,0,285
Catherina,F,100,754,0,754
Martis,M,100,0,26,26
Veer,M,100,0,954,954
Venissa,F,100,127,0,127
Masen,M,97,74,2299,2373
Knolan,M,100,0,40,40
Saffa,F,100,5,0,5
Elijahjohn,M,100,0,11,11
Ahmik,M,100,0,12,12
Cenae,F,100,6,0,6
Keylee,F,100,1289,0,1289
Meanna,F,100,15,0,15
Lacreshia,F,100,189,0,189
Eduin,M,100,0,141,141
Denzal,M,100,0,64,64
Robins,M,100,0,10,10
Chloemae,F,100,11,0,11
Oaklie,F,100,199,0,199
Chae,F,54,175,148,323
Makaiya,F,100,391,0,391
Hilal,F,62,33,20,53
Brant,M,100,10,8685,8695
Ronica,F,100,1267,0,1267
Winette,F,100,22,0,22
Maho,F,100,15,0,15
Zerrion,M,100,0,12,12
Nyx,F,90,53,6,59
Jyden,M,100,0,109,109
Robinetta,F,100,5,0,5
Demartez,M,100,0,5,5
Curran,M,97,30,1035,1065
Daralene,F,100,10,0,10
Agathe,F,100,21,0,21
Rhonin,M,100,0,44,44
Alxander,M,100,0,30,30
Jaderion,M,100,0,18,18
Roseleen,F,100,6,0,6
Shail,M,100,0,64,64
Cobi,M,76,148,466,614
Jakaylee,F,100,44,0,44
Iyasia,F,100,6,0,6
Karanda,F,100,10,0,10
Enedelia,F,100,559,0,559
Iniya,F,100,237,0,237
Jesi,F,93,542,38,580
Lakresha,F,100,264,0,264
Fahmida,F,100,74,0,74
Mekiel,M,100,0,5,5
Lawanna,F,100,1826,0,1826
Kecia,F,100,3146,0,3146
Aimee,F,100,51201,78,51279
Jayziah,M,100,0,45,45
Jhordan,M,67,78,159,237
Rushi,M,100,0,229,229
Naturell,F,100,5,0,5
Norri,F,100,5,0,5
Dalphine,F,100,189,0,189
Kadijah,F,100,1404,0,1404
Yalana,F,100,5,0,5
Nivedh,M,100,0,33,33
Noren,M,100,0,5,5
Padric,M,100,0,12,12
Mikeisha,F,100,186,0,186
En,M,100,0,12,12
Adine,F,100,96,0,96
Malaina,F,100,732,0,732
Berniece,F,100,507,0,507
Mykyla,F,100,23,0,23
Saray,F,100,1875,0,1875
Claudia,F,99,90569,495,91064
Nadyne,F,100,142,0,142
Dendrick,M,100,0,10,10
Tarryn,F,99,715,10,725
Odaliz,F,100,258,0,258
Anastaisha,F,100,11,0,11
Mailene,F,100,10,0,10
Aftyn,F,100,171,0,171
Azayleah,F,100,5,0,5
Tomecka,F,100,30,0,30
Nairobi,F,91,293,30,323
Po,M,100,0,5,5
Trez,M,100,0,34,34
Zalaya,F,100,134,0,134
Mikaylla,F,100,5,0,5
Pamelyn,F,100,118,0,118
Twanya,F,100,60,0,60
Yisleine,F,100,5,0,5
Yashika,F,100,476,0,476
Mallik,M,100,0,19,19
Jewelisa,F,100,39,0,39
Amica,F,100,89,0,89
Phenix,M,62,147,244,391
Darlin,F,94,608,37,645
Neilesh,M,100,0,5,5
Rozanne,F,100,790,0,790
Arlex,M,100,0,5,5
Elbie,M,100,0,5,5
Yesnia,F,100,18,0,18
Davario,M,100,0,11,11
Betzi,F,100,40,0,40
Velen,F,100,35,0,35
Almonte,M,100,0,11,11
Kedesha,F,100,17,0,17
Aleidy,F,100,28,0,28
Nihla,F,100,10,0,10
Atreyu,M,100,0,1322,1322
Kaed,M,100,0,22,22
Krist,M,81,37,160,197
Saliya,F,100,5,0,5
Minhquan,M,100,0,16,16
Lourdez,F,100,89,0,89
Daneille,F,100,476,0,476
Jaboris,M,100,0,28,28
Brayzen,M,100,0,5,5
Elhadji,M,100,0,113,113
Rameez,M,100,0,26,26
Atilla,M,100,0,78,78
Makah,M,100,0,12,12
Vineet,M,100,0,247,247
Hadrien,M,100,0,12,12
Aldric,M,100,0,391,391
Janni,F,100,43,0,43
Jache,F,100,6,0,6
Raheim,M,100,0,766,766
Nicey,F,100,10,0,10
Ayaat,F,100,86,0,86
Distiny,F,100,23,0,23
Nicara,F,100,5,0,5
Freddick,M,100,0,21,21
Jaybree,F,100,5,0,5
Lindly,F,100,5,0,5
Tag,M,100,0,116,116
Calista,F,100,5480,0,5480
Jihanna,F,100,20,0,20
Chigozirim,M,68,6,13,19
Kieara,F,100,766,0,766
Mersades,F,100,248,0,248
Brenette,F,100,23,0,23
Jewell,F,83,5208,1086,6294
Wildon,M,100,0,10,10
Akaya,F,100,101,0,101
Malissa,F,100,7424,0,7424
Beandon,M,100,0,5,5
Peniel,M,59,54,78,132
Jilda,F,100,169,0,169
Patrika,F,100,22,0,22
Analysse,F,100,89,0,89
Lenae,F,100,731,0,731
Arelis,F,100,869,0,869
Kerrianna,F,100,15,0,15
Jennay,F,100,51,0,51
Arlis,M,79,161,603,764
Yojan,M,100,0,81,81
Breindel,F,100,145,0,145
Xannon,M,100,0,5,5
Laquintin,M,100,0,49,49
Cadrian,M,52,10,11,21
Cragi,M,100,0,5,5
Lessie,F,91,1827,179,2006
Immer,M,100,0,11,11
Quitman,M,100,0,103,103
Kemeshia,F,100,5,0,5
Mavi,F,100,38,0,38
Jeroline,F,100,7,0,7
Mahammad,M,100,0,5,5
Donye,M,75,86,252,338
Tyechia,F,100,156,0,156
Anneli,F,100,281,0,281
Joandra,F,100,22,0,22
Tonise,F,100,5,0,5
Naydeline,F,100,74,0,74
Kyya,F,100,11,0,11
Rhea,F,99,8833,92,8925
Ege,M,100,0,97,97
Taquita,F,100,270,0,270
Yoana,F,100,1328,0,1328
Carvell,M,100,0,170,170
Nephtalie,F,100,39,0,39
Latiya,F,100,165,0,165
Kristanna,F,100,52,0,52
Keygan,M,97,11,323,334
Shakana,F,100,6,0,6
Ivoryanna,F,100,7,0,7
Aaidan,M,100,0,38,38
Alphonso,M,100,21,9773,9794
Dickey,M,100,0,445,445
Prynce,M,100,0,117,117
Keshana,F,100,193,0,193
Marg,F,100,31,0,31
Timthy,M,100,0,28,28
Kaitlinn,F,100,188,0,188
Sarya,F,100,127,0,127
Shauneille,F,100,5,0,5
Lastacia,F,100,79,0,79
Kapri,F,98,632,10,642
Jolleen,F,100,137,0,137
Dorian,M,81,4138,17889,22027
Doneal,M,100,0,6,6
Yeleni,F,100,12,0,12
Shankar,M,100,0,62,62
Annastashia,F,100,10,0,10
Nachele,F,100,5,0,5
Juan,M,99,2210,305609,307819
Lica,F,100,5,0,5
Jereck,M,100,0,6,6
Kimbella,F,100,114,0,114
Adebowale,M,100,0,19,19
Cairo,M,88,147,1034,1181
Nayeli,F,100,15601,14,15615
Aylani,F,100,182,0,182
Hassam,M,100,0,12,12
Christiyana,F,100,17,0,17
Dlynn,F,100,66,0,66
Izaya,M,100,0,840,840
Nessiah,F,80,39,10,49
Lundy,M,93,10,135,145
Nestor,M,100,0,8384,8384
Anjrue,M,100,0,5,5
Mohamedamine,M,100,0,5,5
Karinn,F,100,8,0,8
Carolyne,F,100,1733,0,1733
Azara,F,100,154,0,154
Jayke,M,100,0,294,294
Nikkolai,M,100,0,5,5
Rakim,M,100,0,1088,1088
Ameena,F,100,1046,0,1046
Ishanae,F,100,6,0,6
Charta,F,100,5,0,5
Kymani,M,79,687,2629,3316
Deannette,F,100,5,0,5
Makenzey,F,100,163,0,163
Loegan,M,100,0,12,12
Adilyne,F,100,31,0,31
Enasia,F,100,11,0,11
Dreshon,M,100,0,88,88
Cylus,M,100,0,454,454
Jennise,F,100,158,0,158
Janiah,F,100,3683,0,3683
Aoi,F,92,150,13,163
Shymel,M,100,0,5,5
Yvonda,F,100,333,0,333
Rakee,M,100,0,5,5
Gordie,M,100,0,111,111
Mykelle,F,96,109,5,114
Oria,F,100,41,0,41
Tifinie,F,100,11,0,11
Jaymison,M,100,0,186,186
Dovid,M,100,0,1871,1871
Makhyia,F,100,19,0,19
Tal,M,69,500,1130,1630
Kenyun,M,100,0,45,45
Wander,F,100,54,0,54
Reighlynn,F,100,37,0,37
Bryla,F,100,36,0,36
Braniyah,F,100,154,0,154
Amariz,F,100,106,0,106
Maritzabel,F,100,5,0,5
Kseniya,F,100,75,0,75
Madeline,F,100,121449,170,121619
Kieandra,F,100,5,0,5
Jeanclaude,M,100,0,355,355
Mayim,F,100,14,0,14
Demico,M,100,0,75,75
Shylan,F,85,29,5,34
Sonam,F,85,346,59,405
Rumina,F,100,10,0,10
Vel,F,100,13,0,13
Baboucarr,M,100,0,26,26
Clairessa,F,100,99,0,99
Genita,F,100,368,0,368
Keviona,F,100,44,0,44
Krisina,F,100,6,0,6
Willa,F,100,7311,0,7311
Eddie,M,98,2892,116147,119039
Annia,F,100,355,0,355
Ikhlas,F,100,91,0,91
Markaysia,F,100,5,0,5
Ketzaly,F,100,59,0,59
Jaquari,M,100,0,174,174
Caylee,F,100,7544,0,7544
Meiko,F,64,89,49,138
Pabel,M,100,0,22,22
Yasmean,F,100,26,0,26
Emille,F,100,5,0,5
Tantra,F,100,5,0,5
Kavonda,F,100,6,0,6
Glinda,F,100,1773,0,1773
Jaicob,M,100,0,127,127
Tahisa,F,100,6,0,6
Jackelin,F,100,1274,0,1274
Christee,F,100,180,0,180
Jerrick,M,100,0,1839,1839
Toshya,F,100,5,0,5
Samanthamarie,F,100,68,0,68
Tianamarie,F,100,10,0,10
Calen,M,90,221,1945,2166
Yahya,M,100,6,1735,1741
Bernestine,F,100,175,0,175
Cohner,M,100,0,6,6
Vinicio,M,100,0,246,246
Tona,F,100,1220,0,1220
Davinia,F,100,73,0,73
Louan,F,100,41,0,41
Priyanshu,M,100,0,6,6
Arrianne,F,100,34,0,34
Chaydon,M,100,0,5,5
Eylan,M,100,0,11,11
Skylaa,F,100,11,0,11
Jniaya,F,100,5,0,5
Yasiris,F,100,5,0,5
Kaletha,F,100,6,0,6
Lewi,M,100,0,37,37
Ivelin,F,100,8,0,8
Breckyn,F,79,505,132,637
Tashyana,F,100,10,0,10
Mylissa,F,100,399,0,399
Ar,M,100,0,5,5
Blong,M,100,0,255,255
Kirstynn,F,100,11,0,11
Bertin,M,100,0,276,276
Gelissa,F,100,30,0,30
Renessa,F,100,194,0,194
Jamahd,M,100,0,5,5
Fahm,F,100,5,0,5
Marchant,M,100,0,7,7
Jadenne,F,100,6,0,6
Callieann,F,100,19,0,19
Maralee,F,100,474,0,474
Renay,F,99,1794,24,1818
Anabelen,F,100,68,0,68
Lelaina,F,100,130,0,130
Sajdah,F,100,11,0,11
Deyshaun,M,100,0,10,10
Pierson,M,98,34,1895,1929
Nahide,F,100,5,0,5
Montarious,M,100,0,16,16
Anisley,F,100,5,0,5
Janielis,F,100,11,0,11
Hayliegh,F,100,45,0,45
Tayia,F,100,170,0,170
Quintella,F,100,464,0,464
Leyiah,F,100,6,0,6
Pebble,F,100,87,0,87
Rylind,M,100,0,17,17
Kwali,M,100,0,63,63
Rc,M,100,0,47,47
Vickee,F,100,67,0,67
Sheree,F,100,13395,0,13395
Maryann,F,100,32011,11,32022
Malinalli,F,100,8,0,8
Shearon,F,100,145,0,145
Barnie,M,100,0,77,77
Vianne,F,100,255,0,255
Shillae,F,100,5,0,5
Saniiya,F,100,5,0,5
Solomone,M,100,0,22,22
Llesenia,F,100,202,0,202
Aedyn,M,88,59,453,512
Chaniah,F,100,59,0,59
Feodora,F,100,5,0,5
Latorri,F,100,5,0,5
Yazen,M,100,0,222,222
Halimah,F,100,392,0,392
Vyto,M,100,0,6,6
Caytlynn,F,100,8,0,8
Jurney,F,97,157,5,162
Teyla,F,100,214,0,214
Jacoury,M,100,0,6,6
Silberio,M,100,0,5,5
Wendellyn,F,100,12,0,12
Quincie,F,98,229,5,234
Revin,M,100,0,77,77
Asisha,F,100,6,0,6
Aella,F,100,47,0,47
Chihiro,F,100,102,0,102
Almetia,F,100,7,0,7
Dzion,M,100,0,6,6
Jalliyah,F,100,54,0,54
Shawanna,F,100,1404,0,1404
Nat,M,100,0,549,549
Aitan,M,100,0,60,60
Diablo,M,100,0,5,5
Jazion,M,100,0,165,165
Jaylaan,F,100,5,0,5
Onald,M,100,0,5,5
Stehen,M,100,0,29,29
Jasmeet,F,73,176,64,240
Truddie,F,100,5,0,5
Saresa,F,100,26,0,26
Kennett,M,100,0,116,116
Kowanna,F,100,5,0,5
Draya,F,100,248,0,248
Juiliana,F,100,23,0,23
Pandoria,F,100,5,0,5
Jahkira,F,100,13,0,13
Secret,F,100,600,0,600
Anola,F,100,97,0,97
Ennis,M,98,28,1197,1225
Mingo,M,100,0,164,164
Christafer,M,100,0,29,29
Fenet,F,100,15,0,15
Cohan,M,100,0,148,148
Samary,F,100,63,0,63
Michon,F,95,550,29,579
Mckynlee,F,100,308,0,308
Audel,M,100,0,200,200
Johnique,F,100,51,0,51
Amrie,F,100,102,0,102
Leeat,F,100,5,0,5
Salis,M,100,0,6,6
Latravis,M,100,0,137,137
Leightan,F,100,5,0,5
Zynae,F,100,19,0,19
Teonni,F,100,5,0,5
Memorie,F,100,335,0,335
Shloka,F,100,133,0,133
Miku,F,100,113,0,113
Kar,F,100,6,0,6
Quashaun,M,100,0,186,186
Decker,M,99,5,749,754
Lauro,M,100,0,1541,1541
Jesusdaniel,M,100,0,5,5
Keishana,F,100,76,0,76
Orlandra,F,100,14,0,14
Anneta,F,100,25,0,25
Kashan,M,100,0,35,35
Zaaire,M,100,0,10,10
Tylisa,F,100,132,0,132
Deryn,F,87,164,25,189
Anjani,F,100,169,0,169
Share,F,100,22,0,22
Amaziah,M,70,77,180,257
Carollee,F,100,82,0,82
Coner,M,100,0,114,114
Jaesyn,M,100,0,9,9
Jessiqua,F,100,5,0,5
Marlet,F,100,116,0,116
Aerion,M,80,24,96,120
Cayleb,M,100,0,791,791
Kullyn,M,100,0,5,5
Rodolpho,M,100,0,29,29
Ilianis,F,100,11,0,11
Rany,M,68,10,21,31
Ness,M,100,0,11,11
Jelyn,F,100,12,0,12
Kamaal,M,100,0,260,260
Shakedra,F,100,101,0,101
Stiles,M,100,0,234,234
Dezerea,F,100,30,0,30
Laytonya,F,100,12,0,12
Lindasy,F,100,27,0,27
Saphyra,F,100,70,0,70
Kelila,F,100,28,0,28
Maggie,F,100,51491,35,51526
Aania,F,100,36,0,36
Netania,F,100,12,0,12
Keshanna,F,100,78,0,78
Symir,M,100,0,185,185
Arkisha,F,100,50,0,50
Leilaney,F,100,15,0,15
Deybi,M,100,0,6,6
Lukasz,M,100,0,498,498
Torrez,M,100,0,110,110
Haji,M,100,0,65,65
Mellodie,F,100,5,0,5
Kahleya,F,100,5,0,5
Julieanne,F,100,1553,0,1553
Allissa,F,100,2023,0,2023
Paterica,F,100,23,0,23
Kayetta,F,100,5,0,5
Lubna,F,100,305,0,305
Mykeshia,F,100,10,0,10
Jamiya,F,100,2743,0,2743
Kathylene,F,100,11,0,11
Shawnetta,F,100,255,0,255
Rayauna,F,100,28,0,28
Fayeth,F,100,23,0,23
Meea,F,100,11,0,11
Vernal,M,95,24,485,509
Daytwon,M,100,0,9,9
Denard,M,100,0,682,682
Keyosha,F,100,338,0,338
Ellyette,F,100,8,0,8
Caelan,M,76,592,1865,2457
Sula,F,100,112,0,112
Deston,M,100,0,382,382
Myia,F,100,2061,0,2061
Yukino,F,100,18,0,18
Ralonda,F,100,145,0,145
Moataz,M,100,0,51,51
Tristan,M,94,6122,98015,104137
Brighid,F,100,467,0,467
Shilla,F,100,10,0,10
Verlon,M,96,22,574,596
Juliun,M,100,0,56,56
Ligeia,F,100,5,0,5
Kobain,M,100,0,13,13
Alford,M,100,0,1431,1431
Kylani,F,100,95,0,95
Munajj,M,100,0,5,5
Albani,F,100,16,0,16
Quinasia,F,100,36,0,36
Kaitie,F,100,17,0,17
Jerlean,F,100,151,0,151
Sophiana,F,100,43,0,43
Dorion,M,100,0,531,531
Akaylia,F,100,24,0,24
Rowell,M,100,0,38,38
Koi,M,66,188,357,545
Marivy,F,100,10,0,10
Djordje,M,100,0,6,6
Orantes,M,100,0,5,5
Tunja,F,100,22,0,22
Cadijah,F,100,17,0,17
Laicee,F,100,25,0,25
Ladaynian,M,100,0,5,5
Bashirah,F,100,13,0,13
Leiya,F,100,182,0,182
Lamarcus,M,100,0,2674,2674
Subhana,F,100,20,0,20
Jerolene,F,100,5,0,5
Abell,M,100,0,5,5
Synaya,F,100,6,0,6
Jamarrio,M,100,0,12,12
Arkeith,M,100,0,14,14
Klarissa,F,100,2455,0,2455
Lemond,M,100,0,102,102
Chiniqua,F,100,86,0,86
Brayleigh,F,100,867,0,867
Janisa,F,100,336,0,336
Nathali,F,100,530,0,530
Princes,F,100,81,0,81
Niayla,F,100,40,0,40
Sopheia,F,100,6,0,6
Yuliet,F,100,115,0,115
Adonus,M,100,0,70,70
Zuha,F,100,72,0,72
Kayda,F,100,281,0,281
Mercedees,F,100,61,0,61
Jazzleen,F,100,29,0,29
Liylah,F,100,20,0,20
Aisla,F,100,13,0,13
Trew,M,88,11,81,92
Gaylen,M,82,246,1121,1367
Keyanna,F,100,3198,0,3198
Azimjon,M,100,0,6,6
Brynnlie,F,100,62,0,62
Tiaria,F,100,92,0,92
Kalany,F,100,38,0,38
Orlan,M,100,0,183,183
Taytem,F,94,171,11,182
Ebaad,M,100,0,5,5
Saulo,M,100,0,502,502
Dayquan,M,100,0,669,669
Marcquez,M,100,0,25,25
Hughie,M,100,0,381,381
Tamiqua,F,100,22,0,22
Taniyah,F,100,3414,0,3414
Jaquline,F,100,44,0,44
Laileigh,F,100,5,0,5
Harmonie,F,100,1650,0,1650
Kaithleen,F,100,11,0,11
Naysha,F,100,205,0,205
Thembi,F,100,35,0,35
Michellle,F,100,11,0,11
Lathasha,F,100,6,0,6
Miyah,F,100,2329,0,2329
Shanterri,F,100,5,0,5
Noris,F,73,43,16,59
Cartel,M,100,0,67,67
Dyego,M,100,0,6,6
Sharanda,F,100,431,0,431
Jermario,M,100,0,68,68
Lavasia,F,100,37,0,37
Sahir,M,100,0,453,453
Opaline,F,100,5,0,5
Eliya,F,88,463,66,529
Damita,F,100,1506,0,1506
Marella,F,100,305,0,305
Jewelianna,F,100,110,0,110
Leili,F,100,81,0,81
Zaman,M,100,0,28,28
Reganne,F,100,225,0,225
Giovan,M,100,0,277,277
Kynnadee,F,100,6,0,6
Kastriot,M,100,0,5,5
Edvardo,M,100,0,305,305
Sisto,M,100,0,167,167
Nayseth,F,100,11,0,11
Jazmere,F,100,56,0,56
Dennisse,F,100,155,0,155
Demid,M,100,0,5,5
Donall,M,100,0,5,5
Mercedies,F,100,102,0,102
Cavon,M,100,0,183,183
Haili,F,100,822,0,822
Eduard,M,100,0,1250,1250
Dajhon,M,100,0,32,32
Khendra,F,100,11,0,11
Zianna,F,100,361,0,361
Athziri,F,100,424,0,424
Trashawn,M,93,29,378,407
Kynlei,F,100,79,0,79
Jaryl,M,100,0,11,11
Corneilous,M,100,0,10,10
Lelend,M,100,0,94,94
Daryl,M,94,3262,53490,56752
Joesette,F,100,18,0,18
Elcid,M,100,0,5,5
Eton,M,100,0,21,21
Chablis,F,100,126,0,126
Marijo,F,100,950,0,950
Stephney,F,100,38,0,38
Yanaliz,F,100,5,0,5
Bravo,M,100,0,6,6
Terreon,M,100,0,87,87
Vanette,F,100,268,0,268
Vernor,M,100,0,20,20
Amad,M,100,0,302,302
Sierralynn,F,100,5,0,5
Lytia,F,100,14,0,14
Sherill,F,98,704,11,715
Lavonya,F,100,251,0,251
Laray,M,52,319,345,664
Vonna,F,100,506,0,506
Javario,M,100,0,17,17
Sumer,F,100,1487,0,1487
Anemone,F,100,6,0,6
Tenlie,F,100,13,0,13
Tahiry,F,100,255,0,255
Markquan,M,100,0,5,5
Francesc,F,66,19,10,29
Brycn,M,100,0,5,5
Demeria,F,100,43,0,43
Younique,F,100,75,0,75
Nijay,M,54,35,41,76
Taquanda,F,100,37,0,37
Shaylen,F,94,516,32,548
Coua,F,100,25,0,25
Winna,F,100,24,0,24
Carleigha,F,100,11,0,11
Zaakiyah,F,100,5,0,5
Pardeep,M,100,0,53,53
Domique,F,67,139,68,207
Kerrigan,F,96,1833,67,1900
Ladamion,M,100,0,42,42
Brage,M,100,0,5,5
Gresham,M,100,0,80,80
Suyapa,F,100,24,0,24
Naveen,M,78,249,887,1136
Adreian,M,100,0,21,21
Siyam,F,100,5,0,5
Deobrah,F,100,10,0,10
Arlan,M,100,0,1445,1445
Kieya,F,100,47,0,47
Shaikh,M,100,0,30,30
Boban,M,100,0,17,17
Breosha,F,100,57,0,57
Carlisle,M,66,325,640,965
Tarena,F,100,153,0,153
Lenis,M,73,14,38,52
Kelee,F,100,317,0,317
Lamarie,F,100,6,0,6
Srikrishna,M,100,0,37,37
Lawrencia,F,100,147,0,147
Celyne,F,100,10,0,10
Bayani,M,100,0,44,44
Damarus,M,100,0,11,11
Shalise,F,100,411,0,411
Danazia,F,100,32,0,32
Sangria,F,100,16,0,16
Nashmia,F,100,5,0,5
Sanad,M,100,0,214,214
Wendra,F,100,12,0,12
Jaecob,M,100,0,114,114
Meichelle,F,100,30,0,30
Riel,M,75,18,55,73
Yuven,M,100,0,5,5
Anilah,F,100,261,0,261
Sherian,F,100,441,0,441
Rasheeta,F,100,23,0,23
Hanen,F,100,15,0,15
Itzabella,F,100,108,0,108
Tishonda,F,100,13,0,13
Maysin,M,93,5,62,67
Kaory,F,100,20,0,20
Jackqulin,F,100,11,0,11
Olubunmi,F,100,52,0,52
Exavier,M,100,0,1022,1022
Lexsis,F,100,6,0,6
Jeanitta,F,100,5,0,5
Faneisha,F,100,5,0,5
Demontez,M,100,0,184,184
Raenee,F,100,15,0,15
Tisheka,F,100,5,0,5
Emyah,F,100,113,0,113
Averee,F,96,644,25,669
Ddnna,F,100,25,0,25
Jonikka,F,100,21,0,21
Kierin,M,65,17,32,49
Isan,M,100,0,7,7
Felice,F,91,2686,262,2948
Klorissa,F,100,11,0,11
Jamer,M,100,0,39,39
Cleva,F,100,16,0,16
Shatina,F,100,401,0,401
Alexavier,M,100,0,1651,1651
Kanella,F,100,5,0,5
Irwin,M,100,0,3169,3169
Cyani,F,100,60,0,60
Suzon,F,100,17,0,17
Linward,M,100,0,19,19
Jhaiden,M,100,0,28,28
Shadimon,F,100,44,0,44
Marierose,F,100,11,0,11
Brylea,F,100,204,0,204
Aldean,F,54,37,32,69
Darneil,M,100,0,18,18
Tamia,F,100,11266,0,11266
Chalea,F,100,36,0,36
Chaison,M,100,0,30,30
Sharell,F,99,1325,16,1341
Fynley,F,100,32,0,32
Aaditya,M,100,0,457,457
Sharletta,F,100,37,0,37
Courteney,F,100,1124,5,1129
Treva,F,100,4584,6,4590
Zaleth,F,100,7,0,7
Traedyn,M,100,0,18,18
Janeece,F,100,200,0,200
Freddrick,M,100,0,980,980
Chennel,F,100,62,0,62
Namiko,F,100,10,0,10
Jannay,F,100,10,0,10
Janeisha,F,100,352,0,352
Verleen,F,100,48,0,48
Takishia,F,100,26,0,26
Mychal,M,88,265,1909,2174
Yasir,M,100,0,1574,1574
Trond,M,100,0,10,10
Sanchit,M,100,0,5,5
Dequana,F,100,34,0,34
Nikhil,M,100,0,4618,4618
Quinshon,M,100,0,5,5
Faolan,M,100,0,81,81
Jhonnatan,M,100,0,11,11
Deyana,F,100,272,0,272
Raymonda,F,100,107,0,107
Patrell,M,100,0,16,16
Ismat,F,100,5,0,5
Shavell,F,95,113,6,119
Crystina,F,100,614,0,614
Ahbree,F,100,10,0,10
Lilica,F,100,5,0,5
Geneveve,F,100,20,0,20
Leonette,F,100,200,0,200
Nikaya,F,100,165,0,165
Raqueal,F,100,55,0,55
Quannisha,F,100,6,0,6
Earlene,F,100,4404,0,4404
Heatherly,F,100,86,0,86
Mkai,M,100,0,26,26
Streeter,M,100,0,5,5
Yerica,F,100,5,0,5
Tyrail,M,100,0,138,138
Ivelis,F,100,168,0,168
Princton,M,100,0,6,6
Jerret,M,100,0,453,453
Fleda,F,100,5,0,5
Shaquia,F,100,165,0,165
Jessico,F,100,14,0,14
Macaleb,M,100,0,34,34
Kathleeen,F,100,10,0,10
Bryand,M,100,0,5,5
Akane,F,100,241,0,241
Jezreel,M,76,152,478,630
Dimas,M,100,0,1367,1367
Jumanne,M,100,0,16,16
Naquanda,F,100,11,0,11
Karsin,M,83,26,125,151
Kauri,F,87,65,10,75
Jyaire,M,100,0,209,209
Sencere,M,100,0,134,134
Dennis,M,100,1923,411845,413768
Jahkir,M,100,0,5,5
Briney,F,100,5,0,5
Laquane,M,100,0,23,23
Delman,M,100,0,50,50
Martinis,M,100,0,5,5
Cheral,F,100,52,0,52
Elyijah,M,100,0,5,5
Umme,F,100,13,0,13
Sandrine,F,100,154,0,154
Allah,M,100,0,156,156
Nidya,F,100,77,0,77
Faraz,M,100,0,555,555
Juliaette,F,100,5,0,5
Karlissa,F,100,86,0,86
Tariek,M,100,0,17,17
Derrica,F,100,545,0,545
Kamarre,M,100,0,5,5
Deo,M,100,0,72,72
Zaith,M,100,0,24,24
Jamiaya,F,100,68,0,68
Utah,M,100,0,95,95
Johana,F,100,5749,11,5760
Briannie,F,100,55,0,55
Alia,F,100,8473,0,8473
Jaydalis,F,100,27,0,27
Aemon,M,100,0,28,28
Kasim,M,100,0,620,620
Quandarrius,M,100,0,5,5
Sruthi,F,100,369,0,369
Shyteria,F,100,66,0,66
Dazjah,F,100,33,0,33
Camillya,F,100,5,0,5
Kamariyah,F,100,80,0,80
Demari,M,89,175,1372,1547
Akif,M,100,0,82,82
Gokul,M,100,0,82,82
Kemonta,M,100,0,45,45
Kamyl,F,100,8,0,8
Samiha,F,100,423,0,423
Kamaron,M,95,10,179,189
Ellender,F,100,12,0,12
Cataliya,F,100,5,0,5
Kendrew,M,100,0,87,87
Zayia,F,100,11,0,11
Tyaun,M,100,0,30,30
Shayaan,M,100,0,484,484
Kurby,M,100,0,5,5
Quatia,F,100,11,0,11
Browning,M,100,0,49,49
Rosalba,F,100,2658,0,2658
Yarley,M,100,0,6,6
Khrystyn,F,100,26,0,26
Alexxis,F,99,1134,6,1140
Tikira,F,100,11,0,11
Barrette,M,100,0,6,6
Aleela,F,100,6,0,6
Brijae,F,100,19,0,19
Ia,F,100,144,0,144
Jasmone,F,100,18,0,18
Hayze,M,100,0,125,125
Brysonn,M,100,0,10,10
Zebulan,M,100,0,102,102
Aber,F,100,5,0,5
Padme,F,100,73,0,73
Kaushik,M,100,0,224,224
Karapet,M,100,0,23,23
Taejon,M,100,0,178,178
Arlynes,F,100,5,0,5
Saeed,M,100,0,1364,1364
Sequoyah,F,72,435,165,600
Chenelle,F,100,787,0,787
Ceylan,F,100,5,0,5
Yakeline,F,100,44,0,44
Nyrek,M,100,0,5,5
Eyad,M,100,0,614,614
Enner,M,100,0,9,9
Genetha,F,100,28,0,28
Rikisha,F,100,17,0,17
Calisa,F,100,146,0,146
Aryonna,F,100,568,0,568
Yony,M,100,0,156,156
Jamerson,M,100,0,503,503
Pedram,M,100,0,65,65
Zirah,F,100,11,0,11
Greydy,F,100,11,0,11
Declen,M,100,0,24,24
Mystical,F,100,29,0,29
Telina,F,100,281,0,281
Treydon,M,100,0,134,134
Jaylex,M,100,0,10,10
Swan,F,76,73,23,96
Yulexi,F,100,6,0,6
Jayra,F,100,84,0,84
Eliannah,F,100,126,0,126
Mcihael,M,100,0,98,98
Roshni,F,100,934,0,934
Celsey,F,100,223,0,223
Bertina,F,100,730,0,730
Jenessis,F,100,11,0,11
Dashall,M,100,0,5,5
Norea,F,100,10,0,10
Lizza,F,100,55,0,55
Lyniya,F,100,5,0,5
Forester,M,100,0,11,11
Ellyonna,F,100,17,0,17
Tandre,M,100,0,130,130
Zyrek,M,100,0,5,5
Hershey,M,100,0,14,14
Courtnay,F,98,467,10,477
Riverlynn,F,100,7,0,7
Marilis,F,100,5,0,5
Calvinesha,F,100,6,0,6
Nataniel,M,100,0,486,486
Danali,F,100,55,0,55
Simin,F,100,5,0,5
Sylvette,F,100,36,0,36
Melaniece,F,100,7,0,7
Ambar,F,100,2196,5,2201
Britlyn,F,100,131,0,131
Starlisha,F,100,23,0,23
Dannae,F,100,129,0,129
Keyoka,F,100,53,0,53
Cacy,F,100,52,0,52
Tariq,M,100,7,5446,5453
Byonce,F,100,6,0,6
Mairim,F,100,104,0,104
Adleigh,F,100,526,0,526
Allaina,F,100,188,0,188
Shylene,F,100,35,0,35
Efrin,M,100,0,38,38
Daeshaun,M,100,0,339,339
Gionna,F,100,636,0,636
Roberte,M,100,0,5,5
Aurey,F,100,5,0,5
Arry,M,100,0,7,7
Lowell,M,100,33,12039,12072
Kearie,F,100,68,0,68
Amariah,F,100,2114,0,2114
Sham,F,61,49,31,80
Chelsea,F,100,156327,395,156722
Elianie,F,100,30,0,30
Fabrisio,M,100,0,10,10
Abdelrhman,M,100,0,6,6
Shakwan,M,100,0,5,5
Olin,M,100,0,3146,3146
Imalai,F,100,5,0,5
Shanisha,F,100,354,0,354
Mallie,F,93,856,61,917
Wendyann,F,100,10,0,10
Dart,M,100,0,41,41
Daktari,M,100,0,5,5
Jodyann,F,100,5,0,5
Mattheu,M,100,0,118,118
Masada,M,55,5,6,11
Marlania,F,100,6,0,6
Yobani,M,100,0,699,699
Aubrei,F,100,366,0,366
Michonne,F,100,11,0,11
Frika,F,100,5,0,5
Shaunt,M,100,0,40,40
Keyonnia,F,100,11,0,11
Yaindhi,F,100,29,0,29
Raichelle,F,100,12,0,12
Ebba,F,94,84,5,89
Ajita,F,100,11,0,11
Elmer,M,99,139,19541,19680
Shamaree,F,85,29,5,34
Naydean,F,100,10,0,10
Dywane,M,100,0,261,261
Corella,F,100,23,0,23
Saransh,M,100,0,7,7
Leela,F,100,2375,0,2375
Jhamar,M,100,0,10,10
Makonnen,M,100,0,11,11
Nyaira,F,100,182,0,182
Alez,M,100,0,23,23
Jimica,F,100,5,0,5
Cosmo,M,100,0,1069,1069
Suyash,M,100,0,57,57
Elaijah,F,96,129,5,134
Briance,F,100,17,0,17
Knute,M,100,0,320,320
Tajahne,F,100,5,0,5
Hilla,F,100,6,0,6
Umi,F,100,43,0,43
Aliya,F,100,7593,0,7593
Tarrant,M,100,0,39,39
Anavi,F,100,56,0,56
Tapanga,F,100,522,0,522
Jewelia,F,100,410,0,410
Teman,M,100,0,5,5
Onorio,M,100,0,5,5
Skii,F,100,63,0,63
Tautiana,F,100,7,0,7
Shree,F,98,785,13,798
Aleina,F,100,420,0,420
Philadelphia,F,100,34,0,34
Azlee,F,100,24,0,24
Aliviana,F,100,49,0,49
Dlilah,F,100,11,0,11
Jaise,M,93,11,153,164
Chaz,M,98,160,9107,9267
Talaysia,F,100,286,0,286
Garrek,M,100,0,5,5
Tiairra,F,100,59,0,59
Rahel,F,100,394,0,394
Life,M,66,17,33,50
Salicia,F,100,30,0,30
Milie,F,100,31,0,31
Kerie,F,100,320,0,320
Tyandra,F,100,15,0,15
Jailynne,F,100,93,0,93
Teruko,F,100,21,0,21
Lashana,F,100,1060,0,1060
Haruki,M,100,0,192,192
Hidie,F,100,38,0,38
Surabhi,F,100,162,0,162
Leetta,F,100,200,0,200
Yoon,M,72,29,75,104
Kinisha,F,100,124,0,124
Jevontay,M,100,0,5,5
Khawaja,M,100,0,10,10
Sayla,F,100,397,0,397
Chaun,M,97,11,422,433
Elbia,F,100,63,0,63
Shahaan,M,100,0,5,5
Kontrina,F,100,5,0,5
Makalia,F,100,372,0,372
Keikilani,F,100,5,0,5
Regi,M,100,0,16,16
Shaqur,M,100,0,13,13
Jaxn,M,100,0,29,29
Mailea,F,100,5,0,5
Raqeeb,M,100,0,5,5
Jarodd,M,100,0,10,10
Quashanda,F,100,5,0,5
Ridhwan,M,100,0,28,28
Monise,F,100,30,0,30
Abdussamad,M,100,0,6,6
Josheph,M,100,0,19,19
Kyian,M,100,0,55,55
Krishara,F,100,5,0,5
Velita,F,100,83,0,83
Carry,F,74,629,226,855
Jasimen,F,100,12,0,12
Mikecia,F,100,11,0,11
Merelin,F,100,72,0,72
Jervin,M,100,0,6,6
Meissa,F,100,6,0,6
Chrysanne,F,100,12,0,12
Mairah,F,100,18,0,18
Taijah,F,100,377,0,377
Sheng,F,97,370,11,381
Danial,M,99,76,7530,7606
Brynna,F,100,2616,0,2616
Shona,F,100,2377,0,2377
Klohie,F,100,42,0,42
Azaniah,F,67,10,5,15
Swapna,F,100,24,0,24
Dontee,M,100,0,94,94
Aryav,M,100,0,94,94
Jashod,M,100,0,5,5
Kelea,F,100,16,0,16
Zyell,M,100,0,6,6
Tahnesha,F,100,5,0,5
Dejaun,M,100,0,415,415
Abriana,F,100,2223,0,2223
Jaydelynn,F,100,19,0,19
Kendallynn,F,100,13,0,13
Bemjamin,M,100,0,5,5
Achanti,F,100,5,0,5
Kerianne,F,100,785,0,785
Mabry,F,94,586,36,622
Ferney,M,100,0,14,14
Zedric,M,100,0,177,177
Kaide,M,100,0,95,95
Majella,F,100,6,0,6
Anayeli,F,100,1794,0,1794
Terriona,F,100,343,0,343
Shyrone,M,100,0,37,37
Dasen,M,100,0,12,12
Dipa,F,100,18,0,18
Doruk,M,100,0,22,22
Kaylisa,F,100,5,0,5
Jequan,M,100,0,256,256
Deijon,M,100,0,16,16
Daana,F,100,87,0,87
Deshay,F,61,284,183,467
Elliena,F,100,5,0,5
Ramere,M,100,0,60,60
Adahir,M,100,0,50,50
Nikyah,F,100,127,0,127
Hadlynn,F,100,6,0,6
Adalida,F,100,41,0,41
Eldan,M,100,0,8,8
Yarisa,F,100,67,0,67
Lucia,F,100,29473,86,29559
Daeonna,F,100,29,0,29
Ardine,F,100,10,0,10
Elyana,F,100,832,0,832
Kaidance,F,100,362,0,362
Erie,M,89,198,1562,1760
Breann,F,100,5653,0,5653
Karanja,M,100,0,15,15
Ghabriel,M,100,0,12,12
Kayten,F,100,26,0,26
Zarie,F,100,45,0,45
Cliftina,F,100,5,0,5
Jaylun,M,100,0,165,165
Georgina,F,100,11397,0,11397
Shabriana,F,100,5,0,5
Reed,M,97,617,22457,23074
Karolee,F,100,127,0,127
Daigan,M,100,0,30,30
Aven,M,59,954,1376,2330
Rola,F,100,112,0,112
Quitin,M,100,0,5,5
Glenette,F,100,52,0,52
Maryfaith,F,100,5,0,5
Ivery,M,74,129,370,499
Geradine,F,100,10,0,10
Mikayala,F,100,5,0,5
Archit,M,100,0,164,164
Briceida,F,100,440,0,440
Jourdain,M,82,36,169,205
Inti,M,100,0,30,30
Yocelynn,F,100,15,0,15
Colorado,M,100,0,59,59
Brendt,M,100,0,207,207
Embrey,F,100,34,0,34
Tytiauna,F,100,17,0,17
Nyleen,F,100,41,0,41
Kahleia,F,100,5,0,5
Lyia,F,100,5,0,5
Joquan,M,100,0,172,172
Quadaisha,F,100,16,0,16
Ericanthony,M,100,0,5,5
Johany,F,57,66,50,116
Hosam,M,100,0,71,71
Ardarius,M,100,0,34,34
Luzviminda,F,100,12,0,12
Kerren,F,100,15,0,15
Halah,F,100,109,0,109
Isaak,M,100,0,3351,3351
Laqunda,F,100,60,0,60
Sukayna,F,100,23,0,23
Monzerat,F,100,63,0,63
Samita,F,100,5,0,5
Venezia,F,100,268,0,268
Lakeashia,F,100,6,0,6
Darinesha,F,100,6,0,6
Mykila,F,100,8,0,8
Laquista,F,100,16,0,16
Berna,F,100,413,0,413
Tranesha,F,100,95,0,95
Suheyla,F,100,33,0,33
Carolynn,F,100,3956,0,3956
Ahisha,F,100,16,0,16
Arlington,M,96,21,471,492
Dezhon,M,100,0,21,21
Macarthur,M,100,0,801,801
Tyzon,M,100,0,5,5
Tevan,M,100,0,272,272
Dynastee,F,100,95,0,95
Lundynn,F,100,72,0,72
Jepson,M,100,0,11,11
Daejion,M,100,0,5,5
Sharlean,F,100,48,0,48
Aleesa,F,100,639,0,639
Nateyah,F,100,5,0,5
Madilene,F,100,6,0,6
Sonia,F,100,57302,283,57585
Shoshanah,F,100,188,0,188
Safa,F,100,1365,0,1365
Ryusei,M,100,0,28,28
Sexton,M,100,0,5,5
Shunda,F,100,538,0,538
Irv,M,100,0,14,14
Paullette,F,100,126,0,126
Angelysse,F,100,12,0,12
Nnanna,M,100,0,5,5
Icey,F,100,20,0,20
Doranna,F,100,16,0,16
Artadius,M,100,0,5,5
Tyera,F,100,152,0,152
Mckynzee,F,100,46,0,46
Arryonna,F,100,11,0,11
Jefte,M,100,0,127,127
Khaleia,F,100,6,0,6
Matisyahu,M,100,0,28,28
Briesha,F,100,42,0,42
Nannett,F,100,5,0,5
Brennah,F,100,498,0,498
Islee,F,100,11,0,11
Lexxy,F,100,15,0,15
Nourhan,F,100,32,0,32
Yasna,F,100,19,0,19
Karun,M,100,0,16,16
Abree,F,100,455,0,455
Loggan,M,100,0,7,7
Caty,F,100,182,0,182
Jasslynn,F,100,5,0,5
Joshuaanthony,M,100,0,6,6
Aldrick,M,100,0,197,197
Candies,F,100,86,0,86
Maigen,F,100,109,0,109
Phineus,M,100,0,11,11
Jaliyiah,F,100,35,0,35
Alyaa,F,100,17,0,17
Mria,F,100,15,0,15
Edwynn,M,100,0,18,18
Colonel,M,100,0,214,214
Vanecia,F,100,164,0,164
Jay,M,99,1517,142044,143561
Yadin,M,100,0,5,5
Savin,M,100,0,5,5
Shelisha,F,100,66,0,66
Kentra,F,100,33,0,33
Corneisha,F,100,128,0,128
Taeson,M,100,0,5,5
Marisabel,F,100,555,0,555
Emelya,F,100,11,0,11
Retal,F,100,81,0,81
Balee,F,100,24,0,24
Sarom,M,67,5,10,15
Roneesha,F,100,15,0,15
Bartholomew,M,100,0,2524,2524
Sheilamarie,F,100,10,0,10
Lorenzia,M,100,0,5,5
Aset,F,100,10,0,10
Kae,F,100,415,0,415
Sinae,F,100,31,0,31
Laney,F,98,9132,181,9313
Kristell,F,100,150,0,150
Rolena,F,100,36,0,36
Bernabe,M,100,0,1272,1272
Lawanza,F,100,18,0,18
Falynne,F,100,5,0,5
Aleeza,F,100,866,0,866
Varshita,F,100,6,0,6
Mican,M,100,0,37,37
Demea,M,71,5,12,17
Turan,M,100,0,17,17
Alizey,F,100,115,0,115
Xander,M,100,12,18556,18568
Rederick,M,100,0,5,5
Charlinda,F,100,48,0,48
Takarra,F,100,47,0,47
Shao,M,100,0,7,7
Ahliana,F,100,16,0,16
Jaquesha,F,100,130,0,130
Woodroe,M,100,0,25,25
Adhvika,F,100,7,0,7
Amisaday,F,100,5,0,5
Aanav,M,100,0,6,6
Arcangelo,M,100,0,16,16
Leory,M,100,0,62,62
Thanvi,F,100,42,0,42
Daianera,F,100,5,0,5
Anthonia,F,100,164,0,164
Kaelah,F,100,497,0,497
Gaege,M,100,0,66,66
Dorita,F,100,512,0,512
Artemas,M,100,0,39,39
Joshuamichael,M,100,0,54,54
Lalaine,F,100,74,0,74
Sabiel,M,100,0,6,6
Lakesh,F,100,7,0,7
Dalshawn,M,100,0,5,5
Angelicamaria,F,100,24,0,24
Thales,M,100,0,62,62
Reniah,F,100,80,0,80
Decimus,M,100,0,34,34
Jermane,M,100,0,700,700
Jovanie,M,97,11,367,378
Shykeem,M,100,0,86,86
Karell,M,100,0,96,96
Halle,F,100,12584,6,12590
Reeselynn,F,100,7,0,7
Arys,M,55,5,6,11
Rochella,F,100,200,0,200
Kasundra,F,100,11,0,11
Xoi,F,100,8,0,8
Attila,M,100,0,541,541
Beula,F,100,11,0,11
Zeryk,M,100,0,5,5
Deundrae,M,100,0,6,6
Yechezkel,M,100,0,577,577
Grieg,M,100,0,5,5
Deicy,F,100,147,0,147
Sesily,F,100,20,0,20
Jesseica,F,100,5,0,5
Tenita,F,100,219,0,219
Equasha,F,100,5,0,5
Cleave,M,100,0,67,67
Tadarrius,M,100,0,69,69
Pardis,F,100,5,0,5
Teyo,M,100,0,46,46
Jully,F,100,50,0,50
Camika,F,100,76,0,76
Kieona,F,100,50,0,50
Rody,M,100,0,298,298
Kollette,F,100,14,0,14
Relic,M,100,0,5,5
Sherome,M,100,0,5,5
Chrystina,F,100,585,0,585
Makendra,F,100,93,0,93
Wise,M,100,0,19,19
Haylan,F,100,10,0,10
Jaena,F,100,116,0,116
Rayva,F,100,5,0,5
Yurely,F,100,11,0,11
Aretta,F,100,267,0,267
Fadel,M,100,0,119,119
Uhura,F,100,32,0,32
Jamei,F,100,41,0,41
Taishia,F,100,11,0,11
Daveah,F,100,57,0,57
Giacinto,M,100,0,5,5
Youlander,F,100,5,0,5
Brexten,M,100,0,15,15
Chapel,F,67,87,42,129
Kamayah,F,100,133,0,133
Necia,F,100,460,0,460
Naisaiah,M,100,0,6,6
Dhanna,F,100,5,0,5
Nefi,M,100,0,149,149
Jaycub,M,100,0,91,91
Hlee,F,100,96,0,96
Rihannah,F,100,20,0,20
Kemarius,M,100,0,16,16
Dorlan,M,100,0,5,5
Adriah,F,100,47,0,47
Kenji,M,99,33,2831,2864
Kimauri,F,100,5,0,5
Maricelis,F,100,6,0,6
Eumeka,F,100,9,0,9
Mela,F,100,414,0,414
Jarelle,M,100,0,314,314
Cylinda,F,100,77,0,77
Kammron,M,100,0,17,17
Desteni,F,100,192,0,192
Naralie,F,100,10,0,10
Pacen,M,100,0,72,72
Jacquari,M,100,0,5,5
Sai,M,76,308,964,1272
Baeley,F,100,17,0,17
Burhan,M,100,0,136,136
Cytlali,F,100,38,0,38
Khymani,F,50,5,5,10
Tantania,F,100,47,0,47
Tahlya,F,100,5,0,5
Najera,F,100,5,0,5
Wilson,M,99,120,22340,22460
Thorton,M,100,0,15,15
Grandon,M,100,0,32,32
Aeric,M,100,0,91,91
Maricris,F,100,33,0,33
Jerryd,M,100,0,48,48
Camani,F,74,43,15,58
Riann,F,100,644,0,644
Shynice,F,100,61,0,61
Hidaya,F,100,81,0,81
Aedric,M,100,0,14,14
Kaitryn,F,100,12,0,12
Dammian,M,100,0,7,7
Jasn,M,100,0,224,224
Noor,F,88,4596,630,5226
Knight,M,100,0,261,261
Shavan,F,100,5,0,5
Kienan,M,100,0,293,293
Filicia,F,100,83,0,83
Carnell,M,96,142,3378,3520
Tajmah,F,100,11,0,11
Mckinzi,F,100,116,0,116
Shameka,F,100,6191,0,6191
Jenilee,F,100,801,0,801
Bronston,M,100,0,11,11
Keshauna,F,100,251,0,251
Aliee,F,100,7,0,7
Darlise,F,100,6,0,6
Adeliah,F,100,9,0,9
Jamian,M,100,0,402,402
Norelis,F,100,11,0,11
Nasheem,M,100,0,43,43
Taiten,M,100,0,92,92
Aryeh,M,100,0,2111,2111
Latrevious,M,100,0,21,21
Juleny,F,100,10,0,10
Guido,M,100,0,1036,1036
Seidina,F,100,5,0,5
Devante,M,99,57,7567,7624
Hardison,M,100,0,5,5
Macklen,M,100,0,28,28
Dawndee,F,100,5,0,5
Kyreese,M,100,0,92,92
Rondall,M,100,0,505,505
Sri,F,94,79,5,84
Braedon,M,100,0,3694,3694
Oliviamarie,F,100,35,0,35
Laporchia,F,100,74,0,74
Kmaya,F,100,5,0,5
Natahsa,F,100,52,0,52
Delea,F,100,5,0,5
Zooey,F,100,748,0,748
Breina,F,100,42,0,42
Orianne,F,100,5,0,5
Naisha,F,100,1182,0,1182
Miyona,F,100,40,0,40
Robin,F,88,281340,38646,319986
Nataliee,F,100,82,0,82
Patch,M,100,0,5,5
Sonni,F,97,416,15,431
Shahid,M,100,0,600,600
Raghavi,F,100,5,0,5
Slayde,M,100,0,194,194
Sunnye,F,100,29,0,29
Destinie,F,100,2734,0,2734
Ber,M,100,0,10,10
Tiaisha,F,100,14,0,14
Jazzmyne,F,100,486,0,486
Dekorion,M,100,0,5,5
Chantez,F,100,5,0,5
Chellsee,F,100,5,0,5
Stamatios,M,100,0,23,23
Jens,M,100,0,1653,1653
Fiorella,F,100,928,0,928
Isah,M,77,5,17,22
Shymere,M,100,0,16,16
Domenico,M,100,0,2600,2600
Carolinda,F,100,12,0,12
Bralin,M,100,0,104,104
Shonni,F,100,5,0,5
Israel,M,98,1017,50186,51203
Alandra,F,100,877,0,877
Secora,F,100,30,0,30
Aaryanna,F,100,193,0,193
Shata,F,100,26,0,26
Chelbie,F,100,109,0,109
Douglass,M,100,5,3680,3685
Daneysha,F,100,5,0,5
Elica,F,100,62,0,62
Linville,M,100,0,100,100
Ottilia,F,100,6,0,6
Tani,F,99,929,5,934
Madelis,F,100,30,0,30
Eldora,F,100,341,0,341
Latevia,F,100,5,0,5
Piper,F,100,30504,153,30657
Riho,F,100,12,0,12
Daiya,F,100,44,0,44
Krishawn,M,92,12,140,152
Prudance,F,100,5,0,5
Janeese,F,100,89,0,89
Clarise,F,100,648,0,648
Cordairo,M,100,0,32,32
Jaesun,M,100,0,16,16
Timothyjohn,M,100,0,5,5
Zakari,M,86,117,746,863
Alexyanna,F,100,5,0,5
Vandon,M,100,0,43,43
Ketrick,M,100,0,74,74
Stellamarie,F,100,17,0,17
Laurren,F,100,85,0,85
Rasheem,M,100,0,1226,1226
Sahishnu,M,100,0,5,5
Wengel,F,100,5,0,5
Joziel,M,100,0,13,13
Daley,F,83,377,78,455
Melvonia,F,100,5,0,5
Quameek,M,100,0,5,5
Jodi,F,99,79011,906,79917
Sameed,M,100,0,6,6
Jalontae,M,100,0,21,21
Hasir,M,100,0,5,5
Glorimar,F,100,174,0,174
Olamide,F,58,223,159,382
Kale,M,97,226,6818,7044
Sadavia,F,100,5,0,5
Ashiana,F,100,54,0,54
Larrie,M,66,210,408,618
Castle,M,100,0,122,122
Zaymere,M,100,0,5,5
Haneefa,F,100,6,0,6
Gwendolynn,F,100,961,0,961
Cheyna,F,100,124,0,124
Joree,F,100,28,0,28
Anyya,F,100,6,0,6
Inaaya,F,100,404,0,404
Madeson,F,100,20,0,20
Arieli,F,100,18,0,18
Kerrianne,F,100,523,0,523
Sajni,F,100,34,0,34
Naoto,M,100,0,49,49
Deshon,M,93,166,2281,2447
Latajia,F,100,15,0,15
Minami,F,100,185,0,185
Harvy,M,100,0,68,68
Dysha,F,100,6,0,6
Dannicka,F,100,5,0,5
Vraj,M,100,0,302,302
Dorine,F,100,1189,0,1189
Tendra,F,100,5,0,5
Izair,M,100,0,34,34
Garnett,M,79,331,1235,1566
Korin,F,93,1109,85,1194
Jerrina,F,100,5,0,5
Ledarius,M,100,0,462,462
Natalio,M,100,0,124,124
Stefnie,F,100,6,0,6
Sebria,F,100,5,0,5
Neshama,F,100,6,0,6
Kierstan,F,100,462,0,462
Hutchins,M,100,0,5,5
Imogin,F,100,5,0,5
Aevah,F,100,32,0,32
Efthimios,M,100,0,16,16
Niera,F,100,5,0,5
Lay,F,58,7,5,12
Rinesa,F,100,5,0,5
Tysheika,F,100,12,0,12
Mitsy,F,100,193,0,193
Carstyn,M,100,0,6,6
Sanye,F,100,100,0,100
Tayiah,F,100,39,0,39
Jariel,M,97,39,1324,1363
Alayzha,F,100,68,0,68
Seaborn,M,100,0,83,83
Jurnii,F,100,5,0,5
Sapphyre,F,100,41,0,41
Atavion,M,100,0,21,21
Lurine,F,100,23,0,23
Alison,F,100,106379,472,106851
Esat,M,100,0,5,5
Camren,M,91,529,5415,5944
Kewan,M,100,0,331,331
Kinsley,F,99,12176,109,12285
Jaxxson,M,100,0,59,59
Brawley,M,100,0,35,35
Raad,M,100,0,82,82
Abhijot,M,100,0,32,32
Sakeef,M,100,0,5,5
Ellianna,F,100,2018,0,2018
Jaysaun,M,100,0,11,11
Donalda,F,100,203,0,203
Tempest,F,100,1094,0,1094
Sonaya,F,100,29,0,29
Melo,M,100,0,24,24
Addisyn,F,100,6651,0,6651
Raylon,M,100,0,679,679
Yanileth,F,100,7,0,7
Kenzell,M,100,0,49,49
Ahleigha,F,100,6,0,6
Breonte,M,55,5,6,11
Iyana,F,100,4375,0,4375
Tremon,M,100,0,334,334
Milburn,M,100,0,354,354
Gerardo,M,100,239,48195,48434
Annaliz,F,100,100,0,100
Daimarely,F,100,6,0,6
Alice,F,100,124594,354,124948
Jaxxton,M,100,0,7,7
Evalina,F,100,773,0,773
Jaydaliz,F,100,55,0,55
Franciszek,M,100,0,48,48
Doreene,F,100,214,0,214
Melanne,F,100,18,0,18
Brigetta,F,100,158,0,158
Dazarion,M,100,0,16,16
Breelee,F,100,11,0,11
Anessah,F,100,11,0,11
Cleotha,M,93,28,381,409
Shakka,F,100,5,0,5
Nivia,F,100,525,0,525
Marylisa,F,100,28,0,28
Deeasia,F,100,6,0,6
Udbhav,M,100,0,5,5
Cherylee,F,100,85,0,85
Marialuisa,F,100,515,0,515
Jahniyah,F,100,232,0,232
Kamiyra,F,100,6,0,6
Raegin,F,100,19,0,19
Sebastyan,M,100,0,57,57
Afina,F,100,10,0,10
Tomario,M,100,0,5,5
Khyana,F,100,11,0,11
Cheveyo,M,100,0,101,101
Tanijha,F,100,27,0,27
Andric,M,100,0,108,108
Yasmein,F,100,5,0,5
Roshandra,F,100,34,0,34
Eliyana,F,100,199,0,199
Shaki,M,100,0,53,53
Markous,M,100,0,10,10
Deasia,F,100,4208,0,4208
Everlyse,F,100,7,0,7
Calaeb,M,100,0,10,10
Quanisha,F,100,1535,0,1535
Alitzah,F,100,31,0,31
Kyvon,M,100,0,121,121
Jamarlon,M,100,0,54,54
Purnima,F,100,5,0,5
Kodi,F,51,2362,2271,4633
Miori,F,100,11,0,11
Meiya,F,100,44,0,44
Lexus,F,96,6235,263,6498
Mayelin,F,100,90,0,90
Cross,M,100,0,793,793
Welles,M,100,0,40,40
Adalade,F,100,5,0,5
Tammela,F,100,82,0,82
Colie,M,59,85,123,208
Zheng,M,100,0,6,6
Annalisia,F,100,112,0,112
Becka,F,100,320,0,320
Vincenta,F,100,5,0,5
Dyasia,F,100,172,0,172
Lilliannah,F,100,40,0,40
Namiyah,F,100,103,0,103
Michaella,F,100,2003,0,2003
Evelene,F,100,103,0,103
Antown,M,100,0,11,11
Henderson,M,100,0,1328,1328
Angelann,F,100,11,0,11
Amariani,F,100,5,0,5
Baasil,M,100,0,5,5
Candance,F,100,2191,0,2191
Mika,F,84,4911,915,5826
Maran,F,100,22,0,22
Shereena,F,100,58,0,58
Danley,M,100,0,21,21
Kopelynn,F,100,6,0,6
Lekenya,F,100,13,0,13
Tangy,F,100,263,0,263
Derricka,F,100,865,0,865
Jociel,M,100,0,5,5
Dililah,F,100,6,0,6
Shenai,F,100,19,0,19
Ishna,F,100,6,0,6
Latova,F,100,12,0,12
Kamiesha,F,100,17,0,17
Dalajah,F,100,6,0,6
Sonata,F,100,47,0,47
Nicholes,M,100,0,879,879
Zaymir,M,100,0,5,5
Abianna,F,100,5,0,5
Branan,M,100,0,7,7
Dejonna,F,100,7,0,7
Cylis,M,100,0,274,274
Solana,F,100,1231,0,1231
Madria,F,100,17,0,17
Jenna,F,100,141025,257,141282
Yarisleidy,F,100,5,0,5
Doraine,F,100,108,0,108
Ashok,M,100,0,247,247
Elisa,F,100,35852,111,35963
Vanya,F,100,589,0,589
Koreon,M,100,0,5,5
Jakyia,F,100,222,0,222
Teasia,F,100,662,0,662
Krina,F,100,114,0,114
Kamorie,F,83,48,10,58
Larriah,F,100,5,0,5
Jackthomas,M,100,0,6,6
Kissha,F,100,5,0,5
Laneigh,F,100,11,0,11
Sincer,M,100,0,48,48
Daviney,F,100,13,0,13
Cerra,F,100,171,0,171
Gowri,F,100,90,0,90
Vista,F,100,44,0,44
Kaimen,M,100,0,101,101
Tayanna,F,100,450,0,450
Nastassja,F,100,485,0,485
Dunte,M,100,0,23,23
Brytany,F,100,11,0,11
Yittel,F,100,44,0,44
Hayleah,F,100,12,0,12
Abdisalan,M,100,0,6,6
Jeray,M,100,0,51,51
Lorida,F,100,5,0,5
Gwyneth,F,100,4529,0,4529
Graeham,M,100,0,5,5
Scooter,M,100,0,15,15
Ilianie,F,100,5,0,5
Khadijatou,F,100,51,0,51
Derrick,M,99,997,139141,140138
Janat,F,100,42,0,42
Druann,F,100,37,0,37
Brekin,M,100,0,31,31
Fannie,F,100,7833,0,7833
Kayleeanne,F,100,14,0,14
Delfina,F,100,1792,0,1792
Jahan,M,95,25,501,526
Reilee,F,100,21,0,21
Javohn,M,100,0,120,120
Arrik,M,100,0,5,5
Reeselyn,F,100,10,0,10
Varina,F,100,112,0,112
Lithzy,F,100,66,0,66
Laquavis,M,100,0,12,12
Pamie,F,100,28,0,28
Stewart,M,100,69,19229,19298
Tobijah,M,100,0,11,11
Chakina,F,100,11,0,11
Selen,F,100,87,0,87
Aldene,F,100,10,0,10
Breianna,F,100,433,0,433
Dmya,F,100,274,0,274
Nayela,F,100,33,0,33
Darril,M,100,0,69,69
Kaeya,F,100,46,0,46
Zeborah,F,100,5,0,5
Nile,M,89,219,1856,2075
Waylynn,F,72,13,5,18
Martellis,M,100,0,10,10
Tyrecia,F,100,6,0,6
Narjis,F,100,61,0,61
Jaylise,F,100,59,0,59
Patrcia,F,100,94,0,94
Anally,F,100,7,0,7
Devette,F,100,55,0,55
Jaynice,F,100,10,0,10
Tenijah,F,100,5,0,5
Jorgi,F,100,6,0,6
Tymel,M,100,0,171,171
Dylana,F,100,235,0,235
Nakaiah,F,100,6,0,6
Toriana,F,99,542,5,547
Sinclaire,F,100,172,0,172
Shaeley,F,100,63,0,63
Heleana,F,100,20,0,20
Frederika,F,100,61,0,61
Elesa,F,100,203,0,203
Deirdre,F,100,15623,0,15623
Tashua,F,100,47,0,47
Freeland,M,100,0,41,41
Olatokunbo,F,100,15,0,15
Quasha,F,100,32,0,32
Lakeyla,F,100,20,0,20
Taiki,M,100,0,201,201
Mansfield,M,100,0,82,82
Lakyshia,F,100,6,0,6
Brailey,F,99,797,5,802
Nabhya,M,100,0,5,5
Annalissa,F,100,210,0,210
Maclin,M,100,0,109,109
Cyson,M,100,0,31,31
Jawad,M,100,0,944,944
Wani,M,100,0,7,7
Mckeena,F,100,5,0,5
Ebonnie,F,100,28,0,28
Aolany,F,100,16,0,16
Salvado,M,100,0,5,5
Mayraalejandra,F,100,53,0,53
Gwan,F,100,5,0,5
Tajuanda,F,100,6,0,6
Zakeri,M,100,0,6,6
Andrel,M,86,5,32,37
Wilnesha,F,100,20,0,20
Yennifer,F,100,437,0,437
Sylviana,F,100,12,0,12
Norberto,M,100,0,4277,4277
Fitzwilliam,M,100,0,6,6
Donnisha,F,100,445,0,445
Tiffaniamber,F,100,28,0,28
Nadilyn,F,100,8,0,8
Bernando,M,100,0,6,6
Ayn,F,100,129,0,129
Krish,M,100,10,2980,2990
Zacai,M,100,0,18,18
Jodina,F,100,12,0,12
Laterrica,F,100,235,0,235
Raylean,F,100,5,0,5
Sufi,F,100,5,0,5
Nary,F,100,148,0,148
Basil,M,98,94,4538,4632
Thuhuong,F,100,5,0,5
Makailee,F,100,70,0,70
Aliayah,F,100,208,0,208
Valeda,F,100,111,0,111
Cartell,M,100,0,19,19
Ayusha,F,100,17,0,17
Kamra,F,100,59,0,59
Daeja,F,100,694,0,694
Ireneo,M,100,0,16,16
Skyli,F,100,46,0,46
Zalma,F,100,89,0,89
Shylow,F,100,5,0,5
Vyan,M,100,0,17,17
Chamiyah,F,100,10,0,10
Merina,F,100,292,0,292
Han,F,50,501,499,1000
Shahied,M,100,0,7,7
Jennfier,F,100,234,0,234
Bixby,F,71,12,5,17
Hasini,F,100,319,0,319
Tambrey,F,100,32,0,32
Jahzeel,M,73,47,127,174
Josmel,M,100,0,5,5
Merdith,F,100,11,0,11
Gustauo,M,100,0,5,5
Mahailey,F,100,15,0,15
Dwaina,F,100,5,0,5
Dereonna,F,100,62,0,62
Taijarae,F,100,5,0,5
Rajeana,F,100,16,0,16
Arrington,M,72,168,426,594
Kallye,F,100,5,0,5
Nii,M,100,0,57,57
Laquaya,F,100,29,0,29
Mahlani,F,100,12,0,12
Marinah,F,100,34,0,34
Andia,F,100,58,0,58
Harkiran,F,100,20,0,20
Brucha,F,100,462,0,462
Yahye,M,100,0,193,193
Ebone,F,100,1181,0,1181
Bobbyetta,F,100,6,0,6
Kamilya,F,100,76,0,76
Armana,F,100,5,0,5
Rotonia,F,100,5,0,5
Kenise,F,100,165,0,165
Sallee,F,100,145,0,145
Allenna,F,100,5,0,5
Dianie,F,100,11,0,11
Merit,F,71,125,52,177
Sharnisha,F,100,5,0,5
Lasia,F,100,10,0,10
Abdel,M,100,0,506,506
Ronisha,F,100,1403,0,1403
Clairene,F,100,5,0,5
Sapir,F,100,69,0,69
Monte,M,98,384,16657,17041
Pinkey,F,100,85,0,85
Delacey,F,100,35,0,35
Malinda,F,100,15246,0,15246
Javad,M,100,0,56,56
Antonino,M,100,0,1572,1572
Jashana,F,100,6,0,6
Taeya,F,100,325,0,325
Darricka,F,100,46,0,46
Yarin,M,84,5,26,31
Jermisha,F,100,96,0,96
Tirik,M,100,0,5,5
Jacquleen,F,100,6,0,6
Gigette,F,100,5,0,5
Chrisie,F,100,230,0,230
Tayseer,M,100,0,24,24
Daniaya,F,100,5,0,5
Orvan,M,100,0,5,5
Brandis,F,90,730,84,814
Letara,F,100,16,0,16
Soroush,M,100,0,18,18
Richard,M,100,5440,1425102,1430542
Annesa,F,100,39,0,39
Nirel,F,92,73,6,79
Zuzana,F,100,18,0,18
Hameen,M,100,0,16,16
Zekial,M,100,0,6,6
Tymekia,F,100,7,0,7
Abdikarim,M,100,0,21,21
Nkiya,F,100,6,0,6
Tiffinay,F,100,37,0,37
Naftali,M,100,0,1298,1298
Annai,F,100,166,0,166
Keneisha,F,100,528,0,528
Eilee,F,100,106,0,106
Shawda,F,100,24,0,24
Xiomayra,F,100,6,0,6
Mishka,F,100,199,0,199
Atnhony,M,100,0,10,10
Zanna,F,100,441,0,441
Zahniah,F,100,12,0,12
Kimberely,F,100,2301,0,2301
Lyndon,M,97,177,6818,6995
Brilee,F,98,917,18,935
Anastasi,F,100,22,0,22
Auriel,F,94,673,42,715
Jmyah,F,100,11,0,11
Eshton,M,100,0,10,10
Brelon,M,100,0,29,29
Shahina,F,100,11,0,11
Kesha,F,100,5193,5,5198
Timtohy,M,100,0,80,80
Charelle,F,100,429,0,429
Dakita,F,100,24,0,24
Taccarra,F,100,14,0,14
Kiyari,F,100,20,0,20
Kimverly,F,100,5,0,5
Kathileen,F,100,29,0,29
Elfa,F,100,5,0,5
Alisia,F,100,3688,0,3688
Dimya,F,100,13,0,13
Mykeia,F,100,57,0,57
Spandana,F,100,18,0,18
Ciria,F,100,117,0,117
Rochell,F,96,1548,57,1605
Daarina,F,100,47,0,47
Saraya,F,100,1032,0,1032
Emmelin,F,100,19,0,19
Warees,M,100,0,6,6
Yurika,F,100,105,0,105
Salmai,F,100,26,0,26
Nigee,M,100,0,5,5
Abdelrahman,M,100,0,507,507
Mykea,F,100,55,0,55
Aum,M,100,0,148,148
Kenderius,M,100,0,17,17
Marika,F,100,2203,0,2203
Caspar,M,100,0,181,181
Marilea,F,100,109,0,109
Myraa,F,100,9,0,9
Maurkice,M,100,0,13,13
Kourtnei,F,100,137,0,137
Treble,M,100,0,10,10
Siearra,F,100,251,0,251
Marvetta,F,100,269,0,269
Budd,M,100,0,352,352
Antoine,M,99,359,24541,24900
Breiona,F,100,88,0,88
Iridessa,F,100,69,0,69
Jerryca,F,100,7,0,7
Vika,F,100,95,0,95
Abreya,F,100,5,0,5
Greogry,M,100,0,111,111
Laquavius,M,100,0,5,5
Nathifa,F,100,61,0,61
Braylon,M,99,95,12911,13006
Ilythia,F,100,5,0,5
Rainy,F,100,792,0,792
Antanae,F,100,36,0,36
Arseny,M,100,0,10,10
Tanessa,F,100,375,0,375
Kiyanni,F,100,10,0,10
Lashia,F,100,153,0,153
Maddix,M,87,160,1059,1219
Kashden,M,100,0,39,39
Haydyn,M,52,220,235,455
Hera,F,100,380,0,380
Nissa,F,100,1430,0,1430
Mackay,M,91,21,201,222
Dione,F,80,2191,542,2733
Thomason,M,100,0,5,5
Saedie,F,100,5,0,5
Darrly,M,100,0,347,347
Stephenson,M,100,0,187,187
Joachim,M,100,0,779,779
Coya,F,100,18,0,18
Denotra,F,100,12,0,12
Lue,F,77,927,280,1207
Zeniah,F,100,204,0,204
Leyona,F,100,23,0,23
Hariharan,M,100,0,25,25
Charlot,F,100,67,0,67
Dorathy,F,100,252,0,252
Rykin,M,100,0,77,77
Raqwan,M,100,0,13,13
Coast,M,100,0,7,7
Aaleeyah,F,100,93,0,93
Jakyrion,M,100,0,5,5
Willington,M,100,0,11,11
Ommar,M,100,0,26,26
Zayd,M,100,0,1614,1614
Vong,M,100,0,124,124
Habraham,M,100,0,6,6
Victoria,F,100,408385,1038,409423
Zabdy,F,100,6,0,6
Amilio,M,100,0,122,122
Malky,F,100,1438,0,1438
Josselynn,F,100,55,0,55
Rowena,F,100,3530,0,3530
Nalaysia,F,100,48,0,48
Yanni,M,78,168,588,756
Suellyn,F,100,148,0,148
Shanarra,F,100,5,0,5
Maneet,M,100,0,7,7
Lillith,F,100,929,0,929
Antwon,M,100,5,5906,5911
Leora,F,100,3111,0,3111
Divinity,F,100,568,0,568
Jaber,M,100,0,64,64
Brittainy,F,100,531,0,531
Zoeymarie,F,100,10,0,10
Icker,M,100,0,104,104
Rawlins,M,100,0,24,24
Rafiq,M,100,0,335,335
Shalandra,F,100,241,0,241
Trina,F,100,31406,30,31436
Lilith,F,100,3321,0,3321
Tiah,F,100,538,0,538
Keiyon,M,100,0,132,132
Wiatt,M,100,0,98,98
Elita,F,100,450,0,450
Marcina,F,100,259,0,259
Maxwell,M,100,202,75698,75900
Nathanuel,M,100,0,200,200
Christasia,F,100,136,0,136
Concetta,F,100,3083,0,3083
Maythe,F,100,89,0,89
Kataleena,F,100,40,0,40
Chantea,F,100,109,0,109
Sheraz,M,100,0,44,44
Tylun,M,100,0,11,11
Desarey,F,100,29,0,29
Soleya,F,100,5,0,5
Nassiah,F,67,12,6,18
Kollin,M,100,0,2246,2246
Lomont,M,100,0,18,18
Printice,M,100,0,28,28
Cherrel,F,100,32,0,32
Melquiades,M,100,0,146,146
Zacharie,M,100,0,1053,1053
Cordasia,F,100,51,0,51
Mera,F,100,210,0,210
Selin,F,100,731,0,731
Devaunte,M,100,0,125,125
Emarii,M,100,0,5,5
Wales,M,100,0,5,5
Ladonn,F,100,10,0,10
Bluford,M,100,0,16,16
Sayda,F,100,294,0,294
Kentavius,M,100,0,185,185
Shatoria,F,100,510,0,510
Anicka,F,100,82,0,82
Dannalee,F,100,13,0,13
Amaiyah,F,100,548,0,548
Tamica,F,100,2138,0,2138
Kristasia,F,100,29,0,29
Carre,F,100,42,0,42
Davud,M,100,0,18,18
Dabney,F,80,334,85,419
Oliviagrace,F,100,82,0,82
Corrinda,F,100,9,0,9
Enmanuel,M,100,0,884,884
Kiontae,M,100,0,11,11
Inci,F,100,6,0,6
Marites,F,100,72,0,72
Breylen,M,100,0,108,108
Gospel,M,100,0,5,5
Jezebel,F,100,595,0,595
Chanell,F,100,2711,0,2711
Alixis,F,100,74,0,74
Caitlynne,F,100,367,0,367
Ecrin,F,100,33,0,33
Kanyatta,F,100,5,0,5
Ricari,M,100,0,5,5
Adora,F,100,1413,0,1413
Neeti,F,100,48,0,48
Kemarii,F,100,5,0,5
Keilen,M,85,31,182,213
Addalyne,F,100,31,0,31
Akadia,F,100,9,0,9
Maxamillian,M,100,0,170,170
Joharis,F,100,12,0,12
Almir,M,100,0,248,248
Carlito,M,100,0,1057,1057
Kelseigh,F,100,73,0,73
Elira,F,100,33,0,33
Kayti,F,100,247,0,247
Tj,M,99,10,1767,1777
Kashanti,F,100,51,0,51
Tyheim,M,100,0,196,196
Dennen,F,100,7,0,7
Sadeigh,F,100,5,0,5
Ory,M,100,0,142,142
Stepan,M,100,0,178,178
Dalaila,F,100,18,0,18
Demauria,F,55,11,9,20
Danisha,F,100,2311,0,2311
Charleigh,F,100,3082,0,3082
Merita,F,100,607,0,607
Esly,F,98,281,6,287
Asenet,F,100,15,0,15
Kendy,F,97,447,16,463
Driana,F,100,83,0,83
Maryon,F,100,15,0,15
Adylynn,F,100,28,0,28
Beverely,F,100,145,0,145
Elmarie,F,100,36,0,36
Latavis,M,100,0,10,10
Dwaun,M,100,0,48,48
Colette,F,100,17722,0,17722
Dharma,F,99,543,7,550
Jyselle,F,100,18,0,18
Chrystelle,F,100,12,0,12
Ashaan,M,100,0,6,6
Dude,M,100,0,5,5
Troas,F,100,5,0,5
Emilian,M,100,0,61,61
Gerardojr,M,100,0,5,5
Johnese,F,100,41,0,41
Nabiha,F,100,436,0,436
Analyss,F,100,5,0,5
Carell,M,100,0,15,15
Romaine,F,61,754,473,1227
Nelle,F,100,252,0,252
Geraldin,F,100,118,0,118
Sasheen,F,100,43,0,43
Dio,M,100,0,52,52
Kanishka,F,100,37,0,37
Linne,F,100,29,0,29
Katinka,F,100,17,0,17
Kandia,F,75,15,5,20
Garwood,M,100,0,5,5
Kendrell,M,98,18,796,814
Gorkem,M,100,0,5,5
Ziair,M,100,0,129,129
Tabias,M,100,0,326,326
Azarias,M,100,0,137,137
Lavona,F,100,440,0,440
Roniya,F,100,172,0,172
Mahlia,F,100,353,0,353
Izyah,M,100,0,5,5
Colandra,F,100,93,0,93
Ruthy,F,100,469,0,469
Jebidiah,M,100,0,87,87
Timothey,M,100,0,583,583
Dameyon,M,100,0,47,47
Donyae,M,59,206,291,497
Zikomo,M,100,0,5,5
Laveah,F,100,182,0,182
Angellyna,F,100,5,0,5
Jaisha,F,100,235,0,235
Langstyn,F,100,17,0,17
Zekariah,M,100,0,10,10
Niki,F,97,6558,224,6782
Jameece,F,100,5,0,5
Nazariah,F,100,125,0,125
Mendie,F,100,60,0,60
Karlyne,F,100,13,0,13
Armandina,F,100,461,0,461
Aphton,F,100,5,0,5
Hetal,F,100,120,0,120
Jemely,F,100,5,0,5
Dzejla,F,100,5,0,5
Murial,F,100,13,0,13
Solenne,F,100,60,0,60
Leonid,M,100,0,252,252
Rhone,M,100,0,95,95
Aubria,F,100,136,0,136
Davionta,M,100,0,6,6
Dorinna,F,100,6,0,6
Nichell,F,100,56,0,56
Nicolett,F,100,31,0,31
Mortez,M,100,0,30,30
Sohana,F,100,64,0,64
Kerani,F,100,5,0,5
Metehan,M,100,0,5,5
Porshia,F,100,608,0,608
Galiana,F,100,25,0,25
Lyndora,F,100,52,0,52
Kendall,F,64,52614,29887,82501
Errika,F,100,122,0,122
Thurnell,M,100,0,6,6
Emoney,F,100,6,0,6
Naiym,M,100,0,5,5
Margret,F,100,3458,0,3458
Shanei,F,100,6,0,6
Lolitha,F,100,96,0,96
Luxy,F,100,5,0,5
Edna,F,100,31834,53,31887
Campbelle,F,100,21,0,21
Samay,M,98,5,210,215
Salet,F,100,5,0,5
Jarelis,F,100,89,0,89
Makii,M,100,0,31,31
Elanny,F,100,5,0,5
Stevee,F,97,338,11,349
Katori,F,100,75,0,75
Leeandrew,M,100,0,45,45
Azarian,M,100,0,83,83
Gerrett,M,100,0,92,92
Jeylan,M,73,6,16,22
Pantelis,M,100,0,194,194
Quashanna,F,100,5,0,5
Akacia,F,100,139,0,139
Columbia,F,100,22,0,22
Kristyanna,F,100,68,0,68
Martell,M,99,21,2286,2307
Kordan,M,100,0,5,5
Jamalia,F,100,21,0,21
Myrta,F,100,188,0,188
Aliyya,F,100,7,0,7
Cloris,F,100,59,0,59
Gianelle,F,100,98,0,98
Alexavia,F,100,5,0,5
Kyrra,F,100,212,0,212
Daralee,F,100,11,0,11
Yanxiel,M,100,0,5,5
Nyisha,F,100,532,0,532
Sheza,F,100,132,0,132
Timofey,M,100,0,282,282
Ariyah,F,100,2101,0,2101
Shequetta,F,100,17,0,17
Thelton,M,100,0,23,23
Meranda,F,100,2899,0,2899
Benjmain,M,100,0,11,11
Twila,F,100,5859,0,5859
Jamor,M,100,0,28,28
Shameki,F,100,5,0,5
Ademide,M,81,5,21,26
Kalobe,M,100,0,24,24
Jinjer,F,100,5,0,5
Gaia,F,100,761,0,761
Daania,F,100,18,0,18
Wicahpi,F,100,6,0,6
Chyra,F,100,43,0,43
Shadera,F,100,10,0,10
Keywanna,F,100,41,0,41
Neomiah,M,100,0,43,43
Azja,F,100,35,0,35
Yureimy,F,100,5,0,5
Mahala,F,100,1516,0,1516
Karlton,M,100,0,1308,1308
Liliana,F,100,44700,157,44857
Sheku,M,100,0,10,10
Zunairah,F,100,168,0,168
Tevis,M,91,47,470,517
Yomayra,F,100,156,0,156
Beverley,F,100,3919,17,3936
Bethanie,F,100,3549,0,3549
Takiesha,F,100,182,0,182
Malee,F,100,262,0,262
Jhanai,F,100,5,0,5
Phalicia,F,100,5,0,5
Hadlie,F,100,406,0,406
Trevar,M,100,0,367,367
Ozell,M,92,67,728,795
Javionte,M,100,0,5,5
Stowe,M,100,0,5,5
Jerrol,M,100,0,165,165
Rikku,F,100,5,0,5
Breckon,M,100,0,89,89
Aniyia,F,100,82,0,82
Maralyn,F,100,304,0,304
Damajah,M,100,0,17,17
Geovan,M,100,0,5,5
Leashia,F,100,30,0,30
Alaiah,F,100,172,0,172
Lorina,F,100,1126,0,1126
Shyam,M,100,0,660,660
Shermya,F,100,31,0,31
Hoover,M,100,0,191,191
Elijawon,M,100,0,5,5
Markle,M,100,0,10,10
Brejon,M,100,0,5,5
Germayne,M,100,0,5,5
Dyian,M,100,0,8,8
Cordelia,F,100,4643,0,4643
Aviance,F,100,456,0,456
Javarri,M,100,0,56,56
Brenli,F,100,24,0,24
Branya,F,100,29,0,29
Ronata,F,100,39,0,39
Kloi,F,100,71,0,71
Clayburn,M,100,0,68,68
Jamiera,F,100,44,0,44
Monica,F,100,234491,977,235468
Liesel,F,100,822,0,822
Charlann,F,100,65,0,65
Carmencita,F,100,396,0,396
Riston,M,100,0,38,38
Mellinda,F,100,27,0,27
Spiros,M,100,0,555,555
Kimilee,F,100,10,0,10
Ashtynn,F,100,217,0,217
Ruchi,F,100,373,0,373
Ajena,F,100,6,0,6
Torriano,M,100,0,44,44
Marixsa,F,100,27,0,27
Mryah,F,100,6,0,6
Jazzy,F,100,136,0,136
Donda,F,100,152,0,152
Abem,M,100,0,48,48
Daisy,F,100,72711,334,73045
Ebin,M,100,0,280,280
Sharlyne,F,100,64,0,64
Esmee,F,100,266,0,266
Elzora,F,100,15,0,15
Nikolia,M,100,0,5,5
Corrin,F,95,1933,98,2031
Alvira,F,100,52,0,52
Jozyah,M,100,0,23,23
Justan,M,100,0,522,522
Emryk,M,100,0,11,11
Habibah,F,100,37,0,37
Tamayia,F,100,5,0,5
Enan,M,100,0,42,42
Cherena,F,100,18,0,18
Dyna,F,100,203,0,203
Valdene,F,100,5,0,5
Dekendra,F,100,5,0,5
Moncia,F,100,424,0,424
Annalei,F,100,64,0,64
Dalonte,M,100,0,263,263
Avrianna,F,100,173,0,173
Sayah,F,100,10,0,10
Mafata,F,100,6,0,6
Raye,F,90,1166,131,1297
Ayaan,M,96,121,2893,3014
Vernae,F,100,49,0,49
Lebrea,F,100,6,0,6
Shachi,F,100,5,0,5
Debby,F,100,8824,0,8824
Trillium,F,100,34,0,34
Sakiya,F,100,206,0,206
Chantiel,F,100,5,0,5
Kyriakos,M,100,0,128,128
Todo,M,100,0,6,6
Annarose,F,100,432,0,432
Karris,F,100,136,0,136
Emmiliano,M,100,0,5,5
Markees,M,100,0,147,147
Kodie,M,55,974,1168,2142
Genai,F,100,10,0,10
Kenidy,F,100,99,0,99
Ejaz,M,100,0,10,10
Minelly,F,100,32,0,32
Khloye,F,100,6,0,6
Glendi,F,100,70,0,70
Shinnosuke,M,100,0,7,7
Melvia,F,100,328,0,328
Jakylon,M,100,0,19,19
Jerman,M,100,0,412,412
Roshonda,F,100,1069,0,1069
Jerralyn,F,100,9,0,9
Katielynn,F,100,321,0,321
Jacobson,M,100,0,23,23
Radee,M,100,0,5,5
Janekia,F,100,5,0,5
Zakerria,F,100,10,0,10
Tatton,M,100,0,5,5
Rubee,F,100,118,0,118
Rhiana,F,100,1053,0,1053
Jakevious,M,100,0,88,88
Bailei,F,100,156,0,156
Catilyn,F,100,94,0,94
Ezinne,F,100,143,0,143
Barbaro,M,100,0,15,15
Effrem,M,100,0,24,24
Eldwin,M,100,0,52,52
Quantez,M,100,0,604,604
Latundra,F,100,15,0,15
Trystn,M,100,0,5,5
Zesar,M,100,0,5,5
Avelle,F,100,5,0,5
Sairam,M,100,0,6,6
Mukta,F,100,15,0,15
Georgio,M,100,0,562,562
Lamirra,F,100,5,0,5
Deleesa,F,100,10,0,10
Royetta,F,100,73,0,73
Richon,M,100,0,11,11
Becki,F,100,2379,0,2379
Knia,F,100,6,0,6
Dameyune,M,100,0,10,10
Sundy,F,100,95,0,95
Adaija,F,100,34,0,34
Molika,F,100,5,0,5
Nikolai,M,100,0,4945,4945
Livea,F,100,5,0,5
Jaleea,F,100,98,0,98
Trager,M,100,0,8,8
Jerykah,F,100,6,0,6
Yescenia,F,100,15,0,15
Emiliana,F,100,1031,0,1031
Riquel,F,100,25,0,25
Teco,M,100,0,9,9
Maichael,M,100,0,28,28
Rydder,M,100,0,10,10
Ellette,F,100,5,0,5
Dolph,M,100,0,157,157
Shearl,F,50,5,5,10
Kearra,F,100,750,0,750
Morriah,F,100,41,0,41
Janaijah,F,100,6,0,6
Chief,M,100,0,76,76
Lilyonna,F,100,142,0,142
Evagelos,M,100,0,30,30
Leydy,F,100,70,0,70
Zachariah,M,100,37,24418,24455
Zygmunt,M,100,0,41,41
Qadira,F,100,51,0,51
Gitanjali,F,100,40,0,40
Treyvone,M,100,0,64,64
Keighley,F,100,154,0,154
Shaaron,F,100,59,0,59
Akirah,F,100,381,0,381
Roberta,F,100,72491,336,72827
Jerkiya,F,100,5,0,5
Gaitlin,F,100,28,0,28
Audranna,F,100,5,0,5
Tol,M,100,0,5,5
Wintress,F,100,15,0,15
Ahijah,M,100,0,72,72
Rayshon,M,100,0,710,710
Elijahjames,M,100,0,65,65
Dalissa,F,100,82,0,82
Bahia,F,100,17,0,17
Shernette,F,100,5,0,5
Derryck,M,100,0,214,214
Freyja,F,100,474,0,474
Jaasritha,F,100,6,0,6
Daelon,M,100,0,226,226
Maybelline,F,100,364,0,364
Malery,F,100,34,0,34
Jasleen,F,100,1600,0,1600
Kaleb,M,100,192,67867,68059
Zkai,M,100,0,5,5
Treagan,M,100,0,17,17
Chikita,F,100,92,0,92
Quantaya,F,100,21,0,21
Vertell,F,100,10,0,10
Nicholson,M,100,0,92,92
Joanita,F,100,10,0,10
Imunique,F,100,256,0,256
Sheppard,M,100,0,244,244
Sydnea,F,100,12,0,12
Leslea,F,100,349,0,349
Natanim,M,100,0,12,12
Volf,M,100,0,5,5
Ivyanne,F,100,5,0,5
Emmylou,F,100,449,0,449
Lynse,F,100,16,0,16
Lai,F,90,221,25,246
Kimila,F,100,96,0,96
Amandy,F,100,34,0,34
Karola,F,100,5,0,5
Azaleya,F,100,11,0,11
Ertis,M,100,0,5,5
Franceska,F,100,303,0,303
Yelisa,F,100,6,0,6
Joaquim,M,100,0,537,537
Jabian,M,100,0,10,10
Brysen,M,100,6,1913,1919
Carrin,F,100,222,0,222
Dyami,M,98,5,278,283
Omotara,F,100,6,0,6
Lashauna,F,100,732,0,732
Elyah,F,50,5,5,10
Kaliska,F,100,30,0,30
Chenavia,F,100,6,0,6
Xavian,M,100,0,1129,1129
Thera,F,100,382,0,382
Shondre,M,100,0,5,5
Larey,M,100,0,5,5
Nivea,F,100,1048,0,1048
Baylyn,F,100,55,0,55
Jatori,F,79,19,5,24
Arber,M,100,0,243,243
Tamija,F,65,26,14,40
Jarhett,M,100,0,10,10
Kiersti,F,100,34,0,34
Marick,M,100,0,12,12
Dinalee,F,100,6,0,6
Lena,F,100,35434,16,35450
Graice,F,100,21,0,21
Susanna,F,100,13662,0,13662
Cindey,F,100,13,0,13
Gwennan,F,100,5,0,5
Ayoka,F,100,46,0,46
Jenyssa,F,100,5,0,5
Stacye,F,100,521,0,521
Dover,M,100,0,21,21
Annapaula,F,100,6,0,6
Atara,F,100,737,0,737
Neelam,F,100,288,0,288
Haisten,M,100,0,5,5
Margaretha,F,100,54,0,54
Jenniyah,F,100,22,0,22
Mykl,M,100,0,5,5
Heatherlynn,F,100,5,0,5
Wendolyn,F,100,1055,5,1060
Saraiya,F,100,127,0,127
Comeka,F,100,17,0,17
Westin,M,100,0,3577,3577
Antaniyah,F,100,35,0,35
Lew,M,99,10,840,850
Chaney,F,73,1037,392,1429
Netanel,M,100,0,275,275
Jhasmine,F,100,12,0,12
Riordan,M,100,0,209,209
Sirley,F,100,17,0,17
Rhaven,F,100,27,0,27
Ursela,F,100,35,0,35
Sota,M,100,0,88,88
Zekiyah,F,100,7,0,7
Jocell,F,100,31,0,31
Gwenette,F,100,269,0,269
Jameal,M,100,0,213,213
Nadie,F,100,5,0,5
Naira,F,100,258,0,258
Kirtana,F,100,10,0,10
Dhanesh,M,100,0,6,6
Jewett,M,100,0,7,7
Tangie,F,100,1148,0,1148
Khandice,F,100,34,0,34
Kreindy,F,100,13,0,13
Jyles,M,100,0,64,64
Nikali,M,100,0,11,11
Levonia,F,100,105,0,105
Meleah,F,100,1318,0,1318
Adylee,F,100,33,0,33
Seamon,M,100,0,5,5
Anglia,F,100,639,0,639
Shaunacy,F,100,5,0,5
Chavone,F,100,36,0,36
Arnob,M,100,0,5,5
Jaimelynn,F,100,22,0,22
Jeslin,F,100,87,0,87
Ethelbert,M,100,0,5,5
Haku,M,100,0,10,10
Katinia,F,100,16,0,16
Moon,F,77,72,21,93
Jarid,M,100,0,1395,1395
Odyn,M,100,0,43,43
Keondrae,M,100,0,22,22
Jie,M,83,18,86,104
Timya,F,100,357,0,357
Adylenne,F,100,5,0,5
Cassadee,F,100,164,0,164
Kizmet,F,100,42,0,42
Hedrick,M,100,0,5,5
Jhanel,F,100,5,0,5
Shamarie,F,92,128,11,139
Ricard,M,100,0,378,378
Birk,M,100,0,5,5
Drucie,F,100,6,0,6
Johnathyn,M,100,0,78,78
Deavin,M,96,5,127,132
Deloma,F,100,5,0,5
Evanell,F,100,5,0,5
Reichen,M,100,0,72,72
Halid,M,100,0,6,6
Stephenia,F,100,239,0,239
Tassa,F,100,6,0,6
Keiler,M,100,0,32,32
Vicki,F,100,128169,250,128419
Andy,M,99,815,72919,73734
Drelin,M,100,0,16,16
Amarantha,F,100,5,0,5
Juwanna,F,100,49,0,49
Wayburn,M,100,0,5,5
Chaille,F,100,36,0,36
Anthem,M,100,0,28,28
Daityn,F,100,6,0,6
Emilye,F,100,39,0,39
Briarrose,F,100,30,0,30
Reginia,F,100,986,0,986
Geoge,M,100,0,33,33
Dayva,F,100,5,0,5
Tawaina,F,100,34,0,34
Mahogony,F,100,109,0,109
Coraleen,F,100,10,0,10
Louette,F,100,5,0,5
Demel,M,100,0,16,16
Hailo,F,100,24,0,24
Zalet,F,100,5,0,5
Calixta,F,100,30,0,30
Halden,M,100,0,130,130
Rohit,M,100,0,1801,1801
Carliyah,F,100,111,0,111
Garlin,M,100,0,87,87
Special,F,100,338,0,338
Kevin,M,100,5162,1139514,1144676
Kathlynn,F,100,454,0,454
Aryus,M,100,0,7,7
Aylla,F,100,40,0,40
Mea,F,100,1368,0,1368
Quantiana,F,100,5,0,5
Patrisia,F,100,410,0,410
Christyna,F,100,388,0,388
Yhadira,F,100,6,0,6
Takaria,F,100,24,0,24
Garlund,M,100,0,6,6
Traevon,M,100,0,699,699
Kenza,F,100,411,0,411
Starquasia,F,100,14,0,14
Arteria,F,100,38,0,38
Kerek,M,100,0,32,32
Shianne,F,100,3676,0,3676
Maeley,F,100,103,0,103
Davaun,M,100,0,137,137
Nikima,F,100,46,0,46
Adelia,F,100,1714,0,1714
Yannette,F,100,6,0,6
Trelana,F,100,6,0,6
Yuette,F,100,113,0,113
Srikanth,M,100,0,13,13
Sheya,M,100,0,10,10
Kinslea,F,100,41,0,41
Karrien,M,100,0,5,5
Matiya,F,100,5,0,5
Maurico,M,100,0,257,257
Deacan,M,100,0,28,28
Mechell,F,100,481,0,481
Chritine,F,100,8,0,8
Delio,M,100,0,76,76
Iannah,F,100,11,0,11
Renn,M,87,29,198,227
Haliegh,F,100,395,0,395
Johua,M,100,0,35,35
Jakya,F,100,402,0,402
Deveion,M,100,0,76,76
Soumaya,F,100,36,0,36
Anahly,F,100,23,0,23
Sylvania,F,97,172,5,177
Saren,F,100,128,0,128
Laquesta,F,100,5,0,5
Teiona,F,100,44,0,44
Shamori,M,100,0,5,5
Tamarea,F,100,10,0,10
Jaquanda,F,100,115,0,115
Aliveya,F,100,5,0,5
Jasdeep,M,81,49,213,262
Trice,M,100,0,75,75
Dazariah,F,100,35,0,35
Lauraashley,F,100,40,0,40
Renie,F,100,369,0,369
Aizlee,F,100,23,0,23
Cemre,F,100,5,0,5
Ghada,F,100,98,0,98
Briyit,F,100,13,0,13
Anirah,F,100,21,0,21
Yanette,F,100,277,0,277
Aamber,F,100,14,0,14
Lynnet,F,100,82,0,82
Jessic,F,100,139,0,139
Melvyn,M,100,0,933,933
Dontra,M,100,0,46,46
Matoya,F,100,31,0,31
Doratha,F,100,5,0,5
Elvir,M,100,0,38,38
Breeonna,F,100,127,0,127
Malesia,F,100,5,0,5
Dakisha,F,100,56,0,56
Zarahy,F,100,10,0,10
Chariyah,F,100,35,0,35
Begum,F,100,5,0,5
Jones,M,100,0,1366,1366
Jeremah,M,100,0,5,5
Aniqua,F,100,102,0,102
Nydir,M,100,0,5,5
Jazavion,M,100,0,24,24
Subhi,M,100,0,15,15
Tamiria,F,100,17,0,17
Lorece,F,100,6,0,6
Russelle,M,100,0,6,6
Silvia,F,100,17479,51,17530
Carolee,F,100,1981,0,1981
Pansy,F,100,1572,0,1572
Janielys,F,100,22,0,22
Sophee,F,100,291,0,291
Aime,F,98,1643,29,1672
Reighan,F,100,86,0,86
Juliemarie,F,100,6,0,6
Gemise,F,100,6,0,6
Suri,F,100,2061,0,2061
Brittini,F,100,747,0,747
Lajerrica,F,100,12,0,12
Field,M,100,0,49,49
Kaytlyn,F,100,2565,0,2565
Joshuia,M,100,0,33,33
Kornel,M,100,0,5,5
Jamai,M,90,22,189,211
Breyanah,F,100,5,0,5
Ashiyah,F,100,154,0,154
Jahzell,F,100,10,0,10
Careli,F,100,61,0,61
Ronessa,F,100,7,0,7
Luereatha,F,100,5,0,5
Jonne,F,100,48,0,48
Annet,F,100,225,0,225
Kawanza,F,100,48,0,48
Zyshawn,M,100,0,146,146
Clarrisa,F,100,313,0,313
Riva,F,100,1050,0,1050
Sanyra,F,100,5,0,5
Stefen,M,100,0,745,745
Amalie,F,100,914,0,914
Shuntia,F,100,61,0,61
Lanier,M,88,82,620,702
Bekah,F,100,158,0,158
Luxanna,F,100,5,0,5
Latissia,F,100,5,0,5
Eleese,F,100,7,0,7
Makaira,F,100,6,0,6
Soda,F,100,5,0,5
Carlianne,F,100,12,0,12
Tyreq,M,100,0,39,39
Paulisha,F,100,46,0,46
Tayzen,M,100,0,5,5
Tavaria,F,100,113,0,113
Davey,M,99,34,2476,2510
Natalie,F,100,308537,705,309242
Tamarin,F,100,20,0,20
Tyquin,M,100,0,5,5
Micheil,M,100,0,61,61
Arihant,M,100,0,77,77
Zarian,M,90,28,258,286
Cigi,F,100,92,0,92
Kirsta,F,100,264,0,264
Ashaunta,F,100,5,0,5
Kiya,F,99,3336,18,3354
Goodwin,M,100,0,24,24
Franceen,F,100,109,0,109
Cordarrel,M,100,0,62,62
Denitra,F,100,476,0,476
Joanthan,M,100,0,470,470
Jaywon,M,100,0,16,16
Kevron,M,100,0,66,66
Teyani,F,100,11,0,11
Jashone,M,100,0,5,5
Bernett,F,64,18,10,28
Mckinna,F,100,282,0,282
Rahama,F,100,6,0,6
Ailyne,F,100,54,0,54
Tarin,F,74,881,310,1191
Lynden,M,69,383,849,1232
Nichoal,F,100,5,0,5
Andrijana,F,100,6,0,6
Vuk,M,100,0,92,92
Khailee,F,100,61,0,61
Gaudy,F,100,20,0,20
Altariq,M,100,0,205,205
Mala,F,100,592,0,592
Marious,M,100,0,16,16
Avondre,M,100,0,98,98
Lesha,F,100,1053,0,1053
Umeko,F,100,35,0,35
Arek,M,100,0,272,272
Zulmy,F,100,33,0,33
Janluca,M,100,0,14,14
Braven,M,100,0,310,310
Eliakim,M,100,0,54,54
Rabiya,F,100,21,0,21
Deshard,M,100,0,6,6
Jabrian,M,100,0,23,23
Falyn,F,100,842,0,842
Tonka,M,100,0,5,5
Xavy,M,100,0,49,49
Prakrit,M,100,0,5,5
Isella,F,100,146,0,146
Arleatha,F,100,85,0,85
Angelamae,F,100,11,0,11
Marcous,M,100,0,7,7
Alana,F,100,49567,31,49598
Antwione,M,100,0,128,128
Nayely,F,100,2362,0,2362
Jazabell,F,100,10,0,10
Marishka,F,100,81,0,81
Loyda,F,100,141,0,141
Nazariy,M,100,0,15,15
Abcde,F,100,339,0,339
Anavey,F,100,48,0,48
Shavontae,F,95,94,5,99
Keysia,F,100,5,0,5
Tennia,F,100,36,0,36
Astraya,F,100,10,0,10
Deeanna,F,100,1864,0,1864
Lavaughn,M,79,149,546,695
Jamin,M,96,138,3040,3178
Tootie,F,100,5,0,5
Tahaj,M,100,0,34,34
Janissa,F,100,466,0,466
Nakye,M,100,0,29,29
Genica,F,100,15,0,15
Talat,M,100,0,5,5
Isolde,F,100,161,0,161
Blimie,F,100,277,0,277
Akzel,M,100,0,24,24
Keano,M,100,0,276,276
Jaela,F,100,2217,0,2217
Ilias,M,100,0,544,544
Nahjai,F,100,10,0,10
Avary,F,93,1160,85,1245
Chavela,F,100,120,0,120
Bianca,F,100,69105,195,69300
Wilard,M,100,0,6,6
Jerena,F,100,10,0,10
Osiel,M,100,0,1906,1906
Deborra,F,100,230,0,230
Gaytha,F,100,64,0,64
Saylar,F,100,6,0,6
Raydene,F,100,24,0,24
Kaitlynn,F,100,15248,5,15253
Adele,F,100,11858,0,11858
Aavya,F,100,14,0,14
Kamey,F,100,10,0,10
Roxane,F,100,4913,0,4913
Nivriti,F,100,33,0,33
Krisztian,M,100,0,20,20
Lenyn,M,62,6,10,16
Prometheus,M,100,0,15,15
Briannalee,F,100,5,0,5
Jamilyah,F,100,8,0,8
Kenyonna,F,100,142,0,142
Semiko,F,100,31,0,31
Lacresha,F,100,1177,0,1177
Schandra,F,100,6,0,6
Nepoleon,M,100,0,5,5
Rosabell,F,100,8,0,8
Zissel,F,100,171,0,171
Gustave,M,100,0,1092,1092
Marykate,F,100,1891,0,1891
Seretha,F,100,318,0,318
Versace,M,100,0,10,10
Darlyne,F,100,391,0,391
Mallorie,F,100,3819,0,3819
Set,M,100,0,10,10
Jacquilla,F,100,10,0,10
Giuseppina,F,100,618,0,618
Demecia,F,100,84,0,84
Yegor,M,100,0,38,38
Easha,F,100,10,0,10
Jyme,F,100,15,0,15
Vergil,M,100,0,352,352
Sarahy,F,100,764,0,764
Lisveth,F,100,6,0,6
Deisha,F,100,316,0,316
Zailen,M,100,0,71,71
Evolet,F,100,819,0,819
Farrar,F,100,10,0,10
Josephmichael,M,100,0,97,97
Kaesen,M,100,0,127,127
Tannyr,M,100,0,5,5
Jacione,M,100,0,5,5
Kawuan,M,100,0,6,6
Rushda,F,100,6,0,6
Ravynn,F,100,59,0,59
Emoree,F,100,107,0,107
Ezekial,M,100,0,990,990
Lakeva,F,100,111,0,111
Ajai,M,50,163,165,328
Marshalle,F,100,5,0,5
Ferran,F,58,18,13,31
Samahj,M,100,0,5,5
Khamron,M,100,0,104,104
Kineta,F,100,60,0,60
Arhtur,M,100,0,15,15
Caetano,M,100,0,80,80
Keorra,F,100,5,0,5
Josgar,M,100,0,34,34
Tamaika,F,100,19,0,19
Yelena,F,100,926,0,926
Kavina,F,100,70,0,70
Berk,M,100,0,211,211
Leelin,M,100,0,36,36
Decody,M,100,0,5,5
Mykel,M,80,663,2674,3337
Keishona,F,100,22,0,22
Quvondo,M,100,0,6,6
Laikyn,F,100,691,0,691
Lalanya,F,100,79,0,79
Lerenzo,M,100,0,33,33
Raland,M,100,0,10,10
Delaun,M,100,0,5,5
Marschell,F,100,7,0,7
Ayreana,F,100,6,0,6
Christabella,F,100,125,0,125
Annabell,F,100,3165,0,3165
Pheadra,F,100,17,0,17
Lashica,F,100,84,0,84
Vonnita,F,100,5,0,5
Marlynda,F,100,5,0,5
Caesyn,M,100,0,7,7
Haddie,F,100,627,0,627
Jermari,M,100,0,155,155
Ariyona,F,100,165,0,165
Meile,F,100,5,0,5
Jeyson,M,100,0,443,443
Amadea,F,100,85,0,85
Randin,M,100,0,5,5
Sebastien,M,100,0,2998,2998
Adir,M,100,0,137,137
Kathleena,F,100,128,0,128
Beloved,F,100,23,0,23
Riaz,M,100,0,99,99
Kerrin,F,99,1003,10,1013
Linny,M,100,0,6,6
Earley,M,100,0,104,104
Lamarco,M,100,0,104,104
Trinidad,M,65,1627,2973,4600
Patriot,M,100,0,29,29
Shoan,M,100,0,9,9
Nykeesha,F,100,5,0,5
Verneda,F,100,135,0,135
Taequan,M,100,0,135,135
Dhylan,M,100,0,28,28
Mayank,M,100,0,181,181
Marri,F,100,134,0,134
Jimmia,F,100,36,0,36
Karime,F,100,2049,0,2049
Enosh,M,100,0,12,12
Coleta,F,100,35,0,35
Masani,F,100,5,0,5
Christophel,M,100,0,9,9
Ekin,M,95,6,125,131
Yodit,F,100,41,0,41
Gunter,M,100,0,296,296
Payeton,F,100,64,0,64
Condredge,M,100,0,5,5
Emarie,F,100,635,0,635
Jasmie,F,100,38,0,38
Cecilio,M,100,0,1660,1660
Zamaira,F,100,5,0,5
Nachelle,F,100,449,0,449
Sharis,F,100,191,0,191
Ieasha,F,100,534,0,534
Samanda,F,100,249,0,249
Idalynn,F,100,5,0,5
Lolani,F,100,6,0,6
Kalai,M,83,29,144,173
Anyjha,F,100,5,0,5
Alejah,F,100,109,0,109
Azanae,F,100,5,0,5
Katima,F,100,14,0,14
Kinyada,F,100,10,0,10
Sudeep,M,100,0,58,58
Talayasia,F,100,5,0,5
Saralynn,F,100,361,0,361
Tanilah,F,100,14,0,14
Raynor,M,100,0,159,159
Bethann,F,100,2736,0,2736
Dwane,M,100,0,2173,2173
Denis,M,94,778,13132,13910
Roderich,M,100,0,16,16
Mariaisabel,F,100,537,0,537
Zamarcus,M,100,0,6,6
Fredy,M,100,0,3772,3772
Gerrard,M,100,0,547,547
Jameson,M,97,703,20871,21574
Clarke,M,82,447,2089,2536
Shakthi,F,100,40,0,40
Ulrike,F,100,22,0,22
Tanautica,F,100,14,0,14
Divyne,F,100,6,0,6
Marguita,F,100,500,0,500
Lazer,M,100,0,401,401
Hermann,M,100,0,232,232
Videl,F,63,32,19,51
Velvia,F,100,11,0,11
Laili,F,100,17,0,17
Sykeria,F,100,5,0,5
Ifra,F,100,45,0,45
Mayden,F,100,12,0,12
Parishay,F,100,5,0,5
Kaylinda,F,100,16,0,16
Dijana,F,100,41,0,41
Rateel,F,100,28,0,28
Rashawd,M,100,0,74,74
Teric,M,100,0,54,54
Aneesh,M,100,0,776,776
Katryn,F,100,330,0,330
Lonzie,M,100,0,248,248
Regin,F,100,7,0,7
Iriz,F,100,11,0,11
Yamiah,F,100,12,0,12
Kymel,M,100,0,24,24
Callum,M,100,0,3174,3174
Hawanya,F,100,22,0,22
Demontrae,M,100,0,69,69
Omolola,F,100,106,0,106
Zory,F,100,10,0,10
Jerona,F,100,15,0,15
Taqee,M,100,0,10,10
Nadarius,M,100,0,31,31
Lakila,F,100,19,0,19
Cashmir,M,70,6,14,20
Jiovonni,M,100,0,17,17
Madelyngrace,F,100,6,0,6
Monajah,F,100,5,0,5
Jissela,F,100,13,0,13
Arybella,F,100,16,0,16
Cherie,F,100,25819,26,25845
Hever,M,100,0,124,124
Wilton,M,100,0,2882,2882
Salvator,M,100,0,293,293
Lakshya,M,57,30,40,70
Asia,F,99,30532,191,30723
Fonnie,F,100,5,0,5
Ling,F,91,177,18,195
Shacondra,F,100,5,0,5
Efe,M,100,0,227,227
Gizele,F,100,45,0,45
Shaliah,F,100,105,0,105
Omkar,M,100,0,259,259
Robby,M,98,157,9836,9993
Monja,F,100,6,0,6
Narnia,F,100,6,0,6
Shantoya,F,100,79,0,79
Jarnae,F,100,16,0,16
Emmabeth,F,100,5,0,5
Onterrio,M,100,0,36,36
Muzik,M,100,0,6,6
Seona,F,100,49,0,49
Jenci,F,100,5,0,5
Cainon,M,100,0,30,30
Sheren,F,100,5,0,5
Lacarla,F,100,12,0,12
Holger,M,100,0,48,48
Mekesha,F,100,86,0,86
Elany,F,100,114,0,114
Shellina,F,100,32,0,32
Quashana,F,100,16,0,16
Khiabet,F,100,23,0,23
Shurie,F,100,5,0,5
Calogero,M,100,0,364,364
Dashima,F,100,5,0,5
Lorea,F,100,133,0,133
Dawndi,F,100,5,0,5
Jelen,M,100,0,18,18
Maalik,M,100,0,438,438
Sharrie,F,100,641,0,641
Raymoni,F,100,5,0,5
Maday,F,100,75,0,75
Vashanti,F,100,33,0,33
Addalie,F,100,78,0,78
Jeremiyah,M,100,0,165,165
Pooya,M,100,0,5,5
Johny,M,100,0,1746,1746
Jullian,M,72,936,2353,3289
Ezion,M,100,0,12,12
Adysin,F,100,40,0,40
Robia,F,100,20,0,20
Zayan,M,100,0,632,632
Niyon,M,100,0,5,5
Emauri,M,83,18,89,107
Sataria,F,100,6,0,6
Shandera,F,100,5,0,5
Eligh,M,100,0,517,517
Akshat,M,100,0,307,307
Ottavio,M,100,0,17,17
Jouan,M,100,0,5,5
Jaiton,M,100,0,5,5
Vineeta,F,100,11,0,11
Khalill,M,100,0,6,6
Monsanto,M,100,0,5,5
Corvon,M,100,0,27,27
Chamisa,F,100,14,0,14
Warner,M,99,17,2679,2696
Dex,M,100,0,314,314
Vidur,M,100,0,35,35
Hayk,M,100,0,165,165
Ronika,F,100,492,0,492
Theary,F,100,12,0,12
Cambry,F,100,532,0,532
Jaina,F,100,1392,0,1392
Aleeha,F,100,80,0,80
Valasia,F,100,5,0,5
Sumeko,F,100,7,0,7
Elbin,M,100,0,53,53
Katybeth,F,100,11,0,11
Aalaiyah,F,100,39,0,39
Sasan,M,100,0,56,56
Kiaja,F,100,64,0,64
Jakylah,F,100,128,0,128
Randall,M,99,1028,172449,173477
Thomia,F,100,16,0,16
Edgareduardo,M,100,0,5,5
Nikasha,F,100,6,0,6
Asees,F,100,19,0,19
Makella,F,100,80,0,80
Theanna,F,100,5,0,5
Kirin,F,55,351,284,635
Xaviar,M,100,0,512,512
Elmi,M,100,0,5,5
Nayma,F,100,29,0,29
Nyal,M,100,0,8,8
Tapatha,F,100,6,0,6
Mckinney,F,53,17,15,32
Darnell,M,94,1802,26230,28032
Tameica,F,100,32,0,32
Jenard,M,100,0,51,51
Armaan,M,100,0,2108,2108
Hashir,M,100,0,163,163
Markkevin,M,100,0,5,5
Demetia,F,100,5,0,5
Xhavier,M,100,0,6,6
Ashkon,M,100,0,58,58
Gizelle,F,100,2458,0,2458
Kamarr,M,100,0,48,48
Shawen,M,100,0,11,11
Kayne,M,99,15,1568,1583
Kadashia,F,100,26,0,26
Millyana,F,100,11,0,11
Tyasha,F,100,40,0,40
Teyha,F,100,20,0,20
Traven,M,100,0,756,756
Tiarra,F,100,3483,0,3483
Alastair,M,100,0,743,743
Kateline,F,100,118,0,118
Chalene,F,100,132,0,132
Reis,M,87,96,636,732
Alliannah,F,100,34,0,34
Melton,M,100,0,1544,1544
Niche,F,100,5,0,5
Elyna,F,100,79,0,79
Davasia,F,100,21,0,21
Tyrina,F,100,132,0,132
Antavious,M,100,0,501,501
Netasha,F,100,143,0,143
Katence,F,100,6,0,6
Taedyn,M,88,5,35,40
Dumont,M,100,0,5,5
Briget,F,100,500,0,500
Jilyan,F,100,5,0,5
Dontarius,M,100,0,340,340
Ivye,F,100,5,0,5
Taquarius,M,100,0,17,17
Faina,F,100,40,0,40
Jonmarc,M,100,0,70,70
Pharoah,M,100,0,410,410
Monikia,F,100,10,0,10
Ashvika,F,100,16,0,16
Marymichael,F,100,17,0,17
Aneita,F,100,60,0,60
Lillieann,F,100,101,0,101
Beasia,F,100,6,0,6
Aissata,F,100,328,0,328
Jimie,M,84,5,26,31
Searria,F,100,24,0,24
Aalyssa,F,100,110,0,110
Jalessia,F,100,14,0,14
Lekendra,F,100,53,0,53
Dita,F,100,24,0,24
Cheria,F,100,199,0,199
Shelina,F,100,425,0,425
Jarisa,F,100,6,0,6
Derrel,M,100,0,725,725
Troi,F,85,673,115,788
Ranay,F,100,89,0,89
Rachae,F,100,18,0,18
Rima,F,100,1201,0,1201
Birgitta,F,100,83,0,83
Gaetano,M,100,0,1843,1843
Lakeicha,F,100,26,0,26
Alectra,F,100,20,0,20
Chentel,F,100,15,0,15
Tessla,F,100,168,0,168
Rumaldo,M,100,0,496,496
Jessimae,F,100,7,0,7
Kimly,F,100,39,0,39
Jio,M,100,0,6,6
Emarri,M,100,0,6,6
Shavion,F,100,5,0,5
Romare,M,100,0,10,10
Eniyah,F,100,618,0,618
Yohali,F,100,16,0,16
Stehanie,F,100,207,0,207
Mako,M,59,32,46,78
Chauntia,F,100,32,0,32
Amzee,F,100,5,0,5
Brunna,F,100,5,0,5
Zully,F,100,642,0,642
Kidron,M,100,0,6,6
Jenesy,F,100,5,0,5
Edom,F,100,42,0,42
Jenina,F,100,87,0,87
Ephrain,M,100,0,11,11
Lilyin,F,100,20,0,20
Cyrus,M,100,5,14322,14327
Ufemia,F,100,7,0,7
Daimon,M,100,0,678,678
Zavyn,M,100,0,5,5
Makayiah,F,100,5,0,5
Josel,M,100,0,76,76
Areeba,F,100,277,0,277
Deissy,F,100,80,0,80
Aradhya,F,95,90,5,95
Dommonique,F,100,5,0,5
Braedy,M,100,0,44,44
Esprit,F,100,10,0,10
Harlon,M,100,0,672,672
Christianjay,M,100,0,10,10
Sandara,F,100,55,0,55
Patrickjoseph,M,100,0,5,5
Kourtland,M,100,0,78,78
Nanette,F,100,13918,0,13918
Gresia,F,100,89,0,89
Lashawne,F,100,78,0,78
Majida,F,100,5,0,5
Negin,F,100,82,0,82
Luisalberto,M,100,0,305,305
Mabeline,F,100,45,0,45
Kery,F,56,76,60,136
Aisley,F,100,519,0,519
Charlynn,F,100,644,0,644
Kitzi,F,100,6,0,6
Charrise,F,100,220,0,220
Yajahira,F,100,190,0,190
Salomon,M,100,0,2529,2529
Nahje,F,100,5,0,5
Dink,M,100,0,5,5
Kuhu,F,100,5,0,5
Johnathn,M,100,0,34,34
Ashuna,F,100,5,0,5
Yansel,M,100,0,39,39
Dayannara,F,100,103,0,103
Aliannah,F,100,324,0,324
Demedrick,M,100,0,5,5
Dameer,M,100,0,82,82
Ladiamond,F,100,178,0,178
Quyen,F,88,323,42,365
Omie,F,100,58,0,58
Katiemae,F,100,10,0,10
Ronea,F,100,20,0,20
Dasai,M,100,0,5,5
Acob,M,100,0,5,5
Cayd,M,100,0,60,60
Jawara,M,98,5,274,279
Meilyn,F,100,136,0,136
Aviela,F,100,70,0,70
Ciara,F,100,32338,7,32345
Khalea,F,100,225,0,225
Keiley,F,100,450,0,450
Pinches,M,100,0,17,17
Brannigan,M,70,7,16,23
Makinnah,F,100,5,0,5
Dwanna,F,100,409,0,409
Josaphat,M,100,0,11,11
Jatanna,F,100,25,0,25
Espn,M,100,0,137,137
Shykeim,M,100,0,30,30
Leshawnda,F,100,5,0,5
Kish,F,75,15,5,20
Alexsondra,F,100,5,0,5
Shakitha,F,100,13,0,13
Sherral,F,100,139,0,139
Ardan,M,100,0,24,24
Aiyanah,F,100,272,0,272
Ylenia,F,100,22,0,22
Latoisha,F,100,16,0,16
Jahque,M,100,0,5,5
Tamzin,F,100,22,0,22
Sherridan,F,100,12,0,12
Laporsha,F,100,731,0,731
Jaquaylin,M,100,0,5,5
Canden,M,100,0,186,186
Sundee,F,100,282,0,282
Pritesh,M,100,0,57,57
Skyee,F,100,8,0,8
Carvon,M,100,0,7,7
Conney,M,100,0,5,5
Madalena,F,100,519,0,519
Lanashia,F,100,11,0,11
Tzipporah,F,100,244,0,244
Shauniece,F,100,70,0,70
Jeraldin,F,100,66,0,66
Marbeth,F,100,10,0,10
Nhat,M,100,0,46,46
Daebreon,F,72,13,5,18
Myannah,F,100,6,0,6
Jeneva,F,100,634,0,634
Aleyha,F,100,10,0,10
Nakea,F,100,228,0,228
Trevonna,F,100,27,0,27
Liammatthew,M,100,0,7,7
Jamel,M,97,367,10346,10713
Abbigale,F,100,2015,0,2015
Kimbre,F,100,36,0,36
Aryka,F,100,166,0,166
Arvon,M,100,0,11,11
Jax,M,99,56,8909,8965
Wykeem,M,100,0,5,5
Olena,F,100,253,0,253
Trimika,F,100,6,0,6
Brailen,M,100,0,123,123
Shaunell,F,100,42,0,42
Teancum,M,100,0,166,166
Marelin,F,100,231,0,231
Brandonkyle,M,100,0,5,5
Traie,F,100,7,0,7
Mariadelaluz,F,100,144,0,144
Talayah,F,100,516,0,516
Cahlia,F,100,11,0,11
Parita,F,100,5,0,5
Eaven,M,100,0,93,93
Starling,M,76,106,333,439
Sulma,F,100,398,0,398
Chetana,F,100,16,0,16
Shamere,F,68,188,88,276
Reagon,F,100,25,0,25
Abigailrose,F,100,6,0,6
Derrien,M,100,0,177,177
Nedda,F,100,72,0,72
Fancy,F,100,459,0,459
Alexandrea,F,100,8242,0,8242
Casilda,F,100,90,0,90
Renarda,F,97,141,5,146
Shawnequa,F,100,24,0,24
Jeanpierre,M,100,0,1005,1005
Nickalus,M,100,0,444,444
Johnryan,M,100,0,80,80
Chaden,M,100,0,116,116
Loucinda,F,100,204,0,204
Yabsera,F,100,10,0,10
Kishaun,M,100,0,136,136
Tanmay,M,100,0,141,141
Lilygrace,F,100,78,0,78
Odalis,F,98,2450,51,2501
Midas,M,100,0,27,27
Abasi,M,100,0,40,40
Taff,M,100,0,28,28
Maebri,F,100,5,0,5
Elfriede,F,100,15,0,15
Seraphin,F,100,5,0,5
Hill,M,100,0,130,130
Breighton,M,100,0,38,38
Worthy,M,100,0,57,57
Shonte,F,93,1008,80,1088
Dialo,M,100,0,10,10
Anavaeh,F,100,11,0,11
Lavita,F,100,648,0,648
Sheshe,F,100,5,0,5
Genny,F,100,1139,0,1139
Jameriya,F,100,13,0,13
Marquavious,M,100,0,635,635
Cannin,M,100,0,10,10
Landynn,M,77,28,95,123
Aracelly,F,100,114,0,114
Mille,F,100,5,0,5
Deysi,F,100,1311,0,1311
Shirleyann,F,100,94,0,94
Aleq,M,100,0,5,5
Insiyah,F,100,10,0,10
Nathain,M,100,0,5,5
Edgerin,M,100,0,6,6
Nevin,M,98,94,4335,4429
Aydee,F,100,166,0,166
Sinceer,M,58,11,15,26
Kylian,M,91,7,71,78
Endiya,F,100,69,0,69
Lucus,M,100,0,1562,1562
Raphel,M,100,0,140,140
Ketisha,F,100,10,0,10
Janien,F,100,6,0,6
Abihail,F,100,29,0,29
Salette,F,100,11,0,11
Sevion,M,100,0,35,35
Param,M,100,0,209,209
Fashionette,F,100,28,0,28
Shauntiana,F,100,5,0,5
Kaevion,M,100,0,65,65
Kalanni,F,100,5,0,5
Quavion,M,100,0,185,185
Leopold,M,100,0,1298,1298
Ji,F,61,250,158,408
Ilena,F,100,431,0,431
Arush,M,100,0,307,307
Duryea,M,100,0,10,10
Safet,M,100,0,5,5
Lindzie,F,100,144,0,144
Carlis,M,79,151,576,727
Christopherryan,M,100,0,11,11
Rashele,F,100,41,0,41
Senetria,F,100,5,0,5
Tanette,F,100,60,0,60
Evaney,F,100,10,0,10
Swen,M,100,0,21,21
Mondre,M,100,0,29,29
Khailah,F,100,23,0,23
Kerilee,F,100,16,0,16
Fatina,F,100,334,0,334
Alizon,F,100,286,0,286
Lavonte,M,99,11,1105,1116
Shabrittany,F,100,5,0,5
Fortunato,M,100,0,395,395
Gemma,F,100,9192,0,9192
Zederick,M,100,0,5,5
Hayvin,F,100,38,0,38
Tonianne,F,100,225,0,225
Sydea,F,100,6,0,6
Adirah,F,100,5,0,5
Anthoula,F,100,10,0,10
Mayford,M,100,0,14,14
Lakell,M,100,0,5,5
Maeola,F,100,47,0,47
Ikeria,F,100,57,0,57
Caseylynn,F,100,5,0,5
Avasophia,F,100,18,0,18
Pauleth,F,100,6,0,6
Sherryl,F,100,2934,0,2934
Umari,M,100,0,5,5
Cristianna,F,100,84,0,84
Wrenn,F,95,93,5,98
Sheena,F,100,22039,67,22106
Birtha,F,100,159,0,159
Sedwick,M,100,0,5,5
Sheilly,F,100,17,0,17
Jovanne,M,69,29,64,93
Kennita,F,100,157,0,157
Subaru,M,100,0,5,5
Sergei,M,100,0,321,321
Roshea,F,100,10,0,10
Arnitha,F,100,5,0,5
Elfrieda,F,100,48,0,48
Dradyn,M,100,0,15,15
Labreyah,F,100,5,0,5
Kayonia,F,100,5,0,5
Jaunita,F,100,996,0,996
Ciriaco,M,100,0,10,10
Jac,M,100,0,394,394
Sassy,F,100,10,0,10
Yiran,F,67,10,5,15
Arjenis,M,100,0,25,25
Markdavid,M,100,0,5,5
Mayble,F,100,5,0,5
Genevive,F,100,379,0,379
Pamella,F,100,2404,0,2404
Jlayah,F,100,6,0,6
Pink,M,92,5,57,62
Ellesha,F,100,5,0,5
Lanie,F,100,3937,10,3947
Elen,F,100,201,0,201
Chira,F,100,17,0,17
Giselly,F,100,18,0,18
Hanh,F,96,454,21,475
Matheus,M,100,0,1054,1054
Ameka,F,100,136,0,136
Marianny,F,100,96,0,96
Kyllian,M,100,0,46,46
Chapelle,F,100,5,0,5
Aniyaha,F,100,5,0,5
Hemma,F,100,21,0,21
Jeremyah,M,100,0,696,696
Muhammad,M,100,0,9768,9768
Voctoria,F,100,5,0,5
Jaada,F,100,5,0,5
Larsyn,F,100,15,0,15
Sophy,F,100,342,0,342
Unique,F,90,6371,718,7089
Haaris,M,100,0,207,207
Destinay,F,100,17,0,17
Deovion,M,62,43,71,114
Deanjelo,M,100,0,5,5
Oen,M,100,0,5,5
Saphyre,F,100,101,0,101
Shaqueen,F,100,26,0,26
Kaianne,F,100,11,0,11
Jaynisha,F,100,6,0,6
Tareka,F,100,74,0,74
Somayah,F,100,12,0,12
Sabrinna,F,100,214,0,214
Tyius,M,100,0,7,7
Kdence,F,100,15,0,15
Hermon,M,95,36,660,696
Abdule,M,100,0,6,6
Breklyn,F,100,82,0,82
Kiauna,F,100,430,0,430
Gizela,F,100,27,0,27
Leroyal,M,100,0,11,11
Waliyah,F,100,5,0,5
Anissia,F,100,281,0,281
Jatasha,F,100,26,0,26
Kymauri,M,100,0,5,5
Shantrelle,F,100,38,0,38
Deriah,F,100,25,0,25
Sherray,F,100,36,0,36
Jerahmy,M,100,0,8,8
Garick,M,100,0,41,41
Nakiyah,F,100,1019,0,1019
Nurah,F,100,59,0,59
Katanna,F,100,60,0,60
Roshana,F,100,125,0,125
Noori,F,100,11,0,11
Draycen,M,100,0,38,38
Aarohan,M,100,0,16,16
Naely,F,100,23,0,23
Rhiya,F,100,38,0,38
Cabren,M,100,0,5,5
Somiya,F,100,42,0,42
Daydra,F,100,18,0,18
Corvina,F,100,5,0,5
Khamya,F,100,227,0,227
Kadiatu,F,100,24,0,24
Albiery,M,100,0,8,8
Waldon,M,100,0,129,129
Rollo,M,100,0,91,91
Jayin,M,100,0,60,60
Tally,F,85,480,82,562
Lajoi,F,100,11,0,11
Kelsay,F,100,223,0,223
Brendy,F,100,307,0,307
Sumaiya,F,100,407,0,407
Sohom,M,100,0,6,6
Euell,M,100,0,57,57
Alaysia,F,100,3708,0,3708
Trinnity,F,100,165,0,165
Charlles,M,100,0,10,10
Juleidy,F,100,34,0,34
Margareth,F,100,103,0,103
Dominant,M,100,0,5,5
Phillipa,F,100,69,0,69
Latoyra,F,100,5,0,5
Elissa,F,100,15104,0,15104
Corneilus,M,100,0,321,321
Naithen,M,100,0,70,70
Derak,M,100,0,74,74
Avante,M,95,38,696,734
Georgetta,F,100,1518,0,1518
Coreyona,F,100,8,0,8
Fyodor,M,100,0,35,35
Linda,F,100,880656,2291,882947
Alesandra,F,100,770,0,770
Kadrianna,F,100,10,0,10
Meilani,F,100,519,0,519
Jakanye,M,100,0,6,6
Gretell,F,100,18,0,18
Tennley,F,100,30,0,30
Mashanna,F,100,6,0,6
Estee,F,99,656,5,661
Keegan,M,91,2905,29953,32858
Kinden,M,100,0,10,10
Alixzander,M,100,0,55,55
Mehdi,M,100,0,758,758
Jahyda,F,100,5,0,5
Chanice,F,100,563,0,563
Roshad,M,100,0,239,239
Kontina,F,100,10,0,10
Kirt,M,100,0,3454,3454
Terryl,M,55,489,590,1079
Trakia,F,100,5,0,5
Chantis,F,100,5,0,5
Grasiela,F,100,297,0,297
Audreyana,F,100,185,0,185
Zhayne,M,100,0,11,11
Catrese,F,100,17,0,17
Dugan,M,100,0,461,461
Makiel,M,100,0,5,5
Tamarcus,M,100,0,521,521
Dajanea,F,100,13,0,13
Yunxi,F,100,5,0,5
Ondrej,M,100,0,14,14
Yarelys,F,100,13,0,13
Mirza,M,76,120,388,508
Leise,F,100,10,0,10
Natoyia,F,100,22,0,22
Loay,M,100,0,24,24
Latsha,F,100,44,0,44
Jima,F,100,6,0,6
Maliya,F,100,1499,0,1499
Sangeetha,F,100,10,0,10
Manasa,F,100,272,0,272
Kelton,M,100,26,5396,5422
Davaughn,M,100,0,750,750
Summerrain,F,100,5,0,5
Jaquelinne,F,100,159,0,159
Jarlin,F,100,11,0,11
Delitha,F,100,15,0,15
Corsha,F,100,15,0,15
Esquiel,M,100,0,6,6
Aima,F,100,56,0,56
Jaslyne,F,100,191,0,191
Amyrikal,F,100,5,0,5
Raquan,M,100,0,1268,1268
Colben,M,100,0,53,53
Veatrice,F,100,111,0,111
Lizz,F,100,6,0,6
Eytan,M,100,0,290,290
Antoinett,F,100,173,0,173
Rayann,F,100,1417,5,1422
Casea,F,100,5,0,5
Xavi,M,100,6,1360,1366
Jahdae,F,100,10,0,10
Soriya,F,98,223,5,228
Janaka,M,100,0,5,5
Camrun,M,100,0,6,6
Zyan,M,73,251,679,930
Audrena,F,100,96,0,96
Maelea,F,100,41,0,41
Taiyanna,F,100,15,0,15
Latease,F,100,5,0,5
Saphera,F,100,43,0,43
Cozy,F,50,5,5,10
Celeny,F,100,8,0,8
Kapono,M,100,0,166,166
Krue,M,100,0,169,169
Mekela,F,100,5,0,5
Faiza,F,100,676,0,676
Jasonlee,M,100,0,6,6
Tamikah,F,100,20,0,20
Diedra,F,100,1791,0,1791
Cinzia,F,100,78,0,78
Hewey,M,100,0,6,6
Ariyauna,F,100,5,0,5
Perriann,F,100,12,0,12
Nasrudin,M,100,0,5,5
Matelynn,F,100,5,0,5
Indria,F,100,50,0,50
Cammron,M,100,0,26,26
Tekeria,F,100,23,0,23
Inelda,F,100,5,0,5
Nevaehlee,F,100,10,0,10
Tayvianna,F,100,5,0,5
Yler,M,100,0,5,5
Jaushua,M,100,0,11,11
Girtie,F,100,5,0,5
Rakel,F,100,273,0,273
Asmitha,F,100,6,0,6
Gerall,M,100,0,5,5
Loetta,F,100,63,0,63
Takylah,F,100,32,0,32
Doriana,F,100,153,0,153
Hannahgrace,F,100,140,0,140
Del,M,89,354,3005,3359
Darelle,M,96,11,274,285
Latanyia,F,100,5,0,5
Nari,F,100,183,0,183
Makarie,M,100,0,5,5
Brennick,M,100,0,11,11
Lasey,F,100,39,0,39
Xcaret,F,100,87,0,87
Shaunda,F,100,1623,0,1623
Heraclio,M,100,0,241,241
Deionna,F,100,97,0,97
Quinneshia,F,100,5,0,5
Jhaeda,F,100,5,0,5
Donnovin,M,100,0,8,8
Mahlik,M,100,0,231,231
Teryon,M,100,0,5,5
Leahnna,F,100,7,0,7
Loxley,F,80,41,10,51
Amandalyn,F,100,57,0,57
Ehud,M,100,0,5,5
Vylette,F,100,34,0,34
Anilyah,F,100,11,0,11
Khiem,M,100,0,118,118
Allyce,F,100,357,0,357
Deryck,M,100,0,521,521
Angeni,F,100,84,0,84
Jakwon,M,100,0,265,265
Malikaih,M,100,0,5,5
Ardyce,F,100,116,0,116
Taana,F,100,16,0,16
Enisa,F,100,79,0,79
Jerzie,F,100,451,0,451
Andreo,M,100,0,19,19
Reyden,M,100,0,99,99
Geneiveve,F,100,6,0,6
Jovanka,F,100,55,0,55
Dezira,F,100,8,0,8
Nyles,M,100,0,565,565
Shandi,F,100,1739,0,1739
Jackueline,F,100,5,0,5
Jaseir,M,100,0,5,5
Riyadh,M,100,0,48,48
Shawandra,F,100,6,0,6
Thornton,M,100,0,1011,1011
Tamarya,F,100,11,0,11
Arrya,F,100,5,0,5
Weslyn,F,84,86,16,102
Jennifermarie,F,100,56,0,56
Megahn,F,100,64,0,64
Jerrell,M,99,75,5659,5734
Tanni,F,100,6,0,6
Carlhenry,M,100,0,5,5
Thatiana,F,100,68,0,68
Brinley,F,98,4953,88,5041
Keshundra,F,100,13,0,13
Niobe,F,100,158,0,158
Taquira,F,100,38,0,38
Mascud,M,100,0,6,6
Dreden,M,100,0,127,127
Azzam,M,100,0,55,55
Thu,F,99,804,5,809
Parthenia,F,100,404,0,404
Malira,F,100,5,0,5
Vontrell,M,100,0,219,219
Shariden,F,100,5,0,5
Avyanna,F,100,238,0,238
Valyn,F,100,132,0,132
Persephoni,F,100,8,0,8
Nolia,F,100,36,0,36
Qushawn,M,100,0,20,20
Abidan,M,100,0,10,10
Donalyn,F,100,234,0,234
Scharlotte,F,100,18,0,18
Raeniyah,F,100,5,0,5
Sumayya,F,100,185,0,185
Abigael,F,100,1519,5,1524
Melanni,F,100,68,0,68
Alexsandro,M,100,0,267,267
Carina,F,100,14323,35,14358
Reena,F,100,2028,0,2028
Keylly,F,100,37,0,37
Soyla,F,100,192,0,192
Ireland,F,98,4459,80,4539
Hayward,M,100,0,1955,1955
Sudip,M,100,0,5,5
Tearesa,F,100,16,0,16
Merve,F,100,95,0,95
Edberg,M,100,0,6,6
Ketrell,M,100,0,16,16
Abbigayle,F,100,1246,0,1246
Miakota,F,100,5,0,5
Sahaj,M,100,0,239,239
Daryel,M,100,0,401,401
Derrol,M,100,0,5,5
Zionne,F,100,5,0,5
Elynor,F,100,20,0,20
Donnavin,M,100,0,73,73
Perrie,F,85,163,28,191
Radoslav,M,100,0,5,5
Ondine,F,100,72,0,72
Aisya,F,100,5,0,5
Auden,M,72,313,798,1111
Aminta,F,100,244,0,244
Vardaan,M,100,0,28,28
Luisenrique,M,100,0,296,296
Gery,M,100,0,642,642
Keshun,M,99,7,564,571
Lemarion,M,100,0,56,56
Marybeth,F,100,9123,0,9123
Ruaa,F,100,6,0,6
Desjah,F,100,13,0,13
Sandro,M,100,0,1532,1532
Darling,F,100,644,0,644
Klarrissa,F,100,6,0,6
Fredeline,F,100,5,0,5
Jer,F,55,12,10,22
Terreka,F,100,12,0,12
Tamilia,F,100,28,0,28
Takeyra,F,100,10,0,10
Victorianna,F,100,37,0,37
Threase,F,100,22,0,22
Nonda,F,100,5,0,5
Daphni,F,100,26,0,26
Lynnda,F,100,411,0,411
Guiliana,F,100,388,0,388
Almyra,F,100,5,0,5
Shloak,M,100,0,28,28
Kemontay,M,100,0,11,11
Maithili,F,100,21,0,21
Breauna,F,100,1456,0,1456
Reem,F,100,2220,0,2220
Mikeila,F,100,127,0,127
Cutina,F,100,52,0,52
Sadea,F,100,5,0,5
Ladanien,M,100,0,8,8
Altamease,F,100,12,0,12
Salesi,M,100,0,36,36
Sharronda,F,100,148,0,148
Monsserat,F,100,11,0,11
Jamequa,F,100,12,0,12
Lyndee,F,100,1024,0,1024
Varun,M,100,0,2233,2233
Allexander,M,100,0,12,12
Eshan,M,100,0,841,841
Zoeanne,F,100,5,0,5
Treavor,M,100,0,740,740
Lacharles,M,100,0,101,101
Lakitia,F,100,5,0,5
Glynda,F,100,1237,0,1237
Jessiejames,M,100,0,5,5
Nielah,F,100,21,0,21
Guisela,F,100,7,0,7
Santasia,F,100,132,0,132
Maribella,F,100,463,0,463
Jerzey,F,97,288,10,298
Jaevin,M,100,0,104,104
Mahira,F,100,162,0,162
Garn,M,100,0,14,14
Eusevio,M,100,0,16,16
Kiyon,M,100,0,328,328
Bridger,M,100,0,3718,3718
Adalyna,F,100,44,0,44
Britttany,F,100,7,0,7
Moneek,F,100,15,0,15
Amberrose,F,100,206,0,206
Troylene,F,100,23,0,23
Larcenia,F,100,12,0,12
Tiso,M,100,0,7,7
Kentrelle,M,100,0,16,16
Allieanna,F,100,19,0,19
Nekaya,F,100,9,0,9
Simbarashe,M,100,0,5,5
Harbert,M,100,0,6,6
Brandarius,M,100,0,11,11
Sonte,F,100,10,0,10
Elaida,F,100,5,0,5
Mousa,M,100,0,295,295
Kaele,F,100,43,0,43
Jerail,M,100,0,5,5
Cathrynn,F,100,6,0,6
Verdel,M,100,0,5,5
Pele,M,53,40,45,85
Ishmam,M,100,0,5,5
Mikhi,M,100,0,171,171
Kajal,F,100,369,0,369
Nigal,M,100,0,16,16
Malaikah,F,100,23,0,23
Chenille,F,100,207,0,207
Larisa,F,100,3268,0,3268
Jodilynn,F,100,47,0,47
Ambrie,F,100,132,0,132
Winona,F,100,3183,0,3183
Patria,F,100,364,0,364
Cheriese,F,100,14,0,14
Lakeeya,F,100,16,0,16
Anysia,F,100,291,0,291
Ayrica,F,100,38,0,38
Jacyn,F,50,23,23,46
Maurice,M,99,956,77941,78897
Shavaun,F,100,92,0,92
Swecha,F,100,5,0,5
Lynae,F,100,1163,0,1163
Kennadie,F,100,591,0,591
Myasia,F,100,1403,0,1403
Imajen,F,100,5,0,5
Camerone,M,100,0,6,6
Jaisiah,M,100,0,6,6
Jassir,M,100,0,24,24
Sahyra,F,100,15,0,15
Natsumi,F,100,205,0,205
Raden,M,100,0,120,120
Jela,F,100,59,0,59
Cashawn,M,100,0,65,65
Sharyle,F,100,33,0,33
Kellisha,F,100,33,0,33
Jayvionna,F,100,10,0,10
Maximos,M,100,0,464,464
Karesse,F,100,18,0,18
Apolinar,M,100,0,847,847
Ciah,F,100,5,0,5
Aydenne,F,100,5,0,5
Starlita,F,100,5,0,5
Danee,F,100,560,0,560
Evet,F,100,20,0,20
Jenele,F,100,5,0,5
Aleck,M,100,0,609,609
Deryon,M,100,0,5,5
Grisel,F,100,1601,7,1608
Samyra,F,100,752,0,752
Elisiana,F,100,11,0,11
Elden,M,100,0,1698,1698
Imia,F,100,5,0,5
Mykerria,F,100,5,0,5
Dillynn,F,100,25,0,25
Mackynzi,F,100,6,0,6
Cindye,F,100,6,0,6
Shallon,F,100,246,0,246
Sabreya,F,100,5,0,5
Erinique,F,100,6,0,6
Shloime,M,100,0,366,366
Neftali,M,83,380,1862,2242
Aaima,F,100,21,0,21
Trivon,M,100,0,15,15
Ellamae,F,100,374,0,374
Kiziah,F,100,20,0,20
Mykail,M,100,0,59,59
Kaslyn,F,100,43,0,43
Jd,M,97,30,1004,1034
Tammitha,F,100,17,0,17
Beecher,M,100,0,182,182
Marqua,M,100,0,10,10
Kabir,M,100,0,1173,1173
Dziah,F,100,5,0,5
Jaevyn,M,100,0,44,44
Zohair,M,100,0,147,147
Phylis,F,100,1051,0,1051
Anayah,F,100,1662,0,1662
Josph,M,100,0,249,249
Lucesita,F,100,11,0,11
Nyahlee,F,100,5,0,5
Ken,M,100,25,25325,25350
Melandy,F,100,6,0,6
Adelin,F,100,297,0,297
Ladia,F,100,11,0,11
Marysabel,F,100,5,0,5
Maica,F,100,5,0,5
Arezo,F,100,11,0,11
Annasophia,F,100,374,0,374
Kalyssa,F,100,699,0,699
Agassi,M,100,0,6,6
Nau,M,100,0,5,5
Hannalee,F,100,45,0,45
Denishea,F,100,7,0,7
Brexton,M,100,0,398,398
Huner,M,100,0,8,8
Shaniayah,F,100,6,0,6
Yered,M,100,0,6,6
Isaish,M,100,0,86,86
Shireen,F,100,1200,0,1200
Creg,M,100,0,247,247
Karalin,F,100,5,0,5
Lurene,F,100,161,0,161
Malissie,F,100,5,0,5
Jaynell,F,100,109,0,109
Dayven,M,100,0,97,97
Daxton,M,100,0,3835,3835
Vasha,F,100,5,0,5
Zosia,F,100,216,0,216
Roshane,M,100,0,13,13
Zeba,F,100,113,0,113
Markale,M,100,0,149,149
Grason,M,100,0,287,287
Scarlet,F,100,9366,0,9366
Naryia,F,100,10,0,10
Crystalynn,F,100,230,0,230
Tallan,M,100,0,143,143
Ha,F,85,422,73,495
Gennavieve,F,100,93,0,93
Rashay,F,100,158,0,158
Folami,F,100,10,0,10
Allysen,F,100,540,0,540
Jiar,M,100,0,5,5
Ovidio,M,100,0,761,761
Mareisha,F,100,11,0,11
Ilir,M,100,0,148,148
Meahgan,F,100,16,0,16
Ruthe,F,100,136,0,136
Laquanda,F,100,1539,0,1539
Jaydelyn,F,100,37,0,37
Mahith,M,100,0,10,10
Carleene,F,100,11,0,11
Ethan,M,100,633,370693,371326
Gad,M,100,0,59,59
Dalontae,M,100,0,59,59
Hyder,M,100,0,72,72
Telesha,F,100,120,0,120
Lacarlos,M,100,0,29,29
Miel,F,100,65,0,65
Akaiyah,F,100,12,0,12
Shagun,F,100,52,0,52
Nyalise,F,100,12,0,12
Astha,F,100,97,0,97
Jabrandon,M,100,0,5,5
Quintarious,M,100,0,60,60
Yedid,F,100,10,0,10
Aldin,M,100,0,493,493
Denni,F,91,158,15,173
Athaliah,F,100,86,0,86
Alvina,F,100,2164,0,2164
Equasia,F,100,5,0,5
Karrie,F,100,9727,0,9727
Eleonora,F,100,499,0,499
Nayeri,F,100,5,0,5
Markeysha,F,100,58,0,58
Catiria,F,100,33,0,33
Rikesh,M,100,0,6,6
Anuva,F,100,39,0,39
Reshaud,M,100,0,7,7
Jarimiah,M,100,0,5,5
Skylor,M,73,358,973,1331
Andersen,M,79,148,572,720
Jherika,F,100,14,0,14
Cordarrow,M,100,0,7,7
Raivyn,F,100,105,0,105
Dezia,F,100,14,0,14
Camylle,F,100,75,0,75
Chrystan,F,100,11,0,11
Enver,M,100,0,31,31
Yovanni,M,100,0,470,470
Levester,M,100,0,407,407
Jizelle,F,100,828,0,828
Briel,F,100,527,0,527
Deysy,F,100,233,0,233
Raman,M,100,0,292,292
Raylin,F,74,689,242,931
Meiyi,F,100,6,0,6
Gasper,M,100,0,362,362
Zofie,F,100,6,0,6
Linett,F,100,37,0,37
Hallel,F,100,45,0,45
Stephiane,F,100,21,0,21
Nil,M,89,11,86,97
Aveion,M,100,0,140,140
Tristiana,F,100,11,0,11
Benda,F,100,5,0,5
Cristle,F,100,59,0,59
Sadarian,M,100,0,5,5
Mendi,F,100,514,0,514
Sunna,F,100,29,0,29
Parx,M,100,0,5,5
Louretha,F,100,6,0,6
Vani,F,100,264,0,264
Shaquela,F,100,108,0,108
Canna,F,100,63,0,63
Miski,F,100,87,0,87
Tavorian,M,100,0,10,10
Mchenry,M,100,0,5,5
Kaliyha,F,100,22,0,22
Kyndell,F,91,419,40,459
Elasia,F,100,149,0,149
Claretta,F,100,273,0,273
Loula,F,100,21,0,21
Lewanda,F,100,169,0,169
Hefziba,F,100,15,0,15
Sherlanda,F,100,16,0,16
Madason,F,100,183,0,183
Natlaie,F,100,13,0,13
Ranvijay,M,100,0,5,5
Karis,F,99,5128,75,5203
Karine,F,100,1057,0,1057
Markelle,M,56,124,156,280
Kouhei,M,100,0,5,5
Xzavious,M,100,0,30,30
Kenyotta,F,87,130,20,150
Kadeejah,F,100,46,0,46
Vaune,F,100,34,0,34
Sender,M,100,0,62,62
Exzavion,M,100,0,32,32
Kimberle,F,100,1219,0,1219
Alannah,F,100,4802,0,4802
Ifrah,F,100,192,0,192
Ashaureah,F,100,51,0,51
Momen,M,100,0,60,60
Lillieana,F,100,27,0,27
Kennyah,F,100,7,0,7
Daeun,F,100,6,0,6
Aminah,F,100,2833,0,2833
Kamalani,F,97,222,6,228
Ayleah,F,100,53,0,53
Terise,F,100,28,0,28
Kieisha,F,100,5,0,5
Olivija,F,100,5,0,5
Shenoa,F,100,62,0,62
Traneshia,F,100,13,0,13
Breezy,F,100,525,0,525
Tanekqua,F,100,5,0,5
Rainell,F,100,14,0,14
Maily,F,100,358,0,358
Gwynne,F,100,988,0,988
Jenkins,M,100,0,41,41
Pritika,F,100,47,0,47
Jessie,M,55,45290,55163,100453
Adelei,F,100,80,0,80
Abiola,F,76,140,44,184
Anniyah,F,100,572,0,572
Issaias,M,100,0,18,18
Kylena,F,100,51,0,51
Wylder,M,100,0,174,174
Lawan,F,64,96,54,150
Kazmir,M,100,0,42,42
Kelaya,F,100,15,0,15
Tabathia,F,100,183,0,183
Chasetin,M,100,0,5,5
Vernique,F,100,26,0,26
Ori,M,90,98,866,964
Brylyn,F,78,76,22,98
Hadeel,F,100,583,0,583
Samon,F,86,66,11,77
Amanjot,M,100,0,5,5
Paislie,F,100,226,0,226
Beenish,F,100,5,0,5
Emalin,F,100,34,0,34
Regal,M,100,0,26,26
Jakahri,M,100,0,10,10
Lacrista,F,100,19,0,19
Durel,M,100,0,31,31
Yaren,F,100,16,0,16
Eith,M,100,0,11,11
Haeleigh,F,100,146,0,146
Waukesha,F,100,25,0,25
Jarritt,M,100,0,5,5
Aneira,F,100,43,0,43
Florastine,F,100,5,0,5
Sirus,M,100,0,180,180
Allize,F,100,5,0,5
Takeru,M,100,0,78,78
Elyssia,F,100,438,0,438
Ohitika,M,100,0,5,5
Sanvitha,F,100,18,0,18
Winnifred,F,100,500,0,500
Akeiya,F,100,5,0,5
Charol,F,100,12,0,12
Taydin,M,100,0,22,22
Nyailah,F,100,5,0,5
Karly,F,100,9695,5,9700
Sasha,F,96,32839,1297,34136
Typhanie,F,100,15,0,15
Yeico,M,100,0,12,12
Avielle,F,97,167,6,173
Major,M,100,11,7008,7019
Eunika,F,100,10,0,10
Adrien,M,83,1308,6470,7778
Tymier,M,100,0,98,98
Flemon,M,100,0,12,12
Seanice,F,100,17,0,17
Sejal,F,100,737,0,737
Danytza,F,100,12,0,12
Caily,F,100,136,0,136
Bejan,M,100,0,28,28
Tatym,F,98,198,5,203
Sakisha,F,100,7,0,7
Sulynn,F,100,5,0,5
Marlynn,F,100,599,0,599
Cnya,F,100,14,0,14
Yuritzia,F,100,5,0,5
Machai,M,100,0,214,214
Vishaal,M,100,0,87,87
Philip,M,100,682,207005,207687
Shannalee,F,100,5,0,5
Ellyona,F,100,10,0,10
Lakena,F,100,85,0,85
Makana,M,61,230,355,585
Alyssa,F,100,296309,432,296741
Eibhleann,F,100,10,0,10
Skylla,F,100,22,0,22
Ayuub,M,100,0,101,101
Kelicia,F,100,100,0,100
Xyriah,F,100,5,0,5
Deyadira,F,100,6,0,6
Emely,F,100,16380,16,16396
Anamaria,F,100,2717,0,2717
Zenida,F,100,5,0,5
Ajaden,M,100,0,6,6
Yozelin,F,100,26,0,26
Kain,M,100,0,2346,2346
Paeyton,F,100,53,0,53
Jaryiah,F,100,46,0,46
Jaleen,M,52,344,375,719
Quindale,M,100,0,12,12
Lakemia,F,100,5,0,5
Hagen,M,94,138,2107,2245
Mariel,F,98,5534,111,5645
Damariya,F,100,17,0,17
Janavia,F,100,110,0,110
Noli,F,100,13,0,13
Jaiceion,M,100,0,11,11
Theus,M,100,0,53,53
Ecker,M,100,0,25,25
Rishika,F,100,414,0,414
Kade,M,99,157,13604,13761
Zaionna,F,100,10,0,10
Melvenia,F,100,98,0,98
Trinicia,F,100,6,0,6
Sargon,M,100,0,59,59
Ajwa,F,100,45,0,45
Arayna,F,100,102,0,102
Sheldia,F,100,5,0,5
Lum,M,100,0,27,27
Kleo,F,100,28,0,28
Luigina,F,100,11,0,11
Ashden,M,94,16,234,250
Demeisha,F,100,68,0,68
Steadman,M,100,0,67,67
Tikki,F,100,22,0,22
Chapman,M,100,0,540,540
Aijah,F,100,316,0,316
Asacia,F,100,5,0,5
Kaleiyah,F,100,61,0,61
Anjum,F,100,28,0,28
Jontue,M,69,34,77,111
Mackenzie,F,94,114255,7227,121482
Jaidence,F,91,58,6,64
Iyuna,F,100,7,0,7
Tammika,F,100,50,0,50
Merel,M,72,7,18,25
Ardin,M,100,0,18,18
Shamael,F,100,6,0,6
Jayneen,F,100,6,0,6
Tashuna,F,100,25,0,25
Padmini,F,100,5,0,5
Chiana,F,100,215,0,215
Dariah,F,100,323,0,323
Katerra,F,100,240,0,240
Savas,M,100,0,48,48
Jakeel,M,100,0,71,71
Jalyia,F,100,5,0,5
Sossity,F,100,12,0,12
Berenda,F,100,28,0,28
Mirla,F,100,34,0,34
Tiphany,F,100,235,0,235
Daiguan,M,100,0,5,5
Batel,F,100,5,0,5
Cormack,M,100,0,16,16
Jodiann,F,100,157,0,157
Dashonte,F,100,5,0,5
Halayna,F,100,130,0,130
Mavryk,M,100,0,44,44
Erykah,F,100,1356,0,1356
Enaja,F,100,5,0,5
Nera,F,100,20,0,20
Carmenita,F,100,17,0,17
Caprisha,F,100,146,0,146
Khabir,M,100,0,16,16
Averyana,F,100,112,0,112
Crystalgayle,F,100,5,0,5
Morrie,M,100,0,131,131
Doroteo,M,100,0,366,366
Joline,F,100,1462,0,1462
Evyanna,F,100,11,0,11
Shakar,M,100,0,10,10
Metzly,F,100,42,0,42
Banessa,F,100,389,0,389
Taquisha,F,100,307,0,307
Jonee,F,100,295,0,295
Cylen,M,100,0,13,13
Keriann,F,100,961,0,961
Carolette,F,100,29,0,29
Timothea,F,100,152,0,152
Joseluis,M,100,0,3726,3726
Broox,M,100,0,65,65
Lyndell,M,77,363,1226,1589
Keithon,M,100,0,178,178
Razin,M,100,0,5,5
Vache,M,100,0,5,5
Arikka,F,100,10,0,10
Jayanti,F,100,6,0,6
Kahmya,F,100,121,0,121
Coren,M,57,104,137,241
Nehamiah,M,100,0,57,57
Fenwick,M,100,0,6,6
Jony,M,100,0,216,216
Oluseyi,M,100,0,33,33
Balaji,M,100,0,5,5
Marcella,F,100,24316,66,24382
Latreece,F,100,175,0,175
Nevaan,M,100,0,60,60
Meigan,F,100,147,0,147
Jeleah,F,100,41,0,41
Burgandie,F,100,5,0,5
Raniel,M,100,0,19,19
Syvia,F,100,5,0,5
Christhoper,M,100,0,88,88
Glennard,M,100,0,5,5
Ashleymae,F,100,28,0,28
Mouad,M,100,0,23,23
Naliyah,F,100,691,0,691
Masiah,M,80,87,344,431
Zynique,F,100,39,0,39
Neviah,F,100,262,0,262
Paizleigh,F,100,79,0,79
Shyauna,F,100,5,0,5
Kalla,F,100,240,0,240
Michellele,F,100,5,0,5
Karandeep,M,100,0,67,67
Ulisess,M,100,0,10,10
Trusten,M,100,0,87,87
Juanandres,M,100,0,42,42
Rocelia,F,100,21,0,21
Fanya,F,100,24,0,24
Ranette,F,100,104,0,104
Seteria,F,100,11,0,11
Chinika,F,100,19,0,19
Jyshaun,M,100,0,17,17
Klara,F,100,1596,0,1596
Lucretia,F,100,5729,0,5729
Johnandrew,M,100,0,43,43
Parley,M,100,0,230,230
Sylester,M,100,0,18,18
Doranda,F,100,5,0,5
Afiya,F,100,224,0,224
Khylee,F,100,543,0,543
Tyann,F,100,870,0,870
Tayliana,F,100,10,0,10
Ghenet,F,100,5,0,5
Mariyana,F,100,103,0,103
Yesh,M,100,0,10,10
Yari,F,91,254,24,278
Trishell,F,100,12,0,12
Mirabell,F,100,5,0,5
Rane,M,60,124,183,307
Ala,F,73,390,142,532
Etelvina,F,100,15,0,15
Domingos,M,100,0,36,36
Jyzaiah,M,100,0,5,5
Kenney,M,100,5,1861,1866
Yudani,F,100,10,0,10
Alaejah,F,100,16,0,16
Schaffer,M,100,0,5,5
Lisamarie,F,100,1785,0,1785
Cheryce,F,100,44,0,44
Geontae,M,100,0,6,6
Trygve,M,100,0,205,205
Effrey,M,100,0,57,57
Jamareon,M,100,0,231,231
Elanur,F,100,5,0,5
Nabeeha,F,100,210,0,210
Aricela,F,100,72,0,72
Aquanette,F,100,22,0,22
Mills,M,96,11,253,264
Almond,M,100,0,109,109
Mazari,F,100,6,0,6
Kitiara,F,100,94,0,94
Wes,M,100,0,3771,3771
Keniesha,F,100,94,0,94
Benjamine,M,100,0,1021,1021
Reynah,F,100,19,0,19
Cassara,F,100,131,0,131
Brigett,F,100,474,0,474
Disaya,F,100,67,0,67
Chrisna,F,62,10,6,16
Sajaad,M,100,0,5,5
Cnythia,F,100,50,0,50
Saysha,F,100,135,0,135
Hurston,M,100,0,5,5
Rikelme,M,100,0,5,5
Vearl,M,100,0,33,33
Juvia,F,100,21,0,21
Phylliss,F,100,235,0,235
Caleshia,F,100,15,0,15
Chakevia,F,100,5,0,5
Baxley,F,55,12,10,22
Jonette,F,100,1049,0,1049
Lene,F,100,272,0,272
Yolette,F,100,115,0,115
Lyddia,F,100,5,0,5
Shadejah,F,100,5,0,5
Alikah,F,100,11,0,11
Aneesia,F,100,39,0,39
Dowell,M,100,0,58,58
Anyeline,F,100,13,0,13
Traeden,M,100,0,23,23
Kamea,F,100,736,0,736
Davel,M,100,0,17,17
Davidjr,M,100,0,11,11
Kiyonna,F,100,238,0,238
Sehaj,M,54,62,74,136
Taniylah,F,100,13,0,13
Flavia,F,100,811,0,811
Toshana,F,100,5,0,5
Ezella,F,100,19,0,19
Quaveon,M,100,0,22,22
Arney,M,100,0,17,17
Idan,M,100,0,308,308
Terese,F,100,5470,0,5470
Nyirah,F,100,37,0,37
Ronnetta,F,100,344,0,344
Nikida,F,100,35,0,35
Amajah,F,100,25,0,25
Aicia,F,100,47,0,47
Dekai,M,100,0,10,10
Armante,M,100,0,15,15
Morghann,F,100,11,0,11
Jorel,M,100,0,894,894
Riella,F,100,24,0,24
Marcese,M,100,0,10,10
Kokomi,F,100,5,0,5
Martino,M,100,0,645,645
Arielis,F,100,197,0,197
Machiya,F,100,7,0,7
Crickett,F,100,115,0,115
Jejuan,M,100,0,217,217
Yerania,F,100,67,0,67
Aalayah,F,100,592,0,592
Narya,F,100,62,0,62
Ramin,M,100,0,583,583
Monie,F,100,134,0,134
Rela,F,100,5,0,5
Arienna,F,100,105,0,105
Tanneshia,F,100,5,0,5
Belgica,F,100,12,0,12
Breshuna,F,100,5,0,5
Nory,F,100,15,0,15
Telvin,M,100,0,526,526
Shaney,F,100,409,0,409
Merceda,F,100,7,0,7
Kevn,M,100,0,20,20
Arrianna,F,100,1282,0,1282
Kaytlynn,F,100,1236,0,1236
Triste,F,100,5,0,5
Reyne,F,100,224,0,224
Adaugo,F,100,42,0,42
Zylon,M,100,0,57,57
Halaya,F,100,47,0,47
Wuilian,M,100,0,5,5
Nasly,F,100,6,0,6
Jancarlos,M,100,0,909,909
Harlie,F,97,3159,105,3264
Juniah,F,100,5,0,5
Tarrin,M,54,97,113,210
Synceer,M,100,0,13,13
Ericberto,M,100,0,79,79
Taejzon,M,100,0,8,8
Gena,F,100,11332,0,11332
Jumal,M,100,0,38,38
Kenzye,F,100,5,0,5
Jesalyn,F,100,302,0,302
Aroosh,F,80,20,5,25
Etinosa,M,100,0,5,5
Domanik,M,100,0,273,273
Jenavee,F,100,93,0,93
Rosealynn,F,100,32,0,32
Moyra,F,100,24,0,24
Lekeysha,F,100,40,0,40
Alyanna,F,100,1044,0,1044
Irna,F,100,5,0,5
Fredrika,F,100,248,0,248
Alwin,M,100,0,305,305
Muiz,M,100,0,21,21
Shaylinn,F,100,68,0,68
Princewill,M,100,0,10,10
Estil,M,100,0,174,174
Nevaehly,F,100,17,0,17
Sunni,F,99,1812,11,1823
Mariachristina,F,100,66,0,66
Younes,M,100,0,200,200
Wesner,M,100,0,16,16
Carville,M,100,0,5,5
Alondo,M,100,0,43,43
Tootsie,F,100,5,0,5
Jenavive,F,100,60,0,60
Tanielu,M,100,0,6,6
Dola,F,100,88,0,88
Gabriellia,F,100,71,0,71
Sydnye,F,100,59,0,59
Ceilia,F,100,11,0,11
Trinatee,F,100,18,0,18
Kamera,F,100,238,0,238
Jeneal,F,100,40,0,40
Marlik,M,100,0,31,31
Odysseus,M,100,0,150,150
Faron,M,98,52,2297,2349
Lobsang,M,100,0,5,5
Irvina,F,100,6,0,6
Mady,F,100,80,0,80
Revina,F,100,13,0,13
Charri,F,100,15,0,15
Kathleene,F,100,208,0,208
Jahayra,F,100,255,0,255
Ikie,M,100,0,11,11
Storme,F,59,49,34,83
Tancy,F,100,40,0,40
Willadean,F,100,74,0,74
Calep,M,100,0,11,11
Lativia,F,100,61,0,61
Giscard,M,100,0,17,17
Lexiann,F,100,32,0,32
Marcetta,F,100,5,0,5
Steaven,M,100,0,239,239
Avahlynn,F,100,8,0,8
Poua,F,100,7,0,7
Shara,F,100,4667,5,4672
Cherish,F,100,9015,0,9015
Grzegorz,M,100,0,35,35
Johntay,M,100,0,79,79
Sabrielle,F,100,5,0,5
Ayyan,M,100,0,94,94
Logon,M,100,0,81,81
Larre,M,100,0,5,5
Adrian,M,94,13900,201924,215824
Marvina,F,100,488,0,488
Libbi,F,100,205,0,205
Lynze,F,100,148,0,148
Ainslee,F,100,912,0,912
Elvis,M,100,57,13525,13582
Faysal,M,100,0,177,177
Jamariyah,F,100,61,0,61
Ijah,F,90,57,6,63
Mariaesther,F,100,6,0,6
Nalissa,F,100,15,0,15
Alessio,M,100,0,768,768
Kimberlye,F,100,70,0,70
Edd,M,100,0,701,701
Renee,F,99,169102,1511,170613
Labrittany,F,100,105,0,105
Mckayla,F,100,11729,5,11734
Ralena,F,100,17,0,17
Rilwan,M,100,0,10,10
Karista,F,100,142,0,142
Famous,M,100,0,108,108
Fancie,F,100,11,0,11
Sinath,F,100,5,0,5
Tyhesia,F,100,37,0,37
Jazon,M,100,0,195,195
Elisya,F,100,5,0,5
Beyonca,F,100,181,0,181
Kendrae,M,100,0,11,11
Mott,M,100,0,5,5
Darnita,F,100,259,0,259
Darmon,M,100,0,21,21
Raynika,F,100,11,0,11
Kayode,M,100,0,129,129
Chantise,F,100,7,0,7
Israela,F,100,16,0,16
Winslow,M,90,76,693,769
Ealyn,F,100,12,0,12
Quintarius,M,100,0,370,370
Yashasvi,F,100,32,0,32
Jocilynn,F,100,67,0,67
Rolly,M,100,0,159,159
Coreena,F,100,345,0,345
Dhruvan,M,100,0,18,18
Aryane,F,100,10,0,10
Wayneshia,F,100,11,0,11
Trevelyan,M,100,0,6,6
Kaiyan,M,100,0,112,112
Chrsitina,F,100,25,0,25
Helena,F,100,19212,0,19212
Quade,M,100,0,887,887
Deems,M,100,0,12,12
Jerame,M,100,0,563,563
Maragret,F,100,37,0,37
Akelia,F,100,63,0,63
Tremeka,F,100,100,0,100
Jakorie,M,100,0,10,10
Maxy,M,100,0,6,6
Prina,F,100,10,0,10
Emagin,F,100,5,0,5
Coleson,M,100,0,752,752
Adaeze,F,100,355,0,355
Harleyquinn,F,100,65,0,65
Kieran,M,89,1363,10658,12021
Joshlin,F,77,23,7,30
Bangaly,M,100,0,5,5
Johhny,M,100,0,11,11
Demitrice,F,55,6,5,11
Revecca,F,100,54,0,54
Torland,M,100,0,5,5
Yarira,F,100,5,0,5
Bryshon,M,100,0,15,15
Tarig,M,100,0,115,115
Evelina,F,100,2516,0,2516
Thadine,F,100,5,0,5
Itzayani,F,100,20,0,20
Catharina,F,100,267,0,267
Frantisek,M,100,0,5,5
Alekxander,M,100,0,78,78
Marthenia,F,100,5,0,5
Taris,M,75,41,122,163
Cosmas,M,100,0,10,10
Fabien,M,100,0,597,597
Carolan,F,100,88,0,88
Aryela,F,100,5,0,5
Zione,M,100,0,5,5
Kenadi,F,100,1207,0,1207
Jovienne,F,100,5,0,5
Talana,F,100,369,0,369
Mialee,F,100,63,0,63
Madelaine,F,100,2477,0,2477
Argelio,M,100,0,101,101
Ripal,M,100,0,5,5
Rishav,M,100,0,129,129
Athira,F,100,16,0,16
Ivian,F,100,5,0,5
Quinesha,F,100,409,0,409
Sabastion,M,100,0,228,228
Lorilea,F,100,10,0,10
Shondalyn,F,100,5,0,5
Anushree,F,100,100,0,100
Nashanti,F,100,75,0,75
Yosniel,M,100,0,19,19
Marleina,F,100,22,0,22
Faleshia,F,100,20,0,20
Joshuajay,M,100,0,5,5
Feliciti,F,100,52,0,52
Hortense,F,100,398,0,398
Jaimielee,F,100,6,0,6
Mylinda,F,100,796,0,796
Maraina,F,100,26,0,26
Ciley,F,100,5,0,5
Nyvia,F,100,5,0,5
Melaya,F,100,87,0,87
Tekera,F,100,19,0,19
Meldon,M,100,0,112,112
Aleena,F,100,6950,0,6950
Corlin,M,100,0,12,12
Sujey,F,100,606,0,606
Petrona,F,100,168,0,168
Tramiyah,F,100,31,0,31
Jadiss,M,100,0,10,10
Ellery,F,65,2529,1356,3885
Mather,M,100,0,5,5
Rougui,F,100,5,0,5
Logen,M,88,152,1138,1290
Ranota,F,100,6,0,6
Chinita,F,100,263,0,263
Keshaun,M,98,51,2106,2157
Genesia,F,100,78,0,78
Aalayna,F,100,30,0,30
Ashyr,M,100,0,59,59
Anagha,F,100,405,0,405
Jordis,F,98,247,6,253
Kellise,F,100,10,0,10
Campbell,F,58,4668,3407,8075
Lovina,F,100,895,0,895
Jeury,M,100,0,137,137
Muhanad,M,100,0,40,40
Laderrius,M,100,0,52,52
Sawdah,F,100,5,0,5
Rikhil,M,100,0,35,35
Bryssa,F,100,177,0,177
Shetia,F,100,11,0,11
Laeloni,F,100,6,0,6
Nyauna,F,100,16,0,16
Rayson,M,100,0,124,124
Diyora,F,100,12,0,12
Jacquana,F,100,31,0,31
Maber,F,100,11,0,11
Careese,F,100,19,0,19
Yaharia,F,100,5,0,5
Donley,M,100,0,154,154
Randie,F,75,1403,472,1875
Hussain,M,100,0,1064,1064
Lorenn,F,100,5,0,5
Brystol,F,98,563,14,577
Aaryah,F,100,30,0,30
Virgie,F,97,2226,66,2292
Latavius,M,100,0,151,151
Paw,F,100,114,0,114
Chrystal,F,100,14631,5,14636
Davaris,M,100,0,130,130
Latinia,F,100,10,0,10
Velanie,F,100,5,0,5
Kyo,M,100,0,87,87
Gatlen,M,100,0,5,5
Imara,F,100,349,0,349
Takeesha,F,100,137,0,137
Teronda,F,100,19,0,19
Dawndria,F,100,5,0,5
Noa,F,73,3262,1199,4461
Burdell,M,100,0,28,28
Tomecia,F,100,50,0,50
Freemon,M,100,0,29,29
Ophir,M,100,0,16,16
Victoriah,F,100,92,0,92
Toneka,F,100,179,0,179
Kimario,M,100,0,13,13
Jalynn,F,92,4236,346,4582
Jullius,M,100,0,14,14
Dat,M,100,0,515,515
Alliona,F,100,5,0,5
Franchetta,F,100,10,0,10
Avarielle,F,100,15,0,15
Arbi,M,100,0,18,18
Ifeyinwa,F,100,7,0,7
Kharizma,F,100,90,0,90
Montavion,M,100,0,32,32
Jacquil,M,100,0,5,5
Karolin,F,100,15,0,15
Corenna,F,100,25,0,25
Saraii,F,100,20,0,20
Luke,M,100,485,225059,225544
Mahoganie,F,100,69,0,69
Hale,M,97,14,528,542
Tanyeka,F,100,26,0,26
Magdelina,F,100,5,0,5
Hitesh,M,100,0,75,75
Naequan,M,100,0,6,6
Yuniel,M,100,0,82,82
Aveyah,F,100,119,0,119
Janya,F,100,2112,0,2112
Annissia,F,100,27,0,27
Shiran,F,100,46,0,46
Kalieah,F,100,22,0,22
Sherissa,F,100,92,0,92
Tekhi,M,100,0,16,16
Vivienne,F,100,7552,0,7552
Vivana,F,100,17,0,17
Raeliegh,F,100,5,0,5
Florida,F,100,396,0,396
Aquinnah,F,100,86,0,86
Annison,F,100,50,0,50
Ikem,M,100,0,5,5
Kassem,M,100,0,202,202
Chazden,M,100,0,5,5
Ashrita,F,100,65,0,65
Amaiah,F,100,358,0,358
Cleotis,M,100,0,173,173
Atricia,F,100,5,0,5
Marizol,F,100,332,0,332
Anitza,F,100,31,0,31
Natalis,F,100,5,0,5
Rochon,F,50,5,5,10
Engel,M,100,0,11,11
Bittany,F,100,22,0,22
Alexsa,F,100,566,0,566
Nya,F,100,4726,0,4726
Takala,F,100,60,0,60
Aleska,F,100,20,0,20
Devanny,F,100,141,0,141
Zemora,F,100,8,0,8
Laycee,F,100,584,0,584
Emmalie,F,100,625,0,625
Cahya,F,100,5,0,5
Nazeeh,M,100,0,6,6
Rodella,F,100,10,0,10
Erva,F,100,25,0,25
Rubylynn,F,100,12,0,12
Dekon,M,100,0,21,21
Isiash,M,100,0,6,6
Tereska,F,100,17,0,17
Saba,F,95,1285,69,1354
Marial,F,100,37,0,37
Janala,F,100,20,0,20
Calden,M,100,0,54,54
Shemari,M,69,5,11,16
Vincentia,F,100,5,0,5
Trintin,M,100,0,60,60
Taramarie,F,100,36,0,36
Farah,F,98,4523,85,4608
Vicenta,F,100,374,0,374
Sthefany,F,100,43,0,43
Jackalin,F,100,5,0,5
Karver,M,100,0,183,183
Collan,M,100,0,124,124
Contenia,F,100,10,0,10
Beily,F,100,16,0,16
Yulonda,F,100,955,0,955
Maarten,M,100,0,29,29
Jaecyon,M,100,0,14,14
Moez,M,100,0,5,5
Damorion,M,100,0,39,39
Beverly,F,99,166776,942,167718
Meckenzie,F,100,179,0,179
Tahlee,M,100,0,6,6
Avighna,M,100,0,5,5
Trona,F,100,18,0,18
Kesiah,F,100,47,0,47
Fiamma,F,100,18,0,18
Izayuh,M,100,0,5,5
Cyndy,F,100,1323,0,1323
Refugia,F,100,189,0,189
Tymera,F,100,19,0,19
Susette,F,100,924,0,924
Twonda,F,100,5,0,5
Raistlin,M,100,0,338,338
Imhotep,M,100,0,38,38
Lucy,F,100,75498,106,75604
Elandra,F,100,66,0,66
Janak,M,100,0,15,15
Xzaivier,M,100,0,5,5
Boen,M,100,0,56,56
Keshav,M,100,0,849,849
Jumarion,M,100,0,21,21
Nialah,F,100,128,0,128
Jemya,F,100,109,0,109
Mikara,F,100,20,0,20
Erendira,F,100,773,0,773
Jenniah,F,100,63,0,63
Rudis,M,100,0,32,32
Illias,M,100,0,49,49
Keyana,F,100,3600,0,3600
Ashaad,M,100,0,52,52
Supriya,F,100,319,0,319
Caltlin,F,100,7,0,7
Zaryah,F,100,498,0,498
Keisa,F,100,391,0,391
Rosemarie,F,100,23196,5,23201
Wende,F,100,1307,0,1307
Darrus,M,100,0,15,15
Kyajah,F,100,6,0,6
Matus,M,100,0,5,5
Alaynnah,F,100,6,0,6
Durelle,M,100,0,96,96
Khyre,M,100,0,97,97
Cailum,M,100,0,5,5
Teysha,F,100,13,0,13
Domingo,M,100,0,8542,8542
Addilyn,F,100,2595,0,2595
Rikiah,F,100,5,0,5
Ruchama,F,100,184,0,184
Kirsy,F,100,11,0,11
Mashell,F,100,309,0,309
Jahyra,F,100,81,0,81
Madline,F,100,28,0,28
Alexiyana,F,100,12,0,12
Lamoyne,M,100,0,5,5
Trine,F,91,107,11,118
Khallil,M,100,0,5,5
Mishay,F,100,33,0,33
Giovany,M,100,0,1415,1415
Armontae,M,100,0,16,16
Mostyn,M,100,0,6,6
Lenni,F,100,25,0,25
Maaz,M,100,0,377,377
Kymira,F,100,40,0,40
Tharen,M,100,0,38,38
Letetia,F,100,160,0,160
Saraih,F,100,137,0,137
Aline,F,100,3387,0,3387
Dakarii,M,100,0,16,16
Shameek,M,98,5,229,234
Dafina,F,100,118,0,118
Manu,M,99,5,493,498
Abd,M,100,0,17,17
Yakema,F,100,6,0,6
Tyair,M,100,0,30,30
Shrea,F,100,5,0,5
Walsh,M,100,0,5,5
Anjulie,F,100,53,0,53
Marcua,M,100,0,20,20
Machiah,F,100,11,0,11
Christoff,M,100,0,49,49
Latonio,M,100,0,28,28
Sahrai,F,100,5,0,5
Tzion,M,100,0,119,119
Laurrine,F,100,5,0,5
Carissia,F,100,15,0,15
Samona,F,100,306,0,306
Trinell,F,89,40,5,45
Natilyn,F,100,33,0,33
Michaiah,F,80,355,88,443
Nishaun,M,100,0,5,5
Adji,F,100,5,0,5
Rosilind,F,100,11,0,11
Liridona,F,100,73,0,73
Kylene,F,100,1620,0,1620
Alista,F,100,5,0,5
Ronelda,F,100,5,0,5
Onofrio,M,100,0,38,38
Keema,F,100,57,0,57
Savoy,M,93,12,159,171
Aleysa,F,100,18,0,18
Imamu,M,100,0,5,5
Kynnedi,F,100,683,0,683
Jobina,F,100,126,0,126
Lyndsay,F,100,6656,0,6656
Canei,F,100,25,0,25
Edher,M,100,0,32,32
Jakailah,F,100,41,0,41
Udit,M,100,0,5,5
Dianeliz,F,100,10,0,10
Shirika,F,100,17,0,17
Wyonia,F,100,12,0,12
Naason,M,100,0,43,43
Tommy,M,99,1462,108537,109999
Anjali,F,100,4788,0,4788
Deosha,F,100,64,0,64
Kaemen,M,100,0,7,7
Leetal,F,100,5,0,5
Telana,F,100,22,0,22
Ney,M,100,0,5,5
Daryian,F,65,11,6,17
Zianny,F,100,5,0,5
Tamicko,F,100,5,0,5
Ladesha,F,100,65,0,65
Damione,M,100,0,96,96
Gorgonio,M,100,0,6,6
Rage,M,100,0,65,65
Preslyn,F,100,57,0,57
Lavalle,M,96,5,109,114
Kolbe,M,97,37,1104,1141
Kirklyn,F,57,32,24,56
Sopaul,M,100,0,5,5
Shanterika,F,100,5,0,5
Osyrus,M,100,0,5,5
Decklen,M,100,0,24,24
Kamaiah,F,100,5,0,5
Joanthon,M,100,0,5,5
Jeru,M,100,0,26,26
Eymen,M,100,0,20,20
Sallie,F,100,8696,5,8701
Nikya,F,100,246,0,246
Ilyanna,F,100,236,0,236
Noel,M,74,11604,32777,44381
Lateen,F,100,6,0,6
Kamika,F,100,432,0,432
Marieme,F,100,122,0,122
Gabrielalexande,M,100,0,6,6
Sagal,F,100,173,0,173
Audreya,F,100,12,0,12
Loana,F,100,43,0,43
Tedi,F,100,415,0,415
Tazion,M,100,0,11,11
Naziyah,F,100,336,0,336
Allias,M,100,0,10,10
Areonia,F,100,11,0,11
Aleksah,F,100,5,0,5
Dorman,M,100,0,435,435
Domenik,M,98,5,206,211
Emanii,F,100,43,0,43
Zaraya,F,100,128,0,128
Britainy,F,100,101,0,101
Quantas,M,100,0,12,12
Vinathi,F,100,6,0,6
Addley,F,100,86,0,86
Doninic,M,100,0,12,12
Josephus,M,100,0,456,456
Muhamadou,M,100,0,6,6
Jamiqua,F,100,6,0,6
Jozlynne,F,100,12,0,12
Quintyn,M,100,0,311,311
Dakotta,M,63,33,56,89
Shamario,M,100,0,11,11
Safina,F,100,121,0,121
Taryll,M,100,0,60,60
Lanina,F,100,111,0,111
Archie,M,99,158,14614,14772
Enna,F,100,258,0,258
Jerrie,F,95,2854,163,3017
Jaciya,F,100,5,0,5
Kyseem,M,100,0,32,32
Velicity,F,100,16,0,16
Uniqueka,F,100,17,0,17
Carney,M,96,6,135,141
Samrah,F,100,33,0,33
Arkangel,M,100,0,16,16
Trekwan,M,100,0,5,5
Kenidie,F,100,6,0,6
Annemary,F,100,5,0,5
Neosha,F,100,204,0,204
Amora,F,100,1345,0,1345
Chesnee,F,100,173,0,173
Audrii,F,100,5,0,5
Mycah,F,58,667,492,1159
Kendricka,F,100,34,0,34
Simisola,F,100,57,0,57
Zaivian,M,100,0,5,5
Miguela,F,100,10,0,10
Aria,F,98,23295,473,23768
Yasine,M,100,0,10,10
Lauryn,F,100,17928,12,17940
Revell,M,100,0,22,22
Shiona,F,100,24,0,24
Jamess,M,100,0,10,10
Rishaun,M,100,0,5,5
Deanda,F,100,72,0,72
Nicolet,F,100,108,0,108
Jamiece,F,100,16,0,16
Alenah,F,100,114,0,114
Taahirah,F,100,18,0,18
Rchel,F,100,10,0,10
Nelba,F,100,5,0,5
Daryn,M,72,889,2251,3140
Sweta,F,100,217,0,217
Brishon,F,100,5,0,5
Kennasia,F,100,14,0,14
Ottoniel,M,100,0,17,17
Cera,F,100,1311,0,1311
Saide,F,100,118,0,118
Khadijah,F,100,6078,7,6085
Luzma,F,100,6,0,6
Alexine,F,100,84,0,84
Policarpio,M,100,0,5,5
Kirklan,M,100,0,41,41
Avenleigh,F,100,21,0,21
Dilpreet,M,54,32,38,70
Elycia,F,100,402,0,402
Surayya,F,100,5,0,5
Iyonnah,F,100,65,0,65
Madolin,F,100,16,0,16
Nahjay,F,100,5,0,5
Keefe,M,100,0,658,658
Aayla,F,100,304,0,304
Amily,F,100,202,0,202
Kaygen,F,50,12,12,24
Dioselina,F,100,75,0,75
Rune,M,93,15,212,227
Eathel,F,100,6,0,6
Jerico,M,99,8,750,758
Dick,M,100,0,3710,3710
Kahea,F,100,5,0,5
Vivica,F,100,839,0,839
Renorda,F,100,11,0,11
Krishan,M,100,0,358,358
Pondra,F,100,5,0,5
Canan,M,82,5,23,28
Kyal,M,100,0,71,71
Tranasia,F,100,5,0,5
Lilette,F,100,7,0,7
Shephen,M,100,0,23,23
Allysse,F,100,5,0,5
Jonicia,F,100,11,0,11
Brenia,F,100,16,0,16
Zahnya,F,100,20,0,20
Nayisha,F,100,6,0,6
Sambath,M,100,0,22,22
Kaidee,F,100,42,0,42
Jadarrion,M,100,0,51,51
Domonick,M,100,0,976,976
Yahia,M,100,0,175,175
Talayjah,F,100,13,0,13
Gabrien,M,100,0,117,117
Debroa,F,100,5,0,5
Michaelyn,F,100,563,0,563
Ona,F,100,1471,0,1471
Jodell,F,100,676,0,676
Treona,F,100,47,0,47
Alassandra,F,100,28,0,28
Katlynn,F,100,3893,0,3893
Abdiwahab,M,100,0,19,19
Jilliam,F,100,102,0,102
Shaquena,F,100,11,0,11
Heavan,F,100,151,0,151
Jakhira,F,100,5,0,5
Cheketa,F,100,11,0,11
Xian,M,70,81,193,274
Taisean,M,100,0,43,43
Salahaldeen,M,100,0,5,5
Bisa,F,100,19,0,19
Mychaela,F,100,362,0,362
Glena,F,100,385,0,385
Jahvonte,M,100,0,5,5
Shamillia,F,100,5,0,5
Cadge,M,100,0,6,6
Yensid,F,100,5,0,5
Ashirah,F,100,16,0,16
Yussuf,M,100,0,110,110
Chidiebere,M,100,0,68,68
Aabha,F,100,21,0,21
Poetri,F,100,5,0,5
Detoya,F,100,11,0,11
Alese,F,100,445,0,445
Hopi,F,100,5,0,5
Varonica,F,100,231,0,231
Gidgette,F,100,6,0,6
Barnette,F,100,17,0,17
Alythia,F,100,31,0,31
Uzziah,M,98,7,458,465
Kaileeann,F,100,10,0,10
Nasiya,F,100,181,0,181
Arrabella,F,100,96,0,96
Rodnecia,F,100,10,0,10
Alaric,M,100,0,1513,1513
Cathyleen,F,100,15,0,15
Fard,M,100,0,106,106
Greer,F,85,1908,327,2235
Ofilia,F,100,112,0,112
Mathaniel,M,100,0,29,29
Kerryann,F,100,333,0,333
Pamlia,F,100,5,0,5
Mohmmed,M,100,0,34,34
Heela,F,100,32,0,32
Shatorria,F,100,22,0,22
Javiel,M,100,0,337,337
Jonnique,F,100,5,0,5
Arreonna,F,100,11,0,11
Jahnae,F,100,388,0,388
Nazere,M,100,0,17,17
Divyam,M,100,0,5,5
Firdous,F,100,5,0,5
Xotchil,F,100,27,0,27
Delsie,F,100,262,0,262
Trashon,M,100,0,34,34
Sacario,M,100,0,32,32
Sairah,F,100,148,0,148
Mckelle,F,100,58,0,58
Jalonnie,M,100,0,30,30
Siqi,F,100,5,0,5
Satina,F,100,170,0,170
Simra,F,100,264,0,264
Lynett,F,100,454,0,454
Liyu,F,100,22,0,22
Kaviona,F,100,5,0,5
Quavious,M,100,0,10,10
Katheen,F,100,124,0,124
Tiearra,F,100,150,0,150
Jamauria,F,100,35,0,35
Abhay,M,100,0,542,542
Francisco,M,99,803,114186,114989
Branna,F,100,122,0,122
Sheridyn,F,100,87,0,87
Lejeune,F,100,6,0,6
Soffie,F,100,5,0,5
Jenesys,F,100,85,0,85
Phinley,F,85,28,5,33
Damaryon,M,100,0,10,10
Vernadine,F,100,104,0,104
Vanesse,F,100,29,0,29
Jes,M,100,0,126,126
Aleczandria,F,100,12,0,12
Avrey,F,54,308,258,566
Orit,F,100,111,0,111
Anaisabella,F,100,10,0,10
Raycin,M,100,0,5,5
Zzyzx,M,100,0,5,5
Stefhany,F,100,10,0,10
Ortiz,M,100,0,7,7
Jezzel,F,100,15,0,15
Shiori,F,100,184,0,184
Shahzoda,F,100,5,0,5
Kloey,F,100,1405,0,1405
Mikaila,F,100,2230,0,2230
Destanie,F,100,1642,0,1642
Mckaila,F,100,239,0,239
Neria,F,100,54,0,54
Batrina,F,100,5,0,5
Hriday,M,100,0,50,50
Shonnita,F,100,5,0,5
Isaian,M,100,0,5,5
Nyree,F,91,1542,154,1696
Shantora,F,100,7,0,7
Miosoti,F,100,15,0,15
Anajia,F,100,19,0,19
Naveya,F,100,122,0,122
Ayvrie,F,100,11,0,11
Yaneli,F,100,2453,0,2453
Beverlyann,F,100,14,0,14
Jhala,F,100,6,0,6
Rokeem,M,100,0,5,5
Brij,M,100,0,5,5
Mical,M,68,155,330,485
Chali,F,100,15,0,15
Alexios,M,100,0,111,111
Burley,M,100,0,564,564
Tema,F,100,122,0,122
Cadan,M,100,0,265,265
Jayahna,F,100,5,0,5
Josett,F,100,32,0,32
Sherard,M,100,0,537,537
Makila,F,100,298,0,298
Bitsy,F,100,11,0,11
Imiyah,F,100,10,0,10
Kenward,M,100,0,6,6
Kamalei,F,81,81,19,100
Verneita,F,100,5,0,5
Brycelynn,F,100,60,0,60
Javeon,M,100,0,1311,1311
Kathalyn,F,100,11,0,11
Meaghen,F,100,172,0,172
Amarianna,F,100,294,0,294
Jayelin,M,100,0,5,5
Henrik,M,100,0,1398,1398
Lashunya,F,100,5,0,5
Oshyn,F,100,30,0,30
Renarta,F,100,9,0,9
Keldyn,M,100,0,8,8
Ashoka,M,100,0,5,5
Asaiah,M,85,57,334,391
Sayan,M,100,0,122,122
Verle,M,100,0,249,249
Martwan,M,100,0,5,5
Hibo,F,100,44,0,44
Creed,M,100,0,1805,1805
Tahjia,F,100,6,0,6
Kenosha,F,100,377,0,377
Zanquisha,F,100,5,0,5
Kristabella,F,100,34,0,34
Sararose,F,100,42,0,42
Belana,F,100,6,0,6
Riot,M,89,31,259,290
Dahlon,M,100,0,5,5
Tyshera,F,100,25,0,25
Darce,F,100,22,0,22
Caiyah,F,100,19,0,19
Maryalice,F,100,1268,0,1268
Larke,F,100,12,0,12
Lolisa,F,100,25,0,25
Braneisha,F,100,6,0,6
Bilguun,M,100,0,5,5
Leaja,F,100,16,0,16
Miranda,F,100,106546,183,106729
Makalee,F,100,53,0,53
Etosha,F,100,77,0,77
Cillian,M,100,0,575,575
Heylee,F,100,68,0,68
Lyah,F,100,173,0,173
Lekeisha,F,100,785,0,785
Fabain,M,100,0,49,49
Reyhan,M,81,24,100,124
Jarrott,M,100,0,5,5
Woodruff,M,100,0,17,17
Quanita,F,100,546,0,546
Ryonna,F,100,79,0,79
Deante,M,100,5,2477,2482
Merlot,F,100,5,0,5
Rosalin,F,100,549,0,549
Emzley,F,100,5,0,5
Belenda,F,100,107,0,107
Sohela,F,100,5,0,5
Crixus,M,100,0,73,73
Eh,M,59,134,192,326
Chyrl,F,100,219,0,219
Jaquill,M,100,0,40,40
Trevin,M,100,0,4269,4269
Latryce,F,100,11,0,11
Ryin,F,51,60,57,117
Johnnette,F,100,123,0,123
Tomasita,F,100,396,0,396
Mattea,F,100,1543,0,1543
Caniyah,F,100,214,0,214
Brenleigh,F,100,145,0,145
Ambor,F,100,23,0,23
Kevonn,M,100,0,26,26
Ziyad,M,100,0,562,562
Donyale,F,82,354,79,433
Devione,M,100,0,11,11
Kashlee,F,100,10,0,10
Harjas,M,60,17,25,42
Shamayah,F,100,16,0,16
Tasheba,F,100,184,0,184
Tesneem,F,100,66,0,66
Shadin,F,100,10,0,10
Teaisha,F,100,5,0,5
Castor,M,100,0,177,177
Kentavia,F,100,35,0,35
Jahlik,M,100,0,15,15
Shemira,F,100,18,0,18
Saabir,M,100,0,49,49
Shaquenta,F,100,13,0,13
Chaurice,F,100,5,0,5
Lashari,F,100,16,0,16
Meshea,F,100,5,0,5
Redford,M,100,0,47,47
Chayanne,M,63,223,386,609
Zurina,F,100,6,0,6
Jonya,F,100,43,0,43
Kyohei,M,100,0,6,6
Saphirah,F,100,5,0,5
Aashika,F,100,61,0,61
Iriee,F,100,5,0,5
Gar,M,100,0,174,174
Jaceson,M,100,0,7,7
Shantle,F,100,5,0,5
Balentin,M,100,0,17,17
Annastacia,F,100,440,0,440
Anitha,F,100,123,0,123
Shalik,M,100,0,66,66
Yicheng,M,100,0,7,7
Charlestine,F,100,59,0,59
Shikera,F,100,51,0,51
Saaya,F,100,66,0,66
Kynnedy,F,100,354,0,354
Evon,F,83,2206,441,2647
Marylea,F,100,8,0,8
Reaiah,F,100,10,0,10
Alynda,F,100,31,0,31
Katiemarie,F,100,28,0,28
Miaandrea,F,100,6,0,6
Antre,M,100,0,5,5
Lizzet,F,100,601,0,601
Dienne,F,100,5,0,5
Lachonne,F,100,5,0,5
Felita,F,100,783,0,783
Alisha,F,100,54351,131,54482
Leisel,F,100,89,0,89
Sharema,F,100,12,0,12
Gaynor,F,81,44,10,54
Olie,M,80,10,40,50
Panthea,F,100,10,0,10
Avilee,F,100,11,0,11
Reynelda,F,100,29,0,29
Sinda,F,100,192,0,192
Gynesis,F,100,5,0,5
Haoran,M,100,0,6,6
Duwana,F,100,15,0,15
Aidaly,F,100,60,0,60
Quintrel,M,100,0,20,20
Rodolph,M,100,0,24,24
Amunique,F,100,108,0,108
Kiyona,F,100,145,0,145
Holdon,M,100,0,35,35
Eyani,F,100,10,0,10
Elisaul,M,100,0,23,23
Martavius,M,100,0,702,702
Genevia,F,100,378,0,378
Shenitra,F,100,25,0,25
Emperatriz,F,100,26,0,26
Jarreau,M,100,0,152,152
Alistair,M,100,0,1482,1482
Nicolaos,M,100,0,98,98
Frankie,M,72,11645,29450,41095
Chalisse,F,100,5,0,5
Keighton,M,100,0,5,5
Mateya,F,100,97,0,97
Piffany,F,100,14,0,14
Luismiguel,M,100,0,205,205
Asian,F,59,16,11,27
Leani,F,100,114,0,114
Ellsa,F,100,21,0,21
Sarianna,F,100,54,0,54
Sophiee,F,100,12,0,12
Gill,M,95,44,878,922
Natasia,F,100,903,0,903
Mirac,M,100,0,13,13
Korrey,M,100,0,113,113
Tellys,M,100,0,7,7
Sheere,F,100,9,0,9
Irasema,F,100,949,0,949
Kandyn,M,100,0,7,7
Majestie,F,100,5,0,5
Nykia,F,100,967,0,967
Sheba,F,100,1095,0,1095
Lelani,F,100,588,0,588
Kenrick,M,100,0,1132,1132
Izzabell,F,100,115,0,115
Shiane,F,100,433,0,433
Khaleesy,F,100,5,0,5
Jernie,F,100,64,0,64
Alundra,F,100,23,0,23
Diona,F,100,1428,0,1428
Ricco,M,100,0,1328,1328
Taye,M,92,43,510,553
Sharonda,F,100,5839,0,5839
Heleena,F,100,66,0,66
Isidro,M,100,0,6070,6070
Jerhonda,F,100,10,0,10
Kaethe,F,100,20,0,20
Laina,F,100,2565,0,2565
Cesia,F,100,952,0,952
Jaida,F,100,7917,0,7917
Tala,F,100,1851,0,1851
Marthann,F,100,11,0,11
Jamayca,F,100,5,0,5
Khloe,F,100,29003,19,29022
Daygoro,M,100,0,5,5
Kolsten,M,100,0,11,11
Lio,M,100,0,88,88
Yohannes,M,100,0,211,211
Vickii,F,100,102,0,102
Satoya,F,100,118,0,118
Neetu,F,100,35,0,35
Willaim,M,100,0,1026,1026
Nagisa,F,100,6,0,6
Gaea,F,100,40,0,40
Fayez,M,100,0,138,138
Tyeshia,F,100,1092,0,1092
Regenal,M,100,0,6,6
Shamorrow,F,100,6,0,6
Olivea,F,100,502,0,502
Travaughn,M,100,0,158,158
Lexani,F,98,283,5,288
Atreus,M,100,0,11,11
Yachet,F,100,133,0,133
Heyab,F,100,20,0,20
Shaked,M,100,0,6,6
Sadan,F,100,11,0,11
Dimitar,M,100,0,27,27
Gennesys,F,100,20,0,20
Adryel,M,100,0,60,60
Ivymarie,F,100,5,0,5
Margarett,F,100,1195,0,1195
Sentoria,F,100,66,0,66
Zulmarie,F,100,5,0,5
Parson,M,100,0,24,24
Shawntavia,F,100,190,0,190
Tonyell,F,100,11,0,11
Vanisha,F,100,424,0,424
Shanae,F,100,3415,0,3415
Donzel,M,100,0,179,179
Pattrick,M,100,0,89,89
Aszure,F,100,5,0,5
Bibi,F,100,473,0,473
Pagan,F,100,40,0,40
Lilyah,F,100,30,0,30
Indio,M,100,0,86,86
Mylana,F,100,5,0,5
Kahliya,F,100,70,0,70
Consuelo,F,100,8067,5,8072
Jelise,F,100,5,0,5
Dakobe,M,100,0,5,5
Charlii,F,100,38,0,38
Shakeenah,F,100,10,0,10
Yannet,F,100,104,0,104
Obada,M,100,0,26,26
Jaedynn,F,89,131,16,147
Jyran,M,100,0,22,22
Darol,M,100,0,203,203
Georden,M,100,0,5,5
Chant,M,100,0,5,5
Arnitra,F,100,97,0,97
Teneille,F,100,50,0,50
Laylia,F,100,87,0,87
Makeitha,F,100,6,0,6
Nishma,F,100,16,0,16
Amazin,F,100,50,0,50
Raffie,M,100,0,5,5
Breyannah,F,100,14,0,14
Zaney,F,100,5,0,5
Sarkis,M,100,0,640,640
Shalayne,F,100,64,0,64
Itzayana,F,100,1371,0,1371
Jaterrius,M,100,0,76,76
Danyail,F,100,12,0,12
Prakriti,F,100,40,0,40
Eera,F,100,13,0,13
Arva,F,100,98,0,98
Rahniya,F,100,50,0,50
Cathyrn,F,100,50,0,50
Slayter,M,100,0,53,53
Kaleis,F,100,5,0,5
Shakyrah,F,100,53,0,53
Travonda,F,100,37,0,37
Flemming,M,100,0,11,11
Alyonna,F,100,28,0,28
Lanni,F,100,16,0,16
Rasul,M,100,0,306,306
Acer,M,100,0,30,30
Nasreen,F,100,279,0,279
Naylan,M,100,0,5,5
Chrstine,F,100,11,0,11
Shaneqwa,F,100,22,0,22
Illyanna,F,100,130,0,130
Leium,M,100,0,41,41
Mirka,F,100,523,0,523
Davontaye,M,100,0,6,6
Helios,M,100,0,92,92
Kyrah,F,100,1701,0,1701
Rayhana,F,100,78,0,78
Farha,F,100,108,0,108
Jdah,F,100,5,0,5
Nakota,M,60,98,147,245
Mahek,F,100,355,0,355
Rashem,M,100,0,11,11
Odarrius,M,100,0,6,6
Williamjoseph,M,100,0,19,19
Keidi,F,100,14,0,14
Janvier,F,56,15,12,27
Gali,F,100,72,0,72
Keali,F,100,65,0,65
Dorese,F,100,12,0,12
Leray,M,100,0,71,71
Donmonique,F,100,13,0,13
Ailie,F,100,195,0,195
Mike,M,100,443,141177,141620
Nyelle,F,100,207,0,207
Mhari,F,100,5,0,5
Ezechiel,M,100,0,101,101
Deijah,F,100,275,0,275
Iysiss,F,100,5,0,5
Labrea,F,100,201,0,201
Caison,M,100,0,356,356
Sadielynn,F,100,27,0,27
Detrell,M,100,0,94,94
Kadeja,F,100,268,0,268
Khalayah,F,100,6,0,6
Lanyiah,F,100,119,0,119
Bendetta,F,100,24,0,24
Sheilagh,F,100,56,0,56
Kederick,M,100,0,18,18
Melivn,M,100,0,7,7
Jaimy,F,93,381,29,410
Senon,M,100,0,46,46
Darikson,M,100,0,6,6
Coco,F,100,1006,0,1006
Dalian,M,100,0,16,16
Ilma,F,100,67,0,67
Johsua,M,100,0,266,266
Ranezmae,F,100,7,0,7
Kimeko,F,100,20,0,20
Bryston,M,100,0,772,772
Jaybin,M,100,0,5,5
Zemiyah,F,100,5,0,5
Avlynn,F,100,34,0,34
Chrisy,F,100,216,0,216
Zeldy,F,100,40,0,40
Oluwaseun,M,64,125,222,347
Brenna,F,100,27274,0,27274
Windell,M,99,11,1529,1540
Darieus,M,100,0,18,18
Leslyann,F,100,16,0,16
Amilynn,F,100,6,0,6
Zanib,F,100,50,0,50
Nish,M,100,0,20,20
Jasaiah,M,88,10,75,85
Alcindor,M,100,0,33,33
Jacoub,M,100,0,5,5
Daneisha,F,100,671,0,671
Ambi,F,100,23,0,23
Lecretia,F,100,62,0,62
Ncole,F,100,5,0,5
Jelecia,F,100,21,0,21
Fidencio,M,100,0,1524,1524
Jhostin,M,100,0,92,92
Margaretanne,F,100,5,0,5
Haisley,F,100,198,0,198
Afrim,M,100,0,10,10
Ahadu,M,100,0,26,26
Kamri,F,100,910,0,910
Qadriyyah,F,100,41,0,41
Latawnya,F,100,54,0,54
Jenesia,F,100,20,0,20
Mallak,F,100,31,0,31
Diandra,F,100,1916,0,1916
Printess,M,100,0,5,5
Iqbal,M,100,0,35,35
Dimitry,M,100,0,438,438
Launie,F,100,27,0,27
Savio,M,100,0,128,128
Bonham,M,100,0,44,44
Verline,F,100,218,0,218
Nakeisha,F,100,1403,0,1403
Riuka,F,100,5,0,5
Zyanya,F,100,331,0,331
Issis,F,100,159,0,159
Melisaa,F,100,27,0,27
Tiwanna,F,100,259,0,259
Remonica,F,100,36,0,36
Lofton,M,100,0,264,264
Vonya,F,100,84,0,84
Ritchie,M,100,5,3409,3414
Tyquane,M,100,0,19,19
Lebron,M,100,0,1224,1224
Dashanda,F,100,17,0,17
Wendolee,F,100,11,0,11
Josephanthony,M,100,0,67,67
Naquita,F,100,263,0,263
Oakland,M,93,14,174,188
Shawann,F,100,17,0,17
Amritpal,M,100,0,85,85
Jalend,M,100,0,10,10
Cerrisa,F,100,5,0,5
Do,M,100,0,5,5
Lelsie,F,100,22,0,22
Annesia,F,100,21,0,21
Diomar,M,100,0,34,34
Tyquarius,M,100,0,112,112
Tarmara,F,100,31,0,31
Jacalyn,F,100,4786,0,4786
Reili,M,55,5,6,11
Eirian,F,100,5,0,5
Cynthea,F,100,274,0,274
Nayele,F,100,13,0,13
Princewilliam,M,100,0,5,5
Edrin,M,100,0,23,23
Mazzy,F,100,565,0,565
Lauriana,F,100,92,0,92
Lazar,M,100,0,524,524
Dayman,M,100,0,10,10
Lakietha,F,100,36,0,36
Aleshea,F,100,44,0,44
Geran,M,100,0,77,77
Chyvonne,F,100,26,0,26
Nyzaiah,M,100,0,152,152
Italya,F,100,45,0,45
Kamarianna,F,100,10,0,10
Karlyn,F,100,1896,7,1903
Moad,M,100,0,17,17
Jadrian,M,90,50,465,515
Mhina,F,100,5,0,5
Thayla,F,100,5,0,5
Ichelle,F,100,79,0,79
Dodi,F,99,458,5,463
Dreyah,F,100,30,0,30
Hulan,M,100,0,7,7
Griffon,M,100,0,169,169
Hawah,F,100,5,0,5
Simmeon,M,100,0,12,12
Georgy,F,50,15,15,30
Ludean,F,100,11,0,11
Jadalyn,F,100,534,0,534
Lynk,M,100,0,27,27
Jevin,M,100,0,878,878
Vandrea,F,100,5,0,5
Bentlee,M,79,497,1845,2342
Taurie,F,100,33,0,33
Manan,M,100,0,224,224
Sachet,F,100,46,0,46
Rodrico,M,100,0,60,60
Huzaifah,M,100,0,27,27
Graeden,M,100,0,67,67
Kennadi,F,100,1392,0,1392
Bunita,F,100,20,0,20
Eleigha,F,100,5,0,5
Keegun,M,100,0,6,6
Denesha,F,100,906,0,906
Queena,F,100,522,0,522
Makiah,F,86,1833,310,2143
Marken,M,100,0,11,11
Josylin,F,100,5,0,5
Brettney,F,100,121,0,121
Concepcion,F,83,2441,515,2956
Bahati,F,100,16,0,16
Gypsie,F,100,10,0,10
Lamiek,M,100,0,5,5
Olurotimi,M,100,0,6,6
Sharetha,F,100,157,0,157
Muzna,F,100,5,0,5
Ewan,M,100,0,1879,1879
Quatravious,M,100,0,5,5
Mithila,F,100,5,0,5
Taeshon,M,100,0,54,54
Naveyah,F,100,165,0,165
Jamariana,F,100,29,0,29
Rashiem,M,100,0,45,45
Sala,F,100,192,0,192
Stepfon,M,100,0,158,158
Shatana,F,100,90,0,90
Madalyne,F,100,551,0,551
Dorie,F,100,1479,5,1484
Devyne,F,68,116,55,171
Tieg,M,100,0,15,15
Javarrie,M,100,0,5,5
Shayd,M,100,0,26,26
Dawnelle,F,100,506,0,506
Trilla,F,100,29,0,29
Daviyon,M,100,0,215,215
Stevierae,F,100,5,0,5
Lamea,F,100,5,0,5
Juwann,M,100,0,66,66
Saliah,F,100,72,0,72
Kiyla,F,100,230,0,230
Cessily,F,100,24,0,24
Driggs,M,100,0,6,6
Brynley,F,100,1387,0,1387
Shaquarius,F,100,5,0,5
Breelynn,F,100,241,0,241
Tember,F,100,21,0,21
Takierra,F,100,18,0,18
Keavon,M,100,0,77,77
Shaniya,F,100,5944,0,5944
Narjes,F,100,35,0,35
Briceston,M,100,0,5,5
Gwin,F,63,29,17,46
Roxanna,F,100,11018,7,11025
Zeeshan,M,100,0,450,450
Liesha,F,100,59,0,59
Sydna,F,100,51,0,51
Suejin,F,100,5,0,5
Kiswana,F,100,42,0,42
Williams,M,99,24,3183,3207
Kerrian,F,100,23,0,23
Felipedejesus,M,100,0,19,19
Michio,M,100,0,5,5
Josef,M,100,0,7668,7668
Lecole,F,100,5,0,5
Lavada,F,100,1078,0,1078
Joseangel,M,100,0,989,989
Danniel,M,92,186,2010,2196
Rachell,F,100,3512,0,3512
Kierstynn,F,100,107,0,107
Tatianya,F,100,32,0,32
Georgett,F,100,16,0,16
Gaal,F,100,17,0,17
Ruhee,F,100,38,0,38
Evaliz,F,100,7,0,7
Zyriah,F,100,321,0,321
Antionna,F,100,10,0,10
Shama,F,100,399,0,399
Coulter,M,100,0,551,551
Demiyah,F,100,289,0,289
Tyshell,F,100,70,0,70
Lexee,F,100,353,0,353
Anisette,F,100,5,0,5
Kiyami,F,100,5,0,5
Vaibhav,M,100,0,442,442
Sirita,F,100,27,0,27
Shundrika,F,100,19,0,19
Jahsim,M,100,0,17,17
Denetta,F,100,195,0,195
Deunte,M,100,0,125,125
Fama,F,100,18,0,18
Trenee,F,100,113,0,113
Seanmatthew,M,100,0,15,15
Chason,M,100,0,1025,1025
Jashauna,F,100,45,0,45
Hani,M,90,61,554,615
Nayzeth,F,100,137,0,137
Roopal,F,100,5,0,5
Keonie,F,100,5,0,5
Mahwish,F,100,12,0,12
Cama,F,100,5,0,5
Ylan,F,100,12,0,12
Laverna,F,100,668,0,668
Jennilyn,F,100,328,0,328
Caius,M,100,0,615,615
Tarralyn,F,100,5,0,5
Sadiee,F,100,19,0,19
Adria,F,100,5410,7,5417
Aaronae,F,100,5,0,5
Haydan,M,76,84,260,344
Vianna,F,100,1001,0,1001
Tayne,M,69,5,11,16
Travolta,M,100,0,11,11
Tamisha,F,100,2188,0,2188
Sion,M,88,61,430,491
Amilcar,M,100,0,751,751
Imtiaz,M,100,0,30,30
Manuelita,F,100,305,0,305
Yarelin,F,100,137,0,137
Adiv,M,100,0,20,20
Meca,F,100,45,0,45
Shakeba,F,100,6,0,6
Shelia,F,100,43132,111,43243
Audreyna,F,100,5,0,5
Shakuan,M,100,0,12,12
Claramae,F,100,10,0,10
Arooj,F,100,32,0,32
Jelaya,F,100,5,0,5
Tajuanna,F,100,63,0,63
Jeneice,F,100,47,0,47
Frederica,F,100,1234,0,1234
Alanta,F,100,82,0,82
Sepia,F,100,5,0,5
Demerion,M,100,0,10,10
Taliha,F,100,5,0,5
Ashaunti,F,100,360,0,360
Anamika,F,100,148,0,148
Jynesis,F,100,39,0,39
Korine,F,100,259,0,259
Giobani,M,100,0,5,5
Brit,M,81,145,605,750
Tahron,M,100,0,17,17
Colanda,F,100,5,0,5
Ainzley,F,100,16,0,16
Sabin,M,99,6,594,600
Cobyn,M,100,0,6,6
Taja,F,98,1824,28,1852
Jashawna,F,100,88,0,88
Dagney,F,100,5,0,5
Nyomee,F,100,5,0,5
Azion,M,86,21,125,146
Dorien,M,94,64,1060,1124
Makeila,F,100,209,0,209
Charnetta,F,100,184,0,184
Wray,M,95,17,305,322
Laurea,F,100,17,0,17
Lenay,F,100,181,0,181
Sthephanie,F,100,17,0,17
Jamespatrick,M,100,0,47,47
Granada,F,100,15,0,15
Breiden,M,100,0,15,15
Escarlet,F,100,86,0,86
Staphon,M,100,0,7,7
Jehilyn,F,100,6,0,6
Makkiyah,F,100,5,0,5
Jacub,M,100,0,178,178
Aythan,M,100,0,44,44
Graison,M,86,36,225,261
Shelee,F,100,25,0,25
Chastity,F,100,9572,0,9572
Orvie,M,100,0,11,11
Terranisha,F,100,16,0,16
Dianni,F,100,5,0,5
Davayah,F,100,17,0,17
Masynn,F,100,5,0,5
Aparajita,F,100,6,0,6
Dereyon,M,100,0,16,16
Daylyn,F,53,195,171,366
Jonathon,M,100,224,63334,63558
Booth,M,100,0,16,16
Cadem,M,100,0,6,6
Saith,M,100,0,31,31
Nicholaus,M,100,0,3166,3166
Mayetta,F,100,25,0,25
Beneva,F,100,5,0,5
Jakorian,M,100,0,90,90
Teralynn,F,100,16,0,16
Bugra,M,100,0,5,5
Tattianna,F,100,83,0,83
Nabeelah,F,100,7,0,7
Komeka,F,100,10,0,10
Cliffton,M,100,0,1630,1630
Asenat,F,100,6,0,6
Laytoya,F,100,142,0,142
Arhant,M,100,0,10,10
Aroush,F,100,101,0,101
Javarion,M,100,0,249,249
Ranardo,M,100,0,16,16
Shritan,M,100,0,29,29
Shelie,F,100,119,0,119
Salud,F,50,5,5,10
Trinadi,F,100,5,0,5
Chriselda,F,100,304,0,304
Notorious,M,100,0,51,51
Amileah,F,100,19,0,19
Connall,M,100,0,6,6
Maclyn,F,100,5,0,5
Caimen,M,100,0,36,36
Wynnette,F,100,35,0,35
Indi,F,97,181,6,187
Babbett,F,100,5,0,5
Azania,F,100,44,0,44
Indika,F,100,28,0,28
Cassanova,M,100,0,26,26
Anamar,F,100,5,0,5
Mechille,F,100,69,0,69
Lason,M,100,0,101,101
Anania,M,100,0,11,11
Nyeemah,F,100,76,0,76
Clevland,M,100,0,5,5
Christianson,M,100,0,5,5
Nicoll,F,100,56,0,56
Jahn,M,100,0,339,339
Aidaliz,F,100,20,0,20
Mavric,M,100,0,87,87
Kaidon,M,100,0,452,452
Chaunta,F,100,82,0,82
Manessa,F,100,70,0,70
Cordarrell,M,100,0,80,80
Lytzi,F,100,5,0,5
Tralana,F,100,18,0,18
Leysha,F,100,38,0,38
Kovan,M,100,0,5,5
Walisha,F,100,16,0,16
Joed,M,100,0,16,16
Karloz,M,100,0,16,16
Michaell,M,99,5,398,403
Avlyn,F,100,18,0,18
Baze,M,100,0,48,48
Zelpha,F,100,38,0,38
Cherhonda,F,100,8,0,8
Mercedee,F,100,21,0,21
Lennis,M,84,109,570,679
Shloima,M,100,0,56,56
Lyudmila,F,100,11,0,11
Donia,F,100,808,0,808
Waller,M,100,0,27,27
Laythan,M,100,0,156,156
Annick,F,100,168,0,168
Jeneka,F,100,13,0,13
Deago,M,100,0,92,92
Madisynn,F,100,284,0,284
Iroh,M,100,0,20,20
Brindley,F,100,54,0,54
Markea,F,100,79,0,79
Oneka,F,100,125,0,125
Allicia,F,100,689,0,689
Ashana,F,100,214,0,214
Astor,M,100,0,40,40
Yasheika,F,100,27,0,27
Jaxten,M,100,0,198,198
Stanisha,F,100,78,0,78
Ninotchka,F,100,11,0,11
Emet,M,100,0,102,102
Jonnesha,F,100,16,0,16
Adilia,F,100,20,0,20
Randiel,M,100,0,15,15
Lisah,F,100,5,0,5
Dominiqu,F,100,15,0,15
Haeley,F,100,392,0,392
Zanya,F,100,491,0,491
Kaylanna,F,100,37,0,37
Ayalah,F,100,7,0,7
Galileo,M,100,0,193,193
Romeka,F,100,77,0,77
Travonna,F,100,78,0,78
Malyka,F,100,38,0,38
Anet,F,100,95,0,95
Azianna,F,100,5,0,5
Aliena,F,100,231,0,231
Chelcea,F,100,67,0,67
Aariyanna,F,100,14,0,14
Rhionna,F,100,35,0,35
Dilen,M,100,0,35,35
Yaneri,F,100,35,0,35
Jamillette,F,100,13,0,13
Jeannete,F,100,37,0,37
Brysin,M,100,0,156,156
Benjimin,M,100,0,227,227
Jilissa,F,100,7,0,7
Althia,F,100,98,0,98
Yenifer,F,100,1042,0,1042
Zameer,M,100,0,129,129
Ilyne,F,100,6,0,6
Jahana,F,100,10,0,10
Milbert,M,100,0,33,33
Kayceon,M,100,0,54,54
Pranish,M,100,0,30,30
Ki,M,78,98,354,452
Gwenaelle,F,100,5,0,5
Zailey,F,100,412,0,412
Tyvell,M,100,0,39,39
Kyere,M,100,0,7,7
Mareta,F,100,20,0,20
Jayesh,M,100,0,67,67
Adena,F,100,1402,0,1402
Demy,F,100,20,0,20
Liyana,F,100,374,0,374
Dawane,M,100,0,20,20
Sivan,F,90,482,51,533
Kyrien,M,100,0,5,5
Tyrane,M,100,0,22,22
Chelley,F,100,18,0,18
Mariellen,F,100,702,0,702
Lynea,F,100,371,0,371
Hadlee,F,99,1645,10,1655
Alvarez,M,100,0,43,43
Buckner,M,100,0,5,5
Maxsen,M,100,0,19,19
Ryla,F,100,237,0,237
Zlata,F,100,140,0,140
Jadai,F,100,19,0,19
Dariella,F,100,40,0,40
Jannea,F,100,5,0,5
Jabaris,M,100,0,34,34
Yatzary,F,100,56,0,56
Baiya,F,100,13,0,13
Autumn,F,100,108197,264,108461
Aurian,F,100,11,0,11
Deshae,F,82,185,41,226
Kincade,M,100,0,166,166
Tamatoa,M,100,0,22,22
Elora,F,100,2750,0,2750
Eevie,F,100,14,0,14
Hayvn,F,100,25,0,25
Deaundre,M,100,0,902,902
Mirra,F,100,218,0,218
Nikholas,M,100,0,138,138
Tyberious,M,100,0,52,52
Vaila,F,100,5,0,5
Orquidia,F,100,44,0,44
Clem,M,100,0,860,860
Teaghan,F,93,717,53,770
Syniya,F,100,39,0,39
Lashunta,F,100,106,0,106
Tobechukwu,M,100,0,109,109
Tailar,F,100,20,0,20
Ellese,F,100,74,0,74
Joean,F,100,5,0,5
Philliph,M,100,0,21,21
Cyndel,F,100,155,0,155
Dareth,F,100,77,0,77
Marye,F,100,355,0,355
Autom,F,100,10,0,10
Sanari,F,100,85,0,85
Melessia,F,100,212,0,212
Brandson,M,100,0,6,6
Crossley,M,100,0,5,5
Island,F,97,186,6,192
Ashad,M,100,0,157,157
Davetta,F,100,488,0,488
Cortell,M,100,0,5,5
Maximina,F,100,34,0,34
Shir,F,100,169,0,169
Jnaiya,F,100,5,0,5
Tytiana,F,100,1327,0,1327
Pieper,F,100,142,0,142
Rhode,F,100,5,0,5
Axal,M,100,0,6,6
Averett,M,100,0,6,6
Vennessa,F,100,217,0,217
Nyna,F,100,137,0,137
Zeynep,F,100,537,0,537
Ardel,F,84,27,5,32
Jakevia,F,100,52,0,52
Kayshaun,M,100,0,90,90
Bryttni,F,100,57,0,57
Alair,F,100,10,0,10
Jemel,M,100,0,704,704
Kwanna,F,100,27,0,27
Benzino,M,100,0,8,8
Sheik,M,100,0,39,39
Elikai,M,100,0,5,5
Zyden,M,100,0,44,44
Nimrod,M,100,0,192,192
Jhoana,F,100,534,0,534
Pela,F,100,11,0,11
Khasir,M,100,0,51,51
Leodan,M,100,0,182,182
Tonika,F,100,853,0,853
Laban,M,100,0,381,381
Yatana,F,100,29,0,29
Shameya,F,100,21,0,21
Mariacecilia,F,100,6,0,6
Makenah,F,100,260,0,260
Jayslin,F,100,10,0,10
Amanti,M,64,29,52,81
Leandria,F,100,233,0,233
Shalva,F,100,55,0,55
Rethea,F,100,6,0,6
Vayda,F,100,774,0,774
Stanton,M,100,0,3600,3600
Concheta,F,100,5,0,5
Alejo,M,100,0,590,590
Kyrie,F,61,2838,1785,4623
Terriyah,F,100,83,0,83
Federica,F,100,173,0,173
Dovie,F,100,1154,0,1154
Everlina,F,100,38,0,38
Yassiel,M,100,0,11,11
Quetzally,F,100,41,0,41
Marlese,F,100,21,0,21
Amberli,F,100,84,0,84
Jaqwon,M,100,0,103,103
Tallia,F,100,145,0,145
Asharra,F,100,6,0,6
Shawndee,F,100,37,0,37
Ambrielle,F,100,523,0,523
Ehlijah,M,100,0,5,5
Abdual,M,100,0,17,17
Hovhannes,M,100,0,30,30
Leodegario,M,100,0,41,41
Trania,F,100,26,0,26
Raaziq,M,100,0,5,5
Steysi,F,100,5,0,5
Dawnie,F,100,25,0,25
Kelissa,F,100,74,0,74
Daviontae,M,100,0,36,36
Alexisia,F,100,15,0,15
Dane,M,99,359,28970,29329
Ceason,F,100,5,0,5
Kaegan,M,65,181,333,514
Eliceo,M,100,0,292,292
Marsena,F,100,57,0,57
Chamiya,F,100,54,0,54
Jenelee,F,100,5,0,5
Tyquavious,M,100,0,169,169
Amelyah,F,100,18,0,18
Mazin,M,100,0,499,499
Aslhey,F,100,6,0,6
Danyette,F,100,22,0,22
Jayviona,F,100,5,0,5
Raylinn,F,100,62,0,62
Cherysh,F,100,139,0,139
Hearold,M,100,0,5,5
Stav,F,52,21,19,40
Dalany,F,100,5,0,5
Kendalynn,F,100,208,0,208
Gicela,F,100,80,0,80
Vineel,M,100,0,5,5
Kejohn,M,100,0,5,5
Amorette,F,100,446,0,446
Diseree,F,100,10,0,10
Cassin,M,100,0,6,6
Phuoc,M,100,0,135,135
Jairy,F,100,61,0,61
Evalynn,F,100,1389,0,1389
Sharey,F,100,5,0,5
Callaghan,M,86,19,120,139
Razeen,M,100,0,26,26
Crosslyn,F,100,5,0,5
Ramyia,F,100,38,0,38
Lyzander,M,100,0,27,27
Jullianne,F,100,16,0,16
Jennavee,F,100,5,0,5
Tondia,F,100,11,0,11
Ashling,F,100,280,0,280
Charlemagne,M,73,6,16,22
Chaly,M,100,0,5,5
Meraya,F,100,10,0,10
Kulia,F,100,12,0,12
Drexton,M,100,0,8,8
Huntlee,M,54,11,13,24
Nanakwame,M,100,0,10,10
Sanii,F,100,187,0,187
Evanjelina,F,100,50,0,50
Makeo,M,100,0,6,6
Ashonte,F,100,108,0,108
Kellum,M,100,0,37,37
Quinzel,M,100,0,12,12
Niral,M,100,0,17,17
Curtavious,M,100,0,6,6
Brashaun,M,100,0,23,23
Lenton,M,100,0,237,237
Amoz,M,100,0,17,17
Vilene,F,100,6,0,6
Mayalyn,F,100,5,0,5
Holt,M,100,0,913,913
Kisty,F,100,25,0,25
Lain,M,94,20,336,356
Solangie,F,100,24,0,24
Moise,M,100,0,591,591
Onora,F,100,16,0,16
Quayshaun,M,100,0,150,150
Alcibiades,M,100,0,5,5
Kandria,F,100,10,0,10
Pany,F,100,5,0,5
Jekiah,F,100,7,0,7
Jovoni,M,94,5,72,77
Sophira,F,100,60,0,60
Mallika,F,100,326,0,326
Shauntea,F,100,48,0,48
Mikayela,F,100,86,0,86
Tymeisha,F,100,41,0,41
Jenalea,F,100,6,0,6
Diamonde,F,100,37,0,37
Quevin,M,100,0,21,21
Shantana,F,100,157,0,157
Yachira,F,100,5,0,5
Monikah,F,100,5,0,5
Oswald,M,100,0,1384,1384
Alisya,F,100,52,0,52
Sakayla,F,100,13,0,13
Treyanna,F,100,43,0,43
Catalena,F,100,73,0,73
Hermenegildo,M,100,0,54,54
Toronto,M,100,0,49,49
Noveline,F,100,6,0,6
Samiksha,F,100,122,0,122
Ramatou,F,100,8,0,8
Resheda,F,100,12,0,12
Shantez,M,62,29,48,77
Vesa,F,100,28,0,28
Venesta,F,100,12,0,12
Nafee,M,100,0,5,5
Deloy,M,100,0,56,56
Shanquetta,F,100,34,0,34
Yoaly,F,100,12,0,12
Caterina,F,100,2336,0,2336
Reemas,F,100,34,0,34
Mellissa,F,100,5600,0,5600
Azariah,F,62,3081,1921,5002
Jaeline,F,100,69,0,69
Lotus,F,96,901,36,937
Disa,F,100,275,0,275
Stayce,F,100,172,0,172
Vilija,F,100,5,0,5
Deville,M,100,0,16,16
Azharia,F,100,59,0,59
Fisnik,M,100,0,10,10
Mohsin,M,100,0,313,313
Kaybrie,F,100,33,0,33
Marcanthony,M,100,0,1299,1299
Teyvon,M,100,0,19,19
Nimmy,F,100,5,0,5
Deontre,M,100,0,726,726
Ishita,F,100,441,0,441
Ravis,M,100,0,54,54
Jasneet,F,100,39,0,39
Maurion,M,100,0,188,188
Jennier,F,100,247,0,247
Darielys,F,100,64,0,64
Jyelle,F,100,10,0,10
Schaeffer,M,100,0,18,18
Jahni,F,56,107,85,192
Amery,F,83,381,79,460
Kitza,F,100,5,0,5
Dejona,F,100,18,0,18
Kaery,F,100,5,0,5
Jeleesa,F,100,57,0,57
Jaydenn,M,86,42,257,299
Tchanavian,F,100,5,0,5
Cordelro,M,100,0,60,60
Shanesha,F,100,218,0,218
Orissa,F,100,56,0,56
Ruka,F,100,7,0,7
Sayuri,F,100,920,0,920
Shalom,M,66,759,1455,2214
Kyair,M,100,0,140,140
Quinton,M,100,42,25308,25350
Kevan,M,99,48,3323,3371
Daianna,F,100,91,0,91
Tonnesha,F,100,11,0,11
Dontia,F,73,36,13,49
Albertine,F,100,238,0,238
Terrion,M,92,111,1319,1430
Keemya,F,100,6,0,6
Aybri,F,100,7,0,7
Elianni,F,100,10,0,10
Beki,F,100,35,0,35
Anthnoy,M,100,0,6,6
Saviah,F,100,5,0,5
Ericdaniel,M,100,0,5,5
Peiton,F,100,18,0,18
Keedra,F,100,26,0,26
Cohl,M,100,0,200,200
Tura,F,100,68,0,68
Leslie,F,83,245017,49331,294348
Kareesha,F,100,5,0,5
Marisah,F,100,109,0,109
Dacian,M,100,0,220,220
Ezri,F,85,439,76,515
Izetta,F,100,278,0,278
Avanelle,F,100,29,0,29
Emogene,F,100,194,0,194
Kimmika,F,100,7,0,7
Rubisela,F,100,20,0,20
Trevina,F,100,27,0,27
Goretti,F,100,26,0,26
Hamnah,F,100,43,0,43
Kentarious,M,100,0,5,5
Terico,M,100,0,5,5
Mcguire,M,100,0,134,134
Doria,F,100,934,0,934
Jeronda,F,100,76,0,76
Matie,F,100,5,0,5
Jeylah,F,100,33,0,33
Asna,F,100,50,0,50
Jesslyn,F,100,1796,0,1796
Ilah,F,100,236,0,236
Otis,M,99,191,21238,21429
Keara,F,100,4585,0,4585
Jedadia,M,100,0,12,12
Tnia,F,100,61,0,61
Torraine,M,100,0,5,5
Nyele,F,100,5,0,5
Remiyah,F,100,18,0,18
Kamery,F,100,15,0,15
Charlana,F,100,27,0,27
Luul,F,100,18,0,18
Jamyrion,M,100,0,31,31
Giulian,M,100,0,107,107
Nickiya,F,100,16,0,16
Evony,F,100,455,0,455
Kaleema,F,100,46,0,46
Jannifer,F,100,799,0,799
Roderiquez,M,100,0,5,5
Airyanna,F,100,223,0,223
Theophilus,M,100,0,1213,1213
Nashley,F,100,222,0,222
Saia,F,100,78,0,78
Layra,F,100,17,0,17
Trone,M,100,0,19,19
Valynn,F,100,50,0,50
Rihanna,F,100,5007,5,5012
Tamecia,F,100,264,0,264
Cheston,M,100,0,758,758
Anzar,M,100,0,6,6
Shaleen,F,100,540,0,540
Galatea,F,100,11,0,11
Jaideep,M,100,0,66,66
Urijha,M,100,0,6,6
Antonay,F,100,10,0,10
Khalli,F,100,5,0,5
Trestin,M,100,0,178,178
Retag,F,100,5,0,5
Anamaris,F,100,41,0,41
Gwendalina,F,100,6,0,6
Ayzlyn,F,100,5,0,5
Sidni,F,100,231,0,231
Elik,M,100,0,6,6
Aislynne,F,100,36,0,36
Correne,F,100,180,0,180
Christia,F,90,714,82,796
Marysia,F,100,30,0,30
Zamil,M,100,0,6,6
Kein,M,100,0,79,79
Summerlee,F,100,13,0,13
Takayuki,M,100,0,49,49
Anjeanette,F,100,389,0,389
Lacasta,F,100,6,0,6
Norvin,M,100,0,283,283
Chestine,F,100,62,0,62
Brance,M,100,0,246,246
Graycelynn,F,100,9,0,9
Kushi,F,100,71,0,71
Barkim,M,100,0,7,7
Sodbileg,M,100,0,5,5
Carneisha,F,100,39,0,39
Maiko,F,72,71,28,99
Moneca,F,100,33,0,33
Leteshia,F,100,18,0,18
Jekobe,M,100,0,12,12
Dechaun,M,100,0,5,5
Nonna,F,100,49,0,49
Ako,M,100,0,22,22
Geneen,F,100,227,0,227
Serigne,M,100,0,133,133
Huascar,M,100,0,5,5
Rafal,M,100,0,194,194
Mahelet,F,100,26,0,26
Mattheau,M,100,0,21,21
Criztian,M,100,0,5,5
Graylynn,F,100,5,0,5
Fatimah,F,100,2516,0,2516
Anthory,M,100,0,5,5
Janelee,F,100,17,0,17
Jaylanie,F,100,268,0,268
Greig,M,100,0,320,320
Yaminah,F,100,402,0,402
Naomii,F,100,43,0,43
Santricia,F,100,10,0,10
Myzel,M,100,0,25,25
Saxon,M,91,107,1075,1182
Emilea,F,100,394,0,394
Debarh,F,100,5,0,5
Elmore,M,100,0,800,800
Alyzza,F,100,227,0,227
Shannen,F,93,1910,150,2060
Onasis,M,100,0,12,12
Alizayah,F,100,24,0,24
Zantavious,M,100,0,8,8
Laderrica,F,100,13,0,13
Lisvette,F,100,5,0,5
Rosanny,F,100,12,0,12
Socheat,M,100,0,7,7
Kathrina,F,100,777,0,777
Mariabella,F,100,64,0,64
Jsai,M,100,0,5,5
Babita,F,100,11,0,11
Shushan,F,100,5,0,5
Tuongvi,F,100,35,0,35
Asata,F,100,32,0,32
Dennise,F,97,3191,83,3274
Rauf,M,100,0,5,5
Desirea,F,100,1853,0,1853
Champaigne,F,100,44,0,44
Nakeeta,F,100,99,0,99
Ibrahim,M,100,0,9208,9208
Shanndolyn,F,100,11,0,11
Zikeyah,F,100,5,0,5
Wykisha,F,100,18,0,18
Chandace,F,100,5,0,5
Jonn,M,100,0,482,482
Lillybelle,F,100,12,0,12
Jaloni,M,70,60,137,197
Nairah,F,100,24,0,24
Abdull,M,100,0,5,5
Adellynn,F,100,6,0,6
Iyleen,F,100,6,0,6
Makieya,F,100,16,0,16
Santee,M,100,0,57,57
Siddhesh,M,100,0,5,5
Johann,M,94,240,3677,3917
Leticha,F,100,30,0,30
Shayera,F,100,30,0,30
Tyah,F,100,84,0,84
Cherrilynn,F,100,5,0,5
Zoraya,F,100,357,0,357
Anthani,M,100,0,5,5
Wyoma,F,100,10,0,10
Jocinda,F,100,10,0,10
Breighanna,F,100,37,0,37
Akhi,M,100,0,5,5
Trayvis,M,100,0,10,10
Alpha,M,59,813,1187,2000
Alexius,F,93,1492,112,1604
Jalpa,F,100,5,0,5
Jeweline,F,100,24,0,24
Lennell,M,95,5,106,111
Kylem,M,100,0,5,5
Kaileo,M,100,0,5,5
Tuleen,F,100,91,0,91
Thedy,F,100,10,0,10
Samentha,F,100,62,0,62
Tyneeka,F,100,5,0,5
Teriana,F,100,227,0,227
Galina,F,100,272,0,272
Alfie,M,87,76,492,568
Briannia,F,100,69,0,69
Bexton,M,100,0,17,17
Danyella,F,100,361,0,361
Bernardette,F,100,192,0,192
Britney,F,100,33992,83,34075
Nahiomy,F,100,6,0,6
Dharshini,F,100,5,0,5
Arvetta,F,100,59,0,59
Marlaysia,F,100,100,0,100
Chendra,F,100,9,0,9
Juante,M,100,0,5,5
Zaylynn,F,87,103,16,119
Ogle,M,100,0,5,5
Bhavya,F,80,260,66,326
Gig,M,100,0,17,17
Dayanira,F,100,213,0,213
Laurance,M,99,5,883,888
Dalery,F,100,6,0,6
Veneda,F,100,39,0,39
Kharis,F,97,145,5,150
Stanna,F,100,22,0,22
Tralynn,F,100,10,0,10
Tavarris,M,100,0,16,16
Adileny,F,100,39,0,39
Kaithlynn,F,100,5,0,5
Elyanna,F,100,401,0,401
Lakesia,F,100,559,0,559
Khyri,M,97,7,201,208
Isen,M,100,0,23,23
Semere,M,100,0,5,5
Usef,M,100,0,5,5
Sarajo,F,100,40,0,40
Camella,F,100,691,0,691
Andrez,M,100,0,936,936
Isabellia,F,100,10,0,10
Terance,M,100,0,2667,2667
Garrin,M,100,0,405,405
Emerson,F,51,13225,12557,25782
Arisa,F,100,613,0,613
Baran,M,83,25,118,143
Etoy,F,100,14,0,14
Lisaann,F,100,582,0,582
Natesa,F,100,7,0,7
Alberth,M,100,0,52,52
Vedad,M,100,0,45,45
Marguis,M,100,0,153,153
Lavae,F,100,16,0,16
Fawne,F,100,71,0,71
Garrette,M,100,0,364,364
Dionicia,F,100,210,0,210
Rishan,M,100,0,166,166
Racey,F,100,5,0,5
Kowan,M,100,0,7,7
Adiam,F,100,18,0,18
Yaremi,F,100,157,0,157
Nichole,F,100,62916,184,63100
Fayne,F,58,15,11,26
Yosgard,M,100,0,5,5
Milessa,F,100,94,0,94
Emmelynn,F,100,23,0,23
Ginnifer,F,100,75,0,75
Addrienne,F,100,15,0,15
Nakul,M,100,0,170,170
Persaeus,F,100,42,0,42
Dyondre,M,100,0,5,5
Tyranika,F,100,5,0,5
Josealberto,M,100,0,154,154
Shammie,F,100,5,0,5
Neyba,F,100,8,0,8
Yocelyn,F,100,798,0,798
Derric,M,100,0,1401,1401
Kushana,F,100,23,0,23
Enis,M,100,0,175,175
Austynn,F,100,177,0,177
Savhannah,F,100,5,0,5
Sophianna,F,100,38,0,38
Kenita,F,100,354,0,354
Sarenna,F,100,46,0,46
Damontay,M,100,0,146,146
Padon,M,100,0,5,5
Dionisio,M,100,0,843,843
Canen,M,100,0,5,5
Lilliauna,F,100,93,0,93
Tamyko,F,100,12,0,12
Dulio,M,100,0,5,5
Obey,M,100,0,5,5
Marilee,F,100,4235,0,4235
Xiani,F,100,11,0,11
Maudie,F,100,806,0,806
Azra,F,98,648,12,660
Ilayna,F,100,25,0,25
Jerrilee,F,100,28,0,28
Zykera,F,100,77,0,77
Amistad,M,100,0,5,5
Brya,F,98,284,6,290
Deashawn,M,100,0,31,31
Tervell,M,100,0,5,5
Zaydin,M,100,0,285,285
Tuvia,M,100,0,142,142
Antavius,M,100,0,222,222
Raishaun,M,100,0,22,22
Journeii,F,100,6,0,6
Haeun,F,100,37,0,37
Agnese,F,100,5,0,5
Veyda,F,100,133,0,133
Taten,M,100,0,432,432
Elanna,F,100,406,0,406
Lititia,F,100,97,0,97
Aayat,F,100,40,0,40
Lorence,M,100,0,250,250
Henock,M,100,0,23,23
Arihaan,M,100,0,36,36
Neeru,F,100,5,0,5
Inta,F,100,18,0,18
Layle,F,100,17,0,17
Carmala,F,100,6,0,6
Keyandra,F,100,205,0,205
Lashaina,F,100,18,0,18
Jamesyn,F,60,52,34,86
Levorn,M,89,9,73,82
Vondrell,M,100,0,5,5
Jailey,F,100,211,0,211
Tanga,F,100,404,0,404
Brigido,M,100,0,192,192
Quadarious,M,100,0,19,19
Efrat,F,100,52,0,52
Jayma,F,100,364,0,364
Amazyn,F,100,29,0,29
Maila,F,100,333,0,333
Ruah,F,100,16,0,16
Tanejah,F,100,8,0,8
Mikaeli,F,100,5,0,5
Richmond,M,100,0,2032,2032
Sabirin,F,100,73,0,73
Tynesha,F,100,1317,0,1317
Nolita,F,100,90,0,90
Rosamond,F,100,356,0,356
Dewane,M,100,0,266,266
Oluwajomiloju,F,100,15,0,15
Milferd,M,100,0,5,5
Kadarius,M,100,0,924,924
Kentrail,M,100,0,162,162
Kaptain,M,100,0,12,12
Cobin,M,100,0,175,175
Danniela,F,100,135,0,135
Malvin,M,100,0,945,945
Shaliek,M,100,0,16,16
Damire,M,100,0,50,50
Trupti,F,100,7,0,7
Skylia,F,100,23,0,23
Perley,M,100,0,76,76
Avaeh,F,100,45,0,45
Tzippora,F,100,36,0,36
Jimmeka,F,100,5,0,5
Captain,M,100,0,143,143
Draco,M,100,0,398,398
Mawa,F,100,14,0,14
Rashita,F,100,33,0,33
Cidni,F,100,5,0,5
Keatyn,F,66,142,73,215
Demitre,M,100,0,51,51
Eyan,M,100,0,1062,1062
Ravya,F,100,5,0,5
Marel,F,100,5,0,5
Tyjir,M,100,0,5,5
Jacobi,M,91,278,2969,3247
Poojan,M,100,0,5,5
Janai,F,97,2492,83,2575
Vicktor,M,100,0,32,32
Alejandr,M,100,0,8,8
Karoll,F,100,5,0,5
Shakella,F,100,7,0,7
Ednita,F,100,31,0,31
Athene,F,100,45,0,45
Dawnta,F,100,5,0,5
Lily,F,100,110186,122,110308
Elex,M,100,0,249,249
Kasa,F,100,5,0,5
Triana,F,100,907,0,907
Aleighanna,F,100,5,0,5
Marzette,F,100,10,0,10
Sravya,F,100,218,0,218
Jayrin,M,100,0,5,5
Ramia,F,100,182,0,182
Gustavo,M,100,104,34009,34113
Kelly,F,86,468329,74432,542761
Izavella,F,100,10,0,10
Conlan,M,100,0,716,716
Dezera,F,100,34,0,34
Sj,M,100,0,11,11
Fisher,M,99,17,3257,3274
Tylone,M,100,0,5,5
Ariahna,F,100,319,0,319
Truston,M,100,0,41,41
Nyashia,F,100,251,0,251
Rozlyn,F,100,912,0,912
Lann,M,100,0,15,15
Javarous,M,100,0,39,39
Nydirah,F,100,11,0,11
Kanea,F,100,6,0,6
Brayland,M,100,0,36,36
Alahnna,F,100,15,0,15
Mr,M,100,0,5,5
Leelen,M,100,0,36,36
Jayceonna,F,100,14,0,14
Merrel,M,100,0,10,10
Ardeth,F,100,71,0,71
Beauden,M,100,0,66,66
Quintarus,M,100,0,15,15
Donna,F,100,553971,1383,555354
Kennydi,F,100,5,0,5
Temesha,F,100,131,0,131
Shayli,F,100,316,0,316
Thistle,F,100,5,0,5
Akhila,F,100,200,0,200
Zahidah,F,100,5,0,5
Benita,F,100,10097,0,10097
Bavan,F,100,5,0,5
Denford,M,100,0,5,5
Richell,F,100,166,0,166
Miaya,F,100,318,0,318
Chibuzo,M,100,0,16,16
Eivin,M,100,0,75,75
Dolene,F,100,5,0,5
Rajean,F,100,63,0,63
Reinaldo,M,100,0,3551,3551
Richele,F,100,751,0,751
Layota,F,100,16,0,16
Leum,M,100,0,31,31
Haleia,F,100,5,0,5
Oumie,F,100,8,0,8
Karthik,M,100,0,1130,1130
Marisol,F,99,31502,315,31817
Addix,M,100,0,5,5
Virjinia,F,100,21,0,21
Jazlee,F,100,28,0,28
Rancel,M,100,0,8,8
Josalyn,F,100,1835,0,1835
Shauntele,F,100,5,0,5
Nay,M,67,11,22,33
Lazareth,M,100,0,5,5
Cristel,F,100,633,0,633
Gradey,M,100,0,23,23
Paizlie,F,100,38,0,38
Jareese,M,100,0,33,33
Jatziri,F,100,239,0,239
Apache,M,62,10,16,26
Delanea,F,100,5,0,5
Jonahs,M,100,0,25,25
Mile,M,100,0,10,10
Damek,M,100,0,62,62
Keyvonna,F,100,15,0,15
Deneem,F,100,5,0,5
Amada,F,100,1375,0,1375
Katarra,F,100,10,0,10
Rorick,M,100,0,11,11
Haniel,M,97,5,173,178
Kairie,F,100,46,0,46
Khrystal,F,100,351,0,351
Aunya,F,100,110,0,110
Ely,M,90,346,3113,3459
Rhealyn,F,100,45,0,45
Kirbee,F,100,5,0,5
Tanushka,F,100,5,0,5
Herberth,M,100,0,158,158
Minesh,M,100,0,12,12
Charlon,F,100,20,0,20
Jerline,F,100,223,0,223
Kipten,M,100,0,25,25
Emmoni,F,100,10,0,10
Vergie,F,100,411,0,411
Alo,M,100,0,8,8
Marque,M,87,140,977,1117
Kellie,F,100,50349,251,50600
Murrell,M,100,0,228,228
Warrene,F,100,12,0,12
Gwendell,F,100,34,0,34
Zachrey,M,100,0,219,219
Sharada,F,100,56,0,56
Shondala,F,100,12,0,12
Challen,M,93,5,71,76
Kalianna,F,100,219,0,219
Takylia,F,100,5,0,5
Angie,F,100,51242,126,51368
Keiora,F,100,10,0,10
Anjan,M,100,0,24,24
Sathya,M,85,6,35,41
Genisis,F,100,604,0,604
Laterika,F,100,36,0,36
Daniesha,F,100,232,0,232
Rhoen,M,100,0,11,11
Franziska,F,100,174,0,174
Lanece,F,100,5,0,5
Mariolita,F,100,5,0,5
Lindsee,F,100,257,0,257
Saimon,M,100,0,27,27
Sareya,F,100,38,0,38
Requan,M,100,0,69,69
Ayub,M,100,0,810,810
Kaleef,M,100,0,26,26
Seyed,M,100,0,122,122
Junita,F,100,501,0,501
Stephaney,F,100,422,0,422
Sionna,F,100,45,0,45
Azaia,F,100,20,0,20
Tydarius,M,100,0,261,261
Keller,M,89,276,2326,2602
Arvie,M,100,0,79,79
Shadarian,M,100,0,5,5
Rayjohn,M,100,0,19,19
Nausheen,F,100,17,0,17
Yosgarth,M,100,0,8,8
Tyrita,F,100,10,0,10
Porschea,F,100,139,0,139
Jaqueal,M,100,0,6,6
Nellie,F,100,12876,0,12876
Leniya,F,100,122,0,122
Yolando,F,99,418,5,423
Dilson,M,100,0,15,15
Adely,F,100,97,0,97
Nelani,F,100,37,0,37
Taime,F,100,11,0,11
Loretta,F,100,67285,173,67458
Ismary,F,100,15,0,15
Raeghan,F,100,281,0,281
Nansi,F,100,156,0,156
Uchechukwu,M,82,24,110,134
Eswin,M,100,0,68,68
Chenxi,F,100,5,0,5
Aribah,F,100,23,0,23
Rashima,F,100,44,0,44
Abigahil,F,100,42,0,42
Roanan,M,100,0,6,6
Cheyton,M,100,0,25,25
Layonna,F,100,130,0,130
Madicella,F,100,5,0,5
Clevie,M,100,0,15,15
Detavion,M,100,0,35,35
Lasya,F,100,230,0,230
Autianna,F,100,8,0,8
Amos,M,100,22,14101,14123
Jerricho,M,100,0,32,32
Shuntavia,F,100,61,0,61
Tashunda,F,100,58,0,58
Charletha,F,100,60,0,60
Christoher,M,100,0,1089,1089
Rahmad,M,100,0,6,6
Jvian,M,100,0,11,11
Dalayjah,F,100,5,0,5
Cleothis,M,100,0,5,5
Dionisia,F,100,169,0,169
Corben,M,100,0,1259,1259
Laderious,M,100,0,12,12
Geet,F,100,40,0,40
Jocylin,F,100,17,0,17
Fatoumata,F,100,1561,0,1561
Jaemon,M,100,0,22,22
Ryan,M,98,20771,899498,920269
Laurene,F,100,2243,0,2243
Daira,F,100,992,0,992
Brytanni,F,100,10,0,10
Emmilee,F,100,146,0,146
Tajea,F,100,16,0,16
Temuujin,M,100,0,5,5
Karla,F,100,82803,309,83112
Kyomi,F,100,29,0,29
Sheniqua,F,100,703,0,703
Godwin,M,100,0,399,399
Jaimi,F,100,1142,0,1142
Hershell,M,100,0,554,554
Iwan,M,100,0,5,5
Coralee,F,100,1042,0,1042
Kristofer,M,100,0,9342,9342
Mckaylyn,F,100,24,0,24
Maribel,F,99,23025,185,23210
Dewi,F,100,5,0,5
Aamiyah,F,100,302,0,302
Arawyn,F,100,20,0,20
Rakeshia,F,100,53,0,53
Neeah,F,100,6,0,6
Tanira,F,100,24,0,24
Meccah,F,100,6,0,6
Janlyn,F,100,15,0,15
Tashiya,F,100,99,0,99
Dezzarae,F,100,5,0,5
Chatham,M,75,27,81,108
Zackerie,M,100,0,71,71
Mickal,M,100,0,72,72
Lanyla,F,100,55,0,55
Takiah,F,100,107,0,107
Kanaya,F,100,170,0,170
Kheira,F,100,5,0,5
Brenly,F,100,75,0,75
Roddie,M,100,0,196,196
Davontea,M,100,0,5,5
Raemon,M,100,0,31,31
Yamila,F,100,599,0,599
Delsia,F,100,11,0,11
Musse,M,100,0,5,5
Josea,M,100,0,7,7
Oswyn,F,100,6,0,6
Nyomi,F,100,1385,0,1385
Darriell,F,83,54,11,65
Maahira,F,100,5,0,5
Alexxander,M,100,0,188,188
Amirr,M,100,0,49,49
Embra,F,100,6,0,6
Montaz,M,100,0,16,16
Stashia,F,100,76,0,76
Eichael,M,100,0,6,6
Kesia,F,100,661,0,661
Romain,M,100,0,301,301
Karensa,F,100,26,0,26
Shakiela,F,100,22,0,22
Marisella,F,100,454,0,454
Marlesa,F,100,11,0,11
Nevelyn,F,100,38,0,38
Filipa,F,100,5,0,5
Emmary,F,100,153,0,153
Levia,F,100,79,0,79
Penn,M,100,0,491,491
Daleesa,F,100,9,0,9
Valen,M,63,301,509,810
Marliese,F,100,25,0,25
Caylinn,F,100,7,0,7
Jasly,F,100,38,0,38
Rebecaa,F,100,6,0,6
Keliyah,F,100,162,0,162
Vicci,F,100,253,0,253
Lyne,F,97,166,5,171
Zamian,M,100,0,10,10
Nateka,F,100,6,0,6
Kyniah,F,100,30,0,30
Akemy,F,100,10,0,10
Tamkio,F,100,12,0,12
Jasmen,F,98,600,11,611
Bridgit,F,100,1253,0,1253
Aubrielle,F,100,1784,0,1784
Alister,M,100,0,535,535
Houston,M,97,261,8712,8973
Terrence,M,99,482,60019,60501
Dorotha,F,100,255,0,255
Josael,M,100,0,5,5
Davidanthony,M,100,0,58,58
Sameeksha,F,100,11,0,11
Marquize,M,100,0,149,149
Devren,M,100,0,22,22
Adaleah,F,100,49,0,49
Aneesha,F,100,572,0,572
Veeda,F,100,22,0,22
Lonnette,F,100,185,0,185
Ambrosia,F,100,1502,0,1502
Evening,F,100,16,0,16
Fitzroy,M,100,0,163,163
Allura,F,100,560,0,560
Navy,F,84,451,86,537
Benedicte,F,100,5,0,5
Omead,M,100,0,10,10
Dolli,F,100,5,0,5
Mayonna,F,100,9,0,9
Kailiana,F,100,35,0,35
Tovia,M,80,41,167,208
Shakilya,F,100,52,0,52
Tatianah,F,100,41,0,41
Vidhur,M,100,0,15,15
Levoy,M,100,0,7,7
Dearius,M,100,0,353,353
Gianessa,F,100,5,0,5
Aislin,F,100,894,0,894
Rogar,M,100,0,5,5
Raynne,F,100,5,0,5
Laureli,F,100,34,0,34
Aleeyah,F,100,1014,0,1014
Jakov,M,100,0,11,11
Shanele,F,100,73,0,73
Ujjwal,M,100,0,5,5
Channing,M,63,3019,5145,8164
Labrina,F,100,111,0,111
Frankye,F,85,34,6,40
Diasha,F,100,78,0,78
Areon,M,65,45,82,127
Tahtianna,F,100,10,0,10
Deitra,F,100,936,0,936
Fidelia,F,100,220,0,220
Jakeal,M,100,0,5,5
Anell,F,100,47,0,47
Ruqayyah,F,100,292,0,292
Zaryn,F,56,28,22,50
Tamerra,F,100,138,0,138
Leiahna,F,100,5,0,5
Brisayda,F,100,19,0,19
Meriya,F,100,6,0,6
Calsey,F,100,12,0,12
Yasari,F,100,13,0,13
Arora,F,100,154,0,154
Qualisha,F,100,6,0,6
Rishith,M,100,0,70,70
Devonie,F,100,24,0,24
Avonda,F,100,94,0,94
Badal,M,100,0,7,7
Sophina,F,100,187,0,187
Corretta,F,100,125,0,125
Dnesha,F,100,5,0,5
Elena,F,100,55974,86,56060
Elliann,F,100,7,0,7
Gysel,F,100,12,0,12
Muktar,M,100,0,23,23
Zahmier,M,100,0,6,6
Talisha,F,100,2862,0,2862
Avrie,F,99,774,10,784
Vernay,F,100,5,0,5
Arohan,M,100,0,7,7
Gabreal,M,78,41,143,184
Emeterio,M,100,0,231,231
Lawaia,M,100,0,5,5
Jodee,F,99,3001,33,3034
Ulana,F,100,18,0,18
Amylynn,F,100,223,0,223
Cerdic,M,100,0,5,5
Rynesha,F,100,44,0,44
Daundre,M,100,0,141,141
Deiontae,M,100,0,103,103
Taron,M,96,90,2277,2367
Ellody,F,100,15,0,15
Delmonte,M,100,0,59,59
Reider,M,100,0,11,11
Kairan,M,100,0,17,17
Monserat,F,100,374,0,374
Saveria,F,100,5,0,5
Declin,M,100,0,49,49
Jahshua,M,100,0,102,102
Maiesha,F,100,34,0,34
Taneasha,F,100,88,0,88
Rivka,F,100,5985,0,5985
Baby,M,53,5219,5829,11048
Mysti,F,100,706,0,706
Chelci,F,100,236,0,236
Daritza,F,100,142,0,142
Myke,M,100,0,21,21
Caleya,F,100,23,0,23
Shynequa,F,100,6,0,6
Jettie,F,96,498,22,520
Duice,F,100,5,0,5
Krush,M,100,0,5,5
Iresha,F,100,53,0,53
Ahlyssa,F,100,37,0,37
Latosca,F,100,13,0,13
Lalith,M,100,0,5,5
Lorrenzo,M,100,0,5,5
Konye,M,100,0,21,21
Samani,F,100,90,0,90
Neve,F,100,964,0,964
Jerrilyn,F,100,806,0,806
Rushton,M,100,0,87,87
Taydem,F,81,100,24,124
Shryl,F,100,54,0,54
Parvina,F,100,5,0,5
Ishika,F,100,555,0,555
Jaeliyah,F,100,6,0,6
Donnay,F,100,6,0,6
Kaylon,M,63,635,1071,1706
Triscia,F,100,19,0,19
Rindi,F,100,92,0,92
Aliccia,F,100,5,0,5
Nysire,M,100,0,6,6
Kelilah,F,100,64,0,64
Kamyra,F,100,578,0,578
Meily,F,100,105,0,105
Klhoe,F,100,34,0,34
Darrelyn,F,100,91,0,91
Khaleyah,F,100,11,0,11
Ghassan,M,100,0,251,251
Morton,M,100,0,1006,1006
Chakayla,F,100,58,0,58
Shadiamond,F,100,373,0,373
Johntel,M,100,0,6,6
Helon,F,100,26,0,26
Endrit,M,100,0,65,65
Eshal,F,100,560,0,560
Antianna,F,100,5,0,5
Quadasia,F,100,84,0,84
Temilade,F,100,7,0,7
Terraine,F,50,5,5,10
Burns,M,100,0,104,104
Fenn,M,100,0,17,17
Jezabel,F,100,461,0,461
Kawonna,F,100,10,0,10
Maurica,F,100,388,0,388
Salif,M,100,0,52,52
Samiira,F,100,6,0,6
Halayah,F,100,29,0,29
Dillen,M,92,55,644,699
Jasiah,M,89,456,3554,4010
Jayleene,F,100,157,0,157
Laree,F,100,898,0,898
Malique,M,99,11,1681,1692
Dawnette,F,100,656,0,656
Nauman,M,100,0,22,22
Tejuan,M,100,0,68,68
Kameika,F,100,16,0,16
Chiyoka,F,100,5,0,5
Milla,F,100,1503,0,1503
Tolisha,F,100,12,0,12
Edmonia,F,100,43,0,43
Kolton,M,100,0,10196,10196
Shalonte,F,100,5,0,5
Armstead,M,100,0,86,86
Jineane,F,100,17,0,17
Hawi,F,100,26,0,26
Chasteline,F,100,11,0,11
Curly,M,100,0,67,67
Kapria,F,100,34,0,34
Shakeita,F,100,118,0,118
Yandel,M,100,9,3030,3039
Ahonesti,F,100,18,0,18
Jacinth,F,52,12,11,23
Taeisha,F,100,25,0,25
Frandy,M,100,0,123,123
Manaya,F,100,26,0,26
Zachaeus,M,100,0,7,7
Erin,F,97,308547,8978,317525
Zykee,M,100,0,72,72
Nevara,F,100,5,0,5
Hadarah,F,100,7,0,7
Manaia,F,93,138,11,149
Adeley,F,100,14,0,14
Shaniah,F,100,1757,0,1757
Gohar,F,100,27,0,27
Marina,F,100,32016,51,32067
Anissah,F,100,29,0,29
Efrata,F,100,58,0,58
Allizon,F,100,185,0,185
Edroy,M,100,0,5,5
Bry,M,100,0,31,31
Cherol,F,100,17,0,17
Bryony,F,100,192,0,192
Kaimalu,M,100,0,5,5
Allanah,F,100,746,0,746
Seyla,F,100,42,0,42
Anjalie,F,100,39,0,39
Saul,M,100,74,30964,31038
Ohad,M,100,0,10,10
Pietrina,F,100,33,0,33
Aderyn,F,100,34,0,34
Demetrus,M,97,22,633,655
Yaisa,F,100,60,0,60
Severn,M,100,0,61,61
Zackeria,M,100,0,6,6
Sarahjo,F,100,27,0,27
Leavy,M,100,0,33,33
Destinny,F,100,30,0,30
Raeesah,F,100,28,0,28
Kalaiah,F,100,17,0,17
Kaziah,F,96,300,11,311
Oluremi,F,100,5,0,5
Destan,M,100,0,71,71
Pason,M,100,0,28,28
Derrius,M,100,0,774,774
Wedad,F,100,5,0,5
Rylen,M,83,356,1705,2061
Jahzier,M,100,0,70,70
Yaakov,M,100,0,3759,3759
Standley,M,100,0,247,247
Loreena,F,100,118,0,118
Basir,M,100,0,127,127
Janais,F,100,13,0,13
Teleah,F,100,121,0,121
Zulay,F,100,315,0,315
Maximilian,M,100,0,12336,12336
Jaylinne,F,100,38,0,38
Feyza,F,100,12,0,12
Keisey,F,100,10,0,10
Charquita,F,100,33,0,33
Ozziel,M,100,0,23,23
Leitha,F,100,222,0,222
Rowene,F,100,5,0,5
Anvi,F,100,535,0,535
Malta,F,100,11,0,11
Almarion,M,100,0,13,13
Isack,M,100,0,159,159
Tanay,M,54,317,374,691
Dejahne,F,100,6,0,6
Dylanjacob,M,100,0,5,5
Batu,M,100,0,59,59
Manshi,F,100,5,0,5
Theodia,M,100,0,5,5
Sirah,F,100,21,0,21
Ravae,F,100,33,0,33
Carmelito,M,100,0,5,5
Rury,M,100,0,47,47
Demaje,M,100,0,16,16
Kabella,F,100,90,0,90
Donetta,F,100,1509,0,1509
Treneisha,F,100,5,0,5
Dhamani,M,100,0,5,5
Thelonius,M,100,0,21,21
Eleni,F,100,4847,0,4847
Emiterio,M,100,0,5,5
Ziah,F,78,411,118,529
Case,M,100,0,4910,4910
Naihla,F,100,17,0,17
Nateesha,F,100,15,0,15
Jamaia,F,100,69,0,69
Sadika,F,100,6,0,6
Daryanna,F,100,22,0,22
Kosten,M,100,0,5,5
Molique,M,100,0,6,6
Hamp,M,100,0,182,182
Rashonna,F,100,43,0,43
Lucette,F,100,206,0,206
Sophieann,F,100,21,0,21
Gittel,F,100,911,0,911
Berta,F,100,2258,0,2258
Tempesst,F,100,5,0,5
Rhiannon,F,100,13525,5,13530
Cylie,F,100,374,0,374
Levarn,F,100,6,0,6
Sharieka,F,100,44,0,44
Tamberly,F,100,230,0,230
Jalasia,F,100,147,0,147
Reilynn,F,100,94,0,94
Quanice,F,100,5,0,5
Jabreia,F,100,31,0,31
Somtochukwu,M,78,20,70,90
Anazia,F,100,17,0,17
Purcell,M,100,0,202,202
Dearion,M,92,6,74,80
Jaquawn,M,100,0,159,159
Nyshaun,M,100,0,79,79
Zakeria,F,98,203,5,208
Vaugh,M,100,0,12,12
Sumitra,F,100,11,0,11
Nasheed,M,100,0,60,60
Kailer,M,94,21,355,376
Durwin,M,100,0,585,585
Markeesha,F,100,80,0,80
Natileigh,F,100,5,0,5
Kiaralee,F,100,16,0,16
Nadera,F,100,20,0,20
Karamia,F,100,16,0,16
Jeanee,F,100,163,0,163
Loman,M,100,0,36,36
Adisson,F,94,81,5,86
Nic,M,100,0,72,72
Lacorsha,F,100,7,0,7
Brierre,F,100,5,0,5
Macdonald,M,100,0,95,95
Kalayiah,F,100,10,0,10
Nicoline,F,100,10,0,10
Graclynn,F,100,35,0,35
Jamareo,M,100,0,6,6
Jaramiah,M,100,0,81,81
Yazmine,F,100,2258,0,2258
Noellie,F,100,12,0,12
Blayk,M,100,0,33,33
Hermelindo,M,100,0,11,11
Xabian,M,100,0,10,10
Kneisha,F,100,5,0,5
Montavis,M,100,0,145,145
Dillon,M,99,530,59856,60386
Madhumita,F,100,7,0,7
Kennen,M,100,0,212,212
Shirena,F,100,11,0,11
Dernell,M,100,0,10,10
Chez,M,80,27,108,135
Rogie,M,100,0,5,5
Darnette,F,100,75,0,75
Rubin,M,99,16,3026,3042
Dennie,M,85,352,1954,2306
Gwender,F,100,5,0,5
Tyena,F,100,23,0,23
Crewe,M,100,0,68,68
Dairl,M,100,0,16,16
Yohanes,M,100,0,32,32
Dina,F,100,28103,76,28179
Siddeegah,F,100,6,0,6
Chakyra,F,100,54,0,54
Darzell,M,100,0,5,5
Jillyan,F,100,291,0,291
Carter,M,97,3172,114163,117335
Deya,F,100,63,0,63
Doniyah,F,100,16,0,16
Yosgart,M,100,0,257,257
Fuller,M,100,0,122,122
Miette,F,100,221,0,221
Jaquay,M,70,156,371,527
Ixsel,F,100,5,0,5
Robbey,M,100,0,6,6
Berdell,M,100,0,5,5
Mackensi,F,100,94,0,94
Katherin,F,100,2745,0,2745
Aniello,M,100,0,195,195
Celida,F,100,32,0,32
Emelin,F,100,702,0,702
Rashik,M,100,0,5,5
Ayushman,M,100,0,26,26
Elecktra,F,100,5,0,5
Narciso,M,100,0,1315,1315
Juandaniel,M,100,0,152,152
Chirs,M,100,0,12,12
Synneva,F,100,5,0,5
Sui,F,100,30,0,30
Naszier,M,100,0,36,36
Marl,M,100,0,31,31
Coline,F,100,13,0,13
Kirtus,M,100,0,46,46
Roua,F,100,5,0,5
Jaydenmichael,M,100,0,5,5
Marsheela,F,100,11,0,11
Lacreisha,F,100,16,0,16
Lonny,M,99,60,5050,5110
Winta,F,100,77,0,77
Vontray,M,100,0,5,5
Kailah,F,100,1822,0,1822
Daveon,M,99,16,2319,2335
Suliman,M,100,0,143,143
Drena,F,100,438,0,438
Sephiroth,M,100,0,59,59
Ranndy,M,100,0,5,5
Racyn,M,100,0,12,12
Danner,M,98,5,292,297
Shaunak,M,100,0,230,230
Buena,F,100,51,0,51
Jago,M,100,0,46,46
Journi,F,100,1057,0,1057
Jarold,M,100,0,300,300
Johnwilliam,M,100,0,187,187
Kanika,F,100,1186,0,1186
Albana,F,100,71,0,71
Makiala,F,100,5,0,5
Damiann,M,100,0,10,10
Emarion,M,100,0,367,367
Matthis,M,100,0,7,7
Tchalla,M,100,0,8,8
Leeba,F,100,161,0,161
Francise,F,100,6,0,6
Bushra,F,100,601,0,601
Chelyn,F,100,5,0,5
Tyreak,M,100,0,142,142
Aarica,F,100,95,0,95
Ahilyn,F,100,89,0,89
Galen,M,96,495,10563,11058
Shanicka,F,100,217,0,217
Gertha,F,100,208,0,208
Ijahnae,F,100,22,0,22
Rafhael,M,100,0,5,5
Jakarious,M,100,0,5,5
Dedee,F,100,168,0,168
Shardonnay,F,100,26,0,26
Desuan,M,100,0,5,5
Deleta,F,100,34,0,34
Tarvares,M,100,0,66,66
Scotti,F,78,417,119,536
Lylliana,F,100,59,0,59
Mokshitha,F,100,5,0,5
Kassadee,F,100,70,0,70
Cyntheia,F,100,11,0,11
Aelynn,F,100,13,0,13
Icela,F,100,160,0,160
Amore,F,83,592,120,712
Lakieth,M,100,0,6,6
Jeni,F,100,2761,0,2761
Kaliesha,F,100,10,0,10
Dristin,M,73,12,33,45
Shawki,M,100,0,5,5
Amiracle,F,100,920,0,920
Leosha,F,100,31,0,31
Crestina,F,100,43,0,43
Elkanah,M,100,0,20,20
Brockton,M,100,0,687,687
Shakeemah,F,100,16,0,16
Hovik,M,100,0,13,13
Jesyca,F,100,84,0,84
Shiyanne,F,100,19,0,19
Kivon,M,100,0,62,62
Jalyah,F,100,89,0,89
Ramiah,F,96,362,14,376
Celsie,F,100,56,0,56
Bellissa,F,100,6,0,6
Parvathi,F,100,5,0,5
Neilan,M,100,0,46,46
Jasira,F,100,175,0,175
Drevon,M,100,0,611,611
Keirston,F,100,156,0,156
Tishya,F,100,5,0,5
Shetarra,F,100,5,0,5
Katrece,F,100,63,0,63
Aashray,M,100,0,5,5
Chania,F,100,348,0,348
Neshell,F,100,21,0,21
Crystofer,M,100,0,5,5
Jenea,F,100,805,0,805
Jenyfer,F,100,168,0,168
Braylend,M,100,0,5,5
Angelea,F,100,989,0,989
Ke,M,100,0,25,25
Tehana,F,100,6,0,6
Willodean,F,100,55,0,55
Saharrah,F,100,21,0,21
Paetra,F,100,6,0,6
Concha,F,100,217,0,217
Trayvone,M,100,0,50,50
Koko,F,100,35,0,35
Dkwon,M,100,0,6,6
Joelissa,F,100,5,0,5
Kalah,F,100,778,0,778
Jaeleah,F,100,50,0,50
Alena,F,100,10880,0,10880
Chasey,F,100,241,0,241
Tasfia,F,100,116,0,116
Sydni,F,100,5075,0,5075
Katavion,M,100,0,5,5
Kinli,F,100,25,0,25
Mikyia,F,100,20,0,20
Khayir,M,100,0,5,5
Tallis,M,61,41,65,106
Lou,F,88,13301,1784,15085
Dustan,M,100,0,1695,1695
Malayshia,F,100,311,0,311
Olijah,M,100,0,11,11
Marvella,F,100,708,0,708
Journie,F,99,985,6,991
Durke,M,100,0,10,10
Pradyun,M,100,0,78,78
Joses,M,100,0,33,33
Ikeyia,F,100,10,0,10
Shaiheem,M,100,0,11,11
Urie,M,100,0,116,116
Yashraj,M,100,0,10,10
Jannel,F,100,497,0,497
Monterrian,M,100,0,14,14
Aishani,F,100,295,0,295
Kristinamarie,F,100,39,0,39
Jahkeim,M,100,0,10,10
Daudi,M,100,0,15,15
Jarhia,F,100,5,0,5
Maikel,M,100,0,96,96
Nataleigh,F,100,1057,0,1057
Chasney,F,100,27,0,27
Remy,M,57,2927,3945,6872
Blayn,M,100,0,64,64
Tamiracle,F,100,20,0,20
Sahiti,F,100,98,0,98
Demicheal,M,100,0,16,16
Janeigh,F,100,7,0,7
Shenequia,F,100,18,0,18
Voltaire,M,100,0,46,46
Alfio,M,100,0,39,39
Timothyy,M,100,0,11,11
Kareem,M,99,193,13933,14126
Jailenne,F,100,44,0,44
Neia,F,100,21,0,21
Trino,M,100,0,216,216
Katriel,F,92,307,26,333
Rynleigh,F,100,5,0,5
Dimple,F,100,479,0,479
Niree,F,100,5,0,5
Shantavia,F,100,679,0,679
Ivee,F,100,218,0,218
Kelwin,M,100,0,120,120
Shahad,F,96,132,5,137
Lillyanna,F,100,2045,0,2045
Rasun,M,100,0,5,5
Daquez,M,100,0,27,27
Drevyn,M,100,0,15,15
Martae,M,100,0,55,55
Kirkpatrick,M,100,0,25,25
Sayveon,M,100,0,30,30
Danaye,F,100,67,0,67
Terez,M,72,146,379,525
Pama,F,100,151,0,151
Arinze,M,100,0,115,115
Balinda,F,100,638,0,638
Dewan,M,97,16,611,627
Jeovanna,F,100,16,0,16
Brealyn,F,100,135,0,135
Denelda,F,100,24,0,24
Letosha,F,100,24,0,24
Tanjanika,F,100,35,0,35
Valary,F,100,83,0,83
Annasia,F,100,18,0,18
Renad,F,100,139,0,139
Chassie,F,100,195,0,195
Munro,M,100,0,10,10
Betsye,F,100,5,0,5
Fenris,M,100,0,20,20
Earland,M,100,0,6,6
Falisa,F,100,82,0,82
Wendy,F,100,250755,947,251702
Amaijah,F,100,5,0,5
Iaisha,F,100,31,0,31
Cardin,M,92,25,280,305
Marylene,F,100,48,0,48
Termell,M,100,0,5,5
Aymar,F,100,223,0,223
Kylil,M,100,0,73,73
Rajeev,M,100,0,503,503
Valeriana,F,100,5,0,5
Mishael,M,65,172,317,489
Khori,F,72,231,91,322
Hser,F,76,22,7,29
Elder,M,100,0,1041,1041
Taronda,F,100,175,0,175
Pashience,F,100,5,0,5
Rebeccaann,F,100,16,0,16
Myel,F,100,10,0,10
Bayly,F,82,51,11,62
Yukina,F,100,10,0,10
Kynlie,F,100,358,0,358
Kardarius,M,100,0,11,11
Rolanda,F,99,3309,31,3340
Laconia,F,100,41,0,41
Shandreika,F,100,5,0,5
Pamlyn,F,100,5,0,5
Jaimaya,F,100,9,0,9
Tredon,M,100,0,5,5
Chawanna,F,100,15,0,15
Jarmell,M,100,0,18,18
Deshundra,F,100,68,0,68
Friddie,M,100,0,27,27
Culley,M,100,0,75,75
Sherrianne,F,100,10,0,10
Niyla,F,100,316,0,316
Delanta,M,100,0,5,5
Yentel,F,100,7,0,7
Jad,M,100,0,1752,1752
Emmali,F,100,112,0,112
Kiel,M,99,30,2395,2425
Nicolo,M,100,0,1037,1037
Fionnuala,F,100,94,0,94
Ahniyah,F,100,238,0,238
Cynthie,F,100,60,0,60
Keldin,M,100,0,10,10
Monquel,M,100,0,5,5
Masaya,M,100,0,17,17
Rennan,M,100,0,5,5
Vijaya,F,100,5,0,5
Kyianna,F,100,24,0,24
Saniyaa,F,100,12,0,12
Tanairy,F,100,110,0,110
Anurag,M,100,0,228,228
Aeryn,F,97,848,23,871
Starrlynn,F,100,10,0,10
Itza,F,100,280,0,280
Jayliany,F,100,11,0,11
Madilynn,F,100,5704,0,5704
Deiondra,F,100,83,0,83
Jaquinton,M,100,0,24,24
Treasa,F,100,1548,0,1548
Elois,F,100,536,0,536
Ayea,F,100,5,0,5
Kaderius,M,100,0,5,5
Renault,M,100,0,24,24
Aubrianna,F,100,3196,0,3196
Isreal,M,98,52,3267,3319
Javis,M,99,5,806,811
Velveeta,F,100,31,0,31
Mekyah,F,100,6,0,6
Renetia,F,100,6,0,6
Chasie,F,100,28,0,28
Naya,F,100,2892,0,2892
Catasha,F,100,37,0,37
Tinesha,F,100,762,0,762
Yan,M,88,83,619,702
Shavaria,F,100,5,0,5
Yihan,F,68,26,12,38
Blondine,F,100,43,0,43
Anathea,F,100,24,0,24
Jeliyah,F,100,53,0,53
Raylina,F,100,15,0,15
Jollene,F,100,22,0,22
Debrah,F,100,4143,0,4143
Rhylynn,F,100,53,0,53
Kursti,F,100,5,0,5
Alfreeda,F,100,5,0,5
Theola,F,100,318,0,318
Ilyaas,M,100,0,60,60
Mariya,F,100,2077,0,2077
Chekita,F,100,15,0,15
Kathi,F,100,9290,0,9290
Mecha,F,100,12,0,12
Tirrany,F,100,5,0,5
Nishita,F,100,129,0,129
Jenisis,F,100,105,0,105
Railynne,F,100,5,0,5
Sheilyn,F,100,76,0,76
Traniyah,F,100,141,0,141
Haylin,F,100,239,0,239
Fatoumatta,F,100,36,0,36
Quadreka,F,100,5,0,5
Nermeen,F,100,46,0,46
Latroyia,F,100,5,0,5
Shelbia,F,100,5,0,5
Aleisa,F,100,342,0,342
Rozario,M,100,0,5,5
Yaretsi,F,100,129,0,129
Travontae,M,100,0,154,154
Saynab,F,100,18,0,18
Braley,F,95,228,11,239
Eilise,F,100,5,0,5
Deymi,F,100,5,0,5
Idriss,M,100,0,90,90
Demri,F,100,35,0,35
Bryana,F,100,5767,0,5767
Brynnleigh,F,100,131,0,131
Vakesha,F,100,5,0,5
Jennika,F,100,384,0,384
Massie,F,100,5,0,5
Auriella,F,100,99,0,99
Amity,F,100,1692,0,1692
Shermaine,F,74,502,173,675
Qualan,M,100,0,12,12
Happiness,F,100,15,0,15
Piotr,M,100,0,698,698
Pertrina,F,100,5,0,5
Raegann,F,100,36,0,36
Sistine,F,100,5,0,5
Mikylla,F,100,6,0,6
Madelin,F,100,2391,0,2391
Taras,M,100,0,606,606
Jaycie,F,100,3105,5,3110
Alto,M,100,0,97,97
Kinsey,F,96,6549,252,6801
Markeith,M,100,0,1982,1982
Kohan,M,100,0,57,57
Jobani,M,100,0,216,216
Zakwon,M,100,0,5,5
Areecia,F,100,5,0,5
Donahue,M,100,0,64,64
Astley,M,100,0,5,5
Anjely,F,100,15,0,15
Talazia,F,100,15,0,15
Tylei,F,50,5,5,10
Jonross,M,100,0,5,5
Shandolyn,F,100,40,0,40
Emarosa,F,100,6,0,6
Bawi,M,87,12,81,93
Sherika,F,100,1966,0,1966
Shankia,F,100,59,0,59
Clairice,F,100,20,0,20
Christopherjame,M,100,0,92,92
Hirvin,M,100,0,6,6
Mashawn,F,63,62,37,99
Dara,F,95,11593,577,12170
Kaidince,F,100,6,0,6
Mugen,M,100,0,5,5
Ivon,F,79,1038,276,1314
Nikkei,F,100,5,0,5
Johnae,F,100,642,0,642
Arlinda,F,100,1271,0,1271
Jillesa,F,100,7,0,7
Daneya,F,100,79,0,79
Kolene,F,100,41,0,41
Xalia,F,100,10,0,10
Adaire,F,100,45,0,45
Ayveon,M,100,0,6,6
Arreona,F,100,10,0,10
Olaya,F,100,6,0,6
Raeanna,F,100,1564,0,1564
Anderson,M,97,579,16563,17142
Rosiland,F,100,575,0,575
Macklin,M,100,0,820,820
Juni,F,75,51,17,68
Goldi,F,100,5,0,5
Broadus,M,100,0,214,214
Willette,F,100,1298,0,1298
Sharnice,F,100,424,0,424
Macelyn,F,100,34,0,34
Jenasia,F,100,88,0,88
Zahmira,F,100,6,0,6
Diavione,F,100,12,0,12
Juliyana,F,100,31,0,31
Myonna,F,100,285,0,285
Lasheen,F,100,6,0,6
Andreia,F,100,593,0,593
Lenden,M,100,0,18,18
Larez,M,100,0,5,5
Jahdir,M,100,0,5,5
Eulonda,F,100,78,0,78
Divine,F,56,1390,1075,2465
Abby,F,100,54300,153,54453
Rossano,M,100,0,8,8
Kaitlynmarie,F,100,5,0,5
Kahmel,M,100,0,16,16
Kileyann,F,100,6,0,6
Aaronjoseph,M,100,0,7,7
Ceri,F,100,78,0,78
Taryiah,F,100,15,0,15
Lada,F,100,70,0,70
Loal,M,100,0,5,5
Judie,F,100,1752,0,1752
Alijha,M,78,11,38,49
Jeselyn,F,100,11,0,11
Sharaye,F,100,19,0,19
Samantha,F,100,554638,1186,555824
Bernisha,F,100,88,0,88
Trashaun,M,100,0,122,122
Esey,M,100,0,5,5
Khadajah,F,100,26,0,26
Miaa,F,100,48,0,48
Armard,M,100,0,18,18
Jaliesa,F,100,18,0,18
Akiesha,F,100,18,0,18
Arpil,F,100,55,0,55
Alvieri,M,100,0,5,5
Louvinia,F,100,29,0,29
Keiera,F,100,179,0,179
Anyria,F,100,11,0,11
Justyna,F,100,361,0,361
Zabrien,M,100,0,10,10
Every,M,100,0,5,5
Shetika,F,100,12,0,12
Valdir,M,100,0,5,5
Melise,F,100,33,0,33
Nami,F,100,266,0,266
Crimson,F,78,759,214,973
Tylasia,F,100,154,0,154
Ristina,F,100,15,0,15
Navea,F,100,113,0,113
Judean,F,100,13,0,13
Kalima,F,100,125,0,125
Cornetta,F,100,32,0,32
Sone,F,100,5,0,5
Migdalia,F,100,4228,5,4233
Jakarie,M,100,0,107,107
Vershon,M,100,0,10,10
Waldo,M,100,0,1271,1271
Obert,M,100,0,176,176
Eulah,F,100,58,0,58
Jereal,M,100,0,5,5
Umit,M,100,0,5,5
Karmon,F,100,185,0,185
Philmore,M,100,0,40,40
Greda,F,100,5,0,5
Jameila,F,100,112,0,112
Kayella,F,100,11,0,11
Jerrisa,F,100,6,0,6
Jacorious,M,100,0,10,10
Balbina,F,100,32,0,32
Zaelee,F,100,19,0,19
Tenica,F,100,37,0,37
Dorris,F,79,790,206,996
Adut,F,100,27,0,27
Waddell,M,100,0,281,281
Iokepa,M,100,0,61,61
Ayeden,M,100,0,89,89
Issaiah,M,100,0,421,421
Bernt,M,100,0,10,10
Aaralynn,F,100,224,0,224
Rickiyah,F,100,41,0,41
Ansley,F,98,8698,197,8895
Kinzlie,F,100,70,0,70
Kersty,F,100,6,0,6
Judine,F,100,38,0,38
Verdella,F,100,34,0,34
Rayquann,M,100,0,5,5
Courtany,F,100,82,0,82
Nekeisha,F,100,269,0,269
Logun,M,100,0,364,364
Dawnae,F,100,12,0,12
Sparky,M,100,0,5,5
Raquelin,F,100,24,0,24
Chevaun,F,100,6,0,6
Mardena,F,100,5,0,5
Natailia,F,100,5,0,5
Wilnette,F,100,5,0,5
Dimesha,F,100,12,0,12
Lilarose,F,100,6,0,6
Shariah,F,100,827,0,827
Shevone,F,100,13,0,13
Shekeena,F,100,7,0,7
Atika,F,100,53,0,53
Haroutun,M,100,0,5,5
Iristine,F,100,11,0,11
Chrisma,F,100,119,0,119
Keemia,F,100,5,0,5
Farouq,M,100,0,11,11
Elvan,M,100,0,18,18
Patarica,F,100,16,0,16
Juniel,M,100,0,140,140
Royalti,F,100,8,0,8
Wlliam,M,100,0,79,79
Mareike,F,100,5,0,5
Brandelynn,F,100,5,0,5
Jahmell,M,100,0,8,8
Earnell,M,100,0,10,10
Daaiyah,F,100,78,0,78
Aleashia,F,100,25,0,25
Sujeily,F,100,31,0,31
Chidimma,F,100,41,0,41
Zanari,F,100,27,0,27
Khaleef,M,100,0,84,84
Raygene,F,100,12,0,12
Shawdae,F,100,23,0,23
Cay,F,100,200,0,200
Jesusita,F,100,641,0,641
Dawnella,F,100,30,0,30
Dawnene,F,100,6,0,6
Daila,F,100,295,0,295
Shardell,F,100,30,0,30
Caliya,F,100,109,0,109
Sameko,F,100,7,0,7
Nicholl,F,100,171,0,171
Ricayla,F,100,6,0,6
Tyjhawn,M,100,0,7,7
Emyla,F,100,10,0,10
Ojasvi,F,100,6,0,6
Tinnley,F,100,12,0,12
Brynleigh,F,100,863,0,863
Jadeth,F,100,5,0,5
Salvina,F,100,6,0,6
Hansini,F,100,90,0,90
Garrick,M,100,0,5103,5103
Thuy,F,98,1071,17,1088
Ayonah,F,100,6,0,6
Eunice,F,99,14917,155,15072
Kinnard,M,100,0,5,5
Juri,F,95,105,5,110
Senta,F,100,314,0,314
Chanequa,F,100,56,0,56
Kiralyn,F,100,44,0,44
Chas,M,100,5,1254,1259
Jc,M,97,32,1211,1243
Corinthians,M,100,0,26,26
Havisha,F,100,17,0,17
John,M,100,10146,2690071,2700217
Liang,M,100,0,28,28
Shenkia,F,100,10,0,10
Abdulwadud,M,100,0,5,5
Ladana,F,100,320,0,320
King,M,100,5,11563,11568
Krisha,F,100,1632,0,1632
Modupe,F,100,64,0,64
Madalee,F,100,60,0,60
Mats,M,100,0,72,72
Jeniffer,F,100,3609,0,3609
Keinya,F,100,6,0,6
Dynelle,F,100,6,0,6
Ladonne,F,100,71,0,71
Rashim,M,100,0,5,5
Xzaiver,M,100,0,77,77
Vander,M,100,0,684,684
Taleeyah,F,100,69,0,69
Tameki,F,100,59,0,59
Chalyce,F,100,27,0,27
Jasmond,M,65,43,81,124
Tavius,M,100,0,341,341
Alanee,F,100,54,0,54
Jillynn,F,100,12,0,12
Shervonda,F,100,5,0,5
Rakiem,M,100,0,25,25
Jacobee,M,100,0,59,59
Chinitta,F,100,5,0,5
Kampbell,F,100,54,0,54
Harleen,F,100,670,0,670
Tatiyona,F,100,11,0,11
Jadali,F,100,5,0,5
Gavyne,M,100,0,5,5
Devonnte,M,100,0,5,5
Braeya,F,100,5,0,5
Rudell,M,81,39,168,207
Shacarra,F,100,74,0,74
Tkaia,F,100,11,0,11
Jenissa,F,100,192,0,192
Jihad,M,100,5,1798,1803
Colton,M,100,158,99165,99323
Abra,F,100,879,0,879
Blia,F,100,119,0,119
Carle,M,54,134,157,291
Baileyann,F,100,41,0,41
Quayon,M,100,0,16,16
Xsavion,M,100,0,5,5
Rasheta,F,100,36,0,36
Brodan,M,100,0,65,65
Zanariah,F,100,24,0,24
Loann,F,100,209,0,209
Abdullahi,M,100,0,1077,1077
Zhian,M,100,0,5,5
Fahmi,M,100,0,10,10
Micelle,F,100,29,0,29
Excell,M,100,0,126,126
Jarman,M,100,0,70,70
Aleayah,F,100,99,0,99
Janeta,F,100,17,0,17
Pray,M,100,0,6,6
Jaycieon,M,100,0,18,18
Trelon,M,100,0,116,116
Laqwan,M,100,0,15,15
Blyth,F,100,11,0,11
Zaire,M,77,1234,4067,5301
Aliisa,F,100,5,0,5
Suvi,F,100,58,0,58
Savannahjo,F,100,5,0,5
Ekko,F,100,17,0,17
Jahonna,F,100,7,0,7
Lorrel,F,100,5,0,5
Nikkitta,F,100,6,0,6
Kyden,M,97,23,808,831
Zayshaun,M,100,0,6,6
Sakaiya,F,100,5,0,5
Markiece,M,100,0,7,7
Subin,M,62,6,10,16
Nyia,F,99,624,5,629
Emahni,F,100,39,0,39
Neharika,F,100,33,0,33
Mistaya,F,100,6,0,6
Dezmariah,F,100,47,0,47
Jorman,M,100,0,52,52
Genia,F,100,1385,0,1385
Adelay,F,100,27,0,27
Janaisia,F,100,13,0,13
Quayla,F,100,27,0,27
Gabrialle,F,100,28,0,28
Dreux,M,100,0,91,91
Azaryia,F,100,5,0,5
Triska,F,100,5,0,5
Quinnleigh,F,100,7,0,7
Anyieth,F,100,6,0,6
Lavelton,M,100,0,6,6
Deshaya,F,100,5,0,5
Venna,F,100,137,0,137
Shqipe,F,100,11,0,11
Dantrell,M,100,0,567,567
Tammeka,F,100,11,0,11
Emuna,F,100,21,0,21
Amaliah,F,100,20,0,20
Binta,F,100,396,0,396
Shondolyn,F,100,5,0,5
Jakala,F,100,258,0,258
Connelly,F,54,96,82,178
Jalivia,F,100,19,0,19
Khane,M,100,0,25,25
Yinuo,M,100,0,6,6
Anneke,F,100,864,0,864
Marimar,F,100,299,0,299
Shailen,M,92,5,58,63
Demetri,M,95,158,3332,3490
Trejure,F,100,13,0,13
Mckaley,F,100,21,0,21
Quiana,F,100,3931,0,3931
Adoniah,M,63,14,24,38
Jacksen,M,100,0,440,440
Rolene,F,100,116,0,116
Shon,M,93,354,4989,5343
Oryn,M,100,0,25,25
Sadat,M,100,0,87,87
Katrell,M,91,43,418,461
Nandita,F,100,223,0,223
Ilayah,F,100,14,0,14
Shawndrea,F,100,133,0,133
Talayeh,F,100,67,0,67
Nashanda,F,100,34,0,34
Mayren,F,100,27,0,27
Mir,M,100,0,375,375
Jereline,F,100,24,0,24
Sharah,F,100,231,0,231
Alely,F,100,11,0,11
Branddon,M,100,0,21,21
Arthur,M,99,999,168961,169960
Janvi,F,100,290,0,290
Yavonna,F,100,6,0,6
Suanna,F,100,22,0,22
Tonza,F,100,5,0,5
Zakeya,F,100,178,0,178
Derionna,F,100,77,0,77
Schaefer,M,100,0,40,40
Clydean,F,100,9,0,9
Zoei,F,100,592,0,592
Shamecka,F,100,114,0,114
Demitria,F,100,561,0,561
Colicia,F,100,5,0,5
Ma,F,100,576,0,576
Oleta,F,100,513,0,513
Kyung,F,73,74,27,101
Elynn,F,100,236,0,236
Jamelah,F,100,130,0,130
Revati,F,100,5,0,5
Asiel,M,98,6,310,316
Neris,M,100,0,5,5
Zeddicus,M,100,0,22,22
Redd,M,100,0,26,26
Zaysia,F,100,5,0,5
Wilborn,M,100,0,22,22
Gabiel,M,100,0,23,23
Jayvaun,M,100,0,5,5
Austyn,M,65,2363,4301,6664
Aaris,M,51,28,29,57
Irazema,F,100,16,0,16
Illissa,F,100,5,0,5
Abdulaye,M,100,0,5,5
Laaibah,F,100,47,0,47
Quenisha,F,100,191,0,191
Adrial,M,100,0,25,25
Tevy,F,100,6,0,6
Aleira,F,100,35,0,35
Alaxis,F,100,5,0,5
Blossom,F,100,951,0,951
Kiayra,F,100,6,0,6
Mellina,F,100,66,0,66
Aris,M,61,1020,1617,2637
Yaara,F,100,14,0,14
Terriya,F,100,12,0,12
Ihsan,M,100,0,343,343
Jordon,M,88,1818,12829,14647
Romya,F,100,28,0,28
Jarvas,M,100,0,15,15
Neave,F,100,95,0,95
Ismari,F,100,43,0,43
Nadaja,F,100,10,0,10
Sevynn,F,100,10,0,10
Malayjah,F,100,112,0,112
Jobyna,F,100,6,0,6
Cordaris,M,100,0,5,5
Hudsen,M,98,6,244,250
Yocasta,F,100,11,0,11
Diven,M,100,0,5,5
Tracye,F,100,1080,5,1085
Manoj,M,100,0,225,225
Maybellene,F,100,11,0,11
Ruiqi,F,100,5,0,5
Izela,F,100,90,0,90
Rayetta,F,100,415,0,415
Mandy,F,100,37811,138,37949
Destoni,F,100,38,0,38
Dent,M,100,0,26,26
Nicklaus,M,100,0,3227,3227
Tian,M,57,143,193,336
Reauna,F,100,35,0,35
Egzon,M,100,0,16,16
Hazen,M,98,20,864,884
Nguyen,M,78,117,421,538
Verdean,F,100,7,0,7
Caprise,F,100,11,0,11
Lilija,F,100,46,0,46
Ruqiya,F,100,28,0,28
Drelan,M,100,0,22,22
Fallyn,F,100,952,0,952
Keyshaun,M,100,0,633,633
Dariana,F,100,2512,0,2512
Breeza,F,100,37,0,37
Jeninne,F,100,10,0,10
Lamoine,M,100,0,15,15
Rahmah,F,100,69,0,69
Tajanai,F,100,6,0,6
Lazetta,F,100,18,0,18
Johnniqua,F,100,5,0,5
Damier,M,100,0,183,183
Kyrstle,F,100,32,0,32
Jamarquis,M,100,0,120,120
Heymi,F,100,12,0,12
Anai,F,100,1999,0,1999
Spartan,M,100,0,5,5
Shubham,M,100,0,240,240
Chane,M,71,128,311,439
Srividya,F,100,6,0,6
Ezzard,M,100,0,477,477
Anapatricia,F,100,46,0,46
Sreeram,M,100,0,22,22
Aundre,M,100,0,1181,1181
Deliana,F,100,76,0,76
Bernadetta,F,100,88,0,88
Seaver,M,100,0,124,124
Deyla,F,100,35,0,35
Dorienne,F,100,12,0,12
Adrieanna,F,100,363,0,363
Moselle,F,100,30,0,30
Richardo,M,100,0,1924,1924
Gabirelle,F,100,5,0,5
Brianni,F,100,240,0,240
Xiao,F,92,65,6,71
Nevaehlynn,F,100,16,0,16
Aquavia,F,100,5,0,5
Lauranne,F,100,70,0,70
Twiggy,F,100,12,0,12
Rea,F,98,912,17,929
Quesha,F,100,5,0,5
Ayverie,F,100,12,0,12
Shaymaa,F,100,18,0,18
Lindon,M,100,0,654,654
Karlyee,F,100,5,0,5
Takiyah,F,100,1846,0,1846
Shavon,F,91,3862,362,4224
Issel,F,100,11,0,11
Coreyion,M,100,0,6,6
Vishan,M,100,0,10,10
Tajudeen,M,100,0,5,5
Darena,F,100,18,0,18
Ignasio,M,100,0,33,33
Kervens,M,100,0,128,128
Shatira,F,100,115,0,115
Kalei,F,91,1623,161,1784
Raelean,F,100,5,0,5
Avedis,M,100,0,63,63
Takendra,F,100,23,0,23
Ianna,F,100,833,0,833
Sunee,F,100,51,0,51
Zackarie,M,100,0,217,217
Samanthea,F,100,5,0,5
Lukian,M,100,0,11,11
Jaykwon,M,100,0,77,77
Damarien,M,100,0,114,114
Quadarrius,M,100,0,23,23
Khouri,F,55,6,5,11
Terryana,F,100,15,0,15
Sheldan,M,100,0,22,22
Taio,M,100,0,22,22
Gwendelynn,F,100,5,0,5
Arliene,F,100,5,0,5
Jenaka,F,100,6,0,6
Harpar,F,100,5,0,5
Hutchison,M,100,0,19,19
Breylynn,F,100,17,0,17
Branten,M,100,0,24,24
Maurquise,M,100,0,6,6
Tearney,F,100,11,0,11
Tendria,F,100,5,0,5
Chenin,F,100,29,0,29
Knesha,F,100,8,0,8
Ceresa,F,100,28,0,28
Rebecah,F,100,213,0,213
Amirrah,F,100,269,0,269
Vietta,F,100,72,0,72
Jabin,M,100,0,530,530
Ailaina,F,100,20,0,20
Tetsu,M,100,0,5,5
Nayanna,F,100,102,0,102
Haeli,F,100,226,0,226
Aadvik,M,100,0,26,26
Tarhonda,F,100,94,0,94
Ameelah,F,100,6,0,6
Ralee,F,100,18,0,18
Terral,M,96,20,477,497
Makynlee,F,100,362,0,362
Kelsi,F,100,9396,0,9396
Damajae,M,100,0,7,7
Anyi,F,100,81,0,81
Mayuri,F,100,122,0,122
Florine,F,100,1350,0,1350
Riott,M,100,0,26,26
Naporsha,F,100,38,0,38
Belladonna,F,100,218,0,218
Chiketa,F,100,11,0,11
Adryanna,F,100,607,0,607
Vaneesa,F,100,10,0,10
Paridhi,F,100,14,0,14
Oletha,F,100,281,0,281
Samore,F,100,5,0,5
Lakala,F,100,16,0,16
Sascha,F,76,1038,325,1363
Selena,F,100,44013,57,44070
Shawneice,F,100,19,0,19
Jerolyn,F,100,302,0,302
Shayonna,F,100,216,0,216
Ellajean,F,100,13,0,13
Alyzah,F,100,176,0,176
Ariee,F,100,10,0,10
Kimmerly,F,100,83,0,83
Du,M,100,0,22,22
Charita,F,100,1381,0,1381
Ticey,F,100,37,0,37
Shilee,F,100,60,0,60
Kenderek,M,100,0,5,5
Zaidon,M,100,0,26,26
Sharai,F,100,454,0,454
Mattix,M,100,0,275,275
Kyanna,F,100,1699,0,1699
Daiah,F,100,6,0,6
Ahaana,F,100,40,0,40
Makara,F,100,179,0,179
Rimsha,F,100,107,0,107
Kinady,F,100,5,0,5
Aimar,M,50,114,115,229
Saheed,M,100,0,142,142
Ghanem,M,100,0,5,5
Chelseaann,F,100,29,0,29
Rashaad,M,100,0,3030,3030
Mehek,F,100,133,0,133
Charra,F,100,51,0,51
Jontarius,M,100,0,14,14
Tarrick,M,100,0,36,36
Maryellyn,F,100,5,0,5
Phillippa,F,100,39,0,39
Wileen,F,100,80,0,80
Shanygne,F,100,27,0,27
Ahnari,F,100,5,0,5
Lakia,F,100,2621,0,2621
Jane,F,100,161506,431,161937
Hombre,M,100,0,8,8
Messer,M,100,0,10,10
Shermika,F,100,151,0,151
Tahlia,F,100,2140,0,2140
Sheon,F,50,5,5,10
Burim,M,100,0,6,6
Josaih,M,100,0,30,30
Aana,F,100,7,0,7
Jakiara,F,100,16,0,16
Yumalai,F,100,35,0,35
Dornisha,F,100,10,0,10
Markayden,M,100,0,10,10
Kestrel,F,97,166,5,171
Kayke,M,100,0,11,11
Saiyuri,F,100,33,0,33
Shamal,M,100,0,172,172
Fu,M,100,0,10,10
Camilia,F,100,461,0,461
Verda,F,100,693,0,693
Journeigh,F,100,5,0,5
Nolawit,F,100,12,0,12
Herald,M,100,0,198,198
Melvita,F,100,5,0,5
Tyrine,F,100,5,0,5
Madina,F,100,775,0,775
Nateya,F,100,6,0,6
Kindsay,F,100,5,0,5
Ilish,F,100,9,0,9
Kasidi,F,100,79,0,79
Lindbergh,M,100,0,82,82
Nachman,M,100,0,465,465
Gensis,F,100,23,0,23
Manley,M,100,0,552,552
Evett,F,100,309,0,309
Bernay,F,100,13,0,13
Akshan,M,100,0,5,5
Aalycia,F,100,25,0,25
Sherr,F,100,5,0,5
Jaquinta,F,100,5,0,5
Johnmatthew,M,100,0,64,64
Nor,M,55,5,6,11
Britane,F,100,15,0,15
Angyl,F,100,10,0,10
Carlan,F,53,25,22,47
Marifrances,F,100,5,0,5
Datia,F,100,5,0,5
Anayi,F,100,85,0,85
Ritha,F,100,91,0,91
Baylaa,F,100,5,0,5
Crimsyn,F,100,6,0,6
Shamea,F,100,31,0,31
Supreet,F,100,35,0,35
Torrean,M,100,0,50,50
Zeny,F,100,5,0,5
Maygen,F,100,398,0,398
Syna,F,100,84,0,84
Treydan,M,100,0,20,20
Rodrekus,M,100,0,11,11
Damayia,F,100,11,0,11
Seiry,F,100,17,0,17
Kedryn,M,100,0,12,12
Quaneshia,F,100,185,0,185
Markeveon,M,100,0,5,5
Kaeson,M,100,0,435,435
Sparsh,M,100,0,106,106
Jeanchristophe,M,100,0,6,6
Gleny,F,100,5,0,5
Layia,F,100,39,0,39
Raquele,F,100,6,0,6
Nyzir,M,100,0,183,183
Albaraa,M,100,0,46,46
Derriyah,F,100,6,0,6
Elinor,F,100,3438,0,3438
Shaiden,M,100,0,58,58
Chandre,F,100,41,0,41
Manas,M,100,0,249,249
Anaysia,F,100,183,0,183
Ianthe,F,100,32,0,32
Alanah,F,100,2966,0,2966
Chaskel,M,100,0,15,15
Semiah,F,100,59,0,59
Crag,M,100,0,5,5
Jazmin,F,99,38759,227,38986
Simione,M,100,0,5,5
Heyam,F,100,17,0,17
Annalys,F,100,18,0,18
Torrick,M,100,0,16,16
Ryannah,F,100,30,0,30
Riddhima,F,100,41,0,41
Nadalynn,F,100,17,0,17
Cela,F,100,67,0,67
Bethani,F,100,1013,0,1013
Tirrell,M,98,13,759,772
Jacky,M,84,894,4782,5676
Keiasia,F,100,186,0,186
Shahrukh,M,100,0,64,64
Leam,M,100,0,106,106
Thaddaeus,M,100,0,839,839
Vamsi,M,100,0,74,74
Finnly,F,53,10,9,19
Rikeisha,F,100,5,0,5
Ahmoni,F,100,42,0,42
Deambra,F,100,16,0,16
Braylyn,F,58,430,314,744
Chakakhan,F,100,37,0,37
Breasia,F,100,1171,0,1171
Shaniquwa,F,100,5,0,5
Brekon,M,100,0,5,5
Soliyana,F,100,64,0,64
Sekayi,F,100,5,0,5
Meaghan,F,100,13955,7,13962
Rjay,M,100,0,67,67
Kista,F,100,79,0,79
Hajar,F,100,474,0,474
Lanajah,F,100,43,0,43
Reeves,M,97,11,356,367
Tyga,M,100,0,21,21
Wojciech,M,100,0,54,54
Tavaughn,M,100,0,109,109
Enyia,F,100,25,0,25
Mi,F,100,669,0,669
China,F,100,4101,10,4111
Eres,F,100,15,0,15
Kyeria,F,100,18,0,18
Kahir,M,100,0,6,6
Akiylah,F,100,5,0,5
Tranessa,F,100,7,0,7
Mariadelos,F,100,5,0,5
Taryne,F,100,133,0,133
Darlis,F,100,120,0,120
Solay,F,100,39,0,39
Denaeja,F,100,11,0,11
Priyansh,M,100,0,21,21
Zarely,F,100,5,0,5
Vessie,F,100,12,0,12
Aviona,F,100,226,0,226
Leeloo,F,100,42,0,42
Dakaria,F,100,44,0,44
Amadeo,M,100,0,926,926
Armonii,F,100,29,0,29
Alajah,F,100,566,0,566
Drake,M,100,78,30643,30721
Jermira,F,100,5,0,5
Lazariya,F,100,6,0,6
Bianet,F,100,5,0,5
Nakish,F,100,5,0,5
Breaden,M,100,0,11,11
Manlio,M,100,0,6,6
Albree,F,100,37,0,37
Kayla,F,100,328919,565,329484
Beckey,F,100,488,0,488
Calaysia,F,100,6,0,6
Milenka,F,100,19,0,19
Roksana,F,100,30,0,30
Leonisha,F,100,5,0,5
Zane,M,99,339,37718,38057
Applonia,F,100,7,0,7
Meryk,M,100,0,7,7
Aljaquan,M,100,0,6,6
Amandarae,F,100,12,0,12
Salida,F,100,5,0,5
Xzaria,F,100,65,0,65
Tylon,M,100,0,984,984
Nickales,M,100,0,17,17
Maesie,F,100,6,0,6
Davyeon,M,100,0,5,5
Krystale,F,100,170,0,170
Addylan,F,100,5,0,5
Leilaann,F,100,5,0,5
Tahnee,F,100,919,0,919
Royden,M,100,0,350,350
Siren,F,100,41,0,41
Louana,F,100,37,0,37
Corryne,F,100,13,0,13
Saffron,F,100,468,0,468
Makinna,F,100,317,0,317
Joshuaray,M,100,0,5,5
Ismene,F,100,7,0,7
Mahoganee,F,100,5,0,5
Sonica,F,100,5,0,5
Svara,F,100,57,0,57
Sylis,M,100,0,514,514
Kenaniah,M,100,0,45,45
Kelela,F,100,6,0,6
Kaneeshia,F,100,9,0,9
Johnnessa,F,100,11,0,11
Senda,F,100,10,0,10
Sherwyn,M,100,0,6,6
Nathanyel,M,100,0,225,225
Landri,F,100,624,0,624
Yeremy,M,100,0,37,37
Derin,M,86,126,756,882
Romiyah,F,100,19,0,19
Charnesia,F,100,5,0,5
Quayshawn,M,97,5,172,177
Melissaanne,F,100,11,0,11
Darrin,M,100,133,29097,29230
Marytheresa,F,100,37,0,37
Annali,F,100,308,0,308
Kassity,F,100,140,0,140
Merie,F,100,28,0,28
Asthon,M,100,0,11,11
Ashvik,M,100,0,86,86
Erjon,M,100,0,28,28
Caitlinn,F,100,133,0,133
Sayvon,M,100,0,192,192
Piero,M,100,0,572,572
Huguette,F,100,5,0,5
Tasheria,F,100,6,0,6
Dollene,F,100,40,0,40
Kian,M,99,81,5971,6052
Kiri,F,100,833,0,833
Tamariana,F,100,6,0,6
Anastassia,F,100,243,0,243
Aathan,M,100,0,5,5
Dwanda,F,100,234,0,234
Kathaleya,F,100,27,0,27
Mortisha,F,100,15,0,15
Phanta,F,100,7,0,7
Shanalee,F,100,31,0,31
Nethania,F,100,26,0,26
Kylis,F,100,5,0,5
Caramia,F,100,181,0,181
Jeanne,F,100,74385,138,74523
Aunisty,F,100,54,0,54
Alima,F,100,284,0,284
Emilliana,F,100,11,0,11
Laquavious,M,100,0,38,38
Cassidee,F,100,657,0,657
Kholie,F,100,5,0,5
Raul,M,99,419,70822,71241
Cassee,F,100,45,0,45
Montague,M,100,0,195,195
Deserai,F,100,69,0,69
Marlies,F,100,170,0,170
Nguyet,F,100,73,0,73
Nathasa,F,100,11,0,11
Koraleigh,F,100,5,0,5
Lacen,M,100,0,5,5
Jenayah,F,100,87,0,87
Keyera,F,100,867,0,867
Alahna,F,100,767,0,767
Donta,M,98,91,3656,3747
Paiyton,F,100,34,0,34
Treveyon,M,100,0,31,31
Caliope,F,100,37,0,37
Adella,F,100,1643,0,1643
Torianna,F,100,402,0,402
Katravia,F,100,6,0,6
Kiasha,F,100,175,0,175
Tien,M,60,455,688,1143
Sung,M,86,69,435,504
Leopoldo,M,100,0,4043,4043
Darnez,M,100,0,17,17
Jazmenn,F,100,5,0,5
Edee,F,100,90,0,90
Rosaicela,F,100,16,0,16
Wiyaka,F,100,5,0,5
Shanaz,F,100,37,0,37
Aleighsha,F,100,11,0,11
Nilmar,M,100,0,36,36
Andes,M,100,0,12,12
Tommey,M,100,0,49,49
Cerissa,F,100,461,0,461
Jaleiyah,F,100,61,0,61
Ruan,M,100,0,28,28
Lorita,F,100,903,0,903
Breken,M,100,0,122,122
Jurgen,M,100,0,323,323
Ieuan,M,100,0,5,5
Leamond,M,100,0,10,10
Valma,F,100,50,0,50
Hein,M,100,0,6,6
Cuinn,M,100,0,59,59
Kerem,M,100,0,305,305
Enyssa,F,100,5,0,5
Selam,F,100,157,0,157
Houghton,M,100,0,5,5
Kaylaa,F,100,35,0,35
Laqueda,F,100,21,0,21
Chucky,M,100,0,594,594
Denardo,M,100,0,17,17
Silvina,F,100,142,0,142
Ramil,M,100,0,137,137
Syrai,F,100,238,0,238
Jennavieve,F,100,352,0,352
Nesby,M,100,0,5,5
Alijiah,M,100,0,34,34
Shivonni,F,100,6,0,6
Monekia,F,100,6,0,6
Tonicia,F,100,46,0,46
Shernell,F,100,62,0,62
Yahel,M,97,16,477,493
Ethane,M,100,0,23,23
Jorian,M,90,32,293,325
Kazir,M,100,0,5,5
Lon,M,100,15,5631,5646
Audrianne,F,100,27,0,27
Zyana,F,100,415,0,415
Owenn,M,100,0,44,44
Graceanne,F,100,425,0,425
Edwind,M,100,0,5,5
Narmeen,F,100,88,0,88
Ty,M,98,691,42738,43429
Loriel,F,100,193,0,193
Milda,F,100,102,0,102
Asdrubal,M,100,0,5,5
Enzi,M,100,0,24,24
Shawneece,F,100,6,0,6
Siwoo,M,100,0,5,5
Aren,M,82,326,1531,1857
Emilly,F,100,1148,0,1148
Rachal,F,100,1313,0,1313
Alisea,F,100,87,0,87
Bayden,M,98,6,272,278
Javeria,F,100,89,0,89
Mattison,F,91,1954,203,2157
Ayatollah,M,100,0,6,6
Keshara,F,100,145,0,145
Balil,M,100,0,13,13
Ladarian,M,100,0,346,346
Annorah,F,100,22,0,22
Anniesha,F,100,7,0,7
Brittna,F,100,5,0,5
Zain,M,96,174,4726,4900
Kently,F,100,5,0,5
Jin,M,73,359,977,1336
Thays,F,100,5,0,5
Jarissa,F,100,179,0,179
Maryjeanne,F,100,11,0,11
Inshirah,F,100,7,0,7
Alescia,F,100,51,0,51
Talah,F,100,86,0,86
Jamespaul,M,100,0,67,67
Keziya,F,100,5,0,5
Lajarvis,M,100,0,96,96
Donaldson,M,100,0,45,45
Johrdan,M,100,0,5,5
Kathee,F,100,135,0,135
Letitia,F,100,8002,0,8002
Kendi,F,100,509,0,509
Sima,F,100,1454,0,1454
Annavictoria,F,100,24,0,24
Keslee,F,100,57,0,57
Jahnelle,F,100,21,0,21
Andraia,F,100,10,0,10
Jeramia,M,100,0,134,134
Lohan,M,100,0,5,5
Yonel,M,100,0,29,29
Aamanda,F,100,10,0,10
Civona,F,100,5,0,5
Quasheema,F,100,5,0,5
Vintrell,M,100,0,10,10
Kawanis,F,100,22,0,22
Jaicie,F,100,17,0,17
Shaletha,F,100,189,0,189
Tawna,F,100,877,0,877
Alexianna,F,100,219,0,219
Analysa,F,100,295,0,295
Alwaleed,M,100,0,28,28
Cherece,F,100,42,0,42
Darryl,M,99,954,83446,84400
Nyella,F,100,50,0,50
Cenya,F,100,11,0,11
Aleathea,F,100,78,0,78
Biannca,F,100,126,0,126
Ruairi,M,100,0,134,134
Lahari,F,100,85,0,85
Aubri,F,100,3151,0,3151
Sakai,M,72,61,159,220
Mor,F,71,12,5,17
Tytana,F,100,24,0,24
Bryndan,M,100,0,63,63
Dwyne,M,100,0,85,85
Aveyon,M,100,0,46,46
Manuelle,M,100,0,14,14
Drelen,M,100,0,5,5
Jannali,F,100,10,0,10
Aidrianna,F,100,5,0,5
Leaundra,F,100,22,0,22
Adoree,F,100,28,0,28
Azul,F,98,2949,45,2994
Dareion,M,100,0,109,109
Tavion,M,99,13,2555,2568
Zakiel,M,100,0,5,5
Eliasar,M,100,0,253,253
Antonietta,F,100,950,0,950
Dajae,F,100,171,0,171
Bernadette,F,100,33949,60,34009
Etha,F,100,158,0,158
Jonis,M,100,0,46,46
Ridgley,M,100,0,10,10
Madeley,F,100,22,0,22
Keeden,M,100,0,13,13
Sirwilliam,M,100,0,30,30
Josyiah,M,100,0,29,29
Jackquelin,F,100,37,0,37
Feryal,F,100,11,0,11
Aritzel,F,100,53,0,53
Calei,F,100,33,0,33
Tandeka,F,100,7,0,7
Shawauna,F,100,11,0,11
Acura,F,100,26,0,26
Connice,F,100,5,0,5
Ranford,M,100,0,6,6
Anmol,M,56,276,350,626
Cherokee,F,88,2284,322,2606
Christeena,F,100,269,0,269
Medwin,M,100,0,5,5
Janeah,F,100,143,0,143
Ladonnia,F,100,10,0,10
Kennitha,F,100,15,0,15
Abyssinia,F,100,18,0,18
Mahtab,F,100,11,0,11
Icarus,M,100,0,21,21
Jhai,M,83,5,25,30
Nafiz,M,100,0,10,10
Venia,F,100,41,0,41
Zharia,F,100,820,0,820
Treyson,M,100,0,1223,1223
Jeree,F,98,202,5,207
Toral,F,100,26,0,26
Kelii,M,100,0,243,243
Quention,M,100,0,28,28
Kelcee,F,100,683,0,683
Deboris,M,100,0,11,11
Sahanna,F,100,18,0,18
Mckane,M,100,0,17,17
Myquisha,F,100,5,0,5
Timika,F,100,1006,0,1006
Emilyjo,F,100,22,0,22
Raider,M,100,0,240,240
Quaylen,M,100,0,11,11
Claudett,F,100,65,0,65
Judilyn,F,100,6,0,6
Anjay,M,100,0,41,41
Bary,M,100,0,240,240
Gavin,M,100,358,156629,156987
Cailean,M,80,17,68,85
Nyaja,F,100,129,0,129
Noraleigh,F,100,5,0,5
Maleyah,F,100,354,0,354
Alanoud,F,100,5,0,5
Vidyuth,M,100,0,28,28
Remas,F,100,121,0,121
Evlyn,F,100,149,0,149
Anjenette,F,100,82,0,82
Darielis,F,100,13,0,13
Marquon,M,100,0,198,198
Libeth,F,100,5,0,5
Addie,F,99,8768,51,8819
Eveline,F,100,1014,0,1014
Keontay,M,98,5,309,314
Greysyn,M,100,0,20,20
Tedman,M,100,0,25,25
Verenize,F,100,15,0,15
Gillyan,F,100,16,0,16
Shertia,F,100,5,0,5
Sushanth,M,100,0,30,30
Abriam,M,100,0,5,5
Jaworski,M,100,0,58,58
Lu,F,100,2909,6,2915
Aliscia,F,100,269,0,269
Azelynn,F,100,29,0,29
Johnmarco,M,100,0,5,5
Kamion,M,100,0,5,5
Lakeland,M,75,5,15,20
Marquas,M,100,0,5,5
Valek,M,100,0,28,28
Harrel,M,100,0,171,171
Benjie,M,96,31,838,869
Kamaira,F,100,28,0,28
Elyes,M,100,0,18,18
Jayonn,M,100,0,11,11
Raynathan,M,100,0,7,7
Nazaire,M,100,0,93,93
Vismaya,F,100,5,0,5
Anadia,F,100,74,0,74
Titan,M,100,0,1884,1884
Maynard,M,100,0,3100,3100
Anav,M,100,0,13,13
Robertta,F,100,31,0,31
Ariston,M,100,0,226,226
Monya,F,100,572,0,572
Ragena,F,100,57,0,57
Ziniyah,F,100,11,0,11
Monterious,M,100,0,38,38
Dannie,M,85,952,5467,6419
Zula,F,100,173,0,173
Cailynne,F,100,22,0,22
Rey,M,100,0,6157,6157
Burtis,M,100,0,72,72
Geraldi,F,100,10,0,10
Malcum,M,100,0,6,6
Dywana,F,100,12,0,12
Cluster,M,100,0,7,7
Caraline,F,100,784,0,784
Quintesa,F,100,5,0,5
Joaovitor,M,100,0,5,5
Daenerys,F,100,175,0,175
Cattina,F,100,15,0,15
Sylva,F,100,79,0,79
Arikah,F,100,5,0,5
Zi,F,54,57,48,105
Harnoor,F,72,205,79,284
Matthewjohn,M,100,0,10,10
Azah,F,100,5,0,5
Joyse,F,100,5,0,5
Lashaune,F,100,26,0,26
Jabari,M,100,0,7258,7258
Maly,F,100,194,0,194
Donniesha,F,100,34,0,34
Neldon,M,100,0,18,18
Aleathia,F,100,63,0,63
Jeylin,F,100,217,0,217
Nurto,F,100,13,0,13
Venba,F,100,23,0,23
Immani,F,100,18,0,18
Tiyah,F,100,89,0,89
Meris,F,100,49,0,49
Laleh,F,100,51,0,51
Kemira,F,100,19,0,19
Sharryl,F,100,30,0,30
Laquisa,F,100,47,0,47
Jalante,M,100,0,7,7
Tylina,F,100,15,0,15
Pasqual,M,100,0,157,157
Armelle,F,100,14,0,14
Simmie,M,98,10,396,406
Nuriel,M,100,0,49,49
Deisy,F,100,2645,0,2645
Drelynn,M,61,12,19,31
Jonwesley,M,100,0,5,5
Temima,F,100,175,0,175
Deeba,F,100,36,0,36
Vira,F,100,139,0,139
Flesha,F,100,7,0,7
Nikata,F,100,5,0,5
Catalaya,F,100,172,0,172
Aymaan,M,100,0,26,26
Donecia,F,100,40,0,40
Theone,F,93,64,5,69
Chery,F,100,519,0,519
Kairon,M,100,0,186,186
Kipchoge,M,100,0,7,7
Taji,M,76,125,395,520
Conquista,F,100,9,0,9
Almeta,F,100,432,0,432
Lashawnda,F,100,2226,0,2226
Frazer,M,100,0,37,37
Madolyn,F,100,788,0,788
Riyad,M,100,0,259,259
Corryn,F,100,632,0,632
Jamene,F,100,5,0,5
Teral,M,100,0,5,5
Torrien,M,100,0,43,43
Avayah,F,100,310,0,310
Delesa,F,100,66,0,66
Kyanne,F,100,294,0,294
Knylah,F,100,8,0,8
Tremel,M,100,0,337,337
Korla,F,100,12,0,12
Dave,M,100,48,37187,37235
Mickayla,F,100,1733,0,1733
Sharina,F,100,1043,0,1043
Nija,F,98,814,19,833
Jaisen,M,100,0,201,201
Cadience,F,100,80,0,80
Myrka,F,100,523,0,523
Katelyn,F,100,127809,161,127970
Yubia,F,100,34,0,34
Romari,M,100,0,33,33
Nancyjean,F,100,6,0,6
Aretzi,F,100,6,0,6
Sarika,F,100,482,0,482
Joshuel,M,100,0,24,24
Hildie,F,100,7,0,7
Rhinda,F,100,5,0,5
Kaheim,M,100,0,20,20
Shenisha,F,100,11,0,11
Johanah,F,100,5,0,5
Soleil,F,100,2697,0,2697
Kimberlyn,F,100,3380,0,3380
Montaya,F,100,44,0,44
Laquita,F,100,5651,0,5651
Kanessha,F,100,6,0,6
Gregry,M,100,0,32,32
Yecheskel,M,100,0,260,260
Ysamar,F,100,42,0,42
Braysen,M,100,0,294,294
Romelle,M,50,128,130,258
Allicen,F,100,18,0,18
Toccarra,F,100,60,0,60
Danelly,F,100,222,0,222
Kashtin,M,100,0,9,9
Dmarian,M,100,0,5,5
Casina,F,100,5,0,5
Mechel,M,59,70,99,169
Elii,M,100,0,27,27
Emmaneul,M,100,0,5,5
Maryam,F,100,6620,0,6620
Aliviya,F,100,107,0,107
Lucelia,F,100,46,0,46
Devanie,F,100,360,0,360
Vai,M,100,0,5,5
Shonnette,F,100,39,0,39
Jasiana,F,100,5,0,5
Akilia,F,100,5,0,5
Devarious,M,100,0,64,64
Rayza,F,100,40,0,40
Brevan,M,100,0,199,199
Breeona,F,100,145,0,145
Albeiro,M,100,0,83,83
Hritika,F,100,5,0,5
Neimiah,M,100,0,15,15
Shuri,F,100,5,0,5
Khonor,M,100,0,8,8
Nicoe,F,100,6,0,6
Bali,F,100,47,0,47
Amadou,M,100,0,774,774
Shawniqua,F,100,50,0,50
Lauraann,F,100,235,0,235
Yadiel,M,100,0,1842,1842
Deb,F,100,1450,0,1450
Baptiste,M,100,0,33,33
Aissatou,F,100,577,0,577
Chrysanthia,F,100,6,0,6
Zameria,F,100,70,0,70
Morayma,F,100,119,0,119
Loudon,M,100,0,97,97
Lamario,M,100,0,536,536
Tobius,M,100,0,21,21
Jahara,F,97,160,5,165
Skylarmarie,F,100,5,0,5
Kritika,F,100,141,0,141
Chelce,F,100,58,0,58
Renaee,F,100,15,0,15
Macey,F,100,9663,18,9681
Maylani,F,100,214,0,214
Kihanna,F,100,71,0,71
Adaysha,F,100,61,0,61
Araelynn,F,100,5,0,5
Tiiu,F,100,5,0,5
Mashonda,F,100,120,0,120
Amyrah,F,100,319,0,319
Sherrel,F,99,565,7,572
Janean,F,100,1381,0,1381
Ivyana,F,100,210,0,210
Camiyah,F,100,397,0,397
Nadrea,F,100,5,0,5
Janene,F,100,3124,0,3124
Kynslee,F,100,649,0,649
Skylar,F,75,47236,15986,63222
Medgar,M,100,0,46,46
Maurya,F,93,125,10,135
Martinjr,M,100,0,31,31
Sylver,F,95,102,5,107
Kimone,F,100,5,0,5
Kaeshawn,M,100,0,13,13
Zijun,M,100,0,5,5
Peregrin,M,100,0,21,21
Velton,M,100,0,246,246
Altouise,F,100,17,0,17
Joby,M,94,68,1083,1151
Tayshon,M,100,0,213,213
Tabethia,F,100,28,0,28
Yisroel,M,100,0,4246,4246
Melonie,F,100,5188,0,5188
Tereatha,F,100,23,0,23
Alessya,F,100,6,0,6
Briara,F,100,54,0,54
Gayatri,F,100,227,0,227
Dipak,M,100,0,5,5
Joeliz,F,100,27,0,27
Calahan,M,100,0,153,153
Laurencia,F,100,62,0,62
Tulio,M,100,0,193,193
Alando,M,100,0,232,232
Ikeda,F,100,5,0,5
Hawke,M,100,0,73,73
Cleavon,M,100,0,222,222
Mohd,M,100,0,87,87
Laanthony,M,100,0,5,5
Blayze,M,97,26,720,746
Anetta,F,100,272,0,272
Morgynn,F,100,11,0,11
Vyktoria,F,100,31,0,31
Kesten,M,100,0,8,8
Khelan,M,100,0,20,20
Asmaa,F,100,685,0,685
Boaz,M,100,0,1297,1297
Marquasha,F,100,106,0,106
Maricsa,F,100,101,0,101
Yolana,F,100,5,0,5
Mariyha,F,100,10,0,10
Joshuar,M,100,0,5,5
Tatelyn,F,100,64,0,64
Winnona,F,100,19,0,19
Orenthial,M,100,0,29,29
Philecia,F,100,33,0,33
Charlla,F,100,5,0,5
Demitrius,M,99,11,1784,1795
Rahniyah,F,100,17,0,17
Content,F,100,5,0,5
Aquan,M,100,0,137,137
Kelcei,F,100,5,0,5
Joanelle,F,100,29,0,29
Leonda,F,100,198,0,198
Icis,F,100,183,0,183
Not,M,100,0,12,12
Danual,M,100,0,5,5
Taygen,F,55,160,129,289
Kherington,F,100,361,0,361
Lesleyanne,F,100,80,0,80
Clerissa,F,100,30,0,30
Paulos,M,100,0,22,22
Finn,M,98,193,11909,12102
Shilah,F,100,759,0,759
Daisuke,M,100,0,131,131
Ebelina,F,100,11,0,11
Keigen,M,100,0,64,64
Jveon,M,100,0,135,135
Zakar,M,100,0,50,50
Treyvon,M,100,0,3368,3368
Rykeem,M,100,0,17,17
Makelle,F,100,127,0,127
Jnyia,F,100,17,0,17
Ktherine,F,100,5,0,5
Caswell,M,100,0,91,91
Gwana,F,100,10,0,10
Velan,M,100,0,5,5
Anslie,F,100,199,0,199
Tobyas,M,100,0,10,10
Mikayeel,M,100,0,7,7
Maico,M,100,0,115,115
Sidnee,F,100,601,0,601
Albesa,F,100,10,0,10
Mayel,M,100,0,11,11
Naif,M,100,0,67,67
Eshwar,M,100,0,49,49
Christiane,F,100,2173,6,2179
Nakaila,F,100,73,0,73
Saania,F,100,11,0,11
Kessley,F,100,5,0,5
Krishell,F,100,5,0,5
Abdinajib,M,100,0,5,5
Gjon,M,100,0,62,62
Avaelizabeth,F,100,10,0,10
Jaedon,M,98,33,1987,2020
Jaelene,F,100,378,0,378
Bailly,F,100,20,0,20
Reylin,F,72,13,5,18
Yahweh,M,100,0,17,17
Jozey,F,100,72,0,72
Angeluis,M,100,0,5,5
Bonnitta,F,100,10,0,10
Tiffney,F,100,1138,0,1138
Zigmund,M,100,0,40,40
Laricia,F,100,10,0,10
Vijay,M,100,0,1415,1415
Jomeka,F,100,10,0,10
Bhavika,F,100,68,0,68
Navika,F,100,35,0,35
Gerold,M,100,0,1311,1311
Yosmar,M,100,0,110,110
Kardae,M,100,0,16,16
Azelia,F,100,231,0,231
Massi,M,100,0,11,11
Andruw,M,100,0,504,504
Taraneka,F,100,6,0,6
Seneca,M,52,1441,1537,2978
Ryilee,F,100,21,0,21
Nida,F,100,901,0,901
Kambre,F,100,56,0,56
Dindi,F,100,5,0,5
Asauni,F,100,6,0,6
Lesheka,F,100,5,0,5
Eniah,F,100,35,0,35
Minerba,F,100,11,0,11
Treron,M,100,0,21,21
Kinlie,F,100,64,0,64
Alyson,F,100,26690,10,26700
Tatanisha,F,100,586,0,586
Antina,F,100,32,0,32
Dyshawn,M,100,0,287,287
Ville,M,100,0,15,15
Dovber,M,100,0,77,77
Emmajo,F,100,118,0,118
Kajaun,M,100,0,11,11
Avagail,F,100,61,0,61
Artavius,M,100,0,365,365
Jephthe,M,100,0,12,12
Adalise,F,100,31,0,31
Jozette,F,100,482,0,482
Shabnam,F,100,409,0,409
Tarique,M,100,0,319,319
Lidiana,F,100,51,0,51
Cajun,M,100,0,33,33
Minette,F,100,403,0,403
Bailyn,F,92,177,15,192
Lenore,F,100,6600,0,6600
Roslin,F,100,150,0,150
Dylahn,M,100,0,12,12
Kaiana,F,100,153,0,153
Cova,F,100,6,0,6
Ardon,M,100,0,18,18
Josy,F,100,72,0,72
Chealsy,F,100,37,0,37
Nykeia,F,100,17,0,17
Krenar,M,100,0,5,5
Sumeya,F,100,164,0,164
Demion,M,100,0,10,10
Lexxie,F,100,116,0,116
Zair,M,100,0,285,285
Kaisyn,M,62,64,105,169
Nuriah,F,100,27,0,27
Alaja,F,100,165,0,165
Sanquan,M,100,0,7,7
Celiana,F,100,9,0,9
Jaymere,M,100,0,130,130
Ronada,F,100,36,0,36
Sadonte,M,100,0,6,6
Rheann,F,100,55,0,55
Taytum,F,88,1327,184,1511
Tequarius,M,100,0,7,7
Yadria,F,100,5,0,5
Rathana,M,80,13,51,64
Marjory,F,100,1419,0,1419
Demariona,F,100,5,0,5
Roark,M,100,0,338,338
Kiayah,F,100,5,0,5
Tzuriel,M,100,0,27,27
Avrilynn,F,100,5,0,5
Mayrin,F,100,902,0,902
Marelie,F,100,17,0,17
Francellia,F,100,8,0,8
Shalandria,F,100,105,0,105
Sophieanne,F,100,14,0,14
Layson,M,100,0,73,73
Gorden,M,100,0,517,517
Brein,F,100,18,0,18
Aurra,F,100,5,0,5
Laksh,M,100,0,112,112
Sharquita,F,100,41,0,41
Tellie,F,100,16,0,16
Jonney,M,100,0,5,5
Darita,F,100,15,0,15
Candas,F,100,168,0,168
Daxyn,M,100,0,5,5
Fanuel,M,100,0,11,11
Khiry,M,99,7,992,999
Leatricia,F,100,5,0,5
Tkeyah,F,100,1020,0,1020
Krystalrose,F,100,5,0,5
Sabastian,M,100,0,2961,2961
Bahja,F,100,100,0,100
Marcelles,M,100,0,92,92
Becci,F,100,122,0,122
Eduan,M,100,0,5,5
Afeef,M,100,0,11,11
Aldair,M,100,0,1127,1127
Maryellen,F,100,8259,0,8259
Chrisley,F,100,8,0,8
Myanh,F,100,5,0,5
Carmaletta,F,100,5,0,5
Ollis,M,100,0,43,43
Pernell,M,99,33,2547,2580
Nyajah,F,100,111,0,111
Albany,F,100,564,0,564
Jahaira,F,100,1397,0,1397
Quandarious,M,100,0,16,16
Carlie,F,97,12712,379,13091
Samus,F,100,9,0,9
Suen,M,100,0,5,5
Birney,M,100,0,5,5
Alishba,F,100,368,0,368
Evaggelia,F,100,10,0,10
Nyeema,F,100,141,0,141
Carols,M,100,0,129,129
Kyrsti,F,100,40,0,40
Donel,M,93,30,426,456
Abbygayle,F,100,417,0,417
Lesliee,F,100,8,0,8
Hiedi,F,100,1033,0,1033
Ahriyah,F,100,33,0,33
Kishore,M,100,0,30,30
Gracen,F,73,1560,584,2144
Leola,F,100,3363,0,3363
Tyri,M,100,0,95,95
Jettson,M,100,0,48,48
Keish,F,100,11,0,11
Karilee,F,100,43,0,43
Romesha,F,100,79,0,79
Eyas,M,100,0,9,9
Tydell,M,100,0,21,21
Neithen,M,100,0,10,10
Brinlyn,F,100,30,0,30
Aayan,M,100,0,883,883
Benilda,F,100,5,0,5
Yevetta,F,100,5,0,5
Assia,F,100,50,0,50
Savannaha,F,100,129,0,129
Kokoro,F,100,11,0,11
Monce,F,100,10,0,10
Jeani,F,100,359,0,359
Luis,M,99,1417,248075,249492
Erandy,F,100,318,0,318
Javona,F,100,231,0,231
Galaxie,F,100,6,0,6
Ubaid,M,100,0,30,30
Shandella,F,100,5,0,5
Jodeen,F,100,317,0,317
Ginelle,F,100,479,0,479
Colson,M,100,0,1980,1980
Giannina,F,100,309,0,309
Jahmire,M,100,0,93,93
Shaiya,F,100,31,0,31
Sharleez,F,100,6,0,6
Jassmin,F,100,294,0,294
Amor,F,81,907,209,1116
Dahquan,M,100,0,5,5
Adeana,F,100,187,0,187
Drema,F,100,1798,0,1798
Kailena,F,100,61,0,61
Domeeka,F,100,6,0,6
Yaressi,F,100,7,0,7
Makenize,F,100,96,0,96
Rondol,M,100,0,5,5
Carys,F,100,1824,0,1824
Dannye,M,100,0,24,24
Chanson,M,100,0,142,142
Evrin,M,100,0,13,13
Queren,F,100,5,0,5
Yackelin,F,100,36,0,36
Rikayla,F,100,83,0,83
Maimuna,F,100,160,0,160
Lasiah,F,100,6,0,6
Jahlin,M,100,0,25,25
Jozelle,F,100,11,0,11
Kyell,M,100,0,23,23
Ambra,F,100,885,0,885
Shalei,F,100,49,0,49
Vanely,F,100,24,0,24
Dacey,F,100,583,0,583
Lileah,F,100,24,0,24
Kathyren,F,100,29,0,29
Tervin,M,100,0,5,5
Aubreella,F,100,5,0,5
Melvine,F,79,45,12,57
Azaliah,F,100,177,0,177
Abdelhadi,M,100,0,5,5
Vikita,F,100,7,0,7
Annalyn,F,100,792,0,792
Keveon,M,100,0,191,191
Janiyan,F,100,6,0,6
Dayamit,F,100,5,0,5
Princeten,M,100,0,5,5
Ery,M,100,0,6,6
Rossibell,F,100,17,0,17
Onalee,F,100,208,0,208
Sorraya,F,100,5,0,5
Malicia,F,100,110,0,110
Zohara,F,100,35,0,35
Elfrida,F,100,38,0,38
Jimme,M,100,0,12,12
Ineshia,F,100,31,0,31
Prestyn,M,81,127,534,661
Jabien,M,100,0,8,8
Dontarious,M,100,0,102,102
Paarth,M,100,0,96,96
Jadie,F,98,682,11,693
Neeson,M,100,0,6,6
Navin,M,100,0,692,692
Tenneh,F,100,5,0,5
Fernando,M,99,578,85962,86540
Jhosmar,M,100,0,12,12
Leshay,F,100,172,0,172
Stephanee,F,100,515,0,515
Abigaille,F,100,27,0,27
Altaira,F,100,8,0,8
Ishta,F,100,5,0,5
Nazifa,F,100,112,0,112
Aden,M,97,512,16316,16828
Fjolla,F,100,5,0,5
Mysean,M,100,0,16,16
Rayna,F,100,8795,0,8795
Aysel,F,100,95,0,95
Leomar,M,100,0,98,98
Bosco,M,100,0,155,155
Lynnette,F,100,13245,0,13245
Zoya,F,100,2115,0,2115
Leaya,F,100,33,0,33
Dazie,F,100,29,0,29
Donese,F,100,6,0,6
Darhonda,F,100,33,0,33
Cherene,F,100,179,0,179
Jdynn,M,100,0,5,5
Timothy,M,100,4151,1005129,1009280
Amya,F,100,8339,0,8339
Angenique,F,100,6,0,6
Verlena,F,100,115,0,115
Constanza,F,100,539,0,539
Shaquashia,F,100,11,0,11
Althena,F,100,12,0,12
Rocheal,F,100,15,0,15
Layliana,F,100,76,0,76
Giovann,M,100,0,42,42
Jiara,F,100,5,0,5
Kahli,F,78,306,84,390
Camyria,F,100,5,0,5
Trung,M,100,0,760,760
Abigayl,F,100,322,0,322
Farynn,F,100,5,0,5
Chaselyn,F,100,120,0,120
Graciemae,F,100,93,0,93
Aveanna,F,100,30,0,30
Janascia,F,100,7,0,7
Crishawn,M,100,0,39,39
Maggee,F,100,28,0,28
Rhonan,M,100,0,7,7
Romilly,F,100,12,0,12
Shamonte,F,56,22,17,39
Angelino,M,100,0,251,251
Zuleica,F,100,157,0,157
Timora,F,100,23,0,23
Hema,F,100,159,0,159
Kyuana,F,100,5,0,5
Sundown,F,67,12,6,18
Yasim,M,100,0,23,23
Latrelle,F,59,332,235,567
Daylynn,F,90,266,29,295
Maricelys,F,100,5,0,5
Saaim,M,100,0,6,6
Alema,M,100,0,21,21
Lexi,F,100,19213,0,19213
Jaidi,F,100,5,0,5
Jhoselyne,F,100,5,0,5
Tejash,M,100,0,6,6
Taleea,F,100,45,0,45
Dukens,M,100,0,5,5
Tyrik,M,100,0,1280,1280
Anijah,F,100,1175,0,1175
Ashlon,F,93,68,5,73
Davidjohn,M,100,0,17,17
Zianah,F,100,5,0,5
Awet,M,100,0,9,9
Terrico,M,100,0,35,35
Claris,F,100,61,0,61
Khadjiah,F,100,10,0,10
Dynisha,F,100,180,0,180
Candia,F,100,210,0,210
Jmaya,F,100,17,0,17
Siddanth,M,100,0,16,16
Makiyla,F,100,103,0,103
Milei,F,100,27,0,27
Kadejha,F,100,12,0,12
Haziel,M,99,5,560,565
Issela,F,100,5,0,5
Juleisy,F,100,9,0,9
Emaje,M,100,0,5,5
Annalaura,F,100,76,0,76
Tikara,F,100,18,0,18
Jaelee,F,100,299,0,299
Jarris,M,100,0,136,136
Moani,F,100,53,0,53
Zayley,F,100,83,0,83
Jerelyn,F,100,609,0,609
Lenetta,F,100,292,0,292
Suhrit,M,100,0,5,5
Heart,F,100,16,0,16
Aderemi,M,100,0,6,6
Antrina,F,100,10,0,10
Anir,M,100,0,22,22
Arville,M,100,0,119,119
Deshaundra,F,100,21,0,21
Gennifer,F,100,1166,0,1166
Naresh,M,100,0,80,80
Eileena,F,100,31,0,31
Jareo,M,100,0,14,14
Lamese,F,100,5,0,5
Tejon,M,100,0,167,167
Evangela,F,100,310,0,310
Jaxen,M,99,44,3103,3147
Senay,M,100,0,47,47
Agha,M,100,0,11,11
Davanie,F,100,12,0,12
Cadynce,F,100,243,0,243
Bayleigh,F,100,3461,0,3461
Clee,M,100,0,35,35
Nathanel,M,100,0,638,638
Reece,M,82,3227,14512,17739
Yolande,F,100,817,0,817
Ailis,F,100,140,0,140
Cordale,M,100,0,534,534
Brodric,M,100,0,101,101
Duain,M,100,0,25,25
Atravion,M,100,0,5,5
Matilee,F,100,5,0,5
Agam,M,59,76,109,185
Lujack,M,100,0,5,5
Sharmeka,F,100,91,0,91
Donnal,M,100,0,25,25
Suzette,F,100,14858,5,14863
Delante,M,100,0,679,679
Jazz,M,59,465,674,1139
Gadsden,M,100,0,9,9
Tirsa,F,100,122,0,122
Lakasha,F,100,308,0,308
Narrissa,F,100,6,0,6
Jeptha,M,100,0,50,50
Denee,F,100,912,0,912
Lateasa,F,100,13,0,13
Kailene,F,100,202,0,202
Jeannett,F,100,365,0,365
Satyana,F,100,12,0,12
Olha,F,100,8,0,8
Adeleke,M,100,0,5,5
Orhan,M,100,0,80,80
Kabron,M,100,0,11,11
Abbigayl,F,100,29,0,29
Vantrell,M,100,0,11,11
Nakaiya,F,100,140,0,140
Tasya,F,100,54,0,54
Cathlina,F,100,5,0,5
Jazaiya,F,100,5,0,5
Stephinie,F,100,80,0,80
Abdulrahim,M,100,0,87,87
Volvy,M,100,0,10,10
Yechiel,M,100,0,1239,1239
Aryia,F,100,215,0,215
Tifani,F,100,872,0,872
Kantrice,F,100,5,0,5
Denaly,F,100,67,0,67
Deyannah,F,100,5,0,5
Gregg,M,100,113,33383,33496
Yousuf,M,100,0,814,814
Sharonna,F,100,154,0,154
Shanquilla,F,100,23,0,23
Gini,F,100,469,0,469
Zean,M,100,0,12,12
Salma,F,100,6841,5,6846
Deirdra,F,100,1130,0,1130
Laurielle,F,100,68,0,68
Indianna,F,100,34,0,34
Bansi,F,100,6,0,6
Breean,F,100,110,0,110
Kial,M,100,0,20,20
Haydar,M,100,0,17,17
Candelaria,F,100,1401,0,1401
Avalea,F,100,36,0,36
Jabrion,M,100,0,11,11
Adamarie,F,100,116,0,116
Winnette,F,100,12,0,12
Ninfa,F,100,1233,0,1233
Emya,F,100,408,0,408
Quinleigh,F,100,5,0,5
Rwanda,F,100,10,0,10
Shakora,F,100,92,0,92
Edmilson,M,100,0,6,6
Dametri,M,100,0,93,93
Lossie,F,100,78,0,78
Darine,F,100,10,0,10
Nayima,F,100,21,0,21
Tahel,F,100,10,0,10
Yimi,M,100,0,14,14
Miniyah,F,100,9,0,9
Nayomie,F,100,32,0,32
Anatole,M,100,0,69,69
Milani,F,100,1806,0,1806
Jasona,F,100,5,0,5
Howie,M,100,0,581,581
Dmarion,M,100,0,492,492
Maiara,F,100,26,0,26
Ethelle,F,100,5,0,5
Luree,F,100,35,0,35
Tanayia,F,100,80,0,80
Linnett,F,100,10,0,10
Leonnah,F,100,5,0,5
Obdulia,F,100,128,0,128
Jadeah,F,100,11,0,11
Yasmine,F,100,11948,5,11953
Lilika,F,100,16,0,16
Yashica,F,100,1041,0,1041
Abaigael,F,100,13,0,13
Rameka,F,100,37,0,37
Harlis,M,100,0,23,23
Talha,M,100,0,637,637
Bardia,M,100,0,57,57
Deiara,F,100,5,0,5
Khizar,M,100,0,55,55
Ziara,F,100,358,0,358
Jeong,M,100,0,5,5
Pramit,M,100,0,5,5
Galilee,F,100,176,0,176
Kayllie,F,100,6,0,6
Puanani,F,100,67,0,67
Lamaine,M,100,0,7,7
Jaudiel,M,100,0,5,5
Jeresa,F,100,5,0,5
Antaniya,F,100,77,0,77
Elia,F,88,4812,653,5465
Nency,F,100,15,0,15
Grindl,F,100,41,0,41
Jamella,F,100,433,0,433
Jorje,M,100,0,1127,1127
Xachery,M,100,0,5,5
Sheaira,F,100,5,0,5
Jocene,F,100,6,0,6
Levaeh,F,100,45,0,45
Antwanique,F,100,45,0,45
Staceyann,F,100,70,0,70
Ginnie,F,100,617,0,617
Canesha,F,100,161,0,161
Quinnley,F,100,57,0,57
Lashae,F,100,1554,0,1554
Robart,M,100,0,18,18
Yasiel,M,100,0,194,194
Jiali,F,100,79,0,79
Celetha,F,100,5,0,5
Janellen,F,100,22,0,22
Arisdelsy,F,100,7,0,7
Khylah,F,100,44,0,44
Airick,M,100,0,21,21
Tvisha,F,100,193,0,193
Wynton,M,100,0,467,467
Llamile,F,100,6,0,6
Rosse,F,100,23,0,23
Jaydeen,F,51,77,73,150
Lillienne,F,100,34,0,34
Brely,F,100,30,0,30
Rawda,F,100,22,0,22
Tadhg,M,100,0,265,265
Lionardo,M,100,0,108,108
Ancy,F,100,16,0,16
Daimond,F,100,5,0,5
Dedre,F,100,44,0,44
Johary,M,100,0,5,5
Manha,F,100,444,0,444
Amirie,F,100,5,0,5
Yasheka,F,100,87,0,87
Derrell,M,100,16,4516,4532
Kateshia,F,100,11,0,11
Davidson,M,100,0,829,829
Rayla,F,100,628,0,628
Nemiah,M,54,72,85,157
Adejah,F,100,30,0,30
Arnela,F,100,43,0,43
Cmya,F,100,15,0,15
Jahvari,M,100,0,7,7
Tesfa,M,100,0,38,38
Necha,F,100,50,0,50
Natilynn,F,100,17,0,17
Tsvia,F,100,5,0,5
Wain,M,100,0,5,5
Orrie,M,97,6,168,174
Patick,M,100,0,47,47
Mashona,F,100,24,0,24
Reynier,M,100,0,11,11
Adaleigh,F,100,562,0,562
Vestal,M,100,0,28,28
Abbey,F,100,16648,19,16667
Johntyler,M,100,0,10,10
Winterrose,F,100,10,0,10
Dayn,M,100,0,69,69
Advaita,F,100,18,0,18
Britannia,F,100,10,0,10
Chenay,F,100,61,0,61
Hernando,M,100,0,700,700
Kennet,M,100,0,177,177
Trunell,M,100,0,5,5
Dasja,F,100,77,0,77
Natalee,F,100,8457,0,8457
Mal,M,100,0,133,133
Myja,F,100,20,0,20
Deannie,F,100,67,0,67
Dangello,M,100,0,7,7
Celisha,F,100,5,0,5
Kaston,M,100,0,173,173
Josephandrew,M,100,0,5,5
Snithik,M,100,0,18,18
Trana,F,100,119,0,119
Garth,M,100,0,6794,6794
Lorriann,F,100,63,0,63
Mahamed,M,100,0,288,288
Brydie,F,100,5,0,5
Darrek,M,100,0,111,111
Tobie,F,64,1193,683,1876
Danaca,F,100,16,0,16
Hazelann,F,100,5,0,5
Uria,M,100,0,5,5
Byron,M,100,249,56594,56843
Islam,M,79,128,490,618
Vannah,F,100,62,0,62
Charmarie,F,100,18,0,18
Dorismar,F,100,175,0,175
Centeria,F,100,15,0,15
Keiari,F,100,5,0,5
Catie,F,100,932,0,932
Vikas,M,100,0,520,520
Reyyan,F,100,5,0,5
Vienne,F,100,151,0,151
Quinne,F,100,122,0,122
Tabious,M,100,0,5,5
Hewlett,M,100,0,5,5
Bryceton,M,100,0,308,308
Stonewall,M,100,0,101,101
Jimar,M,100,0,23,23
Nicle,F,100,87,0,87
Treda,F,100,5,0,5
Marcin,M,100,0,428,428
Yohandry,M,100,0,6,6
Darain,M,100,0,42,42
Markk,M,100,0,5,5
Agapito,M,100,0,804,804
Paiten,F,96,383,15,398
Jawaun,M,100,0,803,803
Nadir,M,100,0,1002,1002
Fidelis,M,100,0,20,20
Jamhal,M,100,0,5,5
Lexys,F,100,69,0,69
Standford,M,100,0,15,15
Jaqualine,F,100,18,0,18
Elwin,M,100,0,1254,1254
Sentrell,M,100,0,5,5
Vasthi,F,100,13,0,13
Dani,F,90,6633,761,7394
Auggie,M,100,0,5,5
Sundance,M,93,5,65,70
Caneshia,F,100,41,0,41
Lesliann,F,100,6,0,6
Alhassane,M,100,0,26,26
Saleyah,F,100,5,0,5
Briston,M,100,0,320,320
Cynarra,F,100,7,0,7
Alacia,F,100,474,0,474
Leaman,M,100,0,5,5
Barnell,M,100,0,57,57
Yaneira,F,100,33,0,33
Masun,M,100,0,44,44
Joyann,F,100,354,0,354
Imre,M,100,0,112,112
Jaffar,M,100,0,26,26
Monay,F,100,506,0,506
Drennan,M,100,0,28,28
Santiago,M,100,61,41927,41988
Harrell,M,100,0,1026,1026
Jackaline,F,100,21,0,21
Chloelynn,F,100,34,0,34
Caeley,F,100,422,0,422
Nixie,F,100,222,0,222
Oluwatobiloba,M,83,23,112,135
Omoro,M,100,0,38,38
Kasydi,F,100,5,0,5
Sevryn,M,100,0,16,16
Cristalyn,F,100,5,0,5
Rielee,F,100,17,0,17
Ricado,M,100,0,5,5
Jace,M,99,586,47293,47879
Kaesin,M,100,0,21,21
Glenford,M,100,0,198,198
Samarian,F,100,5,0,5
Marysa,F,100,543,0,543
Meggan,F,100,2928,0,2928
Ameria,F,100,505,0,505
Mohan,M,100,0,207,207
Dezmand,M,100,0,5,5
Mitchel,M,100,22,10840,10862
Bevelyn,F,100,156,0,156
Dekeshia,F,100,10,0,10
Mikenlee,F,100,7,0,7
Jesiah,M,96,85,1907,1992
Shadie,F,84,87,16,103
Chuy,M,100,0,11,11
Clarece,F,100,10,0,10
Timmeshia,F,100,6,0,6
Belicia,F,100,554,0,554
Sanaiah,F,100,54,0,54
Nitish,M,100,0,83,83
Cebrina,F,100,31,0,31
Tel,M,100,0,162,162
Nesly,F,90,47,5,52
Braylenn,M,55,5,6,11
Leilanny,F,100,59,0,59
Athenna,F,100,5,0,5
Jasun,M,100,0,156,156
Damie,F,75,18,6,24
Willian,M,100,5,1808,1813
Dylhan,M,100,0,7,7
Naasia,F,100,153,0,153
Joeseph,M,100,0,2027,2027
Akara,F,100,21,0,21
Erivan,M,100,0,5,5
Kamyiah,F,100,186,0,186
Jonael,M,100,0,6,6
Lucea,F,100,10,0,10
Levent,M,100,0,71,71
Shadman,M,100,0,146,146
Jeddie,M,100,0,5,5
Nagwa,F,100,10,0,10
Caleob,M,100,0,6,6
Shayquan,M,100,0,53,53
Treauna,F,100,12,0,12
Addysin,F,100,91,0,91
Mubin,M,100,0,5,5
Dimitre,M,100,0,18,18
Kase,M,100,0,1616,1616
Emerly,F,100,39,0,39
Murline,F,100,35,0,35
Aaqil,M,100,0,28,28
Zamyra,F,100,149,0,149
Auturo,M,100,0,17,17
Nayleen,F,100,192,0,192
Escarlett,F,100,22,0,22
Levid,M,100,0,6,6
Rayniyah,F,100,41,0,41
Maddock,M,100,0,108,108
Aryhanna,F,100,21,0,21
Brinleigh,F,100,240,0,240
Ramsi,F,100,5,0,5
Brescia,F,100,5,0,5
Nafisa,F,100,392,0,392
Jenet,F,100,91,0,91
Timiothy,M,100,0,10,10
Loc,M,100,0,274,274
Kiffin,F,100,5,0,5
Dnylah,F,100,30,0,30
Tatayanna,F,100,23,0,23
Charlin,F,100,37,0,37
Demeris,M,100,0,5,5
Janirah,F,100,15,0,15
Rulon,M,100,0,437,437
Eria,F,100,35,0,35
Kaiyla,F,100,165,0,165
Maghan,F,100,496,0,496
Alaia,F,100,537,0,537
Lasaro,M,100,0,77,77
Maijor,M,100,0,37,37
Oza,M,100,0,10,10
Dalana,F,100,603,0,603
Raeden,M,63,63,107,170
Airiana,F,100,503,0,503
Trapper,M,100,0,738,738
Nishon,M,100,0,5,5
Lanaiya,F,100,174,0,174
Duc,M,100,0,410,410
Adrieonna,F,100,5,0,5
Twilah,F,100,5,0,5
Dennetta,F,100,10,0,10
Madelen,F,100,50,0,50
Nattalee,F,100,11,0,11
Jesa,F,100,48,0,48
Ajia,F,100,598,0,598
Jesseca,F,100,1498,0,1498
Lynis,F,100,5,0,5
Recardo,M,100,0,655,655
Quantisha,F,100,117,0,117
Myrone,M,100,0,5,5
Steed,M,100,0,62,62
Soyoung,F,100,7,0,7
Angelete,F,100,22,0,22
Christye,F,100,32,0,32
Ecstasy,F,100,10,0,10
Nazario,M,100,0,619,619
Zaysha,F,100,13,0,13
Schuylar,F,61,28,18,46
Previn,M,100,0,68,68
Malcon,M,100,0,12,12
Jaeya,F,100,22,0,22
Hilton,M,100,11,2777,2788
Tenice,F,100,6,0,6
Khirsten,F,100,10,0,10
Khennedi,F,100,19,0,19
Kinnie,M,100,0,65,65
Cutter,M,100,0,1237,1237
Emmelee,F,100,5,0,5
Arkeba,F,100,5,0,5
Saby,F,100,32,0,32
Gaya,F,100,52,0,52
Lucie,F,100,3553,0,3553
Likhitha,F,100,5,0,5
Tevin,M,99,59,10655,10714
Gilian,F,100,14,0,14
Gwenyvere,F,100,5,0,5
Edenrose,F,100,5,0,5
Nhu,F,100,354,0,354
Danquan,M,100,0,10,10
Olegario,M,100,0,333,333
Lawsen,M,100,0,90,90
Aisleen,F,100,36,0,36
Blaze,M,93,376,5154,5530
Oh,M,100,0,5,5
Roslynn,F,100,924,0,924
Glennetta,F,100,32,0,32
Dannita,F,100,14,0,14
Darrill,M,100,0,48,48
Rayni,F,100,104,0,104
Terique,M,100,0,68,68
Keemo,M,100,0,7,7
Rinda,F,100,557,0,557
Richardson,M,100,0,482,482
Aaden,M,100,5,3915,3920
Scottlynn,F,100,78,0,78
Hadel,F,100,8,0,8
Keydon,M,100,0,35,35
Lovita,F,100,7,0,7
Yuuka,F,100,10,0,10
Dicie,F,100,105,0,105
Behr,M,100,0,102,102
Naun,M,100,0,26,26
Dirk,M,100,0,10071,10071
Quandell,M,100,0,41,41
Vonnetta,F,100,81,0,81
Jden,M,100,0,256,256
Tamikka,F,100,163,0,163
Clydie,F,100,80,0,80
Kadaija,F,100,10,0,10
Yomaly,F,100,10,0,10
Adesola,F,100,16,0,16
Gursirat,F,100,8,0,8
Alegria,F,100,174,0,174
Derious,M,100,0,37,37
Ayce,M,100,0,99,99
Stefeni,F,100,10,0,10
Yastelin,F,100,10,0,10
Alyric,F,96,183,7,190
Jamuel,M,100,0,14,14
Travia,F,100,208,0,208
Jamaurie,M,100,0,76,76
Katheline,F,100,69,0,69
Jaqlyn,F,100,59,0,59
Mattie,F,100,18256,46,18302
Edyson,M,100,0,33,33
Joniyah,F,100,184,0,184
Mickael,M,99,11,1198,1209
Radley,M,97,24,792,816
Artavian,M,100,0,7,7
Jessup,M,100,0,394,394
Eryc,M,100,0,67,67
Kamarrion,M,100,0,74,74
Krayton,M,100,0,63,63
Chanty,F,100,31,0,31
Mellyora,F,100,5,0,5
Jequetta,F,100,34,0,34
Rydia,F,100,6,0,6
Tiphani,F,100,266,0,266
Natausha,F,100,290,0,290
Suelynn,F,100,50,0,50
Antonnio,M,100,0,42,42
Leicha,F,100,5,0,5
Angelah,F,100,5,0,5
Christalynn,F,100,44,0,44
Anastaysia,F,100,21,0,21
Allister,M,99,6,595,601
Kinara,F,100,33,0,33
Lakea,F,100,182,0,182
Tiye,F,100,232,0,232
Zainaldeen,M,100,0,6,6
Chavonda,F,100,19,0,19
Carmesha,F,100,192,0,192
Lakeysa,F,100,54,0,54
Briya,F,100,200,0,200
Khiyon,M,100,0,38,38
Azeez,M,100,0,68,68
Katline,F,100,27,0,27
Brooklenn,F,100,5,0,5
Jehovah,M,100,0,21,21
Danon,M,90,30,261,291
Zaheim,M,100,0,11,11
Aaleya,F,100,16,0,16
Berenise,F,100,640,0,640
Lechelle,F,100,166,0,166
Calis,F,100,5,0,5
Niamani,F,100,16,0,16
Mandala,F,100,5,0,5
Lashonia,F,100,42,0,42
Trampas,M,100,0,395,395
Carthel,M,100,0,6,6
Nataisha,F,100,54,0,54
Mirayah,F,100,77,0,77
Clell,M,100,0,215,215
Salisa,F,100,116,0,116
Nilaja,F,100,51,0,51
Cesilee,F,100,11,0,11
Caetlyn,F,100,21,0,21
Joory,F,100,18,0,18
Jeiren,M,100,0,17,17
Jacarla,F,100,5,0,5
Jquan,M,100,0,530,530
Deonne,F,90,406,47,453
Diavonte,M,100,0,19,19
Erike,F,61,17,11,28
Forestine,F,100,85,0,85
Neysha,F,100,127,0,127
Ginni,F,100,189,0,189
Jelene,F,100,57,0,57
Patriciann,F,100,22,0,22
Nazih,M,100,0,5,5
Claire,F,100,119687,313,120000
Kaydenn,M,100,0,71,71
Karlea,F,100,235,0,235
Usmaan,M,100,0,9,9
Daisya,F,100,10,0,10
Lacretia,F,100,894,0,894
Lizbett,F,100,109,0,109
Miguelangelo,M,100,0,10,10
Jacqeline,F,100,99,0,99
Samed,M,100,0,6,6
Jaithan,M,100,0,37,37
Leisy,F,100,8,0,8
Kyesha,F,100,759,0,759
Arda,M,98,6,340,346
Avraham,M,100,0,2992,2992
Ladetra,F,100,54,0,54
Tranise,F,100,78,0,78
Faira,F,100,6,0,6
Asharia,F,100,198,0,198
Chakong,M,100,0,16,16
Jannis,F,100,221,0,221
Vinesh,M,100,0,20,20
Dalecia,F,100,24,0,24
Kongpheng,M,100,0,52,52
Seija,F,100,7,0,7
Charessa,F,100,17,0,17
Yennie,F,100,5,0,5
Naguan,M,100,0,13,13
Valeka,F,100,23,0,23
Kathyrn,F,100,2203,0,2203
Paiton,F,88,1077,153,1230
Skyyler,M,100,0,5,5
Matthea,F,100,5,0,5
Kresten,M,100,0,5,5
Jahkel,M,100,0,15,15
Jamik,M,100,0,10,10
Arline,F,100,1761,0,1761
Meka,F,100,568,0,568
Seath,M,100,0,30,30
Cherlin,F,100,55,0,55
Antonesha,F,100,52,0,52
Jemell,M,100,0,149,149
Deltrick,M,100,0,5,5
Yessenya,F,100,5,0,5
Charis,F,99,3462,46,3508
Lynasia,F,100,76,0,76
Kahlilah,F,100,50,0,50
Naziya,F,100,175,0,175
Jameriah,F,100,82,0,82
Marriyah,F,100,9,0,9
Kiuna,F,100,7,0,7
Charmae,F,100,20,0,20
Shayden,M,75,246,734,980
Kamarius,M,100,0,78,78
Canh,M,100,0,6,6
Rosemarry,F,100,6,0,6
Caeli,F,100,505,0,505
Kare,F,100,104,0,104
Harshiv,M,100,0,6,6
Norrie,F,100,13,0,13
Christien,M,86,136,867,1003
Onkar,M,100,0,10,10
Kartikeya,M,100,0,31,31
Cordara,M,100,0,29,29
Akylah,F,100,133,0,133
Liz,F,100,8432,0,8432
Idasia,F,100,5,0,5
Ouinton,M,100,0,5,5
Sias,M,100,0,5,5
Tulip,F,100,63,0,63
Darryan,F,56,19,15,34
Armeta,F,100,5,0,5
Raam,M,100,0,20,20
Kydin,M,100,0,19,19
Kadriana,F,100,12,0,12
Darcy,F,90,20554,2276,22830
Telicia,F,100,489,0,489
Ahuva,F,100,1004,0,1004
Curren,M,100,0,395,395
Atlanta,F,100,587,0,587
Deboraah,F,100,5,0,5
Chaswick,M,100,0,5,5
Tanyha,F,100,5,0,5
Debera,F,100,1150,0,1150
Cathern,F,100,306,0,306
Adline,F,100,107,0,107
Janett,F,100,2453,0,2453
Zahmya,F,100,21,0,21
Hali,F,100,4344,10,4354
Dalesia,F,100,5,0,5
Londonrose,F,100,5,0,5
Amina,F,100,7978,0,7978
Ylanda,F,100,20,0,20
Jaheed,M,100,0,29,29
Vilas,M,100,0,16,16
Oliva,F,100,1044,0,1044
Segundo,M,100,0,142,142
Orlandria,F,100,85,0,85
Army,F,100,6,0,6
Dyonna,F,100,134,0,134
Ambera,F,100,46,0,46
Mckynley,F,100,17,0,17
Layke,M,87,5,34,39
Kyric,M,100,0,6,6
Aniki,M,100,0,10,10
Sissi,F,100,73,0,73
Shandrika,F,100,303,0,303
Daleyzah,F,100,14,0,14
Nader,M,100,0,1430,1430
Tarneshia,F,100,21,0,21
Katherinne,F,100,135,0,135
Hanne,F,100,170,0,170
Daiquon,M,100,0,54,54
Hinaea,F,100,6,0,6
Rhyleigh,F,100,243,0,243
Annibelle,F,100,69,0,69
Garrell,M,100,0,81,81
Donisha,F,100,1269,0,1269
Jaquandre,M,100,0,6,6
Kamarii,F,54,83,71,154
Quenetta,F,100,43,0,43
Travyn,M,100,0,38,38
Saksham,M,100,0,28,28
Calandria,F,100,100,0,100
Serach,F,100,5,0,5
Sharmel,F,100,117,0,117
Japrice,F,100,5,0,5
Marianela,F,100,586,0,586
Jaico,M,100,0,7,7
Keigan,M,87,100,698,798
Brodrick,M,100,0,1638,1638
Decario,M,100,0,10,10
Motoki,M,100,0,5,5
Jaxel,M,100,0,5,5
Jeanbaptiste,M,100,0,5,5
Angela,F,100,626379,1988,628367
Jannan,F,100,5,0,5
Mansel,M,100,0,29,29
Caselyn,F,100,17,0,17
Mussa,M,100,0,81,81
Serbando,M,100,0,18,18
Kristyana,F,100,99,0,99
Meria,F,100,122,0,122
Kalena,F,100,1981,0,1981
Lual,M,100,0,10,10
Kynnlee,F,100,13,0,13
Dequavious,M,100,0,122,122
Hasheem,M,100,0,65,65
Turkesha,F,100,21,0,21
Kiranjot,F,100,5,0,5
Ibon,F,100,5,0,5
Darrian,M,77,964,3152,4116
Takesa,F,100,10,0,10
Brodney,M,100,0,5,5
Terriance,M,100,0,24,24
Joshep,M,100,0,5,5
Takijah,F,100,5,0,5
Kanya,F,96,536,25,561
Kedarius,M,100,0,205,205
Yazleen,F,100,47,0,47
Dalylah,F,100,277,0,277
Dayanah,F,100,23,0,23
Rolland,M,100,0,2392,2392
Trevontay,M,100,0,16,16
Kallea,F,100,5,0,5
Dietmar,M,100,0,11,11
Merete,F,100,12,0,12
Samica,F,100,23,0,23
Handerson,M,100,0,7,7
Travonta,M,100,0,119,119
Chick,M,100,0,15,15
Shanada,F,100,21,0,21
Jewelie,F,100,55,0,55
Damariz,F,100,375,0,375
Kischa,F,100,74,0,74
Jarard,M,100,0,42,42
Shanchez,M,100,0,5,5
Tammarra,F,100,16,0,16
Armany,M,100,0,154,154
Shennan,F,100,5,0,5
Jermon,M,100,0,485,485
Myami,F,100,41,0,41
Ridge,M,100,0,3066,3066
Jaicee,F,100,521,0,521
Loghan,M,52,355,390,745
Tareyn,F,100,5,0,5
Markeisha,F,100,1296,0,1296
Tahjir,M,100,0,57,57
Caytie,F,100,5,0,5
Madelynn,F,100,11566,0,11566
Delanya,F,100,5,0,5
Inger,F,100,1124,0,1124
Shadale,F,100,10,0,10
Brookann,F,100,6,0,6
Vedika,F,100,238,0,238
Charli,F,98,4666,119,4785
Cleo,F,65,4085,2196,6281
Keyria,F,100,5,0,5
Amonda,F,100,72,0,72
Gajuan,M,100,0,21,21
Isamara,F,100,27,0,27
Japonica,F,100,45,0,45
Koye,M,100,0,16,16
Great,M,100,0,12,12
Ninja,F,100,19,0,19
Torilynn,F,100,38,0,38
Deta,F,100,15,0,15
Lyra,F,100,2327,0,2327
Joevany,M,100,0,29,29
Everton,M,100,0,431,431
Makaiyah,F,100,145,0,145
Tynzlee,F,100,5,0,5
Lan,F,74,748,260,1008
Ashelle,F,100,6,0,6
Taisha,F,100,2705,0,2705
Emperess,F,100,5,0,5
Aizlynn,F,100,134,0,134
Reef,M,98,12,631,643
Ezell,M,98,22,1408,1430
Montserrat,F,100,3184,0,3184
Thayne,M,100,0,1042,1042
Coden,M,100,0,80,80
Makael,M,100,0,66,66
Reahanna,F,100,6,0,6
Marycela,F,100,5,0,5
Johnmorgan,M,100,0,5,5
Marqell,M,100,0,5,5
Ethanjacob,M,100,0,36,36
Mikhale,M,100,0,16,16
Kendrick,M,99,322,25013,25335
Jaxxyn,M,100,0,5,5
Yatisha,F,100,6,0,6
Montera,F,100,8,0,8
Davio,M,100,0,27,27
Amarii,M,55,228,277,505
Angelys,F,100,150,0,150
Dayshia,F,100,241,0,241
Cymbre,F,100,5,0,5
Berda,F,100,24,0,24
Parina,F,100,6,0,6
Montressa,F,100,29,0,29
Sharline,F,100,289,0,289
Laella,F,100,5,0,5
Britnai,F,100,5,0,5
Alesa,F,100,910,0,910
Arpine,F,100,10,0,10
Pasley,F,100,5,0,5
Shaikeem,M,100,0,5,5
Savva,M,100,0,57,57
Terresha,F,100,12,0,12
Philesha,F,100,7,0,7
Kymberle,F,100,5,0,5
Carol,F,99,375704,1964,377668
Shekeila,F,100,5,0,5
Saara,F,100,239,0,239
Bogdan,M,100,0,439,439
Jobie,M,82,56,248,304
Brionni,F,100,6,0,6
Naylanie,F,100,13,0,13
Guss,M,100,0,82,82
Mackaela,F,100,5,0,5
Caleab,M,100,0,14,14
Ashyra,F,100,102,0,102
Ilisha,F,100,97,0,97
Jarl,M,100,0,71,71
Ahlea,F,100,32,0,32
Delpha,F,100,172,0,172
Alliyana,F,100,11,0,11
Tirenioluwa,F,100,6,0,6
Tyress,M,100,0,146,146
Berkley,F,71,2323,968,3291
Mynisha,F,100,13,0,13
Olabisi,F,100,5,0,5
Jakwan,M,100,0,143,143
Michaya,F,100,48,0,48
Sadie,F,100,55587,42,55629
Shabrina,F,100,43,0,43
Faiha,F,100,6,0,6
Ajianna,F,100,11,0,11
Airi,F,100,158,0,158
Gisette,F,100,6,0,6
Dannis,M,100,0,114,114
Dequandre,M,100,0,71,71
Purvis,M,100,0,369,369
Osama,M,100,0,826,826
Anden,M,100,0,563,563
Jaunice,F,100,25,0,25
Daury,M,100,0,17,17
Yeferson,M,100,0,12,12
Carabella,F,100,47,0,47
Darnice,F,100,157,0,157
Jnai,F,100,150,0,150
Nihad,F,100,5,0,5
Eual,M,100,0,15,15
Darvis,M,100,0,369,369
Blase,M,100,0,483,483
Rashean,M,100,0,9,9
Khristen,F,100,153,0,153
Raizy,F,100,1503,0,1503
Mckalynn,F,100,11,0,11
Aras,M,100,0,135,135
Ibet,F,100,32,0,32
Gerilynn,F,100,181,0,181
Ioanna,F,100,445,0,445
Crisangel,M,100,0,6,6
Blanca,F,99,23308,126,23434
Dinesha,F,100,243,0,243
Kathalia,F,100,9,0,9
Wenceslao,M,100,0,302,302
Felissia,F,100,5,0,5
Kaemon,M,100,0,274,274
Ashala,F,100,27,0,27
Malila,F,100,20,0,20
Mcgregor,M,100,0,72,72
Woojin,M,100,0,5,5
Jasalin,F,100,12,0,12
Keo,M,100,0,167,167
Declan,M,100,86,21295,21381
Sanjith,M,100,0,93,93
Sharat,M,100,0,5,5
Landyn,M,91,719,7218,7937
Janishia,F,100,16,0,16
Duana,F,100,548,0,548
Kenric,M,100,0,871,871
Kiele,F,100,447,0,447
Reka,F,100,172,0,172
Shreyans,M,100,0,6,6
Abdishakur,M,100,0,39,39
Lakaisha,F,100,113,0,113
Draiman,M,100,0,11,11
Prynn,F,100,5,0,5
Philopateer,M,100,0,68,68
Jaquil,M,100,0,183,183
Arly,F,95,715,41,756
Zynab,F,100,5,0,5
Kilen,M,100,0,22,22
Malikka,F,100,10,0,10
Melissha,F,100,6,0,6
Zarria,F,100,539,0,539
Ameia,F,100,117,0,117
Armelia,F,100,69,0,69
Swarit,M,100,0,23,23
Natividad,F,52,954,874,1828
Rhashad,M,100,0,23,23
Dontavion,M,100,0,100,100
Sparrow,F,88,330,43,373
Colbert,M,100,0,410,410
Kaylamae,F,100,5,0,5
Abbygaile,F,100,47,0,47
Quesean,M,100,0,5,5
Priya,F,100,5115,0,5115
Lorice,F,100,115,0,115
Allisin,F,100,5,0,5
Avali,F,100,5,0,5
Evera,F,100,5,0,5
Melishia,F,100,5,0,5
Rendy,F,89,136,17,153
Lueann,F,100,6,0,6
Hassani,M,100,0,64,64
Sherby,F,100,75,0,75
Miha,F,100,38,0,38
Mansha,F,100,6,0,6
Markevion,M,100,0,110,110
Shemicka,F,100,74,0,74
Kaylii,F,100,17,0,17
Amalin,F,100,6,0,6
Ariyel,F,100,62,0,62
Rmonie,F,100,5,0,5
Clemont,M,100,0,5,5
Sincerity,F,100,56,0,56
Keyveon,M,100,0,5,5
Koen,M,100,5,2320,2325
Mariangely,F,100,52,0,52
Varshitha,F,100,8,0,8
Kaydren,M,100,0,10,10
Jaelle,F,100,351,0,351
Bekka,F,100,100,0,100
Derina,F,100,11,0,11
Carr,M,100,0,96,96
Brenae,F,100,513,0,513
Lakeida,F,100,5,0,5
Maelys,F,100,46,0,46
Fatmata,F,100,220,0,220
Damisha,F,100,171,0,171
Sebastain,M,100,0,386,386
Andreco,M,100,0,15,15
Karrem,M,100,0,15,15
Tamila,F,100,544,0,544
Aroha,F,100,6,0,6
Chanyah,F,100,33,0,33
Tahliya,F,100,12,0,12
Katielyn,F,100,49,0,49
Amour,F,89,192,23,215
Jahdai,F,64,77,43,120
Favion,M,100,0,22,22
Bland,M,100,0,104,104
Kip,M,98,143,7124,7267
Anjolina,F,100,156,0,156
Daimeon,M,100,0,59,59
Alympia,F,100,5,0,5
Clemencia,F,100,143,0,143
Baylin,M,58,136,186,322
Deia,F,100,54,0,54
Porsia,F,100,5,0,5
Rishard,M,100,0,230,230
Jeshawn,M,100,0,86,86
Milo,M,99,98,11077,11175
Namitha,F,100,19,0,19
Lilinoe,F,100,88,0,88
Audelia,F,100,293,0,293
Majer,M,100,0,26,26
Rance,M,100,0,2272,2272
Tamaiya,F,100,82,0,82
Leasia,F,100,931,0,931
Inocencio,M,100,0,342,342
Sigmond,M,100,0,6,6
Alissia,F,100,746,0,746
Beckett,M,97,248,8082,8330
Devyani,F,100,24,0,24
Erionne,F,100,5,0,5
Teanisha,F,100,5,0,5
Darlean,F,100,587,0,587
Jahnvi,F,100,36,0,36
Carrielynn,F,100,6,0,6
Quinterious,M,100,0,101,101
Lashaye,F,100,163,0,163
Karn,F,97,158,5,163
Gabryal,M,100,0,11,11
Krista,F,100,72775,148,72923
Aadesh,M,100,0,15,15
Salyna,F,100,33,0,33
Babbie,F,100,88,0,88
Soheil,M,100,0,6,6
Temiko,F,100,17,0,17
Kemarley,M,100,0,5,5
Braxton,M,98,633,34634,35267
Natayah,F,100,66,0,66
Geralynn,F,100,437,0,437
Yamely,F,100,44,0,44
Chancie,F,97,191,5,196
Keviana,F,100,63,0,63
Lesette,F,100,55,0,55
Tyshelle,F,100,10,0,10
Samoya,F,100,43,0,43
Thresia,F,100,125,0,125
Jakeisha,F,100,134,0,134
Myra,F,100,31321,30,31351
Asrar,F,100,5,0,5
Jeryd,M,100,0,18,18
Jarol,M,100,0,51,51
Temeca,F,100,93,0,93
Cania,F,100,13,0,13
Levine,M,100,0,10,10
Rajinder,M,100,0,23,23
Ceci,F,100,87,0,87
Ashyah,F,100,87,0,87
Nekol,F,100,5,0,5
Silvan,M,100,0,24,24
Karolann,F,100,6,0,6
Chai,M,63,180,311,491
Deedie,F,100,36,0,36
Dametris,M,100,0,10,10
Basiliki,F,100,7,0,7
Jatina,F,100,34,0,34
Izzabel,F,100,29,0,29
Rada,F,100,95,0,95
Jaicyon,M,100,0,8,8
Victorea,F,100,21,0,21
Azalya,F,100,51,0,51
Dagan,M,99,10,984,994
Psymon,M,100,0,10,10
Jamaul,M,100,0,516,516
Aleron,M,100,0,10,10
Lindse,F,100,10,0,10
Anre,M,100,0,5,5
Bama,F,100,22,0,22
Maui,M,61,50,77,127
Zymeire,M,100,0,6,6
Hovsep,M,100,0,33,33
Daichi,M,100,0,195,195
Graceyn,F,100,277,0,277
Chrystel,F,100,77,0,77
Vanasia,F,100,5,0,5
Speros,M,100,0,11,11
Lezah,F,100,16,0,16
Lillionna,F,100,86,0,86
Akemi,F,99,635,5,640
Chauncey,M,93,502,6439,6941
Ondre,M,100,0,250,250
Latrisha,F,100,1804,0,1804
Cherlyl,F,100,6,0,6
Mhya,F,100,5,0,5
Brandi,F,100,101206,389,101595
Laquonda,F,100,63,0,63
Asmita,F,100,40,0,40
Anias,M,89,19,155,174
Jozalyn,F,100,154,0,154
Kinberly,F,100,343,0,343
Daylia,F,100,30,0,30
Keagyn,F,50,11,11,22
Tammala,F,100,88,0,88
Seaniya,F,100,7,0,7
Darelene,F,100,22,0,22
Morgyn,F,100,778,0,778
Nelvin,M,100,0,212,212
Michella,F,100,1064,0,1064
Analiya,F,100,75,0,75
Khoi,M,99,6,466,472
Kasahn,M,100,0,5,5
Lilyona,F,100,99,0,99
Adheesh,M,100,0,5,5
Fynnlee,F,100,6,0,6
Tennile,F,100,132,0,132
Tereza,F,100,672,0,672
Alaizah,F,100,21,0,21
Sayonna,F,100,5,0,5
Alaki,M,100,0,17,17
Cassandr,F,100,152,0,152
Kaliea,F,100,12,0,12
Daxen,M,100,0,40,40
Chaela,F,100,226,0,226
Jarethzy,F,100,24,0,24
Naylen,M,71,5,12,17
Deaisa,F,100,74,0,74
Aia,F,100,15,0,15
Dohnovan,M,100,0,38,38
Patrisha,F,100,1042,0,1042
Millennium,F,100,32,0,32
Peightyn,F,100,111,0,111
Edrica,F,100,11,0,11
Aleise,F,100,39,0,39
Sonnia,F,100,104,0,104
Dmitriy,M,100,0,425,425
Dalaynie,F,100,10,0,10
Jontavious,M,100,0,397,397
Linnda,F,100,5,0,5
Alyzia,F,100,12,0,12
Illona,F,100,122,0,122
Auddie,M,100,0,7,7
Vandan,M,100,0,39,39
Deloras,F,100,180,0,180
Bridjette,F,100,11,0,11
Dajai,F,100,120,0,120
Juliani,F,68,80,37,117
Donvan,M,100,0,12,12
Anniah,F,100,176,0,176
Shailee,F,100,426,0,426
Debbrah,F,100,113,0,113
Irma,F,100,27047,93,27140
Netisha,F,100,25,0,25
Donnette,F,100,1011,0,1011
Corisa,F,100,139,0,139
Margory,F,100,7,0,7
Emontae,M,100,0,30,30
Soojin,F,100,28,0,28
Gilmer,M,100,0,212,212
Sultan,M,100,0,1105,1105
Tylese,F,100,8,0,8
Filippo,M,100,0,522,522
Valaria,F,100,173,0,173
Joycelynn,F,100,456,0,456
Antoinae,F,100,6,0,6
Ali,M,71,9309,22400,31709
Aashia,F,100,6,0,6
Treylin,M,100,0,112,112
Jerzei,F,100,6,0,6
Dylilah,F,100,18,0,18
Devonaire,M,100,0,24,24
Atiyyah,F,100,10,0,10
Santrice,F,100,97,0,97
Janajah,F,100,44,0,44
Yashvi,F,100,203,0,203
Zayvier,M,100,0,118,118
Adriene,F,97,2303,61,2364
Paulia,F,100,15,0,15
Aspin,F,100,80,0,80
Philp,M,100,0,5,5
Jeshaun,M,100,0,28,28
Evangelynn,F,100,38,0,38
Alicemarie,F,100,11,0,11
Malvenia,F,100,5,0,5
Dajha,F,100,149,0,149
Cesiley,F,100,5,0,5
Iyanla,F,100,244,0,244
Kinzey,F,100,327,0,327
Avyukth,M,100,0,77,77
Pharah,F,100,25,0,25
Shateek,M,100,0,33,33
Karianna,F,100,367,0,367
Lonney,M,100,0,212,212
Macelynn,F,100,10,0,10
Naileah,F,100,66,0,66
Raynie,F,100,163,0,163
Carloseduardo,M,100,0,21,21
Taliana,F,100,145,0,145
Chuna,M,100,0,5,5
Laguana,F,100,66,0,66
Indigo,F,82,1551,350,1901
Hovannes,M,100,0,22,22
Rual,M,100,0,22,22
Britten,M,59,332,474,806
Alexandrew,M,100,0,49,49
Kaliannah,F,100,20,0,20
Frimmy,F,100,5,0,5
Makinzy,F,100,168,0,168
Kao,M,63,244,416,660
Iyeshia,F,100,15,0,15
Kalynda,F,100,32,0,32
Melany,F,100,11247,5,11252
Marliyah,F,100,49,0,49
Courtney,F,93,255478,20375,275853
Romayne,F,100,128,0,128
Alayja,F,100,294,0,294
Bakar,M,100,0,6,6
Oakley,M,60,1697,2563,4260
Arloa,F,100,26,0,26
Olyviah,F,100,31,0,31
Arkel,M,100,0,64,64
Ludmilla,F,100,24,0,24
Jora,F,100,75,0,75
Meilany,F,100,6,0,6
Anupriya,F,100,5,0,5
Yenny,F,100,222,0,222
Ilihia,F,100,5,0,5
Gomez,M,100,0,5,5
Aumya,F,100,5,0,5
Dastan,M,100,0,175,175
Hamad,M,100,0,311,311
Aarn,M,100,0,17,17
Remika,F,100,5,0,5
Wwilliam,M,100,0,23,23
Leoncio,M,100,0,447,447
Micchael,M,100,0,6,6
Saalih,M,100,0,15,15
Aymeric,M,100,0,6,6
Damilare,M,100,0,5,5
Zachariyah,M,100,0,5,5
Yorel,M,100,0,85,85
Lukeanthony,M,100,0,5,5
Khyia,F,100,36,0,36
Netia,F,100,5,0,5
Doriel,M,100,0,6,6
Jonea,F,100,120,0,120
Dvon,M,100,0,260,260
Pricsila,F,100,5,0,5
Bryler,M,100,0,143,143
Draconis,M,100,0,10,10
Midori,F,100,831,0,831
Zarif,M,100,0,102,102
Reyli,M,98,13,696,709
Kyelle,F,100,31,0,31
Jaiman,M,100,0,5,5
Bintu,F,100,41,0,41
Artiana,F,100,6,0,6
Kemesha,F,100,73,0,73
Akera,F,98,247,5,252
Bassirou,M,100,0,10,10
Floridalma,F,100,39,0,39
Altaf,M,100,0,8,8
Sequan,M,100,0,320,320
Tarry,M,68,161,340,501
Tinette,F,100,5,0,5
Elizabethmarie,F,100,34,0,34
Oryan,M,100,0,764,764
Daris,M,87,136,901,1037
Nevia,F,100,97,0,97
Garnell,M,96,11,263,274
Zikira,F,100,16,0,16
Lillieanna,F,100,79,0,79
Erminia,F,100,434,0,434
Jawana,F,100,378,0,378
Shenard,M,100,0,10,10
Kealon,M,100,0,26,26
Hadas,F,100,126,0,126
Maryrita,F,100,17,0,17
Janalee,F,100,805,0,805
Zadie,F,100,958,0,958
Boyde,M,100,0,12,12
Marilyn,F,100,135183,380,135563
Nijiah,F,100,5,0,5
Artura,F,100,6,0,6
Briany,F,100,155,0,155
Heavenor,F,100,5,0,5
Kandence,F,100,6,0,6
Tyrus,M,100,0,3668,3668
Katiyah,F,100,11,0,11
Jabriel,M,100,0,751,751
Astou,F,100,69,0,69
Mellonie,F,100,121,0,121
Muizz,M,100,0,10,10
Ranie,F,100,115,0,115
Sandar,F,100,162,0,162
Jeveah,F,100,10,0,10
Donique,F,77,122,36,158
Kimann,F,100,18,0,18
Lonzell,M,100,0,367,367
Fraak,M,100,0,6,6
Ciana,F,100,2028,0,2028
Ayyub,M,100,0,149,149
Jamye,F,99,829,12,841
Quaterius,M,100,0,5,5
Jarielle,F,100,14,0,14
Draylee,F,100,5,0,5
Jayquan,M,100,0,1522,1522
Honi,F,100,46,0,46
Zyree,M,76,16,51,67
Oluwateniola,F,88,46,6,52
Aysenur,F,100,5,0,5
Dorthey,F,100,219,0,219
Bethan,F,100,84,0,84
Tahreem,F,100,15,0,15
Hinda,F,100,820,0,820
Gayl,F,100,360,0,360
Zamirra,F,100,11,0,11
Jonique,F,100,421,0,421
Elixis,F,100,5,0,5
Brynton,M,100,0,11,11
Zylynn,F,100,10,0,10
Srishti,F,100,244,0,244
Jentezen,M,100,0,18,18
Itzary,F,100,5,0,5
Shalana,F,100,574,0,574
Ladislao,M,100,0,60,60
Charlsie,F,100,746,0,746
Tzivya,F,100,12,0,12
Britte,F,100,18,0,18
Tasheeka,F,100,5,0,5
Orentha,M,100,0,6,6
Evangelos,M,100,0,928,928
Stachia,F,100,127,0,127
Patrina,F,100,1862,0,1862
Vontavius,M,100,0,10,10
Lamarr,M,99,19,2395,2414
Haely,F,100,212,0,212
Danielson,M,100,0,5,5
Brionca,F,100,34,0,34
Porshea,F,100,63,0,63
Cheyana,F,100,48,0,48
Odin,M,100,0,3458,3458
Anita,F,100,127253,387,127640
Trigo,M,100,0,68,68
Cristella,F,100,89,0,89
Nyilah,F,100,46,0,46
Jalashia,F,100,10,0,10
Malana,F,100,929,0,929
Phillipe,M,100,0,605,605
Akyrah,F,100,44,0,44
Loyola,F,100,42,0,42
Pouya,M,100,0,6,6
Jacyln,F,100,173,0,173
Coryann,F,100,5,0,5
Newman,M,100,0,489,489
Nitin,M,100,0,613,613
Karishma,F,100,897,0,897
Kenylah,F,100,5,0,5
Jaymeson,M,95,18,371,389
Kamil,M,80,404,1585,1989
Katheleen,F,100,694,0,694
Klaryssa,F,100,189,0,189
Derold,M,100,0,29,29
Mathyas,M,100,0,5,5
Eziquiel,M,100,0,5,5
Xaeden,M,100,0,23,23
Kylen,M,84,428,2194,2622
Siu,F,72,13,5,18
Ima,F,100,520,0,520
Maurisa,F,100,292,0,292
Darion,M,92,561,6530,7091
Keshanti,F,100,43,0,43
Marike,F,100,5,0,5
Rosaleen,F,100,444,0,444
Heavyn,F,100,681,0,681
Teejay,M,100,0,105,105
Mallaki,M,100,0,18,18
Lochlen,M,100,0,5,5
Mahria,F,100,30,0,30
Duntae,M,100,0,5,5
Ayniah,F,100,30,0,30
Thyler,M,100,0,10,10
Blanchard,M,100,0,43,43
Dravin,M,100,0,407,407
Deremy,M,100,0,5,5
Jerianne,F,100,106,0,106
Angelia,F,100,21484,22,21506
Areta,F,100,100,0,100
Mak,M,100,0,65,65
Ambrey,F,100,45,0,45
Tany,F,100,28,0,28
Demauri,M,100,0,186,186
Sherrita,F,100,566,0,566
Datavian,M,100,0,5,5
Pookela,M,100,0,68,68
Yumna,F,100,245,0,245
Sergie,M,100,0,5,5
Devito,M,100,0,5,5
Kolbi,F,71,562,235,797
Anahia,F,100,8,0,8
Veronia,F,100,202,0,202
Noha,F,85,282,49,331
Lisette,F,100,9063,0,9063
Raeona,F,100,5,0,5
Geordi,M,100,0,47,47
Brittny,F,100,3578,0,3578
Ernette,F,100,11,0,11
Bethsy,F,100,21,0,21
Mehrdad,M,100,0,6,6
Monnette,F,100,22,0,22
Solei,F,100,347,0,347
Aixa,F,100,964,0,964
Tyjana,F,100,12,0,12
Nodin,M,100,0,11,11
Taber,M,94,28,406,434
Sidiki,M,100,0,7,7
Westleigh,M,100,0,5,5
Teandrea,F,100,33,0,33
Brandale,M,100,0,7,7
Shabrie,F,100,6,0,6
Flor,F,99,6581,91,6672
Jannika,F,100,14,0,14
Sofi,F,100,388,0,388
Avelie,F,100,5,0,5
Lawra,F,100,6,0,6
Vishruth,M,100,0,105,105
Copelyn,F,100,26,0,26
Brylynn,F,100,235,0,235
Shardasia,F,100,23,0,23
Endiah,F,100,15,0,15
Rilie,F,100,240,0,240
Aundrae,M,100,0,26,26
Armenta,F,100,39,0,39
Devoiry,F,100,37,0,37
Walberto,M,100,0,54,54
Murat,M,100,0,264,264
Levance,M,100,0,10,10
Omaree,M,100,0,106,106
Yasmira,F,100,6,0,6
Kinna,F,100,25,0,25
Thalen,M,100,0,5,5
Buckie,M,100,0,5,5
Beverlye,F,100,5,0,5
Deandra,F,85,4821,838,5659
Fabiano,M,100,0,67,67
Finnigan,M,100,0,576,576
Adhitya,M,100,0,12,12
Mariely,F,100,878,0,878
Tamyiah,F,100,49,0,49
Demetres,M,94,6,97,103
Zakhia,F,100,191,0,191
Gaebriel,M,100,0,15,15
Mckay,M,86,287,1821,2108
Cailah,F,100,100,0,100
Detroit,M,100,0,26,26
Llayla,F,100,5,0,5
Dulcie,F,100,588,0,588
Jodanna,F,100,11,0,11
Qalid,M,100,0,6,6
Rahshida,F,100,5,0,5
Mychell,F,100,5,0,5
Americas,F,100,21,0,21
Aileth,F,100,36,0,36
Jaylonn,M,100,0,5,5
Monico,M,97,17,513,530
Lenda,F,100,438,0,438
Leroy,M,99,412,60461,60873
Kiesa,F,100,21,0,21
Adarious,M,100,0,24,24
Abbe,F,100,1320,0,1320
Carlosjavier,M,100,0,5,5
Jenevie,F,100,121,0,121
Lizardo,M,100,0,10,10
Chanella,F,100,6,0,6
Ramona,F,100,38638,137,38775
Ed,M,100,0,8051,8051
Asiah,F,91,1492,149,1641
Malhar,M,100,0,24,24
Rip,M,100,0,179,179
Kadria,F,100,5,0,5
Thelbert,M,100,0,165,165
Tirelle,M,100,0,5,5
Jaquelynn,F,100,258,0,258
Latre,M,100,0,28,28
Zahnae,F,100,6,0,6
Alann,M,100,0,65,65
Ryder,M,98,642,30447,31089
Graciela,F,100,13816,39,13855
Chamika,F,100,129,0,129
Nafeesha,F,100,13,0,13
Niyae,F,100,11,0,11
Zahran,M,100,0,5,5
Jeaneth,F,100,35,0,35
Schanel,F,100,15,0,15
Lavert,M,100,0,150,150
Rakeia,F,100,12,0,12
Louvina,F,100,25,0,25
Inayat,F,100,5,0,5
Lyndze,F,100,16,0,16
Saidee,F,100,226,0,226
Hobbes,M,100,0,20,20
Mustafah,M,100,0,5,5
Eythan,M,100,0,397,397
Trayc,M,100,0,5,5
Aliauna,F,100,5,0,5
Kaitlain,F,100,30,0,30
Tsean,M,100,0,10,10
Trais,M,100,0,6,6
Chantz,M,100,0,1042,1042
Erickson,M,100,0,851,851
Adron,M,100,0,471,471
Daysun,M,100,0,20,20
Colter,M,100,0,3494,3494
Rafid,M,100,0,55,55
Johniece,F,100,62,0,62
Malessa,F,100,74,0,74
Nillie,F,100,5,0,5
Shatara,F,100,1479,0,1479
Ming,M,69,141,308,449
Audriaunna,F,100,5,0,5
Jmiyah,F,100,36,0,36
Krustal,F,100,7,0,7
Dareli,F,100,16,0,16
Jameca,F,100,202,0,202
Meleia,F,100,54,0,54
Danara,F,100,39,0,39
Cristos,M,100,0,35,35
Giulietta,F,100,91,0,91
Erene,F,100,25,0,25
Dannetta,F,100,148,0,148
Aylssa,F,100,269,0,269
Giavonnie,F,100,5,0,5
Kaedynce,F,100,177,0,177
Reyd,M,100,0,5,5
Shekayla,F,100,6,0,6
Rodricus,M,100,0,274,274
Fayann,F,100,10,0,10
Corra,F,100,219,0,219
Lauris,F,52,41,38,79
Mekkah,F,100,16,0,16
Bryten,M,95,7,131,138
Henley,F,77,1650,497,2147
Jacian,M,100,0,35,35
Jassan,M,100,0,5,5
Imir,M,100,0,99,99
Rexall,M,100,0,9,9
Kiaralyn,F,100,5,0,5
Nseya,F,100,12,0,12
Hydie,F,100,63,0,63
Taasia,F,100,13,0,13
Jadiyah,F,100,10,0,10
Martica,F,100,31,0,31
Jillanna,F,100,5,0,5
Quanzie,M,100,0,5,5
Sayvion,M,100,0,188,188
Alisah,F,100,170,0,170
Graycelyn,F,100,11,0,11
Shavita,F,100,18,0,18
Xinyan,F,100,15,0,15
Jaycelynn,F,100,77,0,77
Shikela,F,100,14,0,14
Cayci,F,100,128,0,128
Eldonna,F,100,77,0,77
Brittlynn,F,100,18,0,18
Meliame,F,100,5,0,5
Habeeb,M,100,0,68,68
Jailee,F,100,392,0,392
Cyntoria,F,100,40,0,40
Lindra,F,100,6,0,6
Mialynn,F,100,82,0,82
Jayeda,F,100,5,0,5
Wynelle,F,100,38,0,38
Symeir,M,100,0,5,5
Leatrice,F,100,1604,0,1604
Laeh,F,100,6,0,6
Klayten,M,100,0,73,73
Chrystyan,M,100,0,5,5
Katye,F,100,323,0,323
Waseem,M,100,0,541,541
Hatina,F,100,6,0,6
Diamonique,F,100,957,0,957
Lacorey,M,100,0,86,86
Poyraz,M,100,0,20,20
Bridgetta,F,100,36,0,36
Generra,F,100,41,0,41
Abrahim,M,100,0,508,508
Havish,M,100,0,95,95
Virlyn,M,100,0,5,5
Apiffany,F,100,24,0,24
Allejah,F,100,7,0,7
Lenuel,M,100,0,5,5
Gabbriel,F,100,33,0,33
Makali,F,100,33,0,33
Keven,M,99,116,8381,8497
Andromeda,F,100,663,0,663
Taytiana,F,100,15,0,15
Daanya,F,100,42,0,42
Avyonna,F,100,62,0,62
Nebiyu,M,100,0,32,32
Nickolus,M,100,0,477,477
Cassidey,F,100,73,0,73
Mariangeles,F,100,5,0,5
Pranika,F,100,30,0,30
Porshay,F,100,42,0,42
Aljohara,F,100,7,0,7
Marlie,F,100,2792,0,2792
Riverlyn,F,100,5,0,5
Adhemar,M,100,0,36,36
Moraes,M,100,0,5,5
Amrith,M,100,0,5,5
Allin,M,100,0,53,53
Tifanee,F,100,36,0,36
Kenisha,F,100,3898,5,3903
Hargun,F,75,56,19,75
Franz,M,100,0,1887,1887
Kearson,F,100,5,0,5
Oriyana,F,100,5,0,5
Cinque,M,100,0,327,327
Aynslee,F,100,169,0,169
Fabricio,M,100,0,874,874
Othoniel,M,100,0,37,37
Jestina,F,100,324,0,324
Randolyn,F,100,18,0,18
Tecia,F,100,123,0,123
Vanika,F,100,16,0,16
Gaiden,M,100,0,16,16
Jashiya,F,100,84,0,84
Tamyla,F,100,28,0,28
Trelisa,F,100,5,0,5
Jarelys,F,100,38,0,38
Tahje,M,64,43,77,120
Akevia,F,100,25,0,25
Jhanee,F,100,16,0,16
Kei,M,71,161,390,551
Sibelle,F,100,5,0,5
Misri,F,100,5,0,5
Cyrah,F,100,206,0,206
Eisele,F,100,12,0,12
Annitte,F,100,6,0,6
Jolissa,F,100,341,0,341
Mitch,M,100,0,5313,5313
Aldrich,M,100,0,278,278
Holleigh,F,100,103,0,103
Paylen,F,100,27,0,27
Watisha,F,100,11,0,11
Paria,F,100,6,0,6
Kawayne,M,100,0,5,5
Lasharia,F,100,6,0,6
Shanasia,F,100,179,0,179
Raz,M,100,0,34,34
Tiajah,F,100,114,0,114
Margee,F,100,52,0,52
Marliz,F,100,10,0,10
Srisai,M,100,0,5,5
Therrin,M,100,0,5,5
Azaylia,F,100,93,0,93
Lakley,F,100,5,0,5
Jeilianys,F,100,10,0,10
Corleen,F,100,70,0,70
Kadejia,F,100,25,0,25
Chino,M,100,0,107,107
Yuzuki,F,100,26,0,26
Briniyah,F,100,50,0,50
Kejuan,M,100,0,1499,1499
Kaydien,M,100,0,19,19
Vidyut,M,100,0,29,29
Doyal,M,100,0,268,268
Kumiko,F,100,73,0,73
Sheryl,F,100,67302,128,67430
Jilisa,F,100,30,0,30
Kiersty,F,100,8,0,8
Amerika,F,100,265,0,265
Brynli,F,100,259,0,259
Neaven,M,100,0,23,23
Augustine,M,88,1009,7108,8117
Jamaira,F,100,94,0,94
Abhiraj,M,100,0,53,53
Lekesha,F,100,671,0,671
Armondo,M,100,0,1183,1183
Oumar,M,100,0,445,445
Jceon,M,100,0,96,96
Tyese,F,100,321,0,321
Masahiro,M,100,0,50,50
Mardel,F,100,90,0,90
Lekiesha,F,100,44,0,44
Jasley,F,100,16,0,16
Kadejah,F,100,402,0,402
Jiana,F,100,741,0,741
Yolinda,F,100,176,0,176
Toshiana,F,100,21,0,21
Dondrae,M,100,0,16,16
Deadra,F,100,1048,0,1048
Jahliya,F,100,25,0,25
Elefterios,M,100,0,6,6
Chaquilla,F,100,5,0,5
Jhoselyn,F,100,183,0,183
Avalynne,F,100,111,0,111
Satia,F,100,68,0,68
Lucija,F,100,5,0,5
Jules,M,77,1076,3642,4718
Kaleya,F,100,270,0,270
Ledora,F,100,111,0,111
Aracelio,M,100,0,5,5
Davein,M,100,0,6,6
Tranice,F,100,76,0,76
Imani,F,96,21305,974,22279
Yuval,M,67,154,309,463
Macala,F,100,155,0,155
Jamay,F,100,6,0,6
Julissa,F,100,21877,11,21888
Aliece,F,100,64,0,64
Akito,M,100,0,48,48
Milanna,F,100,104,0,104
Genara,F,100,16,0,16
Dejana,F,100,172,0,172
Jimiah,F,100,5,0,5
Shafiq,M,100,0,80,80
Kalesa,F,100,5,0,5
Shaquania,F,100,21,0,21
Marlice,F,100,5,0,5
Allyanna,F,100,230,0,230
Willmer,M,100,0,25,25
Jonathanjoseph,M,100,0,7,7
Imira,F,100,5,0,5
Kayveon,M,100,0,107,107
Dejuante,M,100,0,12,12
Renford,M,100,0,6,6
Djaun,M,100,0,6,6
Felisa,F,100,1842,0,1842
Tyne,F,97,367,13,380
Kaylyne,F,100,72,0,72
Tiquana,F,100,23,0,23
Quavon,M,100,0,405,405
Montse,F,100,7,0,7
Mauriyah,F,100,24,0,24
Kerington,F,100,62,0,62
Krisa,F,100,205,0,205
Kalayia,F,100,6,0,6
Carynn,F,100,83,0,83
Daneesha,F,100,72,0,72
Tyteana,F,100,37,0,37
Darresha,F,100,11,0,11
Deyra,F,100,65,0,65
Shalome,F,100,18,0,18
Dawnett,F,100,5,0,5
Monseratt,F,100,81,0,81
Chylynn,F,100,5,0,5
Johaan,M,100,0,47,47
Xenya,F,100,5,0,5
Safiya,F,100,1499,0,1499
Hobbs,M,100,0,6,6
Buddie,M,100,0,215,215
Margita,F,100,12,0,12
Yama,M,100,0,60,60
Rajeeni,F,100,17,0,17
Betsey,F,100,1237,0,1237
Kristoffer,M,100,0,3793,3793
Dae,M,65,63,117,180
Shamyria,F,100,12,0,12
Casee,F,100,245,0,245
Apirl,F,100,52,0,52
Tyrale,M,100,0,5,5
Remington,M,81,2029,8460,10489
Geselle,F,100,251,0,251
Jacks,M,100,0,25,25
Ashlie,F,100,9932,5,9937
Kristinn,F,100,5,0,5
Oveda,F,100,6,0,6
Esmerelda,F,100,489,0,489
Kadidra,F,100,17,0,17
Darius,M,99,272,48065,48337
Kaneesha,F,100,482,0,482
Keasiah,F,100,14,0,14
Camarie,F,90,179,21,200
Sonora,F,100,841,0,841
Kyeir,M,100,0,10,10
Deidra,F,100,9938,0,9938
Minh,M,87,261,1759,2020
Cyinthia,F,100,13,0,13
Nouri,M,100,0,11,11
Ecaterina,F,100,10,0,10
Martel,M,99,10,1504,1514
Ganessa,F,100,12,0,12
Iriel,F,100,64,0,64
Atta,M,100,0,12,12
Tryan,M,100,0,23,23
Brann,M,100,0,11,11
Sou,M,100,0,113,113
Jeida,F,100,50,0,50
Vasean,M,100,0,16,16
Janneth,F,100,409,0,409
Jinger,F,100,447,0,447
Kavaris,M,100,0,12,12
Gilford,M,100,0,387,387
Itzela,F,100,26,0,26
Loagan,M,100,0,10,10
Lynsi,F,100,415,0,415
Anneliesa,F,100,11,0,11
Marqui,M,83,59,293,352
Rpbert,M,100,0,19,19
Jaylaa,F,100,55,0,55
Ronyn,M,100,0,8,8
Almitra,F,100,24,0,24
Ruthena,F,100,11,0,11
Aleksandrs,M,100,0,5,5
Hubbert,M,100,0,5,5
Kahdijah,F,100,60,0,60
Talim,F,100,6,0,6
Malakii,M,100,0,46,46
Charlytte,F,100,10,0,10
Jenith,F,100,6,0,6
Claus,M,100,0,123,123
Ariella,F,100,6773,0,6773
Aarona,F,100,5,0,5
Yanibel,F,100,7,0,7
Taurino,M,100,0,15,15
Otavia,F,100,17,0,17
Samata,F,100,5,0,5
Shivana,F,100,10,0,10
Ivanna,F,100,4486,0,4486
Marchel,F,100,73,0,73
Yasel,M,100,0,6,6
Cosette,F,100,1683,0,1683
Efstratios,M,100,0,12,12
Searra,F,100,388,0,388
Jakim,M,100,0,150,150
Amberly,F,100,5443,0,5443
Elysha,F,96,669,26,695
Assiatou,F,100,7,0,7
Yannis,M,74,103,292,395
Marvion,M,100,0,118,118
Feiga,F,100,46,0,46
Roniel,M,100,0,87,87
Beatrice,F,100,30200,37,30237
Eftihia,F,100,12,0,12
Darhyl,M,100,0,11,11
Azziah,F,100,6,0,6
Jeanet,F,100,101,0,101
Angenie,F,100,5,0,5
Allessa,F,100,5,0,5
Sanyi,F,100,49,0,49
Leequan,M,100,0,5,5
Semiya,F,100,41,0,41
Shniyah,F,100,5,0,5
Quentavia,F,100,5,0,5
Daimyan,M,100,0,20,20
Kevone,M,100,0,20,20
Seph,M,100,0,13,13
Anakah,F,100,5,0,5
Dereck,M,100,0,6116,6116
Sania,F,100,1575,0,1575
Lilleigh,F,100,98,0,98
Donyea,M,65,92,171,263
Arlisa,F,100,431,0,431
Angeliyah,F,100,123,0,123
Magee,F,100,10,0,10
Rainne,F,100,5,0,5
Kiyarra,F,100,6,0,6
Zanyiah,F,100,165,0,165
Rakiah,F,100,59,0,59
Rockney,M,100,0,81,81
Anglica,F,100,40,0,40
Ryheim,M,100,0,16,16
Camdynn,F,89,39,5,44
Amillio,M,100,0,36,36
Trevien,M,100,0,11,11
Falin,F,100,48,0,48
Jameah,F,100,147,0,147
Arsen,M,100,0,284,284
Texanna,F,100,22,0,22
Siara,F,100,1550,0,1550
Stafanie,F,100,37,0,37
Randell,M,98,137,8300,8437
Juztin,M,100,0,5,5
Boruch,M,100,0,807,807
Jayanna,F,100,865,0,865
Lekisa,F,100,7,0,7
Daral,M,100,0,23,23
Tazman,M,100,0,10,10
Mychele,F,100,57,0,57
Caidee,F,100,5,0,5
Dreshaun,M,100,0,210,210
Gabryelle,F,100,527,0,527
Marleah,F,100,283,0,283
Reshanda,F,100,78,0,78
Kaishaun,M,100,0,6,6
Colleene,F,100,43,0,43
Kierstyn,F,100,2149,0,2149
Tamarick,M,100,0,63,63
Josian,M,100,0,208,208
Kaetlynn,F,100,16,0,16
Javantay,M,100,0,5,5
Linwood,M,100,0,5465,5465
Daniya,F,100,1197,0,1197
Abdulmajeed,M,100,0,22,22
Chasitty,F,100,56,0,56
Adyleigh,F,100,6,0,6
Riker,M,100,0,402,402
Wanesha,F,100,12,0,12
Jerimi,M,100,0,41,41
Elmon,M,100,0,89,89
Mikhaela,F,100,306,0,306
Damiam,M,100,0,5,5
Antonisha,F,100,268,0,268
Trayon,M,100,0,380,380
Tyrhiana,F,100,5,0,5
Saidah,F,100,313,0,313
Christohpher,M,100,0,13,13
Ahmia,F,100,89,0,89
Kaymani,F,100,6,0,6
Tammer,M,100,0,22,22
Mylashia,F,100,16,0,16
Breyanna,F,100,1331,0,1331
Cathleen,F,100,24513,10,24523
Neric,M,100,0,14,14
Azeneth,F,100,577,0,577
Raykwan,M,100,0,6,6
Nuvia,F,100,993,0,993
Criag,M,100,0,309,309
Hiwot,F,100,17,0,17
Natosha,F,100,3105,0,3105
Dylin,M,84,111,571,682
Santi,M,86,22,131,153
Markeeda,F,100,6,0,6
Tanara,F,100,214,0,214
Wisteria,F,100,17,0,17
Zunaira,F,100,129,0,129
Raianna,F,100,109,0,109
Naila,F,100,1633,0,1633
Wilmer,M,99,33,4658,4691
Chani,F,100,577,0,577
Amandah,F,100,44,0,44
Milaun,F,100,19,0,19
Clate,M,100,0,20,20
Dickson,M,100,0,409,409
Gizell,F,100,96,0,96
Marivelle,F,100,7,0,7
Sakita,F,100,37,0,37
Calloway,M,89,12,95,107
Alson,M,100,0,125,125
Deenie,F,100,17,0,17
Christne,F,100,60,0,60
Rollen,M,100,0,67,67
Esteven,M,100,0,698,698
Cerena,F,100,488,0,488
Cana,F,100,494,0,494
Leri,M,100,0,11,11
Maxen,M,100,0,178,178
Kyngston,M,100,0,121,121
Berl,M,100,0,274,274
Rital,F,100,25,0,25
Aarthi,F,100,104,0,104
Currie,M,54,54,64,118
Yamilet,F,100,3908,0,3908
Aronda,F,100,103,0,103
Macallan,M,100,0,131,131
Eeliyah,F,100,5,0,5
Deairra,F,100,153,0,153
Chiebuka,M,100,0,6,6
Keerstin,F,100,89,0,89
Braxdon,M,100,0,74,74
Raeed,M,100,0,10,10
Brittanylee,F,100,11,0,11
Javiere,M,100,0,10,10
Lelu,F,100,40,0,40
Zaeda,F,100,85,0,85
Keatan,M,100,0,17,17
Analilia,F,100,411,0,411
Elajah,F,100,137,0,137
Ahjahnae,F,100,5,0,5
Jayva,F,100,22,0,22
Caleen,F,100,94,0,94
Daivian,M,100,0,15,15
Pasco,M,100,0,42,42
Coilin,M,100,0,10,10
Gurfateh,M,100,0,27,27
Davaria,F,100,9,0,9
Adhley,F,100,7,0,7
Deshuan,M,100,0,10,10
Yailet,F,100,5,0,5
Juell,M,100,0,55,55
Ossian,M,100,0,23,23
Nardos,F,100,152,0,152
Elibeth,F,100,47,0,47
Attoria,F,100,19,0,19
Jaris,M,94,16,266,282
Venessia,F,100,17,0,17
Ladonya,F,100,215,0,215
Tarsheka,F,100,5,0,5
Sharrika,F,100,5,0,5
Zaccary,M,100,0,227,227
Verdie,F,89,194,24,218
Paradise,F,100,840,0,840
Gregorios,M,100,0,5,5
Tukker,M,100,0,58,58
Tifanny,F,100,149,0,149
Sheery,F,100,6,0,6
Keniyha,F,100,5,0,5
Jovanny,M,100,16,4106,4122
Jovon,M,90,289,2472,2761
Jahdiel,M,100,0,297,297
Audra,F,100,20966,52,21018
Danya,F,99,3076,29,3105
Marialena,F,100,202,0,202
Darlesha,F,100,10,0,10
Mitchael,M,100,0,238,238
Zoeylynn,F,100,23,0,23
Jae,M,55,985,1190,2175
Ilithyia,F,100,35,0,35
Ainslie,F,100,444,0,444
Kinyetta,F,100,38,0,38
Ignacio,M,100,15,13282,13297
Shanyra,F,100,34,0,34
Sei,M,100,0,7,7
Chassica,F,100,5,0,5
Dorsett,M,100,0,29,29
Daughtry,M,100,0,33,33
Treonna,F,100,121,0,121
Jendry,M,100,0,5,5
Jaethan,M,100,0,37,37
Tranika,F,100,75,0,75
Kaiven,M,100,0,62,62
Raffeal,M,100,0,15,15
Tracer,M,100,0,127,127
Sheyla,F,100,3306,0,3306
Joeziah,M,100,0,72,72
Jakiel,M,100,0,5,5
Aeron,M,89,60,509,569
Johnmichael,M,100,0,1968,1968
Renel,M,79,16,62,78
Marista,F,100,5,0,5
Winetta,F,100,5,0,5
Kyiren,M,100,0,5,5
Martavian,M,100,0,15,15
Dakayden,M,100,0,12,12
Linkin,M,100,0,827,827
Kerbie,F,100,18,0,18
Kendis,F,77,30,9,39
Timekia,F,100,19,0,19
Alphus,M,100,0,6,6
Ozie,M,73,76,208,284
Marshella,F,100,162,0,162
Deawn,F,100,6,0,6
Reese,F,65,25317,13363,38680
Gilliam,M,82,10,46,56
Jacquay,M,57,13,17,30
Cennedy,F,100,5,0,5
Astin,M,70,151,357,508
Teletha,F,100,86,0,86
Breahanna,F,100,6,0,6
Livi,F,100,203,0,203
Kenneith,M,100,0,185,185
Davious,M,100,0,32,32
Bonney,F,100,281,0,281
Ilanna,F,100,74,0,74
Jamilette,F,100,274,0,274
Sea,M,52,10,11,21
Emeree,F,100,93,0,93
Jasmain,F,100,82,0,82
Mekenzi,F,100,49,0,49
Dontavian,M,100,0,70,70
Lakeisha,F,100,12786,36,12822
Kelsei,F,100,263,0,263
Ive,F,100,6,0,6
Zyliyah,F,100,10,0,10
Aodhan,M,100,0,208,208
Jesicca,F,100,121,0,121
Koldyn,M,100,0,8,8
Yaelin,F,100,40,0,40
Hadleigh,F,100,1523,0,1523
Daylon,M,100,10,2602,2612
Keanon,M,100,0,146,146
Garak,M,100,0,5,5
Senecca,M,100,0,27,27
Teodora,F,100,512,0,512
Jardan,M,100,0,5,5
Mileva,F,100,5,0,5
Ulise,M,100,0,5,5
Gerrell,M,100,0,430,430
Benina,F,100,11,0,11
Rukaya,F,100,44,0,44
Deklen,M,100,0,116,116
Abrion,M,100,0,6,6
Afton,F,90,3083,350,3433
Malec,M,100,0,11,11
Shamsa,F,100,10,0,10
Monae,F,100,1860,0,1860
Makensey,F,100,126,0,126
Daivon,M,100,0,613,613
Elainy,F,100,14,0,14
Jasemine,F,100,183,0,183
Michal,M,51,3174,3277,6451
Pamler,F,100,25,0,25
Brentyn,M,100,0,180,180
Camron,M,97,399,13192,13591
Mercedas,F,100,5,0,5
Zhyair,M,100,0,5,5
Shatesha,F,100,11,0,11
Dienna,F,100,16,0,16
Karem,F,66,233,118,351
Kenze,F,100,10,0,10
Niketh,M,100,0,5,5
Turina,F,100,19,0,19
Yedida,F,100,5,0,5
Haralambos,M,100,0,253,253
Rokaya,F,100,17,0,17
Destinyann,F,100,5,0,5
Volney,M,100,0,75,75
Malajia,F,100,5,0,5
Kamill,F,100,68,0,68
Jhamarion,M,100,0,6,6
Ii,M,100,0,5,5
Bobbyjoe,M,100,0,89,89
Massimiliano,M,100,0,185,185
Jaisley,F,100,5,0,5
Giovannah,F,100,6,0,6
Lynsee,F,100,131,0,131
Godric,M,100,0,137,137
Tomesia,F,100,5,0,5
Minal,F,100,132,0,132
Hamsika,F,100,17,0,17
Swayam,M,100,0,36,36
Vikki,F,100,5909,0,5909
Dabriel,M,100,0,6,6
Ora,F,86,4420,735,5155
Jelesa,F,100,71,0,71
Adolphe,M,100,0,5,5
Ivet,F,100,233,0,233
Jeliana,F,100,6,0,6
Ekamjit,M,100,0,5,5
Dren,M,100,0,10,10
Omaury,M,100,0,13,13
Wyline,F,100,5,0,5
Jaysie,F,100,68,0,68
Berj,M,100,0,5,5
Malva,F,100,67,0,67
Tikita,F,100,62,0,62
Melannie,F,100,1379,0,1379
Kiante,M,69,182,414,596
Kamyrn,F,100,26,0,26
Seairra,F,100,222,0,222
Zhyon,M,80,12,48,60
Juwana,F,100,137,0,137
Yancey,M,97,34,1230,1264
Shaakira,F,100,224,0,224
Tyge,M,100,0,72,72
Tehreem,F,100,53,0,53
Akilesh,M,100,0,5,5
Cendra,F,100,11,0,11
Zerina,F,100,128,0,128
Jaylnn,F,100,92,0,92
Bentura,M,100,0,10,10
Nayomee,F,100,13,0,13
Mavia,F,100,5,0,5
Shakeela,F,100,257,0,257
Bernarr,M,100,0,5,5
Suada,F,100,15,0,15
Harutun,M,100,0,16,16
Fraidy,F,100,653,0,653
Murvin,M,100,0,33,33
Kadeedra,F,100,15,0,15
Nateria,F,100,12,0,12
Larice,F,100,47,0,47
Jaymani,M,100,0,12,12
Shakelah,F,100,7,0,7
Muhtasim,M,100,0,6,6
Shambrica,F,100,28,0,28
Shontice,F,100,11,0,11
Keating,M,65,6,11,17
Rosann,F,100,1750,0,1750
Nuhamin,F,100,28,0,28
Eiad,M,100,0,11,11
Mahima,F,100,362,0,362
Lynnell,F,100,488,0,488
Rowley,M,100,0,25,25
Elizajane,F,100,5,0,5
Kasea,F,100,13,0,13
Falana,F,100,124,0,124
Emmalea,F,100,400,0,400
Jessicah,F,100,295,0,295
Harini,F,100,448,0,448
Javione,M,100,0,65,65
Rhasheen,M,100,0,6,6
Bettyann,F,100,493,0,493
Teo,M,100,0,939,939
Femke,F,100,5,0,5
Thoms,M,100,0,200,200
Nayna,F,100,5,0,5
Adarius,M,100,0,1144,1144
Raees,M,100,0,12,12
Tinaka,F,100,11,0,11
Jennah,F,100,2539,0,2539
Shandia,F,100,27,0,27
Manvi,F,100,72,0,72
Jaydamarie,F,100,10,0,10
Keighan,M,83,20,97,117
Laionna,F,100,20,0,20
Noralie,F,100,5,0,5
Tallon,M,100,0,849,849
Molleigh,F,100,122,0,122
Jerelle,M,94,12,182,194
Narriah,F,100,10,0,10
Keeshan,F,100,5,0,5
Daveyon,M,100,0,228,228
Eland,M,100,0,47,47
Prudencio,M,100,0,208,208
Jessica,F,100,1036661,3570,1040231
Aires,M,78,7,25,32
Nickai,M,100,0,7,7
Shruthika,F,100,44,0,44
Lynnsey,F,100,765,0,765
Tojuana,F,100,11,0,11
Zaydenn,M,100,0,28,28
Binah,F,100,38,0,38
Yanahi,F,100,10,0,10
Abhigna,F,100,27,0,27
Jullien,M,100,0,207,207
Tharin,M,100,0,11,11
Grayer,M,100,0,105,105
Thandiwe,F,100,100,0,100
Joycelin,F,100,130,0,130
Juelez,M,100,0,14,14
Nouha,F,100,5,0,5
Kee,M,98,10,508,518
Caliann,F,100,84,0,84
Brysten,M,100,0,77,77
Sharna,F,100,413,0,413
Lise,F,100,2642,0,2642
Weida,F,100,5,0,5
Ashleylynn,F,100,34,0,34
Kellar,M,100,0,82,82
Deshya,F,100,8,0,8
Sparkles,F,100,73,0,73
Koralie,F,100,5,0,5
Tavette,F,100,5,0,5
Lachante,F,100,18,0,18
Ashor,M,100,0,5,5
Cleaven,M,100,0,30,30
Jennaveve,F,100,21,0,21
Connley,M,100,0,16,16
Rakwan,M,100,0,13,13
Ahrianna,F,100,161,0,161
Shikara,F,100,68,0,68
Joemy,F,100,12,0,12
Fenix,M,75,124,382,506
Lebaron,M,100,0,190,190
Masako,F,100,17,0,17
Alsion,F,100,17,0,17
Verne,M,94,77,1193,1270
Colden,M,100,0,587,587
Walker,M,99,227,16376,16603
Dewitte,M,100,0,7,7
Neriyah,F,100,122,0,122
Michiko,F,100,445,0,445
Damarte,M,100,0,5,5
Shehroz,M,100,0,5,5
Credell,M,100,0,7,7
Markeis,M,100,0,281,281
Cristofher,M,100,0,95,95
Dreysen,M,100,0,18,18
Charitha,F,100,5,0,5
Sianah,F,100,6,0,6
Adahy,M,100,0,6,6
Sudarshan,M,100,0,41,41
Jenavie,F,100,176,0,176
Jahleel,M,100,0,887,887
Mekiah,F,62,110,66,176
Tijae,F,100,6,0,6
Deyan,M,100,0,31,31
Quanasha,F,100,11,0,11
Tashonda,F,100,386,0,386
Gillian,F,100,15148,61,15209
Quartterio,M,100,0,5,5
Tavery,F,100,12,0,12
Aara,F,100,50,0,50
Kaylis,F,100,13,0,13
Lennix,M,64,53,94,147
Jenie,F,100,210,0,210
Leeanna,F,100,3289,0,3289
Chailyn,F,100,144,0,144
Tane,F,90,159,17,176
Eschelle,F,100,5,0,5
Dakarai,M,98,18,1059,1077
Milorad,M,100,0,5,5
Lenn,M,98,6,357,363
Margues,M,100,0,48,48
Yhoalibeth,F,100,12,0,12
Osmon,M,100,0,5,5
Xzorion,M,100,0,43,43
Jayc,M,100,0,35,35
Eliara,F,100,5,0,5
Johnavon,M,100,0,103,103
Meeghan,F,100,235,0,235
Laquata,F,100,32,0,32
Shaikha,F,100,5,0,5
Zarren,M,100,0,16,16
Chinelo,F,96,125,5,130
Debbra,F,100,3511,0,3511
Sharessa,F,100,6,0,6
Linlee,F,100,72,0,72
Catria,F,100,5,0,5
Renecia,F,100,50,0,50
Ireonna,F,100,10,0,10
Mcayla,F,100,17,0,17
Samyah,F,100,583,0,583
Amethyst,F,100,2537,0,2537
Jaydrian,M,100,0,132,132
Bao,M,55,579,722,1301
Laylanni,F,100,19,0,19
Abiezer,M,100,0,12,12
Jeovan,M,100,0,5,5
Xzayvian,M,100,0,18,18
Jonas,M,100,28,18289,18317
Jahleal,M,100,0,5,5
Williamjames,M,100,0,5,5
Roshaun,M,87,55,377,432
Jerritt,M,100,0,148,148
Mennie,F,100,36,0,36
Shawnacy,F,100,5,0,5
Rajni,F,100,17,0,17
Annakathryn,F,100,5,0,5
Charman,F,100,154,0,154
Raeneisha,F,100,8,0,8
Charleszetta,F,100,11,0,11
Peydon,M,100,0,24,24
Ozlem,F,100,10,0,10
Qorianka,F,100,7,0,7
Devki,F,100,13,0,13
Tuson,M,100,0,5,5
Merci,F,100,458,0,458
Truen,M,100,0,15,15
Arkadiusz,M,100,0,5,5
Mykeil,M,100,0,10,10
Dahlton,M,100,0,115,115
Quintel,M,100,0,287,287
Paty,F,100,5,0,5
Bryasha,F,100,5,0,5
Dajanay,F,100,139,0,139
Nyseem,M,100,0,17,17
Luckie,M,63,10,17,27
Celaya,F,100,6,0,6
Iniko,M,100,0,54,54
Armita,F,100,38,0,38
Gillianna,F,100,10,0,10
Yuridia,F,100,2383,0,2383
Lillianne,F,100,878,0,878
Dajonique,F,100,6,0,6
Ilinca,F,100,11,0,11
Jillana,F,100,110,0,110
Makhila,F,100,28,0,28
Zanden,M,100,0,94,94
Velouria,F,100,16,0,16
Sevag,M,100,0,165,165
Eireen,F,100,5,0,5
Orlagh,F,100,6,0,6
Dathan,M,100,0,1446,1446
Liset,F,100,1019,0,1019
Jenavi,F,100,56,0,56
Imaad,M,100,0,146,146
Anyelina,F,100,115,0,115
Shawniece,F,100,175,0,175
Kaala,F,100,43,0,43
Omed,M,100,0,5,5
Akoni,M,100,0,98,98
Jannik,M,100,0,12,12
Hirsch,M,100,0,10,10
Chelynne,F,100,21,0,21
Youssef,M,100,0,2109,2109
Brooklinn,F,100,176,0,176
Johnette,F,100,1492,0,1492
Carye,F,100,11,0,11
Marasia,F,100,63,0,63
Dalaina,F,100,225,0,225
Trinitty,F,100,16,0,16
Rayshan,M,100,0,22,22
Lillee,F,100,717,0,717
Versavia,F,100,10,0,10
Jeniva,F,100,25,0,25
Dutch,M,100,0,918,918
Rawle,M,100,0,11,11
Myrla,F,100,13,0,13
Audreena,F,100,66,0,66
Ebelia,F,100,53,0,53
Idelisa,F,100,5,0,5
Zarita,F,100,14,0,14
Idi,M,100,0,9,9
Brekke,F,100,7,0,7
Timolin,F,100,40,0,40
Regine,F,100,1332,0,1332
Demarcio,M,100,0,11,11
Toriono,M,100,0,6,6
Vanicia,F,100,10,0,10
Lakeem,M,100,0,127,127
Jezika,F,100,15,0,15
Harsimrat,F,100,5,0,5
Dylyn,M,78,25,90,115
Macklyn,F,100,37,0,37
Zephan,M,100,0,367,367
Teriah,F,100,70,0,70
Masao,M,100,0,24,24
Jazive,F,100,11,0,11
Justinray,M,100,0,18,18
Rhiane,F,100,5,0,5
Munib,M,100,0,11,11
Krimsyn,F,100,12,0,12
Pharell,M,100,0,169,169
Shaking,M,100,0,5,5
Yvonnia,F,100,53,0,53
Denize,F,100,21,0,21
Raylan,M,92,183,2156,2339
Jamyiah,F,100,277,0,277
Carreen,F,100,50,0,50
Lesandra,F,100,29,0,29
Emmry,F,100,86,0,86
Brooklen,F,100,216,0,216
Inri,M,100,0,86,86
Lyncoln,M,69,51,115,166
Januarie,F,100,10,0,10
Kyliah,F,100,287,0,287
Fielder,M,100,0,6,6
Adalynn,F,100,8643,0,8643
Jagroop,M,100,0,6,6
Dagne,F,100,12,0,12
Lyndia,F,100,614,0,614
Dejsha,F,100,11,0,11
Ayanna,F,100,13998,0,13998
Manav,M,100,0,584,584
Addisen,F,99,1005,6,1011
Dawud,M,100,0,685,685
Giamarie,F,100,51,0,51
Stephania,F,100,2073,0,2073
Darryll,M,100,0,1232,1232
Aftin,F,100,61,0,61
Lanijah,F,100,124,0,124
Sanyia,F,100,234,0,234
Macalla,F,100,8,0,8
Symere,M,100,0,33,33
Josseline,F,100,525,0,525
Hypatia,F,100,17,0,17
Corbie,F,71,12,5,17
Kinleigh,F,100,1025,0,1025
Xylar,M,100,0,5,5
Dequann,M,100,0,72,72
Quarmaine,M,100,0,6,6
Tabassum,F,100,11,0,11
Breiann,F,100,18,0,18
Elier,M,100,0,332,332
Braylan,M,95,44,911,955
Thadis,M,100,0,10,10
Demarquis,M,100,0,430,430
Matisse,F,55,195,157,352
Awo,F,100,7,0,7
Saleemah,F,100,169,0,169
Daquann,M,100,0,143,143
Carianna,F,100,70,0,70
Reshard,M,100,0,338,338
Surya,M,76,231,712,943
Julean,M,100,0,38,38
Keadrian,M,100,0,5,5
Laetitia,F,100,291,0,291
Jaquisha,F,100,218,0,218
Rehema,F,100,86,0,86
Nayelly,F,100,477,0,477
Melad,M,100,0,11,11
Rashia,F,100,135,0,135
Kohlby,M,100,0,27,27
Ren,M,87,170,1131,1301
Braston,M,100,0,5,5
Aydah,F,100,19,0,19
Rayma,F,100,373,0,373
Kaytee,F,100,382,0,382
Arius,M,93,36,488,524
Gabbanelli,F,100,7,0,7
Neshanta,F,100,9,0,9
Shirle,F,100,10,0,10
Moustafa,M,100,0,280,280
Bong,M,100,0,10,10
Krystiana,F,100,347,0,347
Selia,F,100,478,0,478
Jeanetta,F,100,3050,0,3050
Annabellelee,F,100,5,0,5
Flavian,M,100,0,5,5
Raheema,F,100,21,0,21
Tammatha,F,100,153,0,153
Dodson,M,100,0,5,5
Elvena,F,100,18,0,18
Remell,F,100,18,0,18
Romonica,F,100,37,0,37
Kristah,F,100,16,0,16
Rondarius,M,100,0,205,205
Judas,M,100,0,347,347
Kewanda,F,100,125,0,125
Jaton,F,53,62,55,117
Aizza,F,100,54,0,54
Camiah,F,100,156,0,156
Hesston,M,100,0,188,188
Camrynn,F,94,457,30,487
Sire,M,100,0,383,383
Royal,M,88,712,5322,6034
Sahory,F,100,41,0,41
Devarsh,M,100,0,8,8
Graycin,F,54,33,28,61
Miyoka,F,100,7,0,7
Attikus,M,100,0,73,73
Frantzy,M,100,0,16,16
Keiwon,M,100,0,10,10
Davelle,M,95,5,89,94
Greysin,M,100,0,30,30
Aloura,F,100,116,0,116
Jemier,M,100,0,5,5
Danyiah,F,100,36,0,36
Locksley,M,100,0,5,5
Annikah,F,100,89,0,89
Azer,M,100,0,5,5
Ladon,M,80,253,994,1247
Radine,F,100,16,0,16
Mavie,F,100,5,0,5
Meshell,F,100,495,0,495
Eshon,M,100,0,10,10
Melynda,F,100,2664,0,2664
Taquil,M,100,0,6,6
Keyair,M,100,0,5,5
Catreena,F,100,6,0,6
Lynx,M,100,0,37,37
Laquette,F,100,43,0,43
Julanne,F,100,107,0,107
Judeen,F,100,24,0,24
Laveyah,F,100,48,0,48
Tyden,M,100,0,216,216
Bricia,F,100,238,0,238
Anabelia,F,100,6,0,6
Xyion,M,79,5,19,24
Dearia,F,100,104,0,104
Dairin,F,100,40,0,40
Andrean,F,80,20,5,25
Blade,M,100,0,1792,1792
Andreina,F,99,1185,6,1191
Satsha,F,100,5,0,5
Jaquarrius,M,100,0,24,24
Lesleyann,F,100,86,0,86
Melodee,F,100,2164,0,2164
Amoree,F,100,71,0,71
Ahshanti,F,100,5,0,5
Dawm,F,100,5,0,5
Latisha,F,100,18311,38,18349
Aulden,M,100,0,41,41
Maecie,F,100,72,0,72
Pearse,M,100,0,147,147
Corderal,M,100,0,19,19
Anjail,F,100,51,0,51
Mijah,F,100,41,0,41
Levenia,F,100,12,0,12
Scarlytt,F,100,5,0,5
Trinety,F,100,13,0,13
Tico,M,100,0,81,81
Angelette,F,100,388,0,388
Marcum,M,100,0,20,20
Marquarius,M,100,0,166,166
Meta,F,100,1209,0,1209
Vollie,M,100,0,45,45
Bodey,M,100,0,328,328
Francee,F,100,58,0,58
Shailie,F,100,5,0,5
Shaleigh,F,100,351,0,351
Lagina,F,100,425,0,425
Robinann,F,100,17,0,17
Benjamim,M,100,0,21,21
Isidora,F,100,234,0,234
Artez,M,100,0,546,546
Felina,F,100,351,0,351
Brishaun,M,100,0,5,5
Vara,F,100,78,0,78
Mirandah,F,100,56,0,56
Bradford,M,100,39,26582,26621
Quavonte,M,100,0,6,6
Jaeven,M,100,0,68,68
Deziray,F,100,439,0,439
Shyleen,F,100,30,0,30
Kaycee,F,97,6726,212,6938
Johnparker,M,100,0,7,7
Analea,F,100,202,0,202
Nakieta,F,100,17,0,17
Nyota,F,100,24,0,24
Ireatha,F,100,5,0,5
Haajar,F,100,6,0,6
Syuri,F,100,11,0,11
Constancio,M,100,0,22,22
Gryphon,M,100,0,434,434
Shawntale,F,100,5,0,5
Kylan,M,88,714,5267,5981
Justa,F,100,126,0,126
Nolyn,M,89,53,418,471
Emelly,F,100,334,0,334
Nelina,F,100,18,0,18
Champayne,F,100,107,0,107
Deontae,M,100,0,3129,3129
Rakan,M,100,0,363,363
Sristi,F,100,21,0,21
Caitland,F,100,96,0,96
Jartavis,M,100,0,5,5
Xaylen,M,100,0,7,7
Mais,F,100,24,0,24
Juile,F,100,17,0,17
Coralei,F,100,21,0,21
Elfego,M,100,0,76,76
Meritt,F,50,11,11,22
Renyah,F,100,7,0,7
Eyvette,F,100,228,0,228
Toiya,F,100,123,0,123
Marlan,M,98,14,730,744
Greyling,M,100,0,12,12
Sinh,M,100,0,11,11
Assandra,F,100,5,0,5
Terriah,F,100,121,0,121
Ashmi,F,100,51,0,51
Shalynn,F,100,1405,0,1405
Devontray,M,100,0,18,18
Jossiah,M,100,0,121,121
Zephyra,F,100,39,0,39
Tycen,M,100,0,356,356
Lunette,F,100,43,0,43
Carolann,F,100,3176,0,3176
Jaecia,F,100,5,0,5
Jacoya,F,100,132,0,132
Genoa,F,100,106,0,106
Charmelle,F,100,101,0,101
Lateeka,F,100,6,0,6
Cyniyah,F,100,39,0,39
Khristal,F,100,45,0,45
Marvalene,F,100,20,0,20
Abbigal,F,100,148,0,148
Azelin,F,100,41,0,41
Skyana,F,100,5,0,5
Lislie,F,100,27,0,27
Sidahmed,M,100,0,5,5
Vasudha,F,100,31,0,31
Shimshon,M,100,0,245,245
Aidelis,F,100,12,0,12
Tariyah,F,100,378,0,378
Marianella,F,100,31,0,31
Adi,F,59,686,481,1167
Jaceyon,M,100,0,191,191
Tandie,F,100,12,0,12
Maliana,F,100,16,0,16
Johnell,M,79,278,1041,1319
Jentri,F,100,198,0,198
Lymari,F,100,40,0,40
Heli,F,87,102,15,117
Kenzingtyn,F,100,5,0,5
Juwanda,F,100,16,0,16
Lawrnce,M,100,0,30,30
Awn,F,100,5,0,5
Damante,M,100,0,99,99
Wynne,F,92,1038,94,1132
Truce,M,100,0,13,13
Anney,F,100,27,0,27
Linea,F,100,134,0,134
Jaide,F,100,1166,0,1166
Cherree,F,100,48,0,48
Arianda,F,100,22,0,22
Tiarnan,M,100,0,26,26
Panda,F,100,88,0,88
Lathon,M,100,0,83,83
Maikia,F,100,15,0,15
Tkayah,F,100,5,0,5
Kennth,M,100,0,1670,1670
Chinesta,F,100,5,0,5
Jahsan,M,100,0,17,17
Josilin,F,100,58,0,58
Gessell,F,100,5,0,5
Ambur,F,100,495,0,495
Bufford,M,100,0,72,72
Riyaan,M,86,11,68,79
Mkenzi,F,100,16,0,16
Adriahna,F,100,74,0,74
Pascual,M,100,0,1895,1895
Nyanna,F,100,238,0,238
Zorianna,F,100,100,0,100
Janill,F,100,23,0,23
Cassidy,F,94,51789,3128,54917
Coldin,M,100,0,5,5
Shonique,F,100,77,0,77
Mourya,M,100,0,5,5
Vayden,M,100,0,99,99
Leca,F,100,11,0,11
Aaja,F,100,5,0,5
Callye,F,100,7,0,7
Hridya,F,100,5,0,5
Olufunmilayo,F,100,34,0,34
Leilanee,F,100,45,0,45
Deaija,F,100,12,0,12
Louka,M,100,0,5,5
Maziyah,F,100,114,0,114
Adina,F,100,5474,0,5474
Abril,F,100,6667,5,6672
Boulder,M,100,0,10,10
Lanikki,F,100,11,0,11
Eileene,F,100,94,0,94
Iniyan,M,100,0,26,26
Jadden,M,91,28,300,328
Ezkiel,M,100,0,24,24
Dwaine,M,100,0,2724,2724
Sameen,F,90,92,10,102
Sashenka,F,100,50,0,50
Kihana,F,100,23,0,23
Matheson,M,100,0,94,94
Aaroosh,M,100,0,6,6
Marlyssa,F,100,16,0,16
Kailib,M,100,0,5,5
Lamonica,F,100,1662,6,1668
Tiara,F,100,22821,61,22882
Draylan,M,100,0,11,11
Shalante,F,100,5,0,5
Zaiven,M,100,0,23,23
Terecia,F,100,91,0,91
Jeramiha,M,100,0,28,28
Peytonn,F,100,5,0,5
Rashunda,F,100,349,0,349
Fracine,F,100,5,0,5
Maanasa,F,100,88,0,88
Kataleia,F,100,27,0,27
Emmit,M,100,0,1496,1496
Onia,F,100,15,0,15
Damauri,M,100,0,249,249
Jannica,F,100,28,0,28
Royston,M,100,0,111,111
Cayden,M,95,1532,26989,28521
Almeater,F,100,5,0,5
Igor,M,100,0,647,647
Shaquoya,F,100,95,0,95
Rodric,M,100,0,443,443
Mayvis,F,100,17,0,17
Jahzarah,F,100,24,0,24
Amane,F,100,44,0,44
Moriya,F,100,92,0,92
Conny,F,83,344,72,416
Jesikah,F,100,18,0,18
Roland,M,100,136,39184,39320
Michaelah,F,100,205,0,205
Niasia,F,100,829,0,829
Jeannene,F,100,381,0,381
Remigio,M,100,0,521,521
Breylyn,F,100,6,0,6
Alpesh,M,100,0,5,5
Brason,M,100,0,117,117
Amiir,M,100,0,61,61
Kaikea,M,100,0,39,39
Prarthana,F,100,37,0,37
Zahki,M,100,0,78,78
Alfonson,M,100,0,8,8
Camerino,M,100,0,21,21
Destinye,F,100,37,0,37
Brendella,F,100,6,0,6
Evalinda,F,100,10,0,10
Amaiya,F,100,1354,0,1354
Kortana,F,100,5,0,5
Aydun,M,100,0,6,6
Siana,F,100,782,0,782
Tanell,F,100,52,0,52
Kernisha,F,100,10,0,10
Malaija,F,100,34,0,34
Starkisha,F,100,94,0,94
Ronicka,F,100,11,0,11
Melroy,M,100,0,19,19
Deayra,F,100,12,0,12
Urban,M,100,0,692,692
Danery,F,100,5,0,5
Jaquel,M,75,123,365,488
Darrylin,F,100,14,0,14
Jewlia,F,100,32,0,32
Shaniaya,F,100,11,0,11
Tarak,M,100,0,22,22
Cassadie,F,100,164,0,164
Karac,M,100,0,36,36
Cahmari,M,100,0,6,6
Jerrimy,M,100,0,17,17
Gahel,M,100,0,70,70
Zavon,M,100,0,182,182
Kayston,M,100,0,32,32
Neviyah,F,100,44,0,44
Dovetta,F,100,16,0,16
Lasheika,F,100,146,0,146
Halim,M,100,0,172,172
Allonah,F,100,5,0,5
Viv,F,100,5,0,5
Gwendolynne,F,100,46,0,46
Machela,F,100,11,0,11
Yamileth,F,100,3574,0,3574
Sufyan,M,100,0,294,294
Tyshea,F,100,136,0,136
Ahlanie,F,100,5,0,5
Judith,F,100,175185,437,175622
Tieran,M,79,6,22,28
Ashle,F,100,545,0,545
Sybille,F,100,10,0,10
Alician,F,100,12,0,12
Mikeil,M,100,0,5,5
Rebbecca,F,100,2120,0,2120
Rashe,M,100,0,11,11
Kenithia,F,100,6,0,6
Latravius,M,100,0,29,29
Ledel,M,100,0,5,5
Mckenzi,F,100,1743,0,1743
Shady,M,60,196,288,484
Lanasha,F,100,56,0,56
Cloi,F,100,5,0,5
Haaheo,M,100,0,11,11
Gaetan,M,100,0,101,101
Jeshurun,M,100,0,47,47
Trevione,M,100,0,70,70
Asa,M,91,998,10493,11491
Korynne,F,100,135,0,135
Maximilien,M,100,0,258,258
Keyisha,F,100,13,0,13
Hania,F,100,389,0,389
Jamall,M,100,0,1420,1420
Zaydan,M,100,0,197,197
Carlisha,F,100,665,0,665
Travaris,M,100,0,402,402
Antesha,F,100,5,0,5
Zacharey,M,100,0,446,446
Surely,F,100,10,0,10
Windie,F,100,139,0,139
Lulu,F,100,1148,0,1148
Khiandra,F,100,5,0,5
Jahmarley,M,100,0,32,32
Achary,M,100,0,32,32
Aireona,F,100,212,0,212
Marianita,F,100,99,0,99
Premier,M,100,0,5,5
Prajit,M,100,0,15,15
Issachar,M,100,0,47,47
Laden,M,100,0,76,76
Challie,F,100,5,0,5
Arhan,M,100,0,175,175
Ainsleigh,F,100,356,0,356
Zoa,F,100,100,0,100
Lipman,M,100,0,6,6
Xiclaly,F,100,49,0,49
Gabrial,M,85,264,1527,1791
Leana,F,100,3277,0,3277
Mikaele,M,100,0,109,109
Calondra,F,100,10,0,10
Dutchess,F,100,84,0,84
Devlynn,F,100,49,0,49
Daya,F,100,468,0,468
Obryant,M,100,0,31,31
Aquarius,F,63,235,136,371
Addisin,F,100,25,0,25
Dantes,M,100,0,6,6
Vilate,F,100,5,0,5
Antoniyo,M,100,0,5,5
Tacorra,F,100,7,0,7
Johne,M,86,5,32,37
Antanea,F,100,5,0,5
Kendre,M,79,64,240,304
Eluterio,M,100,0,152,152
Kistin,F,100,7,0,7
Dmarius,M,100,0,60,60
Tavaras,M,100,0,132,132
Alnesha,F,100,5,0,5
Kiros,M,100,0,11,11
Belanna,F,100,92,0,92
Tolonda,F,100,10,0,10
Kanijah,F,100,242,0,242
Ellar,F,100,17,0,17
Markira,F,100,20,0,20
Marquia,F,100,459,0,459
Neliyah,F,100,15,0,15
Ansleigh,F,100,960,0,960
Shailynne,F,100,5,0,5
Meldia,F,100,6,0,6
Luvena,F,100,5,0,5
Amande,F,100,19,0,19
Labresha,F,100,117,0,117
Zhaire,M,100,0,85,85
Meoshi,F,100,5,0,5
Cahlil,M,100,0,124,124
Linder,F,100,216,0,216
Georgann,F,100,900,0,900
Ayna,F,100,33,0,33
Zytaevius,M,100,0,5,5
Koralyn,F,100,64,0,64
Dastyn,M,100,0,5,5
Iridian,F,99,581,7,588
Meeka,F,100,342,0,342
Mabyn,F,100,13,0,13
Ketziah,F,100,5,0,5
Monserrat,F,100,5737,26,5763
Juanmiguel,M,100,0,181,181
Kahmora,F,100,22,0,22
Ezlynn,F,100,5,0,5
Jahai,M,100,0,6,6
Alaila,F,100,307,0,307
Lakaysha,F,100,27,0,27
Ellis,M,87,2328,16092,18420
Algeria,F,100,32,0,32
Berlin,F,71,1086,439,1525
Jeovani,M,100,0,295,295
Torian,M,85,220,1260,1480
Briaunna,F,100,446,0,446
Meshay,F,100,5,0,5
Renina,F,100,11,0,11
Inisha,F,100,42,0,42
Brione,F,83,54,11,65
Helly,F,100,5,0,5
Lyllie,F,100,69,0,69
Aijha,F,100,5,0,5
Ollin,M,100,0,76,76
Tyesha,F,100,4559,0,4559
Rockell,F,100,206,0,206
Jasminne,F,100,123,0,123
Loie,F,100,29,0,29
Creshawn,M,100,0,10,10
Hasika,F,100,11,0,11
Xaiden,M,100,0,470,470
Nohe,M,100,0,21,21
Trevan,M,100,0,921,921
Cordeshia,F,100,5,0,5
Fenna,F,100,17,0,17
Chelsye,F,100,114,0,114
Kenz,F,100,5,0,5
Bertha,F,100,23731,67,23798
Rickira,F,100,6,0,6
Tyia,F,100,232,0,232
Learah,F,100,19,0,19
Levelle,M,100,0,251,251
Dekisha,F,100,70,0,70
Deen,M,99,5,370,375
Camey,F,100,172,0,172
Kimberla,F,100,149,0,149
Annay,F,100,57,0,57
Flavio,M,100,0,2380,2380
Kiren,M,78,33,118,151
Mariaines,F,100,12,0,12
Lauressa,F,100,7,0,7
Steffie,F,100,22,0,22
Mirakle,F,100,186,0,186
Johnnesha,F,100,19,0,19
Stevenray,M,100,0,16,16
Charidy,F,100,135,0,135
Luserito,F,100,5,0,5
Julie,F,100,478321,1370,479691
Saundria,F,100,17,0,17
Lyfe,M,73,45,121,166
Maricely,F,100,5,0,5
Lockie,F,100,5,0,5
Sumiyah,F,100,46,0,46
Jedric,M,100,0,6,6
Gile,M,100,0,5,5
Sebrena,F,100,449,0,449
Shyli,F,100,25,0,25
Desaun,M,100,0,16,16
Dayari,F,100,7,0,7
Kanyiah,F,100,41,0,41
Jovohn,M,100,0,5,5
Hamidou,M,100,0,42,42
Jacquelynne,F,100,658,0,658
Lakken,F,100,25,0,25
Leib,M,100,0,252,252
Kyril,M,100,0,17,17
Ahmani,F,85,352,61,413
Christiam,M,100,0,5,5
Quanaisha,F,100,5,0,5
Zakhar,M,100,0,11,11
Nikyta,F,100,7,0,7
Taqiyya,F,100,11,0,11
Kynadi,F,100,184,0,184
Amenata,F,100,5,0,5
Delawrence,M,100,0,130,130
Kaleel,M,100,0,439,439
Jager,M,100,0,460,460
Lyanna,F,100,661,0,661
Mekhia,F,100,235,0,235
Zachriah,M,100,0,10,10
Joriel,M,100,0,53,53
Bernis,M,100,0,91,91
Damonnie,M,100,0,5,5
Arisbet,F,100,53,0,53
Melana,F,100,753,0,753
Nyasha,F,100,630,0,630
Ausia,F,100,5,0,5
Saraelizabeth,F,100,20,0,20
Jerold,M,100,0,3842,3842
Maro,M,100,0,46,46
Jaquayla,F,100,107,0,107
Allysson,F,100,259,0,259
Shamonica,F,100,297,0,297
Patrena,F,100,92,0,92
Rebekka,F,100,1996,0,1996
Ousmane,M,100,0,382,382
Mirajane,F,100,5,0,5
Treycen,M,100,0,41,41
Simron,F,100,5,0,5
Howland,M,100,0,11,11
Ranaldo,M,100,0,38,38
Ailiana,F,100,5,0,5
Anglea,F,100,1489,0,1489
Ragini,F,100,21,0,21
Char,F,100,458,0,458
Damayah,F,100,23,0,23
Klyde,M,100,0,51,51
Derrione,M,100,0,5,5
Roxxane,F,100,5,0,5
Salley,F,100,176,0,176
Cadian,M,100,0,7,7
Allure,F,100,278,0,278
Rylinn,F,100,263,0,263
Emilynn,F,100,298,0,298
Dsean,M,100,0,314,314
Tiawana,F,100,135,0,135
Myanni,F,100,5,0,5
Colbee,F,78,18,5,23
Timica,F,100,107,0,107
Gristian,M,100,0,5,5
Vadir,M,100,0,11,11
Brendin,M,100,0,693,693
Laquarius,M,89,5,42,47
Miari,F,100,13,0,13
Jenyka,F,100,5,0,5
Daeshawn,M,99,5,720,725
Annice,F,100,601,0,601
Sennie,F,100,14,0,14
Hayato,M,100,0,196,196
Trami,F,100,6,0,6
Miriel,F,100,5,0,5
Xaidyn,M,100,0,31,31
Usbaldo,M,100,0,90,90
Yishay,M,100,0,16,16
Ural,M,100,0,95,95
Ivoree,F,100,72,0,72
Faithlyn,F,100,255,0,255
Ameerah,F,100,1514,0,1514
Fonisha,F,100,11,0,11
Jaquavia,F,100,47,0,47
Nasear,M,100,0,16,16
Blanche,F,100,4717,0,4717
Dashton,M,100,0,49,49
Jenedy,F,100,5,0,5
Ezequil,M,100,0,5,5
Trueman,M,100,0,5,5
Charlston,M,100,0,21,21
Jenisa,F,100,149,0,149
Aitza,F,100,25,0,25
Danille,F,100,702,0,702
Carlise,F,100,186,0,186
Nelda,F,100,5647,0,5647
Brooklynrose,F,100,5,0,5
Deatrick,M,100,0,25,25
Nancy,F,100,529495,1587,531082
Jalaal,M,100,0,10,10
Garit,M,100,0,19,19
Misty,F,100,84210,237,84447
Muniba,F,100,15,0,15
Shalona,F,100,108,0,108
Alazhia,F,100,5,0,5
Brent,M,100,561,132619,133180
Adilson,M,100,0,50,50
Malayka,F,100,26,0,26
Sulin,F,100,5,0,5
Artisha,F,100,478,0,478
Adwaith,M,100,0,5,5
Aby,F,76,180,56,236
Dorea,F,100,66,0,66
Milesha,F,100,10,0,10
Jaycen,M,99,5,758,763
Aleda,F,100,360,0,360
Lekesia,F,100,23,0,23
Jhony,M,100,0,282,282
Tsubaki,F,100,10,0,10
Eliezar,M,100,0,18,18
Willim,M,100,0,137,137
Zohar,F,62,107,66,173
Carmeleta,F,100,5,0,5
Tequan,M,100,0,390,390
Huynh,M,100,0,22,22
Anginette,F,100,83,0,83
Bemnet,F,53,27,24,51
Dannya,F,100,62,0,62
Tyvion,M,100,0,96,96
Dacee,F,100,5,0,5
Meliek,M,100,0,21,21
Zackeri,M,100,0,30,30
Vohn,M,100,0,5,5
Reniya,F,100,277,0,277
Lizzette,F,100,1681,0,1681
Yarnell,F,58,88,64,152
Jathziry,F,100,17,0,17
Sevon,M,97,6,182,188
Chrysa,F,100,94,0,94
Najma,F,100,567,0,567
Aamyah,F,100,51,0,51
Georginia,F,100,27,0,27
Deshia,F,100,91,0,91
Maruice,M,100,0,168,168
Sydny,F,100,270,0,270
Ixcel,F,100,20,0,20
Aybrie,F,100,19,0,19
Montese,M,100,0,5,5
Zavian,M,100,0,913,913
Iniki,F,87,45,7,52
Milvia,F,100,7,0,7
Beret,F,100,15,0,15
Mattias,M,100,0,1112,1112
Almonzo,M,100,0,18,18
Zeenah,F,100,5,0,5
Daman,M,100,0,627,627
Darcie,F,100,5332,0,5332
Neiva,F,100,88,0,88
Safwan,M,100,0,380,380
Albano,M,100,0,5,5
Viviene,F,100,34,0,34
Dajun,M,100,0,12,12
Riyon,M,100,0,19,19
Nishia,F,100,11,0,11
Karah,F,100,3026,0,3026
Stihl,M,100,0,32,32
Lemari,M,100,0,5,5
Leverett,M,100,0,20,20
Tanley,F,100,41,0,41
Ridwan,M,96,15,357,372
Takaia,F,100,11,0,11
Kyerra,F,100,346,0,346
Ladaria,F,100,26,0,26
Roquel,F,100,68,0,68
Anime,F,100,5,0,5
Hazaiah,M,100,0,33,33
Madilyn,F,100,13362,0,13362
Deshara,F,100,126,0,126
Avik,M,100,0,162,162
Dystiny,F,100,59,0,59
Dariyan,F,55,23,19,42
Kiaira,F,100,496,0,496
Rayqwan,M,100,0,11,11
Tiffini,F,100,1290,0,1290
Carolyon,F,100,6,0,6
Sunshyne,F,100,89,0,89
Kelina,F,100,169,0,169
Ameika,F,100,5,0,5
Duwanna,F,100,11,0,11
Dray,M,100,0,245,245
Ednesha,F,100,6,0,6
Nickyla,F,100,5,0,5
Najae,F,86,521,82,603
Miika,F,100,5,0,5
Anterion,M,100,0,6,6
Rennette,F,100,29,0,29
Janayshia,F,100,11,0,11
Liniyah,F,100,5,0,5
Shalesha,F,100,26,0,26
Suriah,F,100,105,0,105
Marcee,F,100,686,0,686
Suman,F,86,63,10,73
Tazaria,F,100,86,0,86
Talina,F,100,951,0,951
Deaunte,M,100,0,354,354
Ngozi,F,95,427,21,448
Ody,M,71,5,12,17
Gabriyel,F,54,13,11,24
Marvelene,F,100,10,0,10
Corie,F,78,3477,988,4465
Lashasta,F,100,23,0,23
Mehgan,F,100,543,0,543
Johnhenry,M,100,0,493,493
Zahair,M,100,0,12,12
Jalisha,F,100,541,0,541
Raiyah,F,100,27,0,27
Napolean,M,100,0,235,235
Lesane,M,100,0,8,8
Atlantis,F,96,402,17,419
Kishana,F,100,89,0,89
Tazmeen,F,100,17,0,17
Marlyse,F,100,40,0,40
Reinhardt,M,100,0,10,10
Lekhi,M,100,0,5,5
Catalia,F,100,83,0,83
Elnatan,M,100,0,17,17
Narcissus,F,100,11,0,11
Bryceon,M,100,0,10,10
Braheem,M,100,0,253,253
Khareem,M,100,0,32,32
Fiesta,F,100,6,0,6
Eko,M,100,0,5,5
Desarai,F,100,73,0,73
Shavar,M,100,0,350,350
Taneille,F,100,5,0,5
Keeisha,F,100,5,0,5
Zanisha,F,100,6,0,6
Kenyarda,F,100,16,0,16
Adalene,F,100,218,0,218
Devaugh,M,100,0,5,5
Aliska,F,100,5,0,5
Jisaiah,M,100,0,41,41
Cirena,F,100,11,0,11
Dustine,F,60,146,96,242
Shell,F,62,198,119,317
Makaylea,F,100,11,0,11
Jeffren,M,100,0,72,72
Candie,F,100,2878,0,2878
Antoney,M,100,0,63,63
Liann,F,100,487,0,487
Eureeka,F,100,5,0,5
Myliegh,F,100,5,0,5
Claudis,M,100,0,86,86
Anah,F,100,335,0,335
Ameliana,F,100,101,0,101
Cordia,F,100,234,0,234
Emeth,M,100,0,6,6
Elexcia,F,100,30,0,30
Cyril,M,100,10,3452,3462
Abdilahi,M,100,0,10,10
Charnique,F,100,22,0,22
Kalell,M,100,0,17,17
Jackye,F,100,106,0,106
Tovi,M,100,0,35,35
Ashlee,F,99,42890,258,43148
Socrates,M,100,0,456,456
Melysa,F,100,80,0,80
Shireka,F,100,43,0,43
Lakicha,F,100,11,0,11
Jordano,M,100,0,51,51
Karlah,F,100,11,0,11
Ulyssa,F,100,183,0,183
Davinity,F,100,52,0,52
Tiina,F,100,38,0,38
Tanyetta,F,100,40,0,40
Blaiklee,F,100,17,0,17
Naveh,F,100,49,0,49
Markina,F,100,11,0,11
Shannell,F,100,488,0,488
Canasia,F,100,6,0,6
Ausencio,M,100,0,34,34
Lurlene,F,100,114,0,114
Ariann,F,98,394,6,400
Crissandra,F,100,15,0,15
Jingyi,F,100,10,0,10
Naoya,M,100,0,17,17
Anashia,F,100,27,0,27
Jacarius,M,100,0,101,101
Mattaya,F,100,5,0,5
Winfred,M,98,63,3441,3504
Baren,M,100,0,5,5
Greyson,M,98,435,17313,17748
Matheo,M,100,0,400,400
Shelbie,F,100,5163,0,5163
Amaris,F,97,5857,159,6016
Carlson,M,100,0,490,490
Leighlan,M,100,0,5,5
Amzi,F,100,5,0,5
Ronyae,F,100,17,0,17
Taneal,F,100,127,0,127
Syara,F,100,41,0,41
Kalila,F,100,616,0,616
Wanakee,F,100,37,0,37
Lixandro,M,100,0,10,10
Aidenjames,M,100,0,62,62
Doralene,F,100,49,0,49
Rhana,F,100,5,0,5
Azilyn,F,100,10,0,10
Zhair,M,100,0,5,5
Yetzael,M,100,0,26,26
Kohlton,M,100,0,349,349
Kenyada,F,79,565,146,711
Jacklene,F,100,28,0,28
Cassonia,F,100,5,0,5
Azan,M,100,0,242,242
Halie,F,100,7262,0,7262
Solly,M,100,0,5,5
Richrd,M,100,0,399,399
Latrissa,F,100,7,0,7
Akyia,F,100,81,0,81
Oddie,M,100,0,46,46
Atalya,F,100,125,0,125
Enissa,F,100,5,0,5
Tagert,M,100,0,6,6
Chicora,F,100,5,0,5
Baranda,F,100,16,0,16
Venika,F,100,6,0,6
Yeeleng,M,100,0,40,40
Saylah,F,100,62,0,62
Tattyana,F,100,6,0,6
Jusitn,M,100,0,143,143
Misheel,F,100,31,0,31
Jen,F,79,272,72,344
Mclain,M,92,14,167,181
Kalise,F,100,491,0,491
Lazare,M,100,0,5,5
Briauna,F,100,1319,0,1319
Pratiksha,F,100,6,0,6
Starletta,F,100,112,0,112
Najji,M,100,0,5,5
Fanessa,F,100,12,0,12
Dalan,M,100,0,515,515
Harmandeep,M,100,0,10,10
Duewa,F,100,7,0,7
Brayley,F,100,133,0,133
Fraya,F,100,16,0,16
Kamina,F,100,22,0,22
Havok,M,100,0,12,12
Arieona,F,100,195,0,195
Anniemarie,F,100,11,0,11
Ausitn,M,100,0,30,30
Ryna,F,70,47,20,67
Dreshan,M,100,0,9,9
Ida,F,100,22302,46,22348
Felisia,F,100,258,0,258
Skylynne,F,100,80,0,80
Neily,F,100,46,0,46
Tristion,M,100,0,44,44
Florisel,F,100,5,0,5
Lariana,F,100,34,0,34
Mckinleigh,F,100,205,0,205
Treylon,M,100,0,264,264
Damontra,M,100,0,15,15
Bette,F,100,4695,0,4695
Kylise,F,100,10,0,10
Maye,F,100,114,0,114
Rege,M,100,0,5,5
Maricruz,F,100,2734,0,2734
Benedikt,M,100,0,18,18
Xain,M,100,0,29,29
Marixza,F,100,12,0,12
Fawwaz,M,100,0,23,23
Bricker,M,100,0,15,15
Quintasha,F,100,53,0,53
Tashaya,F,100,84,0,84
Tierani,F,100,5,0,5
Marlane,F,100,396,0,396
Cali,F,99,12405,87,12492
Bettyjane,F,100,30,0,30
Mardeen,F,100,19,0,19
Roston,M,100,0,57,57
Taig,M,100,0,5,5
Janey,F,100,3187,0,3187
Carrena,F,100,5,0,5
Abygaile,F,100,13,0,13
Ruhaan,M,100,0,130,130
Kertrina,F,100,9,0,9
Laddie,M,99,5,377,382
Kawika,M,100,0,1021,1021
Ternisha,F,100,28,0,28
Andice,F,100,5,0,5
Akayden,M,100,0,5,5
Jvaughn,M,100,0,29,29
Yuting,F,100,5,0,5
Sand,F,100,10,0,10
Tahniya,F,100,35,0,35
Taleshia,F,100,157,0,157
Anelys,F,100,39,0,39
Lacynthia,F,100,10,0,10
Amisa,F,100,11,0,11
Jaidev,M,100,0,107,107
Eleasha,F,100,77,0,77
Annyka,F,100,28,0,28
Keauri,F,100,6,0,6
Sadio,F,100,5,0,5
Kalleigh,F,100,468,0,468
Mylene,F,100,635,0,635
Burnard,M,100,0,29,29
Bracie,F,100,39,0,39
Omeria,F,100,5,0,5
Niekia,F,100,5,0,5
Wandalee,F,100,16,0,16
Deontrez,M,100,0,30,30
Ianah,F,100,5,0,5
Genesis,F,97,51048,1654,52702
Dajza,F,100,5,0,5
Naelani,F,100,52,0,52
Phadra,F,100,15,0,15
Dalbert,M,100,0,70,70
Jamaire,M,100,0,28,28
Jadey,F,100,58,0,58
Haresh,M,100,0,11,11
Bruna,F,100,392,0,392
Dalay,F,100,38,0,38
Hazim,M,100,0,71,71
Shaneesa,F,100,5,0,5
Christyan,M,98,5,253,258
Kaijah,F,100,117,0,117
Tyonne,M,67,16,33,49
Sevda,F,100,12,0,12
Eriksson,M,100,0,15,15
Besty,F,100,44,0,44
Cohen,M,99,88,9307,9395
Sait,M,100,0,11,11
Varon,M,100,0,10,10
Shantele,F,100,238,0,238
Kimoni,M,59,142,205,347
Sid,M,100,0,1334,1334
Fabion,M,100,0,185,185
Tuong,M,55,5,6,11
Alexandros,M,100,0,1347,1347
Brode,M,100,0,117,117
Kadija,F,100,471,0,471
Joumana,F,100,20,0,20
Itai,M,100,0,338,338
Clora,F,100,166,0,166
Caleel,M,100,0,60,60
Biatris,F,100,17,0,17
Raynisha,F,100,222,0,222
Gisel,F,100,2077,0,2077
Mareo,M,100,0,179,179
Jamilah,F,99,2078,16,2094
Quinston,M,100,0,13,13
Kalon,M,98,17,833,850
Murdock,M,100,0,79,79
Maksen,M,100,0,6,6
Darcelle,F,100,361,0,361
Jeyly,F,100,6,0,6
Shnita,F,100,5,0,5
Webber,M,100,0,18,18
Maitreyi,F,100,22,0,22
Madux,M,100,0,17,17
Westley,M,100,5,5504,5509
Cmone,F,100,5,0,5
Margrethe,F,100,11,0,11
Sydeny,F,100,12,0,12
Maia,F,100,11068,0,11068
Zabien,M,100,0,21,21
Cady,F,99,2190,20,2210
Zaynab,F,100,1083,0,1083
Yumiko,F,100,212,0,212
Claudiajoy,F,100,6,0,6
Javiyon,M,100,0,15,15
Herny,M,100,0,140,140
Sonnie,F,57,516,385,901
Kentravious,M,100,0,154,154
Venida,F,100,81,0,81
Kedrian,M,100,0,15,15
Donyell,M,56,398,504,902
Lisetta,F,100,5,0,5
Kairo,M,100,0,508,508
Kanita,F,100,204,0,204
Cervando,M,100,0,105,105
Sharnet,F,100,5,0,5
Harles,M,100,0,93,93
Sulia,F,100,5,0,5
Thaman,M,100,0,19,19
Sobia,F,100,61,0,61
Lauriel,F,100,140,0,140
Lakeiya,F,100,25,0,25
Orazio,M,100,0,68,68
Dalexa,F,100,29,0,29
Argelis,M,88,5,36,41
Evaya,F,100,18,0,18
Damerion,M,100,0,23,23
Cristalina,F,100,12,0,12
Miliana,F,100,322,0,322
Jahzel,F,91,52,5,57
Tabria,F,100,255,0,255
Deontea,M,100,0,33,33
Gesina,F,100,5,0,5
Envy,F,99,385,5,390
Richanda,F,100,58,0,58
Dake,M,100,0,5,5
Sahnnon,F,100,18,0,18
Lashelle,F,100,1045,0,1045
Asianay,F,100,5,0,5
Norfleet,M,100,0,7,7
Talore,F,100,38,0,38
Emeryk,M,100,0,5,5
Krisheena,F,100,6,0,6
Zaiah,F,56,83,65,148
Keaundria,F,100,13,0,13
Taylen,M,59,689,997,1686
Gladimir,M,100,0,12,12
Maricio,M,100,0,10,10
Krea,F,100,5,0,5
Feben,F,100,12,0,12
Andora,F,100,123,0,123
Harrington,M,100,0,123,123
Victorya,F,100,504,0,504
Mindel,F,100,146,0,146
Cidalia,F,100,11,0,11
Rommel,M,100,0,1284,1284
Jadalys,F,100,6,0,6
Ladavian,M,100,0,5,5
Ellabelle,F,100,10,0,10
Doan,M,69,17,37,54
Bryasia,F,100,15,0,15
Darreus,M,100,0,15,15
Cordella,F,100,84,0,84
Angelyce,F,100,7,0,7
Ryanlee,M,100,0,20,20
Arnetia,F,100,76,0,76
Teuna,F,100,6,0,6
Crispin,M,100,5,1295,1300
Kimonte,M,100,0,5,5
Mykena,F,100,12,0,12
Alize,F,94,4679,322,5001
Emmabelle,F,100,36,0,36
Marquae,M,100,0,16,16
Hamna,F,100,90,0,90
Jaylein,F,76,16,5,21
Deboraha,F,100,353,0,353
Ayven,M,90,22,190,212
Melaki,M,100,0,24,24
Jonalyn,F,100,206,0,206
Cindee,F,100,858,0,858
Daejah,F,100,448,0,448
Hendley,F,100,5,0,5
Navion,M,100,0,39,39
Jaquai,M,100,0,33,33
Achilles,M,100,0,1497,1497
Floyde,M,100,0,36,36
Javel,M,100,0,161,161
Kistina,F,100,5,0,5
Amariyana,F,100,78,0,78
Naviyah,F,100,68,0,68
Trayshon,M,100,0,13,13
Ledawn,F,100,10,0,10
Sourya,M,100,0,16,16
Doran,M,97,50,1756,1806
Brizeida,F,100,307,0,307
Riza,F,100,38,0,38
Malaki,M,100,5,2956,2961
Lavinia,F,100,1972,0,1972
Kenyatta,F,58,4209,3093,7302
Mae,F,100,13312,36,13348
Schneur,M,100,0,264,264
Frankee,F,100,160,0,160
Makenna,F,100,24624,8,24632
Django,M,100,0,223,223
Naftula,M,100,0,77,77
Wynell,F,97,194,6,200
Tacorey,M,100,0,29,29
Laysa,F,100,88,0,88
Iliya,M,91,12,115,127
Joevani,M,100,0,23,23
Keiyana,F,100,149,0,149
Drenisha,F,100,6,0,6
Jimi,M,65,611,1122,1733
Syah,F,100,32,0,32
Tameca,F,100,697,0,697
Elize,F,97,188,5,193
Leejay,M,100,0,5,5
Lyka,F,100,10,0,10
Simrah,F,100,195,0,195
Kendu,M,100,0,10,10
Annakate,F,100,216,0,216
Jaeli,F,100,182,0,182
Orange,M,100,0,33,33
Sherrilyn,F,100,517,0,517
Queneisha,F,100,5,0,5
Yannie,F,100,10,0,10
Tyniqua,F,100,56,0,56
Jonelle,F,99,2762,21,2783
Hevan,F,100,18,0,18
Pervis,M,100,0,481,481
Cleveland,M,100,32,9103,9135
Demoni,M,76,51,161,212
Yaneisha,F,100,5,0,5
Belany,F,100,5,0,5
Sameia,F,100,5,0,5
Coron,M,100,0,84,84
Yedidya,M,100,0,68,68
Brytney,F,100,103,0,103
Nkiruka,F,100,27,0,27
Shalie,F,100,148,0,148
Natyia,F,100,23,0,23
Wessie,F,100,10,0,10
Rosslyn,F,100,506,0,506
Shiloe,F,100,29,0,29
Nykiria,F,100,5,0,5
Mugisha,M,100,0,10,10
Cierrah,F,100,282,0,282
Zacheria,M,100,0,34,34
Raedyn,F,66,130,67,197
Shangaleza,F,100,5,0,5
Dakhari,M,100,0,126,126
Jwyanza,M,100,0,6,6
Grizel,F,100,52,0,52
Dilann,M,100,0,5,5
Kaneshia,F,100,451,0,451
Saegan,F,100,11,0,11
Zykirah,F,100,32,0,32
Hajer,F,100,101,0,101
Laylin,F,100,35,0,35
Anyla,F,100,1179,0,1179
Oluwadurotimi,M,100,0,6,6
Kruize,M,100,0,5,5
Poe,M,67,5,10,15
Quadir,M,100,0,1339,1339
Randalph,M,100,0,24,24
Marlone,M,100,0,28,28
Kato,M,100,0,336,336
Shantai,F,100,160,0,160
Vernecia,F,100,84,0,84
Nature,F,80,224,57,281
Sharmain,F,100,176,0,176
Kyshawn,M,100,0,383,383
Vontarius,M,100,0,5,5
Gipson,M,100,0,5,5
Mercury,M,94,6,91,97
Meledy,F,100,5,0,5
Rasmus,M,100,0,49,49
Jacqelyn,F,100,5,0,5
Neal,M,100,67,36558,36625
Felizardo,M,100,0,5,5
Jorga,F,100,55,0,55
Sheneshia,F,100,5,0,5
Aakriti,F,100,30,0,30
Dianetta,F,100,11,0,11
Gonsalo,M,100,0,207,207
Delene,F,100,507,0,507
Jan,F,75,43550,14150,57700
Jewelyssa,F,100,9,0,9
Jeanmarie,F,100,2112,0,2112
Alyxandra,F,100,698,0,698
Aneeya,F,100,5,0,5
Maydelyn,F,100,7,0,7
Jamyra,F,100,814,0,814
Dashara,F,100,35,0,35
Pranesh,M,100,0,15,15
Jarexi,F,100,5,0,5
Mayalen,F,100,11,0,11
Tayelor,F,100,158,0,158
Yalia,F,100,6,0,6
Virgal,M,100,0,26,26
Yo,F,100,9,0,9
Deaysia,F,100,65,0,65
Daniza,F,100,5,0,5
Kyrese,M,100,0,256,256
Rhema,F,100,592,0,592
Cassiopia,F,100,45,0,45
Nydra,F,100,14,0,14
Chrisalynn,F,100,5,0,5
Darriyah,F,100,11,0,11
Gedalia,M,100,0,79,79
Yanai,F,100,54,0,54
Tyvonne,M,100,0,10,10
Noman,M,100,0,46,46
Howard,M,100,476,103986,104462
Joquin,M,100,0,11,11
Joseantonio,M,100,0,706,706
Bana,F,100,101,0,101
Myoshi,F,100,42,0,42
Irielle,F,100,28,0,28
Anhtuan,M,100,0,5,5
Rhaniya,F,100,38,0,38
Gauge,M,100,0,3631,3631
Sailer,F,100,12,0,12
Whitnee,F,100,597,0,597
Anjie,F,100,36,0,36
Paralee,F,100,97,0,97
Deici,F,100,35,0,35
Raylena,F,100,39,0,39
Abnel,M,100,0,6,6
Dag,M,100,0,49,49
Pamalia,F,100,5,0,5
Devaughnte,M,100,0,10,10
Venkat,M,100,0,106,106
Kawailani,F,100,17,0,17
Johnjames,M,100,0,34,34
Kennetha,F,100,556,0,556
Delquan,M,100,0,107,107
Qadry,M,100,0,34,34
Jaysen,M,100,0,2303,2303
Jocqui,M,100,0,41,41
Kricket,F,100,40,0,40
Juelian,M,100,0,5,5
Anareli,F,100,53,0,53
Octavio,M,100,5,9188,9193
Infantgirl,F,100,11,0,11
Tyleyah,F,100,6,0,6
Sharielle,F,100,5,0,5
Kenry,M,100,0,55,55
Monaca,F,100,87,0,87
Kyonne,M,100,0,5,5
Alyicia,F,100,5,0,5
Raysha,F,100,98,0,98
Miray,F,100,50,0,50
Lotoya,F,100,466,0,466
Aracellie,F,100,5,0,5
Vyolette,F,100,6,0,6
Charmella,F,100,5,0,5
Caidan,M,100,0,312,312
Irissa,F,100,48,0,48
Kosta,M,100,0,242,242
Lakhi,M,100,0,14,14
Terralynn,F,100,5,0,5
Nyasa,F,100,10,0,10
Ashwaq,F,100,21,0,21
Brinton,M,100,0,613,613
Londonn,F,100,5,0,5
Rances,M,100,0,17,17
Huntyr,F,73,37,14,51
Jshawn,M,100,0,287,287
Porscha,F,100,1447,0,1447
Song,F,74,201,71,272
Skylie,F,100,447,0,447
Gabrian,M,100,0,127,127
Sanil,M,100,0,32,32
Gearldine,F,100,940,0,940
Tristia,F,100,14,0,14
Kaedynn,F,76,16,5,21
Sommer,F,100,5732,0,5732
Davondre,M,100,0,48,48
Zykayla,F,100,13,0,13
Draydin,M,100,0,13,13
Nashea,F,100,108,0,108
Breona,F,100,1967,0,1967
Quashonda,F,100,21,0,21
Meshae,F,100,5,0,5
Dellah,F,100,11,0,11
Danit,F,100,15,0,15
Trion,M,100,0,5,5
Aurelie,F,100,251,0,251
Nataka,F,100,6,0,6
Sisira,F,100,29,0,29
Jeilene,F,100,16,0,16
Staccato,M,100,0,16,16
Juriel,M,100,0,44,44
Janovia,F,100,13,0,13
Tranae,F,100,186,0,186
Sydra,F,100,5,0,5
Ricky,M,99,1627,212131,213758
Aliza,F,100,7292,5,7297
Cathal,M,100,0,35,35
Shammond,M,100,0,67,67
Lenelle,F,100,33,0,33
Anneelizabeth,F,100,15,0,15
Jungwoo,M,100,0,5,5
Anrea,F,100,12,0,12
Dresha,F,100,5,0,5
Jezabelle,F,100,121,0,121
Aneisha,F,100,583,0,583
Anny,F,100,1016,0,1016
Annalin,F,100,14,0,14
Briaja,F,100,25,0,25
Shristopher,M,100,0,6,6
Aayanah,F,100,10,0,10
Isys,F,100,294,0,294
Jabraylin,M,100,0,8,8
Siriah,F,100,53,0,53
Sahel,M,100,0,25,25
Blakney,F,100,5,0,5
Demarea,M,100,0,214,214
Kameshia,F,100,298,0,298
Alliyiah,F,100,5,0,5
Weston,M,100,23,30582,30605
Delite,F,100,10,0,10
Warden,M,100,0,57,57
Omariyon,M,100,0,18,18
Laterria,F,100,204,0,204
Nathniel,M,100,0,11,11
Alxis,F,100,16,0,16
Kaselyn,F,100,22,0,22
Dashan,M,95,10,205,215
Lensey,F,100,35,0,35
Filza,F,100,21,0,21
Derrika,F,100,168,0,168
Karrell,M,100,0,10,10
Norreen,F,100,6,0,6
Mitt,M,100,0,27,27
Torez,M,100,0,90,90
Riland,M,100,0,12,12
Laketria,F,100,6,0,6
Inell,F,100,321,0,321
Lushawn,F,100,5,0,5
Naiesha,F,100,39,0,39
Aniko,F,100,82,0,82
Lavanya,F,100,186,0,186
Pharrah,F,100,86,0,86
Nowah,M,100,0,5,5
Noele,F,100,135,0,135
Red,M,100,0,47,47
Patresa,F,100,26,0,26
Johnnell,M,100,0,72,72
Karlen,F,89,125,16,141
Teerra,F,100,5,0,5
Yaquelyn,F,100,40,0,40
Nusrat,F,100,151,0,151
Konstandinos,M,100,0,29,29
Alexjandro,M,100,0,49,49
Zakayah,F,100,6,0,6
Zelia,F,100,319,0,319
Zaccheaus,M,100,0,85,85
Jaimz,M,100,0,11,11
Galo,M,100,0,313,313
Mickail,M,100,0,5,5
Nyan,M,100,0,70,70
Marquin,M,100,0,107,107
Masyn,M,70,366,852,1218
Kimora,F,100,6953,0,6953
Nathina,F,100,12,0,12
Malora,F,100,20,0,20
Zanijah,F,100,28,0,28
Rmoni,F,100,58,0,58
Boede,M,100,0,5,5
Kassim,M,100,0,277,277
Erico,M,100,0,77,77
Jermih,M,100,0,6,6
Ainara,F,100,152,0,152
Azayvion,M,100,0,19,19
Bellarae,F,100,36,0,36
Arsh,M,100,0,388,388
Traetyn,M,100,0,5,5
Elsah,F,100,12,0,12
Onur,M,100,0,108,108
Markaya,F,100,42,0,42
Meyra,F,100,5,0,5
Tmya,F,100,73,0,73
Tayson,M,100,0,575,575
Zebadiah,M,100,0,882,882
Arie,F,52,1457,1322,2779
Saleema,F,100,191,0,191
Asten,M,79,8,30,38
Cyrina,F,100,42,0,42
Anta,F,100,32,0,32
Adhav,M,100,0,24,24
Trek,M,100,0,89,89
Jm,M,100,0,5,5
Sabri,M,80,33,128,161
Marqueisha,F,100,42,0,42
Taseen,M,100,0,115,115
Myrle,F,54,83,70,153
Detri,F,100,5,0,5
Daytwan,M,100,0,6,6
Kensen,M,100,0,13,13
Kellam,M,100,0,30,30
Cada,F,100,5,0,5
Aadhi,M,100,0,12,12
Dayveon,M,100,0,342,342
Shatiya,F,100,50,0,50
Baelee,F,100,31,0,31
Dajah,F,100,1925,7,1932
Sharnee,F,100,102,0,102
Shloma,M,100,0,269,269
Meredith,F,98,65821,1341,67162
Shalymar,F,100,5,0,5
Danh,M,100,0,216,216
Josslin,F,100,80,0,80
Devrick,M,100,0,25,25
Nicasia,F,100,6,0,6
Milenia,F,100,33,0,33
Crosley,M,69,19,42,61
Leangela,F,100,11,0,11
Jazmun,F,100,12,0,12
Nesbit,M,100,0,5,5
Zaki,M,100,0,935,935
Tine,F,100,108,0,108
Pressly,F,100,37,0,37
Lleyton,M,100,0,605,605
Yleana,F,100,26,0,26
Charlanne,F,100,23,0,23
Raheem,M,100,6,6758,6764
Keaven,M,100,0,39,39
Alayjah,F,100,593,0,593
Rochelly,F,100,5,0,5
Alezandra,F,100,107,0,107
Takeiya,F,100,6,0,6
Cyenna,F,100,115,0,115
Tavar,M,100,0,29,29
Breanca,F,100,39,0,39
Cateleya,F,100,26,0,26
Diamon,F,95,507,25,532
Hildana,F,100,10,0,10
Breya,F,100,479,0,479
Lycan,M,100,0,51,51
Chritian,M,100,0,7,7
Rownan,M,100,0,6,6
Latriece,F,100,183,0,183
Leilamarie,F,100,5,0,5
Johnross,M,100,0,63,63
Thair,M,100,0,12,12
Jitesh,M,100,0,10,10
Malibu,F,100,45,0,45
Keajah,F,100,88,0,88
Pratheek,M,100,0,32,32
Nesita,F,100,5,0,5
Daquarious,M,100,0,11,11
Sedric,M,100,0,1395,1395
Tiffnie,F,100,5,0,5
Seveon,M,100,0,5,5
Aprilann,F,100,15,0,15
Stylez,M,100,0,29,29
Teko,M,100,0,11,11
Zyion,M,83,131,629,760
Ixtzel,F,100,10,0,10
Bernardino,M,100,0,1098,1098
Bisceglia,F,100,26,0,26
Aieshia,F,100,5,0,5
Sindey,M,100,0,5,5
Keecha,F,100,12,0,12
Miakayla,F,100,5,0,5
Ataliah,F,100,6,0,6
Miking,M,100,0,102,102
Jilian,F,100,798,0,798
Usha,F,100,147,0,147
Jozlynn,F,100,550,0,550
Winchester,M,100,0,6,6
Kresha,F,100,77,0,77
Ngan,F,100,214,0,214
Sylinda,F,100,40,0,40
Amalee,F,100,90,0,90
Beril,M,100,0,5,5
Tamathy,F,100,15,0,15
Seanthomas,M,100,0,5,5
Neshaun,M,100,0,11,11
Mekeisha,F,100,12,0,12
Amalia,F,100,7934,0,7934
Elaynah,F,100,55,0,55
Mayssa,F,100,12,0,12
Linsdey,F,100,19,0,19
Kimyada,F,100,60,0,60
Matthw,M,100,0,18,18
Manee,F,100,5,0,5
Prospero,M,100,0,5,5
Chioke,M,100,0,86,86
Saketh,M,100,0,356,356
Jaylond,M,100,0,19,19
Angellena,F,100,25,0,25
Karrah,F,100,775,0,775
Epigmenio,M,100,0,15,15
Chain,M,100,0,5,5
Waylin,M,100,0,139,139
Treqwan,M,100,0,6,6
Addonis,M,100,0,5,5
Dunia,F,100,505,0,505
Daylanie,F,100,5,0,5
Jayvin,M,100,0,739,739
Leelan,M,100,0,281,281
Tayt,M,100,0,64,64
Joyanna,F,100,545,0,545
Amarra,F,100,197,0,197
Aman,M,92,161,1843,2004
Stephaniemarie,F,100,59,0,59
Breidy,F,100,5,0,5
Yveline,F,100,6,0,6
Camyah,F,100,82,0,82
Aiyahna,F,100,28,0,28
Lovis,M,100,0,6,6
Kella,F,100,359,0,359
Ebrahima,M,100,0,5,5
Beaufort,M,100,0,5,5
Silvio,M,100,0,1123,1123
Breshay,F,100,104,0,104
Grabriel,M,100,0,11,11
Adwitiya,F,100,5,0,5
Aaniylah,F,100,11,0,11
Jieun,F,100,18,0,18
Semetria,F,100,6,0,6
Adalea,F,100,41,0,41
Antjuan,M,100,0,806,806
Trudee,F,100,77,0,77
Carey,M,51,11972,12671,24643
Maricelda,F,100,28,0,28
Bethe,F,100,29,0,29
Salone,F,100,5,0,5
Sakhia,F,100,28,0,28
Yitzchock,M,100,0,10,10
Millard,M,100,0,3252,3252
Lyrae,F,100,40,0,40
Sayde,F,100,571,0,571
Emiel,M,100,0,10,10
Isabel,F,99,80836,836,81672
Clarette,F,100,6,0,6
Averyn,M,100,0,5,5
Carnisha,F,100,195,0,195
Brayla,F,100,320,0,320
Kingstun,M,100,0,10,10
Dazmond,M,100,0,5,5
Deaire,M,100,0,57,57
Larren,M,77,22,74,96
Exequiel,M,100,0,29,29
Claira,F,100,1434,0,1434
Krystan,F,100,397,0,397
Jameliah,F,100,23,0,23
Abdoulaziz,M,100,0,10,10
Dulce,F,100,16229,49,16278
Decklyn,M,73,30,83,113
Nataysha,F,100,43,0,43
Meti,F,100,5,0,5
Chale,M,100,0,14,14
Liliona,F,100,11,0,11
Skyanne,F,100,101,0,101
Michie,M,100,0,6,6
Crissie,F,100,398,0,398
Sieana,F,100,10,0,10
Sanisha,F,100,18,0,18
Natashia,F,100,2630,0,2630
Naturelle,F,100,46,0,46
Shraga,M,100,0,408,408
Lametra,F,100,57,0,57
Tolly,F,100,6,0,6
Mickyle,M,100,0,5,5
Raju,M,100,0,6,6
Terianna,F,100,92,0,92
Jorgejr,M,100,0,5,5
Carlishia,F,100,5,0,5
Casandr,F,100,5,0,5
Ramya,F,100,990,0,990
Juwelz,M,100,0,5,5
Richae,F,100,10,0,10
Petronia,F,100,21,0,21
Amyra,F,100,820,0,820
Thai,M,86,184,1104,1288
Eponine,F,100,19,0,19
Ame,F,100,352,0,352
Sherisse,F,100,193,0,193
Alii,M,86,6,36,42
Libya,F,100,14,0,14
Karolena,F,100,14,0,14
Burnette,F,80,230,56,286
Carliee,F,100,6,0,6
Lamond,M,100,0,677,677
Kamarie,F,70,381,163,544
Tanika,F,100,4509,0,4509
Babacar,M,100,0,135,135
Esmi,F,100,28,0,28
Dashell,F,67,47,23,70
Shenita,F,100,1550,0,1550
Malkolm,M,100,0,10,10
Chrstopher,M,100,0,74,74
Lanaisha,F,100,46,0,46
Yunus,M,100,0,375,375
Aryiah,F,100,252,0,252
Gianpaul,M,100,0,19,19
Baraa,M,85,17,100,117
Darshay,F,100,83,0,83
Jamier,M,100,0,898,898
Lawayne,M,98,10,424,434
Lyndi,F,100,1602,0,1602
Marpessa,F,100,8,0,8
Zareia,F,100,14,0,14
Somya,F,100,156,0,156
Tamekia,F,100,1883,0,1883
Jacquia,F,100,33,0,33
Reubin,M,100,0,155,155
Tashima,F,100,347,0,347
Mancy,F,100,15,0,15
Andricka,F,100,5,0,5
Chaze,M,100,0,179,179
Coleen,F,100,9766,0,9766
Natiya,F,100,136,0,136
Jakell,M,96,6,147,153
Lakelyn,F,99,452,5,457
Orielle,F,100,31,0,31
Zoeya,F,100,40,0,40
Delaysha,F,100,5,0,5
Persaius,F,100,18,0,18
Khadjah,F,100,37,0,37
Tekeira,F,100,5,0,5
Shiphrah,F,100,10,0,10
Herman,M,99,205,33491,33696
Evita,F,100,1131,0,1131
Sidney,M,61,19672,31261,50933
Rejean,M,69,8,18,26
Sasami,F,100,5,0,5
Tranel,M,100,0,8,8
Itan,M,100,0,5,5
Messias,M,100,0,5,5
Saurav,M,100,0,165,165
Kent,M,100,161,54875,55036
Raaid,M,100,0,5,5
Rubicela,F,100,36,0,36
Dazhaun,M,100,0,10,10
Vhonda,F,100,13,0,13
Breonica,F,100,47,0,47
Inass,F,100,5,0,5
Charlesedward,M,100,0,5,5
Eisenhower,M,100,0,5,5
Caragan,F,100,54,0,54
Chuck,M,100,5,14561,14566
Ti,M,83,12,57,69
Odus,M,100,0,73,73
Rustina,F,100,22,0,22
Kadenn,M,100,0,12,12
Kiyle,M,100,0,11,11
Eulogio,M,100,0,428,428
Jadereon,M,100,0,5,5
Traycen,M,100,0,64,64
Camy,F,100,182,0,182
Kristos,M,100,0,43,43
Mekya,F,100,10,0,10
Kalaiya,F,100,6,0,6
Jazay,F,100,6,0,6
Jiron,M,100,0,6,6
Tajanae,F,100,463,0,463
Ketia,F,100,50,0,50
Eithne,F,100,5,0,5
Trevez,M,100,0,11,11
Jennely,F,100,14,0,14
Vyacheslav,M,100,0,16,16
Trustyn,M,100,0,16,16
Shaquaila,F,100,5,0,5
Gates,M,84,44,231,275
Lissandro,M,100,0,108,108
Dandi,F,100,10,0,10
Caridad,F,100,1672,0,1672
Seydou,M,100,0,81,81
Camry,F,91,1166,120,1286
Mc,F,77,209,61,270
Carlus,M,97,10,374,384
Nisaa,F,100,46,0,46
Audrea,F,100,1813,0,1813
Gaberielle,F,100,11,0,11
Anaili,F,100,21,0,21
Alisen,F,100,208,0,208
Majdi,M,100,0,21,21
Danariah,F,100,5,0,5
Aser,M,100,0,42,42
Alaiza,F,100,152,0,152
Nyeim,M,100,0,5,5
Kady,F,100,2614,0,2614
Dorisha,F,100,11,0,11
Raely,F,100,46,0,46
Safiah,F,100,5,0,5
Yonina,F,100,47,0,47
Zoe,F,100,101446,419,101865
Journey,F,91,8647,870,9517
Kaylahni,F,100,7,0,7
Michel,M,72,3267,8482,11749
Levaughn,M,100,0,87,87
Anivia,F,100,5,0,5
Jareny,F,100,5,0,5
Keegon,M,100,0,17,17
Chartez,M,100,0,5,5
Thyra,F,100,401,0,401
Liisa,F,100,422,0,422
Damiya,F,100,632,0,632
Makhala,F,100,48,0,48
Kaffie,F,100,11,0,11
Savona,F,100,22,0,22
Jonmatthew,M,100,0,5,5
Anjelo,M,100,0,132,132
Ibtisam,F,100,81,0,81
Felder,M,100,0,15,15
Najada,F,100,11,0,11
Alanzo,M,100,0,301,301
Jireth,F,100,5,0,5
Tharon,M,97,12,422,434
Kyreon,M,100,0,5,5
Kholee,F,100,6,0,6
Eleena,F,100,273,0,273
Jenny,F,99,80778,415,81193
Kesuan,M,100,0,6,6
Ariela,F,100,2008,0,2008
Kennison,F,76,45,14,59
Kealynn,F,100,11,0,11
Vantrice,F,100,15,0,15
Ramel,M,100,0,1388,1388
Kayliana,F,100,571,0,571
Charneice,F,100,22,0,22
Natalynn,F,100,253,0,253
Brehon,M,100,0,19,19
Fern,F,99,4154,31,4185
Riqui,F,100,19,0,19
Laqunita,F,100,10,0,10
Breylon,M,100,0,239,239
Threse,F,100,10,0,10
Shingo,M,100,0,26,26
Xaida,F,100,6,0,6
Pleas,M,100,0,117,117
Solo,M,100,0,7,7
Myrah,F,100,328,0,328
Tomeeka,F,100,75,0,75
Sergio,M,100,356,71056,71412
Earna,F,100,5,0,5
Thuyvi,F,100,28,0,28
Varish,M,100,0,36,36
Adlie,F,100,15,0,15
Tunis,M,100,0,6,6
Lourie,F,100,558,0,558
Waqar,M,100,0,5,5
Vanesta,F,100,18,0,18
Bonnie,F,99,164518,1057,165575
Kaitin,F,100,5,0,5
Asiha,F,100,15,0,15
Norbert,M,100,0,4418,4418
Andrica,F,100,33,0,33
Teguila,F,100,10,0,10
Tonya,F,100,119155,435,119590
Anacelis,F,100,5,0,5
Aubriela,F,100,12,0,12
Geary,M,100,0,1847,1847
Cristiana,F,100,782,0,782
Jemuel,M,100,0,78,78
Darchelle,F,100,113,0,113
Marrion,M,76,79,249,328
Jaenelle,F,100,6,0,6
Rexene,F,100,27,0,27
Zyrianna,F,100,41,0,41
Dagem,M,100,0,42,42
Shamonique,F,100,98,0,98
Jenibelle,F,100,5,0,5
Camree,F,100,216,0,216
Tinsleigh,F,100,29,0,29
Pierra,F,100,56,0,56
Kendol,M,100,0,5,5
Fatu,F,100,12,0,12
Pharyn,F,100,5,0,5
Hripsime,F,100,5,0,5
Kymber,F,100,739,0,739
Sovann,M,100,0,35,35
Lynanne,F,100,178,0,178
Brittain,M,57,272,354,626
Lasse,M,100,0,6,6
Jeyren,M,100,0,66,66
Shayon,M,93,7,97,104
Tredena,F,100,6,0,6
Abilgail,F,100,28,0,28
Iyisha,F,100,9,0,9
Tyrrel,M,100,0,10,10
Tatom,F,100,5,0,5
Tawnia,F,100,632,0,632
Nahima,F,100,102,0,102
Anabelle,F,100,6968,0,6968
Havoc,M,100,0,52,52
Nayali,F,100,88,0,88
Rachele,F,100,3246,0,3246
Derra,F,100,125,0,125
Azarah,F,100,45,0,45
Elayna,F,100,3174,0,3174
Marvita,F,100,17,0,17
Sabriah,F,100,82,0,82
Meganne,F,100,294,0,294
Trampus,M,100,0,277,277
Zeah,F,100,52,0,52
Geobani,M,100,0,10,10
Pamila,F,100,641,0,641
Mariechristine,F,100,10,0,10
Tieasha,F,100,118,0,118
Jalian,M,100,0,10,10
Vonette,F,100,62,0,62
Novali,F,100,45,0,45
Karolis,M,100,0,10,10
Trellany,F,100,10,0,10
Norika,F,100,5,0,5
Xzander,M,100,0,348,348
Rasheika,F,100,35,0,35
Athryn,F,100,10,0,10
Inacio,M,100,0,12,12
Mikeal,M,99,19,2160,2179
Biruk,M,100,0,70,70
Lirim,M,100,0,6,6
Serafina,F,100,1464,0,1464
Marquavion,M,100,0,158,158
Robb,M,100,0,3061,3061
Raiza,F,100,304,0,304
Yosel,M,100,0,10,10
Janahi,F,100,5,0,5
Esrael,M,100,0,8,8
Deward,M,100,0,207,207
Jonina,F,100,45,0,45
Sebrenia,F,100,29,0,29
Axeton,M,100,0,5,5
Geddy,M,100,0,175,175
Ahlaya,F,100,103,0,103
Zerek,M,100,0,209,209
Zykeira,F,100,19,0,19
Kove,M,100,0,10,10
Obrian,M,100,0,423,423
Mariauna,F,100,27,0,27
Evetta,F,100,294,0,294
Anders,M,100,0,4768,4768
Yasmene,F,100,75,0,75
Dmir,M,100,0,5,5
Shaterra,F,100,291,0,291
Christin,F,92,11039,967,12006
Serinity,F,100,835,0,835
Lelyn,M,100,0,17,17
Kordale,M,100,0,33,33
Shale,M,73,21,56,77
Keileb,M,100,0,12,12
Xaven,M,100,0,32,32
Izick,M,100,0,214,214
Benajmin,M,100,0,31,31
Tawsha,F,100,84,0,84
Ildefonso,M,100,0,328,328
Ansara,M,100,0,5,5
Sharyne,F,100,7,0,7
Lasherrie,F,100,5,0,5
Quindell,M,100,0,156,156
Jarez,M,100,0,17,17
Behruz,M,100,0,14,14
Dashea,F,100,84,0,84
Agna,F,100,7,0,7
Bricyn,M,100,0,54,54
Brunette,F,100,25,0,25
Zynovia,F,100,6,0,6
Marquina,F,100,5,0,5
Lendsey,F,100,22,0,22
Gerado,M,100,0,169,169
Camaury,M,100,0,5,5
Nathalie,F,100,14833,6,14839
Titianna,F,100,139,0,139
Prue,F,100,6,0,6
Rodrigue,M,100,0,39,39
Assetou,F,100,11,0,11
Jenelle,F,100,6287,0,6287
Maysoon,F,100,61,0,61
Kindyl,F,100,33,0,33
Nejra,F,100,30,0,30
Franchot,M,100,0,139,139
Olean,F,100,34,0,34
Taniko,F,100,33,0,33
Cauy,M,100,0,187,187
Liiban,M,100,0,6,6
Derron,M,100,0,1443,1443
Drenda,F,100,388,0,388
Rourke,M,100,0,220,220
Ferne,F,100,202,0,202
Maudry,F,100,15,0,15
Tyrra,F,100,11,0,11
Latangela,F,100,143,0,143
Pheng,M,100,0,436,436
Jedi,M,100,0,100,100
Cristinia,F,100,10,0,10
Nupur,F,100,110,0,110
Rydan,M,100,0,81,81
Hillery,F,78,490,136,626
Rayniya,F,100,32,0,32
Lamirah,F,100,7,0,7
Jaquarius,M,100,0,773,773
Cullan,M,100,0,306,306
Emmaleigh,F,100,1852,0,1852
Jaciah,F,100,5,0,5
Ranaiya,F,100,6,0,6
Calais,F,100,134,0,134
Dshanti,F,100,31,0,31
Katri,F,100,16,0,16
Darreck,M,100,0,12,12
Vincenza,F,100,955,0,955
Antiqua,F,100,29,0,29
Laird,M,100,0,1090,1090
Mulki,F,100,49,0,49
Rie,F,100,79,0,79
Felecia,F,100,9982,0,9982
Jennabelle,F,100,10,0,10
Kelon,M,100,0,297,297
Anajee,M,100,0,6,6
Ariele,F,100,545,0,545
Shelbyann,F,100,12,0,12
Estefania,F,100,5750,5,5755
Lettie,F,100,1509,0,1509
Kymbra,F,100,10,0,10
Macauly,M,100,0,5,5
Denene,F,100,350,0,350
Josphine,F,100,58,0,58
Niaz,M,100,0,6,6
Araiyah,F,100,43,0,43
Makal,M,100,0,7,7
Grethel,F,100,162,0,162
Hazem,M,100,0,187,187
Zayiah,F,100,15,0,15
Damica,F,100,63,0,63
Qamari,M,100,0,6,6
Jeriod,M,100,0,5,5
Nnenna,F,100,270,0,270
Derica,F,100,639,0,639
Anara,F,100,166,0,166
Amechi,M,100,0,11,11
Allisun,F,100,18,0,18
Lonesha,F,100,5,0,5
Keedan,M,100,0,54,54
Kaeleen,F,100,71,0,71
Ahmauri,M,100,0,15,15
Lela,F,100,8621,0,8621
Nenah,F,100,17,0,17
Nawana,F,100,12,0,12
Kentavious,M,100,0,644,644
Brittiny,F,100,597,0,597
Yitzel,F,100,151,0,151
Casidy,F,100,339,0,339
Kaiea,M,92,5,57,62
Aldayshein,M,100,0,6,6
Amyiah,F,100,651,0,651
Arlaina,F,100,10,0,10
Loyalty,F,76,271,86,357
Yoriel,M,100,0,14,14
Shaquise,F,100,21,0,21
Dailen,M,98,5,294,299
Shaid,M,100,0,5,5
Dallon,M,100,0,586,586
Athon,M,100,0,11,11
Matisha,F,100,167,0,167
Torianno,M,100,0,5,5
Aneeka,F,100,67,0,67
Trelynn,M,55,10,12,22
Montrey,M,100,0,220,220
Lashe,F,100,66,0,66
Lutricia,F,100,586,0,586
Wilhelm,M,100,0,972,972
Anautica,F,100,27,0,27
Nayra,F,100,202,0,202
Sagarika,F,100,17,0,17
Jocelynne,F,100,512,0,512
Lenell,M,69,198,451,649
Harleigh,F,100,2650,0,2650
Sethan,M,100,0,39,39
Komari,M,100,0,27,27
Deztyni,F,100,16,0,16
Simcha,M,87,185,1220,1405
Hayat,F,100,370,0,370
Haiden,M,69,1244,2789,4033
Pamma,F,100,5,0,5
Juston,M,100,0,2425,2425
Furney,M,100,0,5,5
Jamaari,M,100,0,32,32
Daleiza,F,100,45,0,45
Chalissa,F,100,5,0,5
Licia,F,100,702,0,702
Amareyon,M,100,0,5,5
Katresa,F,100,24,0,24
Salamon,M,100,0,17,17
Jalyric,F,94,75,5,80
Ramada,F,100,5,0,5
Gicelle,F,100,53,0,53
Raaina,F,100,12,0,12
Vidisha,F,100,7,0,7
Neizan,M,100,0,23,23
Zebbie,M,81,6,25,31
Anjolee,F,100,12,0,12
Calisto,M,100,0,5,5
Raimund,M,100,0,7,7
Rodrecus,M,100,0,70,70
Angelick,F,100,5,0,5
Ladarren,M,100,0,160,160
Nasiyah,F,100,214,0,214
Kaleese,F,100,42,0,42
Anniece,F,100,30,0,30
Messyah,M,100,0,5,5
Khailyn,F,100,34,0,34
Kylisha,F,100,26,0,26
Guyla,F,100,202,0,202
Marlon,M,99,309,27490,27799
Faridah,F,100,13,0,13
Zamarrion,M,100,0,12,12
Zoiie,F,100,7,0,7
Ashay,F,54,27,23,50
Jakyan,M,100,0,5,5
Elyane,F,100,6,0,6
Nazaret,F,78,123,34,157
Tanayja,F,100,10,0,10
Wyleigh,F,100,5,0,5
Journii,F,100,96,0,96
Brendalee,F,100,415,0,415
Tai,M,60,1661,2510,4171
Chaniel,F,100,17,0,17
Taton,M,100,0,10,10
Ardenia,F,100,34,0,34
Luisafernanda,F,100,35,0,35
Iree,F,100,32,0,32
Fredrich,M,100,0,212,212
Janorris,M,100,0,25,25
Maicon,M,100,0,23,23
Justeena,F,100,10,0,10
Anaely,F,100,27,0,27
Phung,F,91,163,16,179
Leonila,F,100,149,0,149
Brytani,F,100,79,0,79
Darlette,F,100,78,0,78
Desandra,F,100,5,0,5
Berenis,F,100,161,0,161
Ozetta,F,100,5,0,5
Mordecai,M,100,0,651,651
Rhegan,F,100,234,0,234
Teodor,M,100,0,126,126
Esteysi,F,100,5,0,5
Andersyn,F,100,59,0,59
Kirtis,M,100,0,122,122
Pyper,F,100,1901,0,1901
Kaenan,M,100,0,41,41
Jolianna,F,100,30,0,30
Tyesia,F,100,10,0,10
Srivaishnavi,F,100,5,0,5
Nabil,M,97,49,1448,1497
Tanyja,F,100,6,0,6
Ayza,F,100,59,0,59
Manik,M,100,0,22,22
Tionee,F,100,5,0,5
Ramondo,M,100,0,89,89
Hamzah,M,100,0,1042,1042
Jaszmin,F,100,44,0,44
Jemichael,M,100,0,10,10
Daquasha,F,100,18,0,18
Annelis,F,100,25,0,25
Sahmya,F,100,65,0,65
Zuleima,F,100,638,0,638
Lorielle,F,100,270,0,270
Sydonna,F,100,7,0,7
Javonni,M,89,31,241,272
Corniya,F,100,40,0,40
Jaqai,M,100,0,21,21
Zairia,F,100,13,0,13
Zenayda,F,100,35,0,35
Treasia,F,100,6,0,6
Everlean,F,100,57,0,57
Dainera,F,100,7,0,7
Hazeleigh,F,100,6,0,6
Darshea,F,100,5,0,5
Daishanae,F,100,13,0,13
Eevee,F,100,37,0,37
Cleodis,M,100,0,5,5
Antoinet,F,100,8,0,8
Jaxxon,M,100,0,730,730
Mistyann,F,100,16,0,16
Florian,M,100,0,783,783
Hayli,F,100,1749,0,1749
Vicken,M,100,0,21,21
Rial,M,100,0,10,10
Chquita,F,100,5,0,5
Dedan,M,100,0,35,35
Makenzii,F,100,25,0,25
Janiya,F,100,9315,6,9321
Taliayah,F,100,12,0,12
Breylin,M,78,33,116,149
Joesphine,F,100,176,0,176
Iria,F,100,39,0,39
Mindi,F,100,4405,0,4405
Maclean,M,100,0,239,239
Lyrika,F,100,40,0,40
Quanetta,F,100,127,0,127
Ilaisaane,F,100,66,0,66
Dalea,F,100,29,0,29
Eean,M,100,0,67,67
Suleyka,F,100,41,0,41
Araeya,F,100,50,0,50
Jaivion,M,100,0,320,320
Katelee,F,100,108,0,108
Domminick,M,100,0,17,17
Rhiyan,F,100,14,0,14
Genice,F,100,660,0,660
Paishance,F,100,6,0,6
Jurrell,M,100,0,69,69
Montaque,M,100,0,20,20
Balynda,F,100,5,0,5
Martinez,M,97,29,1065,1094
Fenisha,F,100,12,0,12
Daeyonna,F,100,7,0,7
Noreen,F,100,11803,0,11803
Shehzad,M,100,0,29,29
Kharmyn,F,100,14,0,14
Nayanah,F,100,5,0,5
Hughey,M,100,0,50,50
Jerrard,M,100,0,248,248
Donnel,M,93,47,634,681
Makhiyah,F,100,10,0,10
Teriona,F,100,31,0,31
Elman,M,100,0,14,14
Danail,M,100,0,6,6
Rogen,M,100,0,59,59
Chenel,F,100,83,0,83
Maylinn,F,100,11,0,11
Deylan,M,100,0,55,55
Inya,F,100,5,0,5
Nazayah,F,100,8,0,8
Tamiyah,F,100,955,0,955
Thompson,M,100,0,1312,1312
Alamin,M,100,0,103,103
Yarixsa,F,100,6,0,6
Shlonda,F,100,118,0,118
Cheetara,F,100,81,0,81
Arion,M,72,574,1464,2038
Antronette,F,100,25,0,25
Darrica,F,100,32,0,32
Alexandr,M,56,301,385,686
Brijette,F,100,25,0,25
Emeka,M,96,17,390,407
Antrese,F,100,6,0,6
Kamaj,M,100,0,10,10
Ashneel,M,100,0,11,11
Makaii,M,100,0,13,13
Keidren,M,100,0,11,11
Aviyah,F,100,86,0,86
Rahcel,F,100,128,0,128
Mohsen,M,100,0,158,158
Kaymi,F,100,5,0,5
Lamyiah,F,100,44,0,44
Mishall,F,100,6,0,6
Mtthew,M,100,0,6,6
Cristyan,M,100,0,29,29
Zaena,F,100,15,0,15
Iceland,F,100,5,0,5
Dontrez,M,100,0,125,125
Naquesha,F,100,32,0,32
Welda,F,100,7,0,7
Sanay,M,76,24,77,101
Jacqualin,F,100,48,0,48
Aaydan,M,100,0,6,6
Larwance,M,100,0,11,11
Sheniece,F,100,76,0,76
Canita,F,100,12,0,12
Dannapaola,F,100,20,0,20
Calder,M,98,20,1139,1159
Kalysta,F,100,495,0,495
Darrionna,F,100,17,0,17
Delaia,F,100,8,0,8
Airalynn,F,100,21,0,21
Shernard,M,100,0,12,12
Navarre,M,100,0,78,78
Rayane,M,94,7,110,117
Aribel,F,100,16,0,16
Alicea,F,100,1116,0,1116
Benette,F,100,12,0,12
Zykell,M,100,0,16,16
Xsavier,M,100,0,74,74
Nickola,F,100,103,0,103
Keli,F,99,4302,49,4351
Maddeline,F,100,116,0,116
Mandrell,M,100,0,250,250
Breyonna,F,100,828,0,828
Asada,F,100,5,0,5
Lalisha,F,100,10,0,10
Brees,M,77,17,57,74
Sifa,F,100,10,0,10
Jsean,M,100,0,259,259
Taison,M,100,0,141,141
Leyda,F,100,315,0,315
Alinah,F,100,327,0,327
Rudean,F,100,30,0,30
Colbie,F,83,1498,304,1802
Kelis,F,100,2150,6,2156
Laiden,M,100,0,163,163
Jamauri,M,99,11,749,760
Quasean,M,100,0,76,76
Bralynn,F,81,321,74,395
Amyr,M,100,0,112,112
Phantasia,F,100,59,0,59
Annagail,F,100,30,0,30
Zaharra,F,100,41,0,41
Whitton,M,100,0,8,8
Whitnay,F,100,6,0,6
Dayo,F,100,5,0,5
Yaneisy,F,100,121,0,121
Billijo,F,100,183,0,183
Yanel,F,100,172,0,172
Ceriyah,F,100,13,0,13
Annicka,F,100,46,0,46
Temperence,F,100,65,0,65
Maylah,F,100,27,0,27
Embry,F,56,241,192,433
Kyleeann,F,100,106,0,106
Amberrae,F,100,5,0,5
Kimoree,F,100,11,0,11
Mckynzi,F,100,46,0,46
Armaun,M,100,0,10,10
Hayzen,M,100,0,86,86
Anaysa,F,100,14,0,14
Levander,M,100,0,128,128
Zynia,F,100,180,0,180
Nahjae,F,100,66,0,66
Panya,F,100,29,0,29
Shaniel,F,100,40,0,40
Ritamarie,F,100,92,0,92
Chethan,M,100,0,5,5
Brayhan,M,100,0,10,10
Kaiis,M,100,0,7,7
Katrinka,F,100,452,0,452
Elanora,F,100,23,0,23
Suheidy,F,100,14,0,14
Pharrell,M,100,0,311,311
Olani,F,100,12,0,12
Karriann,F,100,21,0,21
Sagine,F,100,5,0,5
Ativa,F,100,7,0,7
Levada,F,100,42,0,42
Laticia,F,100,2331,0,2331
Aariz,M,100,0,406,406
Karelin,F,100,28,0,28
Khye,M,100,0,73,73
Kaimani,M,94,5,72,77
Shaquelle,M,62,45,73,118
Chaniece,F,100,132,0,132
Soham,M,100,0,783,783
Amilia,F,100,1253,0,1253
Aryah,F,100,679,0,679
Alondra,F,100,35025,122,35147
Rakira,F,100,35,0,35
Addalynn,F,100,652,0,652
Santos,M,94,754,12403,13157
Jylissa,F,100,5,0,5
Linay,F,100,5,0,5
Zeal,M,87,5,33,38
Tryg,M,100,0,21,21
Yashwanth,M,100,0,20,20
Joandy,M,100,0,72,72
Jessina,F,100,128,0,128
Liston,M,100,0,333,333
Remel,F,100,5,0,5
Shaqil,M,100,0,5,5
Wiktor,M,100,0,35,35
Kazlynn,F,100,14,0,14
Jonerik,M,100,0,203,203
Makynzi,F,100,152,0,152
Elizabeth,F,100,1031059,3278,1034337
Siriya,F,100,5,0,5
Clemon,M,100,0,428,428
Marquishia,F,100,13,0,13
Rodell,M,100,0,516,516
Tijah,F,95,89,5,94
Nataline,F,100,58,0,58
Statton,M,100,0,5,5
Azyia,F,100,33,0,33
Rhandi,F,100,135,0,135
Jazavier,M,100,0,17,17
Jemarcus,M,100,0,308,308
Shandelle,F,100,92,0,92
Tajahn,M,100,0,5,5
Tanisi,F,100,43,0,43
Leihlani,F,100,5,0,5
Heavin,F,100,129,0,129
Jexiel,M,100,0,18,18
Yanieliz,F,100,21,0,21
Dyland,M,100,0,547,547
Tenleigh,F,100,147,0,147
Izach,M,100,0,48,48
Chandrea,F,100,261,0,261
Keahi,M,90,20,182,202
Midian,M,100,0,5,5
Letti,F,100,65,0,65
Keynia,F,100,6,0,6
Deedee,F,100,3308,0,3308
Everlyn,F,100,348,0,348
Dior,F,71,1431,598,2029
Syia,F,100,12,0,12
Zeylah,F,100,5,0,5
Norvil,M,100,0,6,6
Emmari,F,100,15,0,15
Sundie,F,100,36,0,36
Cayleeann,F,100,5,0,5
Abiella,F,100,16,0,16
Trayshawn,M,100,0,228,228
Karismah,F,100,5,0,5
Keunte,M,100,0,14,14
Raquisha,F,100,5,0,5
Tang,F,100,47,0,47
Brigita,F,100,17,0,17
Jaiyden,M,96,5,128,133
Pallas,F,100,57,0,57
Emeliana,F,100,13,0,13
Agim,M,100,0,27,27
Lyn,F,85,5419,959,6378
Avenly,F,100,42,0,42
Zaron,M,100,0,137,137
Georgenia,F,100,55,0,55
Georg,M,99,5,333,338
Velika,F,100,5,0,5
Namath,M,100,0,5,5
Mekel,M,88,16,123,139
Yisel,F,100,758,0,758
Crystral,F,100,22,0,22
Mykeya,F,100,6,0,6
Orfelinda,F,100,30,0,30
Nusaiba,F,100,55,0,55
Darrio,M,100,0,65,65
Vianette,F,100,16,0,16
Veyonce,F,100,52,0,52
Loukya,F,100,14,0,14
Montonio,M,100,0,5,5
Madonna,F,100,4824,0,4824
Sava,M,95,5,104,109
Ayele,F,50,5,5,10
Hennesie,F,100,5,0,5
Immanol,M,100,0,14,14
Tomoki,M,100,0,150,150
Raynette,F,100,604,0,604
Gesenia,F,100,160,0,160
Davon,M,97,367,12009,12376
Mehul,M,100,0,292,292
Khadeeja,F,100,215,0,215
Abdulwahab,M,100,0,113,113
Nathanielle,M,100,0,5,5
Meritza,F,100,5,0,5
Shelleen,F,100,37,0,37
Keyerra,F,100,292,0,292
Daandre,M,100,0,5,5
Curry,M,92,85,952,1037
Marlea,F,100,549,0,549
Taraj,M,100,0,23,23
Yarenis,F,100,35,0,35
Aubrie,F,100,10707,0,10707
Makasha,F,100,6,0,6
Evelyon,F,100,5,0,5
Latrista,F,100,41,0,41
Kimbie,F,100,5,0,5
Amariyah,F,100,419,0,419
Crystyl,F,100,10,0,10
Otilio,M,100,0,314,314
Kirstian,F,100,20,0,20
Saveer,M,100,0,14,14
Assante,M,100,0,33,33
Roxey,F,100,18,0,18
Aneda,F,100,6,0,6
Kros,M,100,0,5,5
Lyria,F,100,16,0,16
Delwayne,M,100,0,5,5
Kaelia,F,100,5,0,5
Jadier,M,100,0,61,61
Izea,M,100,0,59,59
Loletta,F,100,152,0,152
Kiabeth,F,100,39,0,39
Kellianne,F,100,723,0,723
Rone,M,100,0,15,15
Sendy,F,100,425,0,425
Angelize,F,100,76,0,76
Kyashia,F,100,17,0,17
Miche,F,100,73,0,73
Miamarie,F,100,44,0,44
Arieus,M,100,0,5,5
Fitz,M,100,0,97,97
Fawaz,M,100,0,209,209
Denaiya,F,100,5,0,5
Gracynn,F,100,86,0,86
Analexis,F,100,5,0,5
Yuritzi,F,100,505,0,505
Alexana,F,100,23,0,23
Knyla,F,100,36,0,36
Michi,F,92,91,8,99
Chessica,F,100,86,0,86
Kasten,M,100,0,131,131
Kaua,M,100,0,57,57
Radhika,F,100,937,0,937
Rakell,F,100,49,0,49
Daniah,F,100,368,0,368
Vahin,M,100,0,30,30
Zalena,F,100,21,0,21
Hossam,M,100,0,29,29
Nashyra,F,100,17,0,17
Tametra,F,100,84,0,84
Gregrory,M,100,0,5,5
Zahkai,M,100,0,29,29
Travanti,M,100,0,81,81
Chrysti,F,100,50,0,50
Car,M,100,0,10,10
Rayley,F,100,120,0,120
Woodford,M,100,0,52,52
Tishanna,F,100,63,0,63
Osias,M,100,0,102,102
Jataurus,M,100,0,5,5
Brandilynn,F,100,111,0,111
Sachel,F,100,5,0,5
Yanesa,F,100,11,0,11
Ariyon,F,72,167,65,232
Juawan,M,100,0,17,17
Kang,F,71,108,44,152
Britlynn,F,100,13,0,13
Dominice,F,100,7,0,7
Dorretta,F,100,5,0,5
Chaila,F,100,18,0,18
Lovelace,M,100,0,13,13
Angelyne,F,100,186,0,186
Karyana,F,100,5,0,5
Antione,M,99,49,4609,4658
Johanan,M,100,0,179,179
Jaleisa,F,100,104,0,104
Stephenee,F,100,6,0,6
Srilakshmi,F,100,6,0,6
Emane,F,100,5,0,5
Braydan,M,99,10,953,963
Saada,F,100,5,0,5
Kavontae,M,100,0,69,69
Nayvadius,M,100,0,14,14
Saverio,M,100,0,794,794
Donesia,F,100,21,0,21
Veneita,F,100,6,0,6
Ameyia,F,100,6,0,6
Lemanuel,M,100,0,28,28
Detrice,F,100,304,0,304
Alucard,M,100,0,51,51
Tamita,F,100,13,0,13
Parthiv,M,100,0,73,73
Merrideth,F,100,48,0,48
Leedward,M,100,0,5,5
Maycey,F,100,6,0,6
Rodger,M,100,0,12762,12762
Evens,M,100,0,217,217
Lynette,F,100,37140,53,37193
Tashari,F,100,78,0,78
Narayah,F,100,29,0,29
Ellianne,F,100,51,0,51
Keiana,F,100,1335,0,1335
Cyntia,F,100,483,0,483
Kenichiro,M,100,0,10,10
Jamerial,F,100,5,0,5
Annaleece,F,100,21,0,21
Tannesha,F,100,7,0,7
Eboni,F,100,6455,5,6460
Jenniffer,F,100,2870,0,2870
Lauramarie,F,100,14,0,14
Kelsea,F,100,5383,5,5388
Nelma,F,100,89,0,89
Manasvini,F,100,44,0,44
Coleon,M,100,0,5,5
Jillinda,F,100,10,0,10
Amathyst,F,100,7,0,7
Brayli,F,100,91,0,91
Maryjune,F,100,5,0,5
Luan,M,55,329,400,729
Barbarella,F,100,25,0,25
Nickan,M,100,0,16,16
Charleton,M,100,0,82,82
Kameel,M,100,0,18,18
Margean,F,100,5,0,5
Csilla,F,100,5,0,5
Hercules,M,100,0,512,512
Terea,F,100,195,0,195
Caisley,F,100,17,0,17
Iszac,M,100,0,11,11
Aidrian,M,100,0,40,40
Nicolos,M,100,0,17,17
Jewelian,F,58,14,10,24
Antwaine,M,100,0,328,328
Bethina,F,100,20,0,20
Mistique,F,100,22,0,22
Kennah,F,100,285,0,285
Taetym,F,100,5,0,5
Antinisha,F,100,5,0,5
Renly,M,89,5,40,45
Chardonnay,F,100,637,0,637
Nieja,F,100,5,0,5
Iliza,F,100,49,0,49
Coltin,M,100,0,2201,2201
Laya,F,100,1007,0,1007
Ivree,F,100,10,0,10
Iryss,F,100,5,0,5
Aalea,F,100,7,0,7
Markiesha,F,100,213,0,213
Isabella,F,100,266371,323,266694
Franklen,M,100,0,18,18
Devinee,F,100,29,0,29
Salana,F,100,11,0,11
Neyamiah,F,55,6,5,11
Shalica,F,100,5,0,5
Filimon,M,100,0,126,126
Cougar,M,100,0,206,206
Dailey,F,88,163,23,186
Dhani,M,75,65,191,256
Sharma,F,100,377,0,377
Nikoles,M,100,0,11,11
Rahnasia,F,100,5,0,5
Keondria,F,100,102,0,102
Katalayah,F,100,18,0,18
Halleh,F,100,5,0,5
Rachely,F,100,5,0,5
Ibraheim,M,100,0,5,5
Yariana,F,100,198,0,198
Kristinna,F,100,17,0,17
Saryniti,F,100,13,0,13
Berlene,F,100,5,0,5
Natayshia,F,100,5,0,5
Lawon,F,50,5,5,10
Cherrie,F,100,3206,0,3206
Deshonte,F,55,6,5,11
Janeiya,F,100,6,0,6
Terrylee,F,80,20,5,25
Janice,F,100,221621,597,222218
Amreen,F,100,148,0,148
Tylaya,F,100,22,0,22
Tericka,F,100,151,0,151
Abuk,F,100,35,0,35
Adonay,M,100,0,294,294
Jahnell,F,100,19,0,19
Derien,M,100,0,56,56
Wadiya,F,100,29,0,29
Tamekio,F,100,10,0,10
Glendora,F,100,775,0,775
Stephennie,F,100,5,0,5
Kalyce,F,100,39,0,39
Edenilson,M,100,0,115,115
Shonnon,F,57,31,23,54
Muhamed,M,100,0,438,438
Adalin,F,100,209,0,209
Jahree,M,100,0,66,66
Masumi,F,100,14,0,14
Chalyn,F,100,71,0,71
Aniyyah,F,100,18,0,18
Lesile,F,90,45,5,50
Neidy,F,100,161,0,161
Lillan,F,100,21,0,21
Cilla,F,100,5,0,5
Visente,M,100,0,79,79
Aschley,F,100,29,0,29
Daniil,M,100,0,142,142
Mykisha,F,100,24,0,24
Shivesh,M,100,0,21,21
Mahoghany,F,100,11,0,11
Atari,M,66,41,79,120
Malichai,M,100,0,12,12
Edwardd,M,100,0,5,5
Brandlyn,F,100,41,0,41
Nadalyn,F,100,75,0,75
Leryn,F,100,7,0,7
Daeyon,M,100,0,15,15
Jivan,M,100,0,137,137
Naadirah,F,100,11,0,11
Wisdom,F,54,533,457,990
Laquentin,M,100,0,130,130
Veshawn,M,100,0,7,7
Fartun,F,100,140,0,140
Ellexa,F,100,8,0,8
Janazia,F,100,61,0,61
Tifini,F,100,101,0,101
Nosheen,F,100,10,0,10
Marnee,F,100,375,0,375
Surai,F,100,44,0,44
Javien,M,100,0,1288,1288
Yazid,M,100,0,218,218
Orlaith,F,100,11,0,11
Shamsuddin,M,100,0,10,10
Shamone,F,91,213,22,235
Shrish,M,100,0,24,24
Ashdyn,M,80,6,24,30
Wallis,F,63,243,140,383
Matheos,M,100,0,5,5
Chiedozie,M,100,0,17,17
Ellierose,F,100,6,0,6
Jyree,M,100,0,39,39
Rikishi,M,62,6,10,16
Dyandra,F,100,30,0,30
Rhyanna,F,100,299,0,299
Kemaya,F,100,139,0,139
Ferguson,M,100,0,54,54
Jarryl,M,100,0,5,5
Wyllow,F,100,55,0,55
Shian,F,99,419,6,425
Sophialauren,F,100,5,0,5
Yashmit,M,100,0,5,5
Minelva,F,100,5,0,5
Blandy,F,100,6,0,6
Sofie,F,100,2955,0,2955
Desma,F,100,356,0,356
Kaecyn,M,100,0,5,5
Shambrika,F,100,6,0,6
Chozen,M,100,0,29,29
Maudell,F,100,11,0,11
Tabrea,F,100,17,0,17
Taaffe,F,100,7,0,7
Wenndy,F,100,5,0,5
Bindu,F,100,67,0,67
Alterik,M,100,0,5,5
Jalayshia,F,100,33,0,33
Erastus,M,100,0,5,5
Temprince,F,100,5,0,5
Dejiah,F,100,36,0,36
Mitsi,F,100,7,0,7
Tywan,M,99,15,1181,1196
Brint,M,100,0,49,49
Arthurine,F,100,102,0,102
Halimo,F,100,57,0,57
Domynic,M,100,0,31,31
Noellia,F,100,18,0,18
Augustin,M,100,0,2456,2456
Braelyne,F,100,6,0,6
Cristabel,F,100,200,0,200
Makel,M,93,48,593,641
Jacson,M,100,0,171,171
Pella,F,100,23,0,23
Nike,M,51,106,110,216
Shanecka,F,100,5,0,5
Evaine,F,100,5,0,5
Saviour,M,100,0,33,33
Miaisabella,F,100,80,0,80
Hennesey,F,100,15,0,15
Bitanya,F,100,16,0,16
Brandie,F,100,15736,29,15765
Muriah,F,100,103,0,103
Aile,F,100,43,0,43
Elleona,F,100,6,0,6
Arcangel,M,100,0,120,120
Novaly,F,100,12,0,12
Lendall,M,100,0,8,8
Ahlaam,F,100,17,0,17
Quint,M,100,0,602,602
Tierica,F,100,29,0,29
Logann,F,95,382,22,404
Sherine,F,100,418,0,418
Turon,M,100,0,95,95
Tahnia,F,100,41,0,41
Taelour,F,100,5,0,5
Lanyah,F,100,362,0,362
Tereso,M,100,0,91,91
Jaedin,M,77,117,398,515
Akyla,F,100,182,0,182
Tikyra,F,100,5,0,5
Shaheerah,F,100,24,0,24
Keylan,M,94,43,720,763
Shoshawna,F,100,18,0,18
Lexander,M,100,0,98,98
Mian,M,92,5,56,61
Assael,M,100,0,37,37
Sebasthian,M,100,0,88,88
Kamani,F,55,563,462,1025
Raynell,F,57,560,424,984
Mosetta,F,100,29,0,29
Nashan,M,100,0,6,6
Tenina,F,100,7,0,7
Anzley,F,100,105,0,105
Monasha,F,100,16,0,16
Tannen,M,100,0,138,138
Maleeha,F,100,211,0,211
Candis,F,100,4512,0,4512
Haleah,F,100,36,0,36
Swindell,M,100,0,5,5
Dawnesha,F,100,51,0,51
Issiah,M,100,0,1263,1263
Dayja,F,100,506,0,506
Laityn,F,100,93,0,93
Chauntay,F,100,61,0,61
Chaslyn,F,100,144,0,144
Jocquez,M,100,0,12,12
Quennel,M,100,0,47,47
Nikole,F,100,6679,0,6679
Teshira,F,100,5,0,5
Vandela,F,100,6,0,6
Neida,F,100,1728,0,1728
Kaci,F,99,8629,70,8699
Yetta,F,100,434,0,434
Blass,M,100,0,5,5
Xyan,M,100,0,7,7
Jaycean,M,100,0,18,18
Jamil,M,96,254,6609,6863
Sukanya,F,100,75,0,75
Travers,M,100,0,353,353
Haniah,F,100,97,0,97
Adisynne,F,100,50,0,50
Devontra,M,100,0,5,5
Emonee,F,100,164,0,164
Coran,M,100,0,76,76
Treacy,F,100,78,0,78
Rosaliyah,F,100,5,0,5
Yaeli,F,100,113,0,113
Saveion,M,100,0,53,53
Shivani,F,100,2520,0,2520
Kiyann,F,100,6,0,6
Almalik,M,100,0,86,86
Zoeigh,F,100,37,0,37
Marcinda,F,100,24,0,24
Zaviere,M,100,0,5,5
Gentry,M,61,1514,2323,3837
Marchelle,F,100,1619,0,1619
Jahliel,M,100,0,38,38
Shuan,M,100,0,176,176
Frady,F,100,204,0,204
Sukhjot,M,100,0,11,11
Topher,M,100,0,64,64
Vona,F,100,187,0,187
Shondrick,M,100,0,5,5
Daemond,M,100,0,25,25
Justis,M,78,384,1353,1737
Jaklyn,F,100,235,0,235
Latia,F,100,2865,0,2865
Minta,F,100,304,0,304
Amber,F,100,365517,980,366497
Drayce,M,100,0,70,70
Khadim,M,100,0,143,143
Sharri,F,100,1210,0,1210
Yamaris,F,100,170,0,170
Mekensie,F,100,5,0,5
Jerrita,F,100,6,0,6
Teag,M,100,0,12,12
Imperia,F,100,13,0,13
Ekrem,M,100,0,24,24
Rhen,M,83,22,109,131
Kenzie,F,97,13201,375,13576
Crissy,F,100,2571,0,2571
Broddrick,M,100,0,7,7
Tahj,M,97,73,2392,2465
Aizeah,M,100,0,5,5
Keeshaun,M,100,0,38,38
Ayasha,F,100,252,0,252
Travin,M,100,0,409,409
Bianney,F,100,87,0,87
Adly,F,100,19,0,19
Kaitey,F,100,5,0,5
Nishad,M,100,0,31,31
Lachristy,F,100,5,0,5
Johnlloyd,M,100,0,5,5
Irfaan,M,100,0,5,5
Berat,M,100,0,28,28
Zakhari,M,93,5,66,71
Toki,F,100,7,0,7
Laquaisha,F,100,35,0,35
Athel,M,100,0,12,12
Joyous,F,100,90,0,90
Baheejah,F,100,11,0,11
Travius,M,100,0,195,195
Angelike,F,100,5,0,5
Tabitha,F,100,56475,146,56621
Shantae,F,100,1572,6,1578
Born,M,100,0,5,5
Jayvyn,M,100,0,533,533
Hanif,M,100,0,633,633
Fedaa,F,100,6,0,6
Darilynn,F,100,12,0,12
Kaydrian,M,100,0,17,17
Jolea,F,100,167,0,167
Javaree,M,100,0,31,31
Harli,F,100,903,0,903
Zaky,M,100,0,5,5
Heber,M,100,0,1623,1623
Qian,M,100,0,13,13
Aranya,F,100,17,0,17
Jakesha,F,100,29,0,29
Galvester,M,100,0,5,5
Calyb,M,100,0,64,64
Cornesia,F,100,10,0,10
Teala,F,100,498,0,498
Tarie,F,100,20,0,20
Dmonte,M,100,0,136,136
Mathea,F,100,141,0,141
Lushus,F,100,5,0,5
Pavitra,F,100,6,0,6
Luisandro,M,100,0,5,5
Aigner,F,100,242,0,242
Marishia,F,100,7,0,7
Savonnah,F,100,55,0,55
Haaken,M,100,0,29,29
Obrain,M,100,0,5,5
Damion,M,100,39,15577,15616
Imya,F,100,66,0,66
Rashi,F,60,190,129,319
Aldolfo,M,100,0,18,18
Lucha,F,100,6,0,6
Devaney,F,100,155,0,155
Jala,F,100,1891,0,1891
Doc,M,100,0,346,346
Shevell,F,100,6,0,6
Gerren,M,94,38,552,590
Devari,M,100,0,29,29
Adryen,M,100,0,78,78
Kezia,F,100,1776,0,1776
Nylayah,F,100,19,0,19
Johnanna,F,100,59,0,59
Rise,F,99,892,5,897
Ilynn,F,100,41,0,41
Rishit,M,100,0,106,106
Cinnamin,F,100,6,0,6
Elonzo,M,100,0,98,98
Pax,M,98,5,292,297
Nekole,F,100,46,0,46
Jacori,M,99,12,794,806
Leyton,M,89,200,1632,1832
Zoeii,F,100,30,0,30
Arielyn,F,100,5,0,5
Priyana,F,100,39,0,39
Tanesa,F,100,60,0,60
Lakshmy,F,100,5,0,5
Ayante,F,100,5,0,5
Delayna,F,100,735,0,735
Mariza,F,100,1108,0,1108
Lasharra,F,100,21,0,21
Starlite,F,100,34,0,34
Brene,F,100,22,0,22
Cintra,F,100,5,0,5
Cyprus,M,90,10,87,97
Gregory,M,100,2746,653360,656106
Tijera,F,100,35,0,35
Avira,F,100,6,0,6
Maebel,F,100,55,0,55
Shampagne,F,100,5,0,5
Kourteney,F,100,17,0,17
Caeson,M,100,0,81,81
Jakasia,F,100,6,0,6
Marletha,F,100,5,0,5
Peg,F,100,439,0,439
Shareeta,F,100,50,0,50
Dekesha,F,100,20,0,20
Aranda,F,100,142,0,142
Dreah,F,100,25,0,25
Rupa,F,100,153,0,153
Alcus,M,100,0,5,5
Donivan,M,100,0,1006,1006
Wilbon,M,100,0,18,18
Ajene,M,60,59,89,148
Knightly,M,100,0,6,6
Johnthan,M,100,0,792,792
Alishya,F,100,18,0,18
Ervey,M,100,0,213,213
Shanquil,F,100,5,0,5
Eyasu,M,100,0,40,40
Beya,F,100,130,0,130
Quanye,M,100,0,11,11
Tryson,M,100,0,89,89
Lynne,F,100,44569,181,44750
Hans,M,100,5,10852,10857
Berto,M,100,0,6,6
Faaiz,M,100,0,14,14
Quameir,M,100,0,5,5
Melchi,M,100,0,16,16
Taishon,M,100,0,11,11
Elodia,F,100,735,0,735
Uzoamaka,F,100,40,0,40
Yasiah,F,100,5,0,5
Babie,F,100,15,0,15
Hersh,M,100,0,545,545
Nevelle,M,100,0,6,6
Alyciah,F,100,10,0,10
Damne,F,100,15,0,15
Yuen,F,100,5,0,5
Truth,M,60,242,358,600
Serdar,M,100,0,5,5
Kadaisha,F,100,37,0,37
Tanisia,F,100,68,0,68
Greysi,F,100,11,0,11
Amandalee,F,100,122,0,122
Sharmaine,F,100,1660,5,1665
Shadava,F,100,25,0,25
Elioth,M,100,0,5,5
Tuck,M,100,0,99,99
Jakerion,M,100,0,5,5
Laquashia,F,100,70,0,70
Nadeline,F,100,21,0,21
Patricio,M,100,5,3162,3167
Jasyn,M,100,0,165,165
Stancy,F,100,5,0,5
Vianca,F,100,1774,0,1774
Jaquantae,M,100,0,5,5
Jasonna,F,100,23,0,23
Gabbi,F,100,68,0,68
Alysha,F,100,9117,0,9117
Theador,M,100,0,28,28
Tynli,F,100,6,0,6
In,F,76,16,5,21
Sopheak,M,100,0,38,38
Etheline,F,100,24,0,24
Tyone,M,100,0,23,23
Chintan,M,100,0,5,5
Wells,M,97,29,851,880
Danija,F,100,70,0,70
Gracielynn,F,100,77,0,77
Dakyla,F,100,48,0,48
Santara,F,100,14,0,14
Gwenn,F,100,1084,0,1084
Jenesse,F,100,5,0,5
Dominador,M,100,0,6,6
Matyas,M,100,0,104,104
Regann,F,100,38,0,38
Celestine,F,100,3921,0,3921
Breondra,F,100,5,0,5
Ayinde,M,100,0,404,404
Melbin,M,100,0,50,50
Kristo,M,100,0,31,31
Edwon,M,100,0,5,5
Minea,F,100,6,0,6
Juanfelipe,M,100,0,11,11
Pistol,M,77,14,47,61
Janayra,F,100,12,0,12
Xyla,F,100,295,0,295
Melika,F,100,341,0,341
Jezrael,M,100,0,36,36
Arnaud,M,100,0,15,15
Kalel,M,100,0,1986,1986
Shaquinna,F,100,6,0,6
Amareion,M,100,0,12,12
Donae,F,97,192,6,198
Wathena,F,100,5,0,5
Latrece,F,100,690,0,690
Konan,M,100,0,38,38
Sioban,F,100,36,0,36
Leafy,F,100,5,0,5
Suleyma,F,100,324,0,324
Damonica,F,100,183,0,183
Corderius,M,100,0,79,79
Siennah,F,100,62,0,62
Jaharee,M,100,0,5,5
Wyeth,M,100,0,264,264
Tristien,M,100,0,6,6
Cloyd,M,100,0,547,547
Akaja,F,100,5,0,5
Laterrika,F,100,20,0,20
Mackinnley,M,100,0,10,10
Nyjah,F,67,515,258,773
Mikey,M,100,0,1100,1100
Jayanthony,M,100,0,41,41
Novella,F,100,1395,0,1395
Dulton,M,100,0,5,5
Larsa,F,100,5,0,5
Eldrick,M,100,0,364,364
Brittanni,F,100,150,0,150
Aracel,F,100,5,0,5
Jaafar,M,100,0,48,48
Nimsy,F,100,18,0,18
Briah,F,100,606,0,606
Linzell,M,100,0,5,5
Ellamarie,F,100,189,0,189
Jdan,M,100,0,5,5
Rinata,F,100,6,0,6
Emyree,F,100,8,0,8
Dail,M,61,86,134,220
Hevin,F,100,73,0,73
Bless,M,51,152,157,309
Thandie,F,100,13,0,13
Mylasha,F,100,5,0,5
Curvin,M,100,0,269,269
Delmus,M,100,0,213,213
Mayukha,F,100,30,0,30
Devane,M,100,0,53,53
Spring,F,100,3287,0,3287
Angeliah,F,100,126,0,126
Lola,F,100,26200,0,26200
Baudel,M,100,0,11,11
Leighana,F,100,236,0,236
Maleehah,F,100,18,0,18
Breyelle,F,100,35,0,35
Shrishti,F,100,5,0,5
Chawna,F,100,5,0,5
Nashelly,F,100,10,0,10
Kasara,F,100,229,0,229
Ashawni,F,100,5,0,5
Jamette,F,100,30,0,30
Carlei,F,100,79,0,79
Hemerson,M,100,0,6,6
Inara,F,100,944,0,944
Ahnesti,F,100,59,0,59
Vitas,M,100,0,15,15
Noela,F,100,115,0,115
Dreydin,M,100,0,6,6
Annalyssia,F,100,5,0,5
Ellerie,F,100,165,0,165
Elridge,M,100,0,101,101
Autunm,F,100,13,0,13
Shambhavi,F,100,34,0,34
Imogen,F,100,1166,0,1166
Endy,M,97,15,446,461
Janny,F,100,494,0,494
Hatice,F,100,55,0,55
Giovannina,F,100,7,0,7
Jacobanthony,M,100,0,31,31
Graedy,M,100,0,5,5
Josi,F,100,851,0,851
Anabela,F,100,429,0,429
Ishrat,F,100,47,0,47
Jacqua,F,100,33,0,33
Edisha,F,100,5,0,5
Zayden,M,99,96,10319,10415
Ceaira,F,100,557,0,557
Shelle,F,100,570,0,570
Dustin,M,99,1380,202855,204235
Jhamya,F,100,6,0,6
Mekena,F,100,14,0,14
Portlynn,F,100,5,0,5
Falco,M,100,0,7,7
Josiya,M,100,0,16,16
Daviere,M,100,0,15,15
Kayley,F,100,7695,0,7695
Stayton,M,100,0,10,10
Naieem,M,100,0,10,10
Marleta,F,100,45,0,45
Filiz,F,100,5,0,5
Micayla,F,100,2454,0,2454
Dasia,F,100,4871,0,4871
Yarnelle,F,100,5,0,5
Abney,F,100,10,0,10
Hendricks,M,100,0,43,43
St,M,100,0,11,11
Alvania,F,100,5,0,5
Kemaurie,M,100,0,5,5
Demontrell,M,100,0,10,10
Cassia,F,100,1431,0,1431
Tiaunna,F,100,80,0,80
Mckinsley,F,100,61,0,61
Cashae,F,100,76,0,76
Ivi,F,100,54,0,54
Charlie,M,83,11543,58107,69650
Loisteen,F,100,11,0,11
Saniyia,F,100,5,0,5
Atreo,M,100,0,5,5
Cayce,F,70,1107,472,1579
Icel,F,100,11,0,11
Zairah,F,100,141,0,141
Verna,F,99,11912,91,12003
Yestin,M,100,0,5,5
Sheral,F,100,342,0,342
Mischel,F,100,26,0,26
Ermila,F,100,26,0,26
Johel,M,100,0,35,35
Niaimani,F,100,15,0,15
Emmanel,M,100,0,5,5
Meyosha,F,100,8,0,8
Kallee,F,100,612,0,612
Dinae,F,100,15,0,15
Odinn,M,100,0,12,12
Alanda,F,100,715,0,715
Dewayna,F,100,21,0,21
Constina,F,100,5,0,5
Ibaad,M,100,0,26,26
Devanee,F,100,159,0,159
Mugdha,F,100,16,0,16
Irmani,F,100,7,0,7
Corgan,M,100,0,131,131
Mekyla,F,100,29,0,29
Otha,M,93,157,2020,2177
Ly,F,70,279,119,398
Nicolai,M,100,0,1230,1230
Rikkilee,F,100,7,0,7
Merranda,F,100,132,0,132
Nichaolas,M,100,0,5,5
Treasure,F,98,4918,107,5025
Keymya,F,100,46,0,46
Saydi,F,100,364,0,364
Brisseyda,F,100,10,0,10
Franklyn,M,100,0,2889,2889
Montey,M,100,0,64,64
Corderio,M,100,0,24,24
Beaney,F,100,5,0,5
Baudelio,M,100,0,280,280
Andilyn,F,100,54,0,54
Oluwatomi,F,55,16,13,29
Maitri,F,100,95,0,95
Astoria,F,100,201,0,201
Jeidi,F,100,87,0,87
Ilean,F,100,192,0,192
Ghaith,M,100,0,18,18
Malicka,F,100,5,0,5
Larreon,M,100,0,5,5
Marj,F,100,14,0,14
Jonnell,F,84,58,11,69
Amren,M,100,0,10,10
Hermes,M,100,0,457,457
Darvon,M,100,0,54,54
Nataska,F,100,5,0,5
Quan,M,97,39,1241,1280
Selestino,M,100,0,17,17
Edrees,M,100,0,60,60
Yumin,M,100,0,5,5
Gionni,M,95,47,822,869
Chen,M,73,52,143,195
Melynie,F,100,21,0,21
Rhodonna,F,100,5,0,5
Avamarie,F,100,587,0,587
Charmell,F,100,32,0,32
Letonya,F,100,182,0,182
Doreen,F,100,35841,53,35894
Daleth,F,100,18,0,18
Amear,M,100,0,54,54
Javontez,M,100,0,24,24
Shiesha,F,100,62,0,62
Myelle,F,100,135,0,135
Jurlene,F,100,12,0,12
Mikkala,F,100,12,0,12
Lydianne,F,100,5,0,5
Sandibel,F,100,6,0,6
Deautre,M,100,0,5,5
Ashaz,M,100,0,95,95
Mikalia,F,100,88,0,88
Jaewon,M,100,0,47,47
Aesha,F,100,613,0,613
Future,M,76,21,66,87
Carmelina,F,100,713,0,713
Uhuru,M,85,5,28,33
Aravind,M,100,0,153,153
Cchristopher,M,100,0,5,5
Avneet,F,99,337,5,342
Amyree,F,100,32,0,32
Nikesh,M,100,0,88,88
Zimya,F,100,10,0,10
Nyshay,F,100,5,0,5
Akeyia,F,100,17,0,17
Aurionna,F,100,13,0,13
Layann,F,100,43,0,43
Britan,M,70,11,26,37
Lafern,F,100,11,0,11
Keilianys,F,100,7,0,7
Casy,M,59,86,122,208
Patricia,F,100,852447,2704,855151
Joffrey,M,100,0,77,77
Shiv,M,100,0,1322,1322
Ker,M,67,5,10,15
Anyree,F,100,5,0,5
Kellyn,F,93,1751,136,1887
Makayela,F,100,75,0,75
Asharee,F,100,24,0,24
Romelio,M,100,0,23,23
Juilianna,F,100,5,0,5
Tristano,M,100,0,5,5
Liliyana,F,100,46,0,46
Jarie,F,65,11,6,17
Ethanael,M,100,0,83,83
Tykea,F,100,5,0,5
Davies,M,100,0,11,11
Poorvi,F,100,25,0,25
Devahn,M,100,0,17,17
Darene,F,100,119,0,119
Leyna,F,100,1560,0,1560
Keevan,M,100,0,159,159
Adelice,F,100,5,0,5
Viki,F,100,1548,0,1548
Kwmaine,M,100,0,14,14
Sujay,M,100,0,241,241
Jaydie,F,100,55,0,55
Brei,F,100,70,0,70
Coralito,F,100,5,0,5
Thyais,F,100,7,0,7
Verletta,F,100,34,0,34
Medelin,F,100,12,0,12
Omarionna,F,100,5,0,5
Jamorris,M,100,0,162,162
Mylo,M,94,35,566,601
Rylei,F,93,623,46,669
Evo,M,100,0,5,5
Kimahri,M,100,0,24,24
Cierah,F,100,107,0,107
Rolfe,M,100,0,218,218
Tabrina,F,100,91,0,91
Makela,F,100,286,0,286
Hikeem,M,100,0,105,105
Jawaad,M,100,0,47,47
Yasmani,M,100,0,17,17
Persephonie,F,100,58,0,58
Taaron,M,100,0,10,10
Moncerrath,F,100,90,0,90
Gattis,M,100,0,5,5
Jonesha,F,100,239,0,239
Bobette,F,100,878,0,878
Jaiyla,F,100,107,0,107
Evanni,F,100,5,0,5
Jazel,F,98,514,11,525
Pepi,M,100,0,10,10
Laesha,F,100,34,0,34
Jaxden,M,100,0,31,31
Mossimo,M,100,0,38,38
Rondale,M,100,0,498,498
Omauri,M,100,0,83,83
Jesusmanuel,M,100,0,65,65
Paige,F,99,131460,925,132385
Mauri,F,88,763,101,864
Sherel,F,100,134,0,134
Kaleeyah,F,100,85,0,85
Dashane,M,67,5,10,15
Burt,M,100,0,3181,3181
Legen,M,100,0,8,8
Laima,F,100,38,0,38
Ritaj,F,100,58,0,58
Jerzy,F,52,115,105,220
Achilleus,M,100,0,5,5
Madchen,F,100,17,0,17
Xandyr,M,100,0,25,25
Melaynie,F,100,5,0,5
Sylys,M,100,0,16,16
Aneesa,F,100,1350,0,1350
Veronique,F,100,1395,0,1395
Brenen,M,100,0,318,318
Beni,M,71,21,52,73
Yessel,F,100,7,0,7
Manna,F,100,124,0,124
Taiba,F,100,23,0,23
Laveeda,F,100,5,0,5
Deshai,F,100,22,0,22
Klair,F,100,127,0,127
Tonyia,F,100,567,0,567
Nainika,F,100,52,0,52
Kalliann,F,100,6,0,6
Lewann,F,100,5,0,5
Keira,F,100,25306,7,25313
Harvis,M,100,0,42,42
Vasilios,M,100,0,1301,1301
Beena,F,100,90,0,90
Kemora,F,100,457,0,457
Ryanjay,M,100,0,5,5
Kanisa,F,100,6,0,6
Simryn,F,100,21,0,21
Lyannah,F,100,6,0,6
Biftu,F,100,5,0,5
Kaylnn,F,100,23,0,23
Kameela,F,100,148,0,148
Tahmia,F,100,5,0,5
Vanelly,F,100,5,0,5
Haroldine,F,100,6,0,6
Cadon,M,100,0,231,231
Cameil,F,100,5,0,5
Hervie,M,100,0,12,12
Kyrstyn,F,100,193,0,193
Demetricus,M,100,0,31,31
Chandell,F,100,104,0,104
Tanaa,F,100,5,0,5
Lacreesha,F,100,13,0,13
Kenechukwu,M,100,0,222,222
Dianah,F,100,385,0,385
Magdaly,F,100,5,0,5
Kevinmatthew,M,100,0,5,5
Nixmary,F,100,5,0,5
Icy,F,100,64,0,64
Jadaliz,F,100,26,0,26
Taeylor,F,100,21,0,21
Ocean,F,51,1361,1292,2653
Ahmeer,M,100,0,39,39
Kenetha,F,100,87,0,87
Rhaelyn,F,100,39,0,39
Milenko,M,100,0,7,7
Emberlin,F,100,40,0,40
Odie,M,93,43,586,629
Kartar,M,100,0,6,6
Zaine,M,99,16,1138,1154
Stella,F,100,50774,41,50815
Sirdarius,M,100,0,7,7
Khristie,F,100,144,0,144
Kinadee,F,100,11,0,11
Jamesson,M,100,0,5,5
Yitta,F,100,216,0,216
Kwanze,M,100,0,5,5
Cavion,M,100,0,90,90
Steven,M,100,4311,1180200,1184511
Linzi,F,100,552,0,552
Jaysa,F,100,451,0,451
Clayborn,M,100,0,322,322
Chastan,M,100,0,5,5
Crissangel,M,100,0,5,5
Reenie,F,100,35,0,35
Irani,F,100,5,0,5
Asma,F,100,1644,0,1644
Nykolas,M,100,0,292,292
Miquez,M,100,0,5,5
Dakeria,F,100,16,0,16
Yasen,M,100,0,11,11
Cynthi,F,100,16,0,16
Khiron,M,100,0,5,5
Kemyah,F,100,100,0,100
Nikie,F,100,191,0,191
Daizhon,M,100,0,11,11
Teuila,F,100,43,0,43
Bellani,F,100,5,0,5
Delayni,F,100,90,0,90
Keif,M,100,0,25,25
Ladrina,F,100,21,0,21
Saion,M,100,0,5,5
Callen,M,90,365,3160,3525
Paycee,F,100,14,0,14
Lenci,F,100,12,0,12
Corkey,M,100,0,34,34
Cheneka,F,100,6,0,6
Burgandy,F,100,196,0,196
Erick,M,99,412,65210,65622
Abrar,F,53,330,296,626
Thoedore,M,100,0,6,6
Najaya,F,100,21,0,21
Trinae,F,100,48,0,48
Peytan,F,100,252,0,252
Devonta,M,99,36,2849,2885
Nakeya,F,100,805,0,805
Tiquila,F,100,5,0,5
Jaleyza,F,100,9,0,9
Asir,M,100,0,58,58
Nathaya,F,100,5,0,5
Ahmier,M,100,0,25,25
Nikkie,F,100,707,0,707
Camiryn,F,100,27,0,27
Poppy,F,100,1740,0,1740
Batina,F,100,139,0,139
Laurynn,F,100,445,0,445
Greggery,M,100,0,16,16
Abbriella,F,100,24,0,24
Latrivia,F,100,34,0,34
Hillory,F,100,22,0,22
Yelonda,F,100,46,0,46
Leairah,F,100,23,0,23
Moukthika,F,100,17,0,17
Drayton,M,100,0,1454,1454
Mahiya,F,100,88,0,88
Iann,M,100,0,334,334
Ryleeann,F,100,61,0,61
Josephjames,M,100,0,16,16
Renelda,F,100,135,0,135
Karita,F,100,197,0,197
Solage,F,100,6,0,6
Lasalle,M,94,16,248,264
Naliah,F,100,167,0,167
Sherman,M,99,138,17885,18023
Simya,F,100,206,0,206
Fanchon,F,100,195,0,195
Reven,M,83,6,29,35
Syan,F,88,103,14,117
Zamuel,M,100,0,19,19
Fain,M,71,6,15,21
Audianna,F,100,53,0,53
Tini,F,100,10,0,10
Hidi,F,100,57,0,57
Kenzlea,F,100,5,0,5
Nachel,F,100,5,0,5
Naviah,F,100,179,0,179
Miguelina,F,100,267,0,267
Egor,M,100,0,50,50
Darriona,F,100,126,0,126
Trigg,M,100,0,239,239
Lenward,M,100,0,119,119
Gion,M,100,0,8,8
Ordan,M,100,0,5,5
Croix,M,100,0,481,481
Itianna,F,100,6,0,6
Hokulani,F,100,96,0,96
Jaydalynn,F,100,115,0,115
Josaia,M,100,0,5,5
Zyonah,F,100,12,0,12
Mablean,F,100,10,0,10
Sanvi,F,100,779,0,779
Kieler,M,100,0,57,57
Siddhant,M,100,0,403,403
Lanaia,F,100,31,0,31
Shahnaz,F,100,39,0,39
Khaleesia,F,100,8,0,8
Latysha,F,100,124,0,124
Adylen,F,100,19,0,19
Ximena,F,100,15739,6,15745
Dashari,F,100,5,0,5
Johnaaron,M,100,0,6,6
Eleah,F,100,190,0,190
Mickenzi,F,100,5,0,5
Viviano,M,100,0,116,116
Siria,F,100,275,0,275
Rishik,M,100,0,231,231
Breydan,M,100,0,239,239
Khalema,F,100,5,0,5
Cienna,F,100,1964,0,1964
Shantalle,F,100,12,0,12
Alaysiah,F,100,67,0,67
Davonda,F,100,67,0,67
Javonna,F,100,808,0,808
Heartly,F,100,16,0,16
Khaos,M,100,0,16,16
Genero,M,100,0,10,10
Mattelyn,F,100,114,0,114
Zuleidy,F,100,33,0,33
Delacy,F,100,20,0,20
Caliese,F,100,5,0,5
Ruchy,F,100,203,0,203
Shreyank,M,100,0,11,11
Rhonald,M,100,0,10,10
Abirami,F,100,31,0,31
Omesha,F,100,66,0,66
Dilany,F,100,5,0,5
Aaiden,M,100,0,543,543
Julianne,F,100,25635,0,25635
Nashari,F,100,13,0,13
Klaus,M,100,0,828,828
Sicilia,F,100,169,0,169
Tyannah,F,100,85,0,85
Reza,M,100,0,815,815
Peyten,F,78,424,120,544
Vyctoria,F,100,157,0,157
Nicolemarie,F,100,101,0,101
Femi,M,59,19,27,46
Miarose,F,100,147,0,147
Zuhur,F,100,16,0,16
Tinna,F,100,312,0,312
Ariaan,M,100,0,5,5
Naiomy,F,100,68,0,68
Nakhi,M,100,0,110,110
Alfonsa,M,100,0,61,61
Quantrell,M,100,0,390,390
Dannon,M,84,92,476,568
Jenette,F,100,1485,0,1485
Falcon,M,95,16,282,298
Mariaalejandra,F,100,10,0,10
Jamoria,F,100,16,0,16
Cadell,M,100,0,85,85
Mkyla,F,100,10,0,10
Vittorio,M,100,0,953,953
Nicklus,M,100,0,46,46
Domanick,M,100,0,728,728
Tymeer,M,100,0,62,62
Zoelie,F,100,18,0,18
Alfonzo,M,100,0,3969,3969
Paulina,F,100,14967,5,14972
Galyn,F,63,52,31,83
Bellamarie,F,100,117,0,117
Carloyn,F,100,182,0,182
Jaydyn,M,55,639,778,1417
Fierra,F,100,45,0,45
Briananthony,M,100,0,5,5
Kaler,M,100,0,48,48
Josimar,M,100,0,81,81
Tyniah,F,100,117,0,117
Henleigh,F,100,94,0,94
Priscyla,F,100,6,0,6
Trevona,F,100,5,0,5
Kynlee,F,100,2514,0,2514
Kakisha,F,100,17,0,17
Delean,F,100,5,0,5
Aldine,F,78,35,10,45
Melodi,F,100,1478,0,1478
Avrumi,M,100,0,27,27
Daquanda,F,100,5,0,5
Izael,M,100,0,300,300
Thatcher,M,100,0,2185,2185
Sharmayne,F,100,246,0,246
Tomasa,F,100,982,0,982
Kaysha,F,100,1180,0,1180
Cedella,F,100,23,0,23
Lonyea,F,100,5,0,5
Jihan,F,92,536,46,582
Kamili,F,100,50,0,50
Zoryana,F,100,12,0,12
Musheerah,F,100,11,0,11
Amissa,F,100,21,0,21
Adithi,F,100,294,0,294
Shorn,M,100,0,5,5
Anagh,M,100,0,5,5
Jarison,M,100,0,5,5
Jiovanna,F,100,105,0,105
Stosh,M,100,0,22,22
Annemari,F,100,14,0,14
Yatta,F,100,10,0,10
Blakelie,F,100,17,0,17
Keili,F,100,378,0,378
Suyai,F,100,5,0,5
Racine,F,99,472,5,477
Krystina,F,100,4666,0,4666
Ethny,F,100,5,0,5
Ardit,M,100,0,90,90
Vennela,F,100,64,0,64
Sayeeda,F,100,6,0,6
Nerely,F,100,5,0,5
Nahya,F,100,10,0,10
Martise,M,100,0,109,109
Adamariz,F,100,196,0,196
Ieashia,F,100,29,0,29
Shontaya,F,100,6,0,6
Shelaya,F,100,5,0,5
Andrews,M,100,0,443,443
Cha,M,87,37,253,290
Learta,F,100,5,0,5
Brenlie,F,100,32,0,32
Smayan,M,100,0,24,24
Noemie,F,100,237,0,237
Kira,F,100,31884,27,31911
Saharra,F,100,129,0,129
Gela,F,100,26,0,26
Rodriguez,M,99,5,927,932
Contrina,F,100,168,0,168
Statler,M,100,0,16,16
Luisa,F,100,9415,33,9448
Jacoby,M,99,109,8483,8592
Salethia,F,100,5,0,5
Seanda,F,100,14,0,14
Maicol,M,100,0,98,98
Merla,F,100,117,0,117
Madelein,F,100,170,0,170
Kimyetta,F,100,130,0,130
Mahaylia,F,100,5,0,5
Zoie,F,100,8224,0,8224
Tyuana,F,100,5,0,5
Oluwatomisin,F,65,91,49,140
Seager,M,100,0,10,10
Hoyle,M,100,0,141,141
Reatha,F,100,644,0,644
Adalyne,F,100,245,0,245
Mcdonald,M,100,0,214,214
Aaven,M,100,0,31,31
Nethan,M,100,0,57,57
Kaydrie,F,100,6,0,6
Jovi,F,69,586,259,845
Bevin,F,89,1004,122,1126
Norielle,F,100,7,0,7
Katiejo,F,100,73,0,73
Lorretta,F,100,1365,0,1365
Lizbeth,F,100,23119,31,23150
Jondrea,F,100,19,0,19
Myrical,F,100,168,0,168
Laking,M,100,0,6,6
Telma,F,100,245,0,245
Kalean,F,100,5,0,5
Satine,F,100,72,0,72
Kishea,F,100,6,0,6
Tenchi,M,100,0,10,10
Caila,F,100,1079,0,1079
Alektra,F,100,20,0,20
Dayceon,M,100,0,9,9
Nakeda,F,100,48,0,48
Louanna,F,100,481,0,481
Sorrell,M,100,0,26,26
Cynara,F,100,135,0,135
Lollie,F,100,130,0,130
Demonica,F,100,339,0,339
Nazanin,F,100,78,0,78
Lujayn,F,100,47,0,47
Anastazia,F,100,647,0,647
Nicho,M,100,0,5,5
Ander,M,100,0,854,854
Caeden,M,98,29,1683,1712
Kellen,M,92,1136,13415,14551
Kherrington,F,100,45,0,45
Djay,M,100,0,34,34
Lanyard,M,100,0,5,5
Harlin,M,96,23,570,593
Kaelea,F,100,104,0,104
Katrisa,F,100,5,0,5
Herbert,M,99,281,53741,54022
Clydell,M,94,6,92,98
Ayslyn,F,100,5,0,5
Wittney,F,100,29,0,29
Kelbe,F,100,5,0,5
Kowen,M,100,0,158,158
Leiland,M,100,0,362,362
Shakura,F,100,197,0,197
Sherwood,M,100,0,1964,1964
Lovette,F,100,400,0,400
Rickiesha,F,100,5,0,5
Anija,F,100,323,0,323
Smriti,F,100,177,0,177
Padraig,M,100,0,648,648
Ashantianna,F,100,6,0,6
Favour,F,89,251,30,281
Kerma,F,100,5,0,5
Raymod,M,100,0,6,6
Caydyn,M,100,0,58,58
Nahrain,F,100,5,0,5
Aliyanna,F,100,360,0,360
Brantleigh,F,100,43,0,43
Jario,M,100,0,6,6
Aryiel,F,100,11,0,11
Accacia,F,100,26,0,26
Audelio,M,100,0,5,5
Sashya,F,100,5,0,5
Syris,M,100,0,179,179
Delontay,M,100,0,29,29
Quatez,M,100,0,36,36
Ariyan,F,60,269,182,451
Joevon,M,100,0,164,164
Kaustubh,M,100,0,30,30
Omarian,M,100,0,260,260
Heena,F,100,253,0,253
Nea,F,100,295,0,295
Tajma,F,100,53,0,53
Shykira,F,100,56,0,56
Arliss,M,60,121,184,305
Casmira,F,100,9,0,9
Kyreece,M,100,0,7,7
Romeshia,F,100,13,0,13
Hassan,M,100,7,8490,8497
Tranis,M,100,0,6,6
Xailey,F,100,5,0,5
Shyneice,F,100,10,0,10
Heven,F,100,35,0,35
Ismahan,F,100,79,0,79
Kierre,M,80,94,366,460
Kalecia,F,100,72,0,72
Kristobal,M,100,0,11,11
Adis,M,100,0,192,192
Jerriana,F,100,6,0,6
Akol,M,100,0,6,6
Tevez,M,100,0,6,6
Melquan,M,100,0,254,254
Lettia,F,100,5,0,5
Cayn,M,100,0,12,12
Bellamia,F,100,69,0,69
Ranetta,F,100,114,0,114
Samaje,M,100,0,12,12
Jarielys,F,100,69,0,69
Kazim,M,100,0,86,86
Chantrice,F,100,71,0,71
Emslee,F,100,32,0,32
Darlena,F,100,1245,0,1245
Zuriela,F,100,11,0,11
Rechele,F,100,5,0,5
Devri,F,100,91,0,91
Chazmine,F,100,35,0,35
Cloteal,F,100,37,0,37
Kylepatrick,M,100,0,10,10
Kaylanne,F,100,5,0,5
Violeth,F,100,11,0,11
Hayleigh,F,100,4616,0,4616
Rico,M,99,45,8452,8497
Jimiyah,F,100,5,0,5
Kyland,M,100,0,366,366
Nilton,M,100,0,85,85
Catelynne,F,100,5,0,5
Ryunosuke,M,100,0,17,17
Anjelah,F,100,23,0,23
Vaylen,M,100,0,17,17
Ambrosha,F,100,10,0,10
Georgeanne,F,100,660,0,660
Mariselda,F,100,65,0,65
Lorely,F,100,160,0,160
Sabeeh,M,100,0,6,6
Thom,M,100,0,607,607
Brandina,F,100,6,0,6
Lenya,F,100,78,0,78
Lorilynn,F,100,130,0,130
Matteo,M,100,5,8011,8016
Mau,M,100,0,5,5
Keilee,F,100,413,0,413
Jerra,F,100,489,0,489
Sumaira,F,100,26,0,26
Ankita,F,100,480,0,480
Jamieka,F,100,54,0,54
Brittanii,F,100,5,0,5
Avyana,F,100,130,0,130
Cyrille,M,65,6,11,17
Beaux,M,93,54,687,741
Rhilyn,F,100,48,0,48
Shatori,F,100,88,0,88
Jaxzyn,M,100,0,5,5
Leyla,F,100,5533,0,5533
Meilee,F,100,20,0,20
Tenae,F,100,136,0,136
Manfredo,M,100,0,5,5
Nahida,F,100,12,0,12
Christann,F,100,6,0,6
Tiyon,M,100,0,214,214
Sharity,F,100,38,0,38
Kendelyn,F,100,10,0,10
Bernise,F,100,29,0,29
Mirlande,F,100,19,0,19
Jakendra,F,100,11,0,11
Caitrin,F,100,405,0,405
Yamili,F,100,79,0,79
Ainhoa,F,100,71,0,71
Yaresi,F,100,10,0,10
Larvell,M,100,0,6,6
Qualik,M,100,0,20,20
Adeena,F,100,316,0,316
Maelee,F,100,704,0,704
Carlon,M,86,98,578,676
Cieana,F,100,5,0,5
Syona,F,100,71,0,71
Kaizlyn,F,100,7,0,7
Xaria,F,100,512,0,512
Udy,F,100,17,0,17
Kristjana,F,100,6,0,6
Joniya,F,100,143,0,143
Tondelayo,F,100,17,0,17
Kiliyah,F,100,5,0,5
Mylasia,F,100,170,0,170
Trentyn,M,100,0,496,496
Cormarion,M,100,0,15,15
Jlin,M,100,0,17,17
Jakylen,M,100,0,44,44
Jerriah,F,100,106,0,106
Sulton,M,100,0,11,11
Trentavious,M,100,0,5,5
Pacifica,F,100,6,0,6
Henoch,M,100,0,24,24
Delwyn,M,100,0,534,534
Martella,F,100,5,0,5
Anglene,F,100,5,0,5
Amielia,F,100,30,0,30
Guiliano,M,100,0,12,12
Keighla,F,100,12,0,12
Conne,F,100,10,0,10
Vonica,F,100,5,0,5
Judalon,F,100,11,0,11
Coraleigh,F,100,43,0,43
Jahmia,F,100,104,0,104
Karsha,F,100,22,0,22
Duarte,M,100,0,15,15
Colinda,F,100,168,0,168
Rinley,F,100,7,0,7
Lillianrose,F,100,5,0,5
Dorn,M,92,12,134,146
Istvan,M,100,0,81,81
Tyece,F,100,10,0,10
Cassanda,F,100,55,0,55
Monyetta,F,100,7,0,7
Lakiera,F,100,35,0,35
Jeylene,F,100,11,0,11
Lavere,M,100,0,5,5
Shelbyjo,F,100,5,0,5
Kyan,M,95,132,2597,2729
Efrem,M,100,0,1513,1513
Dwan,M,57,883,1186,2069
Centhia,F,100,14,0,14
Josephlee,M,100,0,10,10
Ellanor,F,100,248,0,248
Tenara,F,100,5,0,5
Dahntay,M,100,0,29,29
Shaymus,M,100,0,61,61
Avrielle,F,100,124,0,124
Rolande,F,100,62,0,62
Temaka,F,100,31,0,31
Justain,M,100,0,6,6
Dangel,M,61,15,23,38
Glennda,F,100,398,0,398
Eritrea,F,100,5,0,5
Martravious,M,100,0,29,29
Nira,F,100,294,0,294
Kaitrin,F,100,58,0,58
Makamae,F,100,11,0,11
Lealani,F,100,37,0,37
Jadiamond,F,100,5,0,5
Niemah,F,100,65,0,65
Jacquelyn,F,100,63007,95,63102
Lamichael,M,100,0,288,288
Sharifa,F,100,520,0,520
Keyetta,F,100,67,0,67
Laural,F,100,855,0,855
Kyeisha,F,100,231,0,231
Dioni,F,56,20,16,36
Crisinda,F,100,5,0,5
Fonzie,M,100,0,23,23
Jhanvi,F,100,108,0,108
Hersch,M,100,0,12,12
Tavaris,M,100,6,2307,2313
Roseli,F,100,13,0,13
Kilei,F,100,20,0,20
Guenther,M,100,0,5,5
Sharnita,F,100,186,0,186
Everdeen,F,100,8,0,8
Cathrine,F,100,4483,0,4483
Wandra,F,100,263,0,263
Amukta,F,100,5,0,5
Kiwon,M,100,0,5,5
Pranjal,F,56,29,23,52
Alexanra,F,100,5,0,5
Avian,M,79,260,954,1214
Javaughn,M,100,0,802,802
Brok,M,100,0,261,261
Nayel,M,100,0,34,34
Aleeta,F,100,56,0,56
Tayquan,M,100,0,251,251
Nattalie,F,100,208,0,208
Aadin,M,100,0,112,112
Tiano,M,100,0,16,16
Octavious,M,100,5,1382,1387
Clotilde,F,100,153,0,153
Reighlyn,F,100,56,0,56
Nicolle,F,100,5547,0,5547
Festus,M,100,0,62,62
Tierra,F,100,14550,70,14620
Zyyanna,F,100,6,0,6
Devance,M,100,0,5,5
Carlyann,F,100,54,0,54
Oma,F,98,713,15,728
Jozlyn,F,100,1003,0,1003
Jaterica,F,100,5,0,5
Ewing,M,100,0,193,193
Abrahem,M,100,0,41,41
Hamsini,F,100,89,0,89
Jalaysia,F,100,298,0,298
Aldous,M,100,0,52,52
Tryna,F,100,57,0,57
Arjae,M,100,0,5,5
Herik,M,100,0,17,17
Boady,M,100,0,10,10
Deiona,F,100,82,0,82
Eimmy,F,100,17,0,17
Articia,F,100,20,0,20
Maytal,F,100,150,0,150
Anterio,M,100,0,86,86
Reiny,F,100,5,0,5
Nicere,M,100,0,5,5
Seaanna,F,100,5,0,5
Seanpaul,M,100,0,260,260
Khaliya,F,100,263,0,263
Yulitza,F,100,156,0,156
Ermine,F,58,7,5,12
Taylore,F,100,666,0,666
Romond,M,100,0,66,66
Bulut,M,100,0,6,6
Pandy,F,100,14,0,14
Ailet,F,100,6,0,6
Catlin,F,70,1055,446,1501
Tremia,F,100,21,0,21
Camerion,M,100,0,17,17
Hamda,F,100,46,0,46
Stefanny,F,100,204,0,204
Zshakira,F,100,5,0,5
Jemauri,M,100,0,5,5
Celita,F,100,207,0,207
Mariaelisa,F,100,5,0,5
Jaquest,M,100,0,5,5
Tempress,F,100,18,0,18
Emmaus,M,91,5,49,54
Marquille,M,100,0,5,5
Lior,M,66,194,370,564
Daneal,M,78,6,21,27
Deriona,F,100,82,0,82
Ebubechukwu,M,100,0,63,63
Kiana,F,100,23012,19,23031
Keayon,M,100,0,5,5
Ukari,F,100,16,0,16
Jyheim,M,100,0,23,23
Jahim,M,100,0,12,12
Lowana,F,100,79,0,79
Teale,F,100,116,0,116
Access,M,100,0,6,6
Jaynette,F,100,17,0,17
Shamyla,F,100,32,0,32
Megail,M,100,0,7,7
Allea,F,100,119,0,119
Omeka,F,100,106,0,106
Medford,M,100,0,96,96
Kaydon,M,92,80,900,980
Romellow,M,100,0,10,10
Zasia,F,100,6,0,6
Daijiah,F,100,5,0,5
Dudley,M,100,6,3954,3960
Rondie,M,76,5,16,21
Ryion,M,100,0,6,6
Aimme,F,100,26,0,26
Sofiana,F,100,22,0,22
Laderian,M,100,0,6,6
Jaleny,F,100,5,0,5
Jametria,F,100,43,0,43
Layleigh,F,100,10,0,10
Jonhathan,M,100,0,5,5
Kentay,M,100,0,12,12
Serena,F,100,36293,16,36309
Anrew,M,100,0,21,21
Ledell,M,98,5,322,327
Karym,M,100,0,16,16
Wardah,F,100,42,0,42
Theda,F,100,1141,0,1141
Duretta,F,100,11,0,11
Doward,M,100,0,9,9
Yurico,F,100,45,0,45
Harl,M,100,0,109,109
Catey,F,100,18,0,18
Jerryn,M,100,0,37,37
Aniken,M,100,0,67,67
Antal,M,100,0,8,8
Mehrab,M,100,0,5,5
Xayvier,M,100,0,64,64
Jennavive,F,100,44,0,44
Keanan,M,100,0,536,536
Shelbi,F,100,5362,0,5362
Burnis,M,100,0,263,263
Vontae,M,100,0,49,49
Jikayla,F,100,5,0,5
Bouvier,M,100,0,5,5
Jatwan,M,100,0,10,10
Shardi,F,100,16,0,16
Takye,M,100,0,5,5
Dreshun,M,100,0,33,33
Kailayah,F,100,12,0,12
Wardell,M,100,0,2138,2138
Takyiah,F,100,11,0,11
Kellon,M,100,0,291,291
Khaliel,M,100,0,105,105
Neiman,M,98,5,302,307
Luciana,F,100,6885,0,6885
Seniya,F,100,138,0,138
Temarion,M,100,0,22,22
Ansal,F,100,5,0,5
Kawanda,F,100,423,0,423
Juaquin,M,100,0,1210,1210
Daniece,F,100,26,0,26
Chanai,F,100,10,0,10
Keasia,F,100,1515,0,1515
Khaelyn,F,100,6,0,6
Khrista,F,100,228,0,228
Shauna,F,100,27528,55,27583
Louanne,F,100,1195,0,1195
Torya,F,100,60,0,60
Lorain,F,100,298,0,298
Kevlin,M,100,0,5,5
Helenna,F,100,33,0,33
Nafees,M,100,0,36,36
Quintera,F,100,40,0,40
Jewelissa,F,100,30,0,30
Ahmina,F,100,13,0,13
Dreyten,M,100,0,5,5
Jenah,F,100,465,0,465
Narayana,M,77,5,17,22
Fernandeo,M,100,0,5,5
Utahna,F,100,5,0,5
Elliette,F,100,604,0,604
Telena,F,100,304,0,304
Dakarie,M,100,0,17,17
Jayten,M,100,0,70,70
Stepen,M,100,0,56,56
Cian,M,99,22,2182,2204
Kicia,F,100,12,0,12
Markieth,M,100,0,11,11
Keeghan,M,80,78,311,389
Stephanic,F,100,5,0,5
Nariman,F,100,5,0,5
Taralyn,F,100,668,0,668
Haston,M,100,0,73,73
Beaumont,M,100,0,95,95
Shioban,F,100,5,0,5
Zyleigh,F,100,19,0,19
Alisi,F,100,56,0,56
Jiahao,M,100,0,12,12
Jamias,M,100,0,28,28
Naia,F,100,1024,0,1024
Kasaundra,F,100,450,0,450
Carrie,F,100,164697,523,165220
Venellope,F,100,6,0,6
Krisinda,F,100,96,0,96
Dreydon,M,100,0,81,81
Gavyn,M,98,99,4421,4520
Ventrell,M,100,0,5,5
Tihesha,F,100,48,0,48
Yoltzin,M,51,83,87,170
Nikeem,M,100,0,5,5
Enajiah,F,100,8,0,8
Keats,M,100,0,48,48
Lilyan,F,100,2140,0,2140
Esai,M,100,0,1608,1608
Amenah,F,100,127,0,127
Nabella,F,100,11,0,11
Colina,F,100,17,0,17
Dayonte,M,100,0,5,5
Jataya,F,100,111,0,111
Kiyel,M,100,0,5,5
Se,F,67,12,6,18
Edward,M,100,2432,565895,568327
Geramie,M,100,0,17,17
Jehnna,F,100,15,0,15
Keerthana,F,100,274,0,274
Sampath,M,100,0,5,5
Camela,F,100,747,0,747
Katelinn,F,100,163,0,163
Lanessa,F,100,479,0,479
Saraiyah,F,100,66,0,66
Lynlee,F,100,843,0,843
Neilah,F,100,52,0,52
Jave,M,100,0,5,5
Adja,F,100,149,0,149
Saniaya,F,100,24,0,24
Nataliegh,F,100,5,0,5
Jakeela,F,100,10,0,10
Cece,F,100,352,0,352
Mckenzee,F,100,706,0,706
Kollier,M,100,0,5,5
Tabatha,F,100,19263,0,19263
Asil,F,50,5,5,10
Joshewa,M,100,0,10,10
Ayneka,F,100,18,0,18
Delshaun,M,100,0,46,46
Maxemiliano,M,100,0,110,110
Bambi,F,100,5109,0,5109
Chaka,F,76,841,262,1103
Quendarious,M,100,0,5,5
Ishanti,F,100,12,0,12
Konyae,M,100,0,8,8
Emiliano,M,100,0,16405,16405
Lauran,F,100,1424,0,1424
Jordeyn,F,100,7,0,7
Betzabe,F,100,158,0,158
Hiram,M,100,0,6117,6117
Merlynn,F,100,21,0,21
Joshuadaniel,M,100,0,11,11
Chat,M,100,0,5,5
Datrion,M,100,0,10,10
Zamira,F,100,614,0,614
Antorion,M,100,0,6,6
Teron,M,100,0,933,933
Aariyona,F,100,5,0,5
Gray,M,92,243,2710,2953
Ladayja,F,100,5,0,5
Tyteona,F,100,11,0,11
Dalasia,F,100,70,0,70
Towanna,F,100,708,0,708
Conlon,M,100,0,13,13
Natasja,F,100,77,0,77
Shamani,F,100,52,0,52
Tamorion,M,100,0,5,5
Rachale,F,100,33,0,33
Chandale,F,100,5,0,5
Kayo,M,97,5,153,158
Thalina,F,100,13,0,13
Karyn,F,100,13015,5,13020
Laquincy,M,100,0,134,134
Alyiah,F,100,854,0,854
Keiarra,F,100,347,0,347
Yavin,M,100,0,34,34
Kayesha,F,100,10,0,10
Kurumi,F,100,7,0,7
Takemia,F,100,5,0,5
Adaliyah,F,100,5,0,5
Roneika,F,100,5,0,5
Anais,F,99,5965,41,6006
Kera,F,100,3284,0,3284
Raena,F,100,1243,0,1243
Jennfer,F,100,128,0,128
Yaslin,F,100,405,0,405
Kaysten,M,100,0,16,16
Yevgeniy,M,100,0,6,6
Pearl,F,98,16038,270,16308
Natrina,F,100,11,0,11
Vila,F,100,25,0,25
Chantale,F,100,319,0,319
Aasiyah,F,100,359,0,359
Arriona,F,100,111,0,111
Deantony,M,100,0,5,5
Jamileth,F,100,640,0,640
Coryn,F,100,876,0,876
Sarath,M,70,20,46,66
Alexio,M,100,0,161,161
Cowana,F,100,5,0,5
Kedra,F,100,548,0,548
Caludia,F,100,16,0,16
Jayci,F,100,1405,0,1405
Gerldine,F,100,87,0,87
Andrea,F,99,402259,5397,407656
Khadeshia,F,100,13,0,13
Mung,M,100,0,34,34
Jeriko,M,100,0,82,82
Ja,M,66,136,264,400
Skylei,F,100,25,0,25
Natellie,F,100,12,0,12
Wanyae,M,100,0,10,10
Kayvion,M,100,0,226,226
Chrisine,F,100,15,0,15
Raylynn,F,99,1558,19,1577
Bevyn,F,100,23,0,23
Zantasia,F,100,6,0,6
Lynnix,F,100,33,0,33
Shantey,F,100,37,0,37
Durenda,F,100,102,0,102
Gurnaaz,F,100,5,0,5
Santini,M,100,0,9,9
Siva,M,100,0,32,32
Avaia,F,100,11,0,11
Ranen,M,100,0,102,102
Dottie,F,100,3792,0,3792
Treina,F,100,77,0,77
Aishat,F,100,48,0,48
Marlyce,F,100,145,0,145
Ancelmo,M,100,0,51,51
Serenityrose,F,100,6,0,6
Anselmo,M,100,0,1732,1732
Fellipe,M,100,0,5,5
Mckall,F,100,12,0,12
Anqunette,F,100,23,0,23
Kamarionna,F,100,5,0,5
Zedan,M,100,0,5,5
Kaoru,F,74,17,6,23
Alcia,F,100,23,0,23
Staciann,F,100,5,0,5
Chalanda,F,100,54,0,54
Kimbala,F,100,5,0,5
Wally,M,99,17,2857,2874
Dewon,M,100,0,389,389
Adelfo,M,100,0,63,63
Danyell,F,89,2500,324,2824
Nicholsa,M,100,0,6,6
Savhanna,F,100,166,0,166
Azmir,M,100,0,15,15
Torren,M,96,22,524,546
Dominyck,M,100,0,68,68
Nazya,F,100,7,0,7
Marichelle,F,100,11,0,11
Nayellie,F,100,86,0,86
Hennessy,F,96,979,39,1018
Stanly,M,100,0,475,475
Daicy,F,100,52,0,52
Hunberto,M,100,0,27,27
Shuntana,F,100,5,0,5
Haelie,F,100,75,0,75
Itohan,F,100,5,0,5
Donnika,F,100,80,0,80
Aryana,F,100,5421,0,5421
Qadir,M,100,0,313,313
Alleyna,F,100,41,0,41
Charliss,F,100,7,0,7
Laurae,F,100,10,0,10
Jolei,F,100,30,0,30
Jatory,M,100,0,15,15
Kyran,M,94,128,2028,2156
Kaisha,F,100,962,0,962
Zimora,F,100,27,0,27
Leiyana,F,100,22,0,22
Topacio,F,100,151,0,151
Romulus,M,100,0,173,173
Majesti,F,100,39,0,39
Isiaah,M,100,0,60,60
Aarin,M,60,296,443,739
Elan,M,79,678,2506,3184
Ginaya,F,100,6,0,6
Regeana,F,100,25,0,25
Leeson,M,100,0,16,16
Ho,M,100,0,129,129
Auniya,F,100,10,0,10
Arteen,M,100,0,10,10
Neona,F,100,31,0,31
Media,F,100,105,0,105
Milica,F,100,302,0,302
Micaylah,F,100,79,0,79
Cescily,F,100,6,0,6
Lawryn,F,100,42,0,42
Janille,F,100,81,0,81
Dyanira,F,100,5,0,5
Sivad,M,100,0,18,18
Machel,F,92,118,10,128
Cynne,F,100,10,0,10
Nyhiem,M,100,0,5,5
Cicilia,F,100,64,0,64
Naiely,F,100,5,0,5
Domarion,M,100,0,13,13
Ashgan,F,100,5,0,5
Alrahman,M,100,0,5,5
Akash,M,100,0,1971,1971
Karianne,F,100,986,0,986
Jaali,M,100,0,6,6
Dezmund,M,100,0,44,44
Nasiah,F,63,172,100,272
Zakhary,M,100,0,31,31
Jermine,M,100,0,372,372
Shontrice,F,100,22,0,22
Ryhana,F,100,16,0,16
Leonita,F,100,16,0,16
Kourtlyn,F,100,219,0,219
Markysha,F,100,6,0,6
Saphira,F,100,1015,0,1015
Lynnon,F,100,8,0,8
Zyonnah,F,100,12,0,12
Lynzi,F,100,533,0,533
Dimaggio,M,100,0,56,56
Brandolyn,F,100,145,0,145
Paili,F,100,5,0,5
Ayan,M,72,554,1411,1965
Dontaz,M,100,0,6,6
Carrolyn,F,100,91,0,91
Payge,F,100,1041,0,1041
Stephen,M,100,2489,692700,695189
Samyuktha,F,100,148,0,148
Porchea,F,100,116,0,116
Kiandre,M,100,0,235,235
Dahliah,F,100,10,0,10
Daisymarie,F,100,5,0,5
Nyderah,F,100,5,0,5
Kalisee,F,100,5,0,5
Narith,M,100,0,11,11
Jsiah,M,100,0,50,50
Keichia,F,100,5,0,5
Zoiey,F,100,60,0,60
Comfort,F,100,196,0,196
Lafran,F,100,5,0,5
Irean,F,100,44,0,44
Janki,F,100,254,0,254
Marcelin,M,100,0,5,5
Ravonne,F,100,5,0,5
Mayen,M,100,0,15,15
Mieya,F,100,5,0,5
Shaquay,F,100,55,0,55
Anup,M,100,0,190,190
Savian,M,100,0,290,290
Ayako,F,100,119,0,119
Bethanee,F,100,188,0,188
Kivan,M,100,0,6,6
Hollymarie,F,100,5,0,5
Nalen,M,100,0,26,26
Rishima,F,100,6,0,6
Ernie,M,99,82,10401,10483
Quamere,M,100,0,103,103
Rudolph,M,100,23,15910,15933
Merisha,F,100,34,0,34
Apryle,F,100,131,0,131
Tawne,F,100,5,0,5
Nghi,F,81,22,5,27
Kadarian,M,100,0,22,22
Angellynn,F,100,60,0,60
Enga,F,100,24,0,24
Chayan,M,84,5,27,32
Anaee,F,100,6,0,6
Pilar,F,91,4208,409,4617
Addelynne,F,100,23,0,23
Madox,M,100,0,256,256
Pemberley,F,100,22,0,22
Pruitt,M,100,0,16,16
Rennis,M,100,0,5,5
Ayo,M,56,68,86,154
Tatiania,F,100,17,0,17
Harveer,M,100,0,27,27
Kimmberly,F,100,77,0,77
Salamata,F,100,5,0,5
Awad,M,100,0,104,104
Shyheim,M,100,0,869,869
Robbye,F,100,207,0,207
Jazmeen,F,100,152,0,152
Faelan,M,100,0,15,15
Cheyene,F,97,720,22,742
Tynijah,F,100,6,0,6
Jessican,F,100,5,0,5
Ariyanah,F,100,175,0,175
Carylon,F,100,365,0,365
Barbora,F,100,5,0,5
Jahnna,F,100,25,0,25
Lycinda,F,100,5,0,5
Cedrick,M,100,10,5867,5877
Zaisha,F,100,6,0,6
Daemon,M,100,0,1030,1030
Jefery,M,100,0,52,52
Annalease,F,100,10,0,10
Guendi,F,100,12,0,12
Lillyjo,F,100,5,0,5
Devontez,M,100,0,39,39
Trad,M,100,0,31,31
Maryette,F,100,16,0,16
Catarino,M,100,0,881,881
Parth,M,100,0,1727,1727
Dahmari,M,100,0,11,11
Izabela,F,100,1272,0,1272
Heyward,M,100,0,750,750
Kenyjah,F,100,5,0,5
Chantice,F,100,22,0,22
Jailen,M,81,275,1156,1431
Geordon,M,100,0,44,44
Haileymarie,F,100,26,0,26
Jazziah,F,100,6,0,6
Cariel,F,100,12,0,12
Norrah,F,100,5,0,5
Tamekka,F,100,60,0,60
Serigo,M,100,0,39,39
Chavelle,F,100,23,0,23
Kairy,F,95,107,6,113
Errion,M,100,0,7,7
Raen,F,100,6,0,6
Gursimran,F,77,20,6,26
Anarie,F,100,57,0,57
Tyjah,F,75,174,58,232
Jeylani,M,55,5,6,11
Kimmi,F,100,220,0,220
Steely,F,84,27,5,32
Jakier,M,100,0,6,6
Skyra,F,100,65,0,65
Corvus,M,100,0,11,11
Resean,M,100,0,62,62
Esain,M,100,0,5,5
Viany,F,100,27,0,27
Evdoxia,F,100,5,0,5
Wareesha,F,100,32,0,32
Chivon,F,100,207,0,207
Tammey,F,100,778,0,778
Forde,M,100,0,5,5
Zelinda,F,100,47,0,47
Selest,F,100,29,0,29
Gelila,F,100,182,0,182
Risako,F,100,31,0,31
Mccormick,M,100,0,57,57
Carrianna,F,100,15,0,15
Leabella,F,100,18,0,18
Macrina,F,100,133,0,133
Trasean,M,100,0,67,67
Turiya,F,100,13,0,13
Ardi,M,100,0,51,51
Falena,F,100,16,0,16
Aaliyaha,F,100,21,0,21
Angeleah,F,100,443,0,443
Cordaryl,M,100,0,176,176
Karsan,M,100,0,11,11
Mijoi,F,100,5,0,5
Wynston,M,100,0,282,282
Zui,M,100,0,6,6
Joreen,F,100,41,0,41
Ritika,F,100,503,0,503
Shahil,M,100,0,74,74
Damar,M,99,5,947,952
Abhinaya,F,100,5,0,5
Krishana,F,100,162,0,162
Miryea,F,100,6,0,6
Erina,F,100,758,0,758
Riniya,F,100,11,0,11
Latassha,F,100,5,0,5
Keyara,F,100,1589,0,1589
Analice,F,100,15,0,15
Grayling,M,100,0,528,528
Katera,F,100,551,0,551
Geriyah,F,100,23,0,23
Xang,M,100,0,24,24
Karlis,M,100,0,72,72
Sudiksha,F,100,90,0,90
Sriya,F,100,440,0,440
Gearl,M,89,5,39,44
Victor,M,99,1314,225722,227036
Chipper,M,100,0,276,276
Shanata,F,100,6,0,6
Helin,F,100,37,0,37
Tilia,F,100,60,0,60
Koleigh,F,100,5,0,5
Abdiqani,M,100,0,20,20
Beyan,M,100,0,6,6
Damaj,M,100,0,10,10
Kalionna,F,100,5,0,5
Kailub,M,100,0,22,22
Orel,M,97,6,167,173
Lionso,M,100,0,11,11
Jaxi,F,100,27,0,27
Aizik,M,100,0,210,210
Vere,M,100,0,5,5
Palmira,F,100,437,0,437
Jori,F,93,1856,137,1993
Saanjh,F,100,5,0,5
Khallid,M,100,0,87,87
Senteria,F,100,5,0,5
Kimla,F,100,154,0,154
Lucian,M,100,22,5690,5712
Amoreena,F,100,153,0,153
Jamina,F,100,156,0,156
Lacher,F,100,11,0,11
Timberlyn,F,100,85,0,85
Upton,M,100,0,20,20
Sharann,F,100,6,0,6
Jakobie,M,100,0,411,411
Aspasia,F,100,142,0,142
Ronnay,F,100,5,0,5
Lakayden,M,100,0,5,5
Daquin,M,100,0,21,21
Danzelle,M,100,0,13,13
Bailea,F,100,215,0,215
Kendric,M,100,0,2007,2007
Crystelle,F,100,77,0,77
Jakylia,F,100,5,0,5
Jaland,M,100,0,24,24
Chivonne,F,100,130,0,130
Ezias,M,100,0,13,13
Taiz,F,100,98,0,98
Tymire,M,100,0,43,43
Kaydree,F,100,16,0,16
Kamini,F,100,27,0,27
Tzivy,F,100,10,0,10
Jennalyse,F,100,5,0,5
Jarrek,M,100,0,5,5
Gillan,F,100,5,0,5
Marleyann,F,100,11,0,11
Lace,F,98,387,6,393
Larissa,F,100,21780,0,21780
Roseann,F,100,9960,0,9960
Shaasia,F,100,116,0,116
Ninos,M,100,0,28,28
Tralena,F,100,10,0,10
Braina,F,100,10,0,10
Nahayla,F,100,10,0,10
Unice,F,95,95,5,100
Breonnah,F,100,6,0,6
Elbonie,F,100,5,0,5
Livianna,F,100,48,0,48
Tranyah,F,100,5,0,5
Jaxstin,M,100,0,12,12
Engelberto,M,100,0,5,5
Ulyesses,M,100,0,16,16
Shahzad,M,100,0,80,80
Vibhav,M,100,0,136,136
Takeysha,F,100,123,0,123
Srinithya,F,100,5,0,5
Akeyra,F,100,5,0,5
Marriana,F,100,65,0,65
Raelynne,F,100,321,0,321
Jenaia,F,100,5,0,5
Mariby,F,100,11,0,11
Jearlene,F,100,31,0,31
Shonn,M,98,5,242,247
Takeila,F,100,63,0,63
Branden,M,99,330,26554,26884
Tonua,F,100,10,0,10
Kariyana,F,100,5,0,5
Tavious,M,100,0,143,143
Jaklynn,F,100,29,0,29
Chenese,F,100,10,0,10
Yurisa,F,100,10,0,10
Diop,M,100,0,6,6
Brianna,F,100,241165,412,241577
Damariona,F,100,12,0,12
Krya,F,100,5,0,5
Dannilynn,F,100,43,0,43
Zakiah,F,75,322,108,430
Craig,M,100,941,274181,275122
Dorraine,F,100,230,0,230
Kidd,M,100,0,12,12
Lamees,F,100,320,0,320
Aj,M,99,17,1630,1647
Macaire,F,50,5,5,10
Petra,F,100,6839,10,6849
Addelyn,F,100,1129,0,1129
Shermeka,F,100,139,0,139
Kimyah,F,100,90,0,90
Kallon,M,100,0,48,48
Lathan,M,100,0,2878,2878
Varinia,F,100,18,0,18
Tinea,F,100,60,0,60
Shatema,F,100,34,0,34
Aniayah,F,100,138,0,138
Shondel,F,50,24,24,48
Neeko,M,100,0,231,231
Ormond,M,100,0,82,82
Myair,F,100,5,0,5
Sheneeka,F,100,37,0,37
Syrenity,F,100,170,0,170
Bansari,F,100,17,0,17
Annyah,F,100,24,0,24
Lania,F,100,812,0,812
Yashas,M,100,0,86,86
Kiyora,F,100,6,0,6
Zorya,F,100,5,0,5
Latesa,F,100,181,0,181
Kylee,F,99,43198,422,43620
Czaria,F,100,15,0,15
Cecellia,F,100,10,0,10
Melvin,M,99,832,96947,97779
Jovane,M,100,0,74,74
Kuran,M,100,0,27,27
Donshay,M,70,28,64,92
Dameshia,F,100,58,0,58
Katriana,F,100,203,0,203
Chaiya,F,100,5,0,5
Azlin,F,100,73,0,73
Beta,F,100,11,0,11
Sheliyah,F,100,10,0,10
Xariyah,F,100,26,0,26
Micalah,F,100,135,0,135
Vaeda,F,100,145,0,145
Huda,F,100,1166,0,1166
Mya,F,100,47380,54,47434
Christiano,M,100,0,522,522
Twanette,F,100,31,0,31
Kristyanne,F,100,5,0,5
Elenna,F,100,154,0,154
Alekai,M,100,0,22,22
Filippos,M,100,0,6,6
Callan,M,69,1001,2250,3251
Teslyn,F,100,29,0,29
Shekema,F,100,30,0,30
Coleden,M,100,0,12,12
Yahir,M,99,50,9152,9202
Meikah,F,100,12,0,12
Simrin,F,100,91,0,91
Naliya,F,100,106,0,106
Geoffery,M,100,0,1485,1485
Sekena,F,100,6,0,6
Reola,F,100,105,0,105
Afsheen,F,85,82,15,97
Ikram,F,97,229,6,235
Garic,M,100,0,10,10
Raiyana,F,100,5,0,5
Marquala,F,100,11,0,11
Martika,F,100,1077,0,1077
Gracianne,F,100,10,0,10
Kheyla,F,100,5,0,5
Tashara,F,100,1147,0,1147
Chassady,F,100,10,0,10
Tyun,M,100,0,7,7
Toika,F,100,12,0,12
Azareah,F,100,5,0,5
Pareesa,F,100,11,0,11
Freda,F,100,9819,0,9819
Alfa,F,91,53,5,58
Shalece,F,100,79,0,79
Keontaye,M,100,0,30,30
Shavetta,F,100,30,0,30
Roma,F,95,2196,116,2312
Jeilany,F,100,15,0,15
Ngawang,M,74,8,23,31
Bun,M,100,0,10,10
Damarr,M,100,0,41,41
Olachi,F,100,13,0,13
Demere,M,100,0,71,71
Stana,F,100,117,0,117
Shawta,F,100,42,0,42
Breena,F,100,802,0,802
Raihan,M,100,0,155,155
Keren,F,100,3600,0,3600
Philly,M,100,0,5,5
Nawal,F,100,883,0,883
Ladan,F,100,177,0,177
Kiyoko,F,100,115,0,115
Jahiel,M,100,0,6,6
Aryaa,F,100,62,0,62
Chrysten,F,100,62,0,62
Katia,F,100,5172,0,5172
Llandel,M,100,0,7,7
Tamaira,F,100,272,0,272
Ellia,F,100,702,0,702
Krishuna,F,100,7,0,7
Kelyn,F,60,384,256,640
Vasiliy,M,100,0,67,67
Jaleil,M,100,0,70,70
Stillman,M,100,0,41,41
Edrik,M,100,0,59,59
Tyquil,M,100,0,17,17
Ashilee,F,100,5,0,5
Christenia,F,100,5,0,5
Coralia,F,100,41,0,41
Teaya,F,100,47,0,47
Teani,F,100,17,0,17
Monesha,F,100,420,0,420
Vachan,M,100,0,5,5
Stellamae,F,100,13,0,13
Khaalid,M,100,0,111,111
Ivandejesus,M,100,0,5,5
Carlosdaniel,M,100,0,84,84
Davionn,M,100,0,20,20
Deylon,M,100,0,18,18
Tyquawn,M,100,0,17,17
Pharon,M,55,5,6,11
Kamaliyah,F,100,6,0,6
Carsan,M,100,0,11,11
Pernetta,F,100,5,0,5
Hedaya,F,100,46,0,46
Shannya,F,100,5,0,5
Camil,F,64,86,48,134
Euriah,M,90,5,47,52
Conley,M,89,219,1718,1937
Amoria,F,100,93,0,93
Lafonya,F,100,10,0,10
Deondric,M,100,0,10,10
Alyessa,F,100,5,0,5
Roseline,F,100,502,0,502
Tasharia,F,100,34,0,34
Ladestiny,F,100,32,0,32
Raquelle,F,100,752,0,752
Bodean,M,100,0,10,10
Kellan,M,94,429,6451,6880
Shubhi,F,100,11,0,11
Daysia,F,100,684,0,684
Ganesa,F,100,16,0,16
Aivan,M,93,5,63,68
Eiyanna,F,100,5,0,5
Latira,F,100,16,0,16
Kinzington,F,100,6,0,6
Ranson,M,100,0,221,221
Vevelyn,F,100,29,0,29
Trivian,F,100,5,0,5
Jolly,M,64,44,77,121
Cainen,M,100,0,249,249
Sylina,F,100,174,0,174
Shoshana,F,100,4276,0,4276
Aneyda,F,100,5,0,5
Annamay,F,100,82,0,82
Charina,F,100,110,0,110
Dessarae,F,100,19,0,19
Zayli,F,100,88,0,88
Rashad,M,99,85,14508,14593
Jennice,F,100,299,0,299
Deziree,F,100,1330,0,1330
Yhair,M,100,0,50,50
Blondell,F,100,396,0,396
Michaeljohn,M,100,0,235,235
Shakeer,M,100,0,24,24
Devien,M,100,0,17,17
Jaleo,M,100,0,18,18
Tysheana,F,100,5,0,5
Ayad,M,100,0,42,42
Autin,M,100,0,11,11
Suad,F,98,205,5,210
Delecia,F,100,336,0,336
Keshona,F,100,117,0,117
Toshiko,F,100,57,0,57
Ozzy,M,100,0,1118,1118
Javir,M,100,0,11,11
Nylia,F,100,189,0,189
Territa,F,100,25,0,25
Dontay,M,100,0,2200,2200
Julitza,F,100,176,0,176
Keirsten,F,100,1330,0,1330
Olliyah,F,100,10,0,10
Raenah,F,100,55,0,55
Jenn,F,100,23,0,23
Nalo,F,100,12,0,12
Rayonna,F,100,843,0,843
Kaylean,F,100,87,0,87
Deola,F,100,30,0,30
Dannell,F,62,234,142,376
Dvonta,M,100,0,48,48
Pypper,F,100,5,0,5
Aracelys,F,100,82,0,82
Yesli,F,100,150,0,150
Jawuan,M,100,0,661,661
Ralik,M,100,0,42,42
Benjamin,M,100,2089,608558,610647
Nixen,M,100,0,24,24
Pratima,F,100,10,0,10
Deanne,F,100,12546,5,12551
Cyd,F,100,522,0,522
Melanieann,F,100,10,0,10
Belkys,F,100,112,0,112
Katoria,F,100,178,0,178
Fae,F,100,413,0,413
Kailynn,F,100,3253,0,3253
Jalesha,F,100,137,0,137
Aileana,F,100,30,0,30
Nola,F,100,7642,0,7642
Sowmya,F,100,80,0,80
Hayz,M,100,0,5,5
Havier,M,100,0,68,68
Alaza,F,100,21,0,21
Kaelynn,F,100,3318,0,3318
Vernette,F,100,541,0,541
Dawnyel,F,100,56,0,56
Kemal,M,100,0,257,257
Arismendy,M,100,0,5,5
Lachlann,M,100,0,6,6
Abubakr,M,100,0,254,254
Stefan,M,100,42,17805,17847
Liddie,F,100,94,0,94
Iyanna,F,100,4046,0,4046
Arwilda,F,100,5,0,5
Avona,F,100,29,0,29
Demmi,F,100,41,0,41
Robertocarlos,M,100,0,30,30
Jashaun,M,100,0,1099,1099
Kamar,M,98,19,1200,1219
Eriverto,M,100,0,61,61
Kashana,F,100,172,0,172
Syvannah,F,100,46,0,46
Lucais,M,100,0,5,5
Ademir,M,100,0,23,23
Kregg,M,100,0,388,388
Kersten,F,100,913,0,913
Brelin,M,100,0,34,34
Chloye,F,100,21,0,21
Delianys,F,100,5,0,5
Jawun,M,100,0,48,48
Tanise,F,100,79,0,79
Harel,M,100,0,124,124
Elijiah,M,100,0,943,943
Shamiqua,F,100,39,0,39
Noelie,F,100,43,0,43
Piilani,F,100,5,0,5
Asela,F,100,5,0,5
Somil,M,100,0,5,5
Jossalynn,F,100,57,0,57
Kaiona,F,100,15,0,15
Nomar,M,100,0,442,442
Tishara,F,100,176,0,176
Masiyah,F,75,137,46,183
Synclair,F,100,12,0,12
Taizha,F,100,5,0,5
Althea,F,100,7935,0,7935
Dontrae,M,100,0,116,116
Khailey,F,100,33,0,33
Duron,M,100,0,562,562
Tavarus,M,100,0,933,933
Chaya,F,100,10609,10,10619
Kyneisha,F,100,5,0,5
Kirti,F,100,69,0,69
Heathermarie,F,100,17,0,17
Ermin,M,100,0,86,86
Kaizlee,F,100,57,0,57
Zyriel,F,100,10,0,10
Jorjia,F,100,40,0,40
Dade,M,100,0,810,810
Adolfo,M,100,10,12527,12537
Chandini,F,100,34,0,34
Ranarda,F,100,13,0,13
Rahmon,M,100,0,63,63
Dawniel,F,100,33,0,33
Gala,F,100,1338,0,1338
Latrinda,F,100,46,0,46
Pearlette,F,100,17,0,17
Jaimya,F,100,67,0,67
Diamontae,M,100,0,23,23
Daivyon,M,100,0,5,5
Kweku,M,100,0,69,69
Liel,F,89,196,24,220
Florrie,F,100,143,0,143
Monteze,M,100,0,16,16
Kathyleen,F,100,313,0,313
Devaya,F,100,12,0,12
Roberts,M,100,0,154,154
Yarecsi,F,100,5,0,5
Lucien,M,100,5,3738,3743
Shamiko,F,100,11,0,11
Ikisha,F,100,37,0,37
Vivyanna,F,100,11,0,11
Yazhini,F,100,17,0,17
Jeilin,F,100,53,0,53
Chatia,F,100,19,0,19
Frankly,M,100,0,5,5
Pippin,F,100,12,0,12
Sevin,M,79,65,247,312
Rashael,F,100,10,0,10
Wintana,F,100,10,0,10
Dasmond,M,100,0,39,39
Pharaoh,M,100,0,494,494
Katheryn,F,100,9126,0,9126
Charletta,F,100,959,0,959
Jurrien,M,100,0,20,20
Ices,F,100,26,0,26
Josh,M,100,0,13952,13952
Teven,M,100,0,275,275
Adelino,M,100,0,5,5
Ginamarie,F,100,1070,0,1070
Bevis,M,100,0,6,6
Mariangelis,F,100,6,0,6
Karleena,F,100,26,0,26
Destynie,F,100,284,0,284
Saral,M,100,0,7,7
Paigelynn,F,100,10,0,10
Rheba,F,100,160,0,160
Emagine,F,100,7,0,7
Mamie,F,100,7297,0,7297
Dreyvin,M,100,0,5,5
Derez,M,100,0,13,13
Latyra,F,100,215,0,215
Loreatha,F,100,37,0,37
Brecken,M,77,607,2073,2680
Kwadwo,M,100,0,203,203
Alayzia,F,100,266,0,266
Virgilia,F,100,44,0,44
Koren,F,88,1514,212,1726
Chrisanne,F,100,280,0,280
Antonyo,M,100,0,627,627
Cailtin,F,100,5,0,5
Tymere,M,100,0,414,414
Fidelmar,M,100,0,10,10
Khyir,M,100,0,19,19
Korina,F,100,2371,0,2371
Aliiyah,F,100,8,0,8
Tamantha,F,100,143,0,143
Dakai,M,100,0,49,49
Tykirah,F,100,5,0,5
Eliyah,F,64,706,397,1103
Azari,F,69,342,151,493
Ketch,M,100,0,21,21
Simayah,F,100,7,0,7
Tyreka,F,100,180,0,180
Kadey,F,100,130,0,130
Rahmel,M,100,0,617,617
Kadarrius,M,100,0,155,155
Carine,F,100,522,0,522
Enith,F,100,11,0,11
Tadrian,M,100,0,6,6
Kohlston,M,100,0,5,5
Niamiah,F,100,29,0,29
Laruen,F,100,156,0,156
Klynn,F,100,494,0,494
Anabelli,F,100,5,0,5
Ketherine,F,100,5,0,5
Anelise,F,100,403,0,403
Un,F,50,7,7,14
Zuria,F,100,245,0,245
Dacie,F,100,130,0,130
Demetrice,F,52,1749,1590,3339
Kripa,F,100,92,0,92
Myamarie,F,100,5,0,5
Ether,F,91,60,6,66
Nytasha,F,100,34,0,34
Majestic,F,68,207,99,306
Clayden,M,100,0,49,49
Analeesa,F,100,16,0,16
Bibianna,F,100,44,0,44
Adayshia,F,100,19,0,19
Danalee,F,100,71,0,71
Staley,M,59,74,107,181
Kaylae,F,100,6,0,6
Keaundrea,F,100,6,0,6
Barron,M,100,0,3552,3552
Tamorah,F,100,80,0,80
Syesha,F,100,63,0,63
Eulis,M,100,0,62,62
Keliah,F,100,120,0,120
Khadir,M,100,0,131,131
Felica,F,100,2086,0,2086
Aliegha,F,100,85,0,85
Rekker,M,100,0,7,7
Quadair,M,100,0,12,12
Katherleen,F,100,35,0,35
Tikayla,F,100,11,0,11
Syvella,F,100,6,0,6
Quamya,F,100,5,0,5
Twaina,F,100,13,0,13
Yaretsy,F,100,40,0,40
Nailani,F,100,72,0,72
Brae,F,60,153,101,254
Larken,F,100,57,0,57
Essined,F,100,5,0,5
Shaunteria,F,100,8,0,8
Anaise,F,100,277,0,277
Bretley,M,100,0,29,29
Dawnetta,F,100,302,0,302
Kaeshon,M,100,0,5,5
Cashanti,F,100,7,0,7
Nyah,F,100,4099,5,4104
Alin,F,75,359,119,478
Lelia,F,100,3245,0,3245
Prisicilla,F,100,7,0,7
Torsha,F,100,134,0,134
Yadid,M,100,0,12,12
Malvina,F,100,210,0,210
Brinnly,F,100,5,0,5
Arlandis,M,100,0,12,12
Fawzia,F,100,6,0,6
Arshawn,M,100,0,88,88
Primo,M,100,0,340,340
Shaquaya,F,100,96,0,96
Myleigh,F,100,843,0,843
Jawaski,M,100,0,5,5
Chandler,M,80,7330,30067,37397
Jovette,F,100,10,0,10
Avanthi,F,100,5,0,5
Annaliisa,F,100,5,0,5
Mckenna,F,99,32270,183,32453
Raevyn,F,100,486,0,486
Shontaye,F,100,35,0,35
Posy,F,100,11,0,11
Esaie,M,100,0,5,5
Estephani,F,100,174,0,174
Juliarose,F,100,23,0,23
Ryeleigh,F,100,77,0,77
Shondale,M,85,14,77,91
Jillean,F,100,47,0,47
Ricquan,M,100,0,24,24
Lolanda,F,100,30,0,30
Derelle,M,100,0,80,80
Jonatan,M,100,0,3181,3181
Cheisa,F,100,10,0,10
Ballard,M,100,0,241,241
Bobbette,F,100,451,0,451
Chirstopher,M,100,0,1051,1051
Shelon,F,100,20,0,20
Aslin,F,100,135,0,135
Brandelyn,F,100,177,0,177
Pearla,F,100,389,0,389
Ranulfo,M,100,0,99,99
Abubacar,M,100,0,14,14
Laterese,F,100,6,0,6
Jaciyah,F,100,16,0,16
Heri,M,100,0,39,39
Vedat,M,100,0,6,6
Tausha,F,100,1369,0,1369
Jannett,F,100,758,0,758
Corraine,F,100,5,0,5
Jaivyn,M,100,0,131,131
Davohn,M,100,0,6,6
Asan,M,100,0,26,26
Zahniyah,F,100,39,0,39
Celenne,F,100,5,0,5
Ronson,M,100,0,334,334
Dekara,F,100,10,0,10
Boykin,M,100,0,10,10
Damani,M,81,449,1884,2333
Sagan,M,56,257,331,588
Lamariya,F,100,21,0,21
Sydelle,F,100,79,0,79
Malakei,M,100,0,5,5
Jassim,M,100,0,16,16
Tayveon,M,100,0,452,452
Kevina,F,100,420,0,420
Malcohm,M,100,0,5,5
Jency,F,95,177,10,187
Elsie,F,100,18116,16,18132
Bachir,M,100,0,17,17
Kaleila,F,100,7,0,7
Deslyn,F,100,89,0,89
Shayenne,F,100,19,0,19
Ruford,M,100,0,5,5
Menachemmendel,M,100,0,6,6
Aareona,F,100,7,0,7
Tao,M,97,10,282,292
Jemere,M,100,0,32,32
Dashaun,M,99,32,2612,2644
Ryana,F,100,281,0,281
Chanceton,M,100,0,16,16
Zymir,M,100,0,558,558
Jochebed,F,100,58,0,58
Jessely,F,100,10,0,10
Trayana,F,100,45,0,45
Avyaan,M,100,0,44,44
Zepplin,M,100,0,23,23
Takashia,F,100,5,0,5
Ahmaya,F,100,158,0,158
Deonate,M,100,0,17,17
Rachyl,F,100,191,0,191
Jullisa,F,100,137,0,137
Tahriq,M,100,0,5,5
Dedriana,F,100,5,0,5
Jamiyl,M,100,0,23,23
Namia,F,100,19,0,19
Maziah,F,64,84,47,131
Kamdon,M,100,0,317,317
Suree,F,100,5,0,5
Evellyn,F,100,100,0,100
Trasia,F,100,5,0,5
Yenci,F,100,5,0,5
Kaysee,F,100,346,0,346
Amna,F,100,1146,0,1146
Nev,F,100,11,0,11
Texie,F,100,19,0,19
Teaonna,F,100,14,0,14
Jazlynn,F,100,5122,0,5122
Jennisa,F,100,15,0,15
Jumah,M,100,0,6,6
Jarred,M,100,8,12982,12990
Hadija,F,100,15,0,15
Nikeesha,F,100,17,0,17
Shaelin,F,100,287,0,287
Alver,M,100,0,5,5
Jaima,F,100,204,0,204
Joretha,F,100,25,0,25
Aarush,M,100,0,1483,1483
Akwasi,M,100,0,30,30
Santerria,F,100,6,0,6
Shakilah,F,100,30,0,30
Kleber,M,100,0,113,113
Maceon,M,100,0,5,5
Khadijia,F,100,8,0,8
Cheltzie,F,100,15,0,15
Tuvya,M,100,0,5,5
Bravlio,M,100,0,134,134
Chuckie,M,100,0,610,610
Tikeya,F,100,43,0,43
Breayna,F,100,5,0,5
Najelly,F,100,5,0,5
Jahzair,M,100,0,5,5
Jaurice,M,100,0,34,34
Atley,M,51,298,316,614
Shauntavia,F,100,148,0,148
Sade,F,99,9124,86,9210
Lauralei,F,100,77,0,77
Dawnyelle,F,100,24,0,24
Arton,M,100,0,6,6
Tanyell,F,100,48,0,48
Chasya,F,100,74,0,74
Yanelie,F,100,66,0,66
Zayliana,F,100,16,0,16
Eastan,M,100,0,31,31
Yuren,M,100,0,57,57
Fernado,M,100,0,145,145
Lemonica,F,100,5,0,5
Chiemi,F,100,5,0,5
Kes,F,100,33,0,33
Shamikia,F,100,59,0,59
Emalynne,F,100,6,0,6
Nitalia,F,100,15,0,15
Hollin,F,100,45,0,45
Kisher,F,100,5,0,5
Arseniy,M,100,0,56,56
Sritan,M,100,0,5,5
Dagoberto,M,100,0,1612,1612
Mckinley,F,60,6606,4427,11033
Yanitzi,F,100,5,0,5
Leny,M,72,22,57,79
Treesa,F,100,63,0,63
Merridee,F,100,10,0,10
Catara,F,100,23,0,23
Ezekeal,M,100,0,5,5
Kruz,M,98,22,904,926
Sharelle,F,100,737,0,737
Duann,F,100,5,0,5
Nareli,F,100,5,0,5
Raelen,F,100,26,0,26
Alisande,F,100,36,0,36
Amiia,F,100,5,0,5
Sharod,M,100,0,1205,1205
Clark,M,100,102,26361,26463
Tanesha,F,100,5306,0,5306
Rexx,M,100,0,15,15
Simia,F,100,5,0,5
Jarrius,M,100,0,165,165
Kaliq,M,100,0,163,163
Vaelyn,F,100,18,0,18
Gannicus,M,100,0,5,5
Shenea,F,100,147,0,147
Florentino,M,100,0,1927,1927
Malynn,F,100,179,0,179
Nanelle,F,100,5,0,5
Renleigh,F,100,6,0,6
Ardeen,F,100,6,0,6
Emilio,M,100,57,30247,30304
Yanet,F,100,1982,0,1982
Abdihakim,M,100,0,24,24
Shayah,F,100,6,0,6
Yanise,F,100,31,0,31
Alasia,F,100,1368,0,1368
Dezra,F,100,62,0,62
Sharlynn,F,100,139,0,139
Labelle,F,100,11,0,11
Samajae,M,100,0,10,10
Kolvin,M,100,0,23,23
Kyandre,M,100,0,61,61
Hitomi,F,100,107,0,107
Shawntia,F,100,305,0,305
Nykiah,F,100,73,0,73
Ayren,M,90,5,44,49
Mykolas,M,100,0,14,14
Myaira,F,100,10,0,10
Demarrea,M,100,0,11,11
Ronekia,F,100,5,0,5
Nixaliz,F,100,10,0,10
Darshana,F,100,63,0,63
Nitesh,M,100,0,50,50
Jahmauri,M,100,0,16,16
Robann,F,100,7,0,7
Lolah,F,100,121,0,121
Dejhanae,F,100,5,0,5
Larrissa,F,100,343,0,343
Latrevia,F,100,11,0,11
Tila,F,100,419,0,419
Kemarian,M,100,0,23,23
Sibil,F,100,5,0,5
Rhakeem,M,100,0,26,26
Claxton,M,100,0,59,59
Tanvir,M,97,7,230,237
Gianmarco,M,100,0,624,624
Lariel,F,100,10,0,10
Eunji,F,100,5,0,5
Horizon,F,100,33,0,33
Aragorn,M,100,0,43,43
Tykeia,F,100,38,0,38
Cedrika,F,100,28,0,28
Britleigh,F,100,13,0,13
Sevaughn,M,100,0,17,17
Ethelrene,F,100,5,0,5
Saddie,F,100,262,0,262
Eyanna,F,100,175,0,175
Yashua,M,100,0,232,232
Chryel,F,100,22,0,22
Parvati,F,100,12,0,12
Rohnan,M,100,0,31,31
Zayliah,F,100,12,0,12
Jyanna,F,100,29,0,29
Kassandrea,F,100,5,0,5
Tano,M,100,0,15,15
Ymani,F,100,257,0,257
Sharnequa,F,100,6,0,6
Driyah,F,100,5,0,5
Lacory,M,100,0,20,20
Sanniah,F,100,8,0,8
Nermin,M,73,12,32,44
Daniels,M,100,0,27,27
Iiyana,F,100,5,0,5
Jamas,M,100,0,136,136
Caseton,M,100,0,12,12
Pluma,F,100,5,0,5
Cezar,M,100,0,623,623
Romeo,M,100,0,12835,12835
Jamir,M,100,20,4383,4403
Calek,M,100,0,6,6
Cerridwen,F,100,7,0,7
Magdelena,F,100,300,0,300
Dannyelle,F,100,55,0,55
Patrinia,F,100,19,0,19
Coulten,M,100,0,5,5
Jupiter,M,89,11,91,102
Magan,F,100,2739,0,2739
Diogo,M,100,0,368,368
Bettsy,F,100,19,0,19
Theoren,M,100,0,80,80
Kaiah,F,100,403,0,403
Clarion,F,100,10,0,10
Tuesdae,F,100,25,0,25
Onyah,F,100,10,0,10
Chinh,M,100,0,19,19
Guillermina,F,100,1543,0,1543
Jadlynn,F,100,5,0,5
Cheri,F,100,32719,12,32731
Atavia,F,100,219,0,219
Zayla,F,100,1240,0,1240
Tekenya,F,100,5,0,5
Friday,F,100,23,0,23
Dayzie,F,100,20,0,20
Dezden,M,100,0,5,5
Jaceion,M,100,0,92,92
Banelly,F,100,26,0,26
Lief,M,100,0,247,247
Kalani,F,60,2622,1744,4366
Jesssica,F,100,7,0,7
Jisell,F,100,99,0,99
Abbiegayle,F,100,18,0,18
Tyreona,F,100,63,0,63
Jash,M,100,0,109,109
Emiyah,F,100,314,0,314
Ellary,F,100,179,0,179
Loah,F,100,6,0,6
Gracey,F,100,2107,0,2107
Swanson,M,100,0,11,11
Amitai,M,100,0,103,103
Aadrian,M,100,0,5,5
Rosena,F,100,351,0,351
Teighan,F,92,57,5,62
Veasna,M,100,0,146,146
Knicole,F,100,5,0,5
Adnan,M,100,0,1946,1946
Aulbrey,F,100,13,0,13
Kevinjohn,M,100,0,6,6
Lileigh,F,100,172,0,172
Allona,F,100,149,0,149
Alessand,M,100,0,5,5
Seandra,F,100,59,0,59
Elysse,F,100,654,0,654
Angelisa,F,100,707,0,707
Tynlee,F,100,204,0,204
Demontrey,M,100,0,25,25
Virgilio,M,100,0,1166,1166
Aluel,F,100,41,0,41
Xzavyer,M,100,0,34,34
Aydeen,M,100,0,44,44
Zaryk,M,100,0,5,5
Racy,F,100,6,0,6
Iryna,F,100,7,0,7
Dwyer,M,100,0,5,5
Clarinda,F,100,725,0,725
Abbagale,F,100,134,0,134
Mauriah,F,100,133,0,133
Zaequan,M,100,0,34,34
Emiry,F,100,5,0,5
Daylani,F,100,38,0,38
Loleta,F,100,395,0,395
Maneesha,F,100,5,0,5
Milasia,F,100,11,0,11
Dovion,F,100,6,0,6
Cortlin,M,100,0,125,125
Jamirah,F,100,532,0,532
Sherunda,F,100,5,0,5
Leza,F,100,304,0,304
Isamel,M,100,0,6,6
Laramie,M,57,725,947,1672
Liran,M,100,0,28,28
Kimi,F,95,1570,87,1657
Jaikub,M,100,0,5,5
Tashelle,F,100,43,0,43
Kyla,F,100,36208,29,36237
Sameika,F,100,5,0,5
Antohny,M,100,0,29,29
Barrion,M,100,0,5,5
Micheline,F,100,993,0,993
Jenipher,F,100,226,0,226
Berdia,F,100,18,0,18
Akshay,M,100,0,1500,1500
Marali,F,100,5,0,5
Atoli,F,100,5,0,5
Daeshawna,F,100,20,0,20
Aariyah,F,100,276,0,276
Peace,F,84,324,60,384
Dandria,F,100,88,0,88
Donje,M,100,0,6,6
Marykatherine,F,100,697,0,697
Nahki,M,100,0,13,13
Orven,M,100,0,6,6
Geovanni,M,100,0,3211,3211
Jakeira,F,100,190,0,190
Amylee,F,100,185,0,185
Betheny,F,100,263,0,263
Agrim,M,100,0,16,16
Keyuntae,M,100,0,11,11
Tulsa,F,100,16,0,16
Daquesha,F,100,10,0,10
Carolie,F,100,18,0,18
Dayasia,F,100,10,0,10
Benjy,M,100,0,328,328
Taveion,M,100,0,54,54
Maitlyn,F,100,101,0,101
Nayelin,F,100,6,0,6
Lucresia,F,100,50,0,50
Enolia,F,100,5,0,5
Deedy,F,100,8,0,8
Lugina,F,100,10,0,10
Wetona,F,100,5,0,5
Chiemela,F,100,6,0,6
Marni,F,100,3200,5,3205
Deleana,F,100,11,0,11
Jacara,F,100,407,0,407
Francesa,F,100,62,0,62
Light,M,78,6,21,27
Ryota,M,100,0,170,170
Taki,M,91,5,50,55
Ginger,F,100,40034,41,40075
Angeliese,F,100,12,0,12
Yorgelis,F,100,6,0,6
Arzell,M,100,0,15,15
Ollivia,F,100,18,0,18
Trestan,M,100,0,124,124
Karadyn,F,100,5,0,5
Yader,M,100,0,88,88
Haila,F,100,66,0,66
Markera,F,100,5,0,5
Embyr,F,100,20,0,20
Sinea,F,100,21,0,21
Shalayah,F,100,82,0,82
Deundrea,M,100,0,7,7
Dahiana,F,100,152,0,152
Veronica,F,100,177772,813,178585
Sumar,F,100,53,0,53
Nagham,F,100,6,0,6
Elijhah,M,100,0,5,5
Waymon,M,100,0,1963,1963
Zahna,F,100,19,0,19
Lizann,F,100,103,0,103
Nozomi,F,100,90,0,90
Myriam,F,100,2589,0,2589
Nehki,M,100,0,5,5
Fredrik,M,100,0,286,286
Synda,F,100,61,0,61
Daymi,F,100,7,0,7
Margurite,F,100,336,0,336
Abel,M,100,97,37198,37295
Marinel,F,100,5,0,5
Chantai,F,100,5,0,5
Chardasia,F,100,6,0,6
Nicholi,M,100,0,291,291
Natahja,F,100,6,0,6
Walia,F,100,5,0,5
Aquill,M,100,0,7,7
Seniqua,F,100,21,0,21
Chinere,F,100,11,0,11
Lyam,M,100,0,458,458
Castella,F,100,12,0,12
Roul,M,100,0,5,5
Dorella,F,100,16,0,16
Jacopo,M,100,0,11,11
Reesheda,F,100,23,0,23
Annicia,F,100,6,0,6
Romit,M,100,0,5,5
Taffany,F,100,219,0,219
Frann,F,100,45,0,45
Khrystian,M,85,15,83,98
Zahkir,M,100,0,6,6
Sadiyah,F,100,263,0,263
Kathye,F,100,252,0,252
Andrei,M,100,0,2314,2314
Blesson,M,100,0,12,12
Machayla,F,100,33,0,33
Jahsai,M,100,0,30,30
Tylissa,F,100,6,0,6
Nasier,M,100,0,306,306
Dravyn,M,100,0,189,189
Larie,F,100,295,0,295
Mouhammad,M,100,0,5,5
Tasja,F,100,39,0,39
Mistelle,F,100,47,0,47
Jorene,F,100,214,0,214
Autmn,F,100,11,0,11
Jonika,F,100,206,0,206
Justinn,M,100,0,75,75
Damyah,F,100,191,0,191
Witney,F,100,179,0,179
Alvertis,M,100,0,12,12
Vanelope,F,100,15,0,15
Kevis,M,100,0,245,245
Ieva,F,100,53,0,53
Dahmir,M,100,0,146,146
Sayana,F,100,68,0,68
Smith,M,96,78,1811,1889
Kevia,F,100,222,0,222
Deajah,F,100,364,0,364
Billyjoe,M,100,0,398,398
Jolen,M,79,10,37,47
Jamair,M,100,0,99,99
Rosalynda,F,100,51,0,51
Nechuma,F,100,88,0,88
Detrail,M,100,0,6,6
Tranaya,F,100,7,0,7
Kersha,F,100,31,0,31
Aishah,F,100,1035,0,1035
Skyller,M,72,9,23,32
Paydon,M,100,0,120,120
Jadeline,F,100,37,0,37
Ellina,F,100,108,0,108
Deneice,F,100,284,0,284
Antanette,F,100,69,0,69
Serica,F,100,10,0,10
Abdulhadi,M,100,0,82,82
Jannat,F,100,529,0,529
Matilynn,F,100,148,0,148
Jaslinn,F,100,5,0,5
Raeisha,F,100,19,0,19
Kevontay,M,100,0,65,65
Elainie,F,100,34,0,34
Kahleil,M,100,0,21,21
Sirjames,M,100,0,15,15
Elaia,F,100,12,0,12
Donnivin,M,100,0,26,26
Jacere,M,100,0,40,40
Audric,M,100,0,326,326
Samreen,F,100,128,0,128
Marval,F,100,5,0,5
Ayram,F,100,32,0,32
Jakhari,M,100,0,432,432
Talene,F,100,72,0,72
Nikeia,F,100,62,0,62
Nayome,F,100,11,0,11
Maletha,F,100,6,0,6
Demarius,M,100,0,1723,1723
Mayjor,M,100,0,29,29
Ramyiah,F,100,43,0,43
Elway,M,100,0,17,17
Leiasia,F,100,12,0,12
Anite,F,100,10,0,10
Amier,M,100,0,400,400
Joziah,M,100,5,1973,1978
Leilla,F,100,12,0,12
Ayedan,M,100,0,5,5
Jackeline,F,100,5883,0,5883
Alaana,F,100,5,0,5
Sammie,M,77,2453,8392,10845
Malulani,F,100,5,0,5
Rasheda,F,100,994,0,994
Jhamel,M,100,0,5,5
Ramandeep,F,84,87,16,103
Cherina,F,100,210,0,210
Tolani,F,100,15,0,15
Shanquell,F,100,7,0,7
Sheilla,F,100,387,0,387
Barri,F,91,484,47,531
Hrishikesh,M,100,0,86,86
Brezlyn,F,100,70,0,70
Jennet,F,100,119,0,119
Anquette,F,100,43,0,43
Tobiann,F,100,7,0,7
Kristinejoy,F,100,5,0,5
Dezmyn,M,76,5,16,21
Rayegan,F,100,5,0,5
Brita,F,100,1013,0,1013
Ricca,F,100,72,0,72
Michaelena,F,100,6,0,6
Alonso,M,100,0,8501,8501
Sashank,M,100,0,36,36
Allston,M,100,0,11,11
Felix,M,99,356,41732,42088
Erblin,M,100,0,5,5
Naquana,F,100,19,0,19
Johnya,F,100,6,0,6
Siraj,M,100,0,336,336
Cieanna,F,100,63,0,63
Laytin,M,100,0,23,23
Lachanta,F,100,10,0,10
Christopherlee,M,100,0,32,32
Syedah,F,100,5,0,5
Greydi,F,100,24,0,24
Takerria,F,100,23,0,23
Charmagne,F,100,323,0,323
Dreniyah,F,100,5,0,5
Legna,F,100,82,0,82
Revea,F,100,5,0,5
Kellieann,F,100,48,0,48
Chelton,M,100,0,16,16
Jyrine,M,100,0,15,15
Antje,F,100,16,0,16
Brooksley,F,100,14,0,14
Keily,F,100,2487,0,2487
Jeaden,M,100,0,5,5
Mellette,F,100,6,0,6
Pattye,F,100,98,0,98
Jamarr,M,100,0,1279,1279
Bader,M,100,0,249,249
Joseff,M,100,0,102,102
Joany,F,92,59,5,64
Mikira,F,100,30,0,30
Trinette,F,100,956,0,956
Khimora,F,100,5,0,5
Ameshia,F,100,150,0,150
Varshini,F,100,160,0,160
Thersia,F,100,61,0,61
Cloyde,M,100,0,5,5
Laquenda,F,100,10,0,10
Miwa,F,100,40,0,40
Samia,F,100,2575,0,2575
Briseyda,F,100,1274,0,1274
Niyahlee,F,100,6,0,6
Khalan,M,100,0,11,11
Abbiegale,F,100,58,0,58
Kahree,M,100,0,11,11
Jaquavian,M,100,0,110,110
Aurin,M,100,0,5,5
Walesca,F,100,23,0,23
Dinean,F,100,5,0,5
Dystany,F,100,94,0,94
Harla,F,100,61,0,61
Crae,M,100,0,8,8
Anaston,F,100,53,0,53
Anaceli,F,100,24,0,24
Quinlynn,F,100,108,0,108
Saragrace,F,100,71,0,71
Kache,F,50,57,56,113
Amymarie,F,100,52,0,52
Jayela,F,100,6,0,6
Tunesia,F,100,45,0,45
Reina,F,100,8741,0,8741
Kededra,F,100,6,0,6
Tiea,F,100,75,0,75
Ferdinan,M,100,0,5,5
Yeabsira,M,100,0,12,12
Alhia,F,100,21,0,21
Kashdyn,M,100,0,6,6
Auviana,F,100,11,0,11
Aadith,M,100,0,39,39
Vernee,F,100,92,0,92
Marvlene,F,100,5,0,5
Sady,F,100,205,0,205
Juma,M,100,0,99,99
Ashleykate,F,100,5,0,5
Janziel,M,100,0,31,31
Rodre,M,100,0,5,5
Zamyia,F,100,88,0,88
Brianny,F,100,394,0,394
Catrece,F,100,47,0,47
Moneshia,F,100,57,0,57
Jhonatan,M,100,0,918,918
Cait,F,100,127,0,127
Ronnita,F,100,103,0,103
Kataliya,F,100,15,0,15
Tellas,M,100,0,46,46
Jessyka,F,100,425,0,425
Abrina,F,100,149,0,149
Graylin,M,95,22,448,470
Javid,M,100,0,338,338
Jvon,M,100,0,462,462
Tolan,M,100,0,39,39
Shafin,M,100,0,55,55
Naazir,M,100,0,11,11
Nizam,M,100,0,5,5
Dazah,F,100,21,0,21
Resa,F,100,972,0,972
Edil,M,84,5,26,31
Aricel,F,100,10,0,10
Yasenia,F,100,159,0,159
Pradyumna,M,100,0,12,12
Yaviel,M,100,0,55,55
Shana,F,100,29224,113,29337
Jakar,M,100,0,53,53
Ladonia,F,100,48,0,48
Keshonda,F,100,157,0,157
Briscoe,M,100,0,22,22
Dameria,F,100,47,0,47
Juanetta,F,100,216,0,216
Ipek,F,100,30,0,30
Ardene,F,100,50,0,50
Falencia,F,100,11,0,11
Kawona,F,100,5,0,5
Manuel,M,99,786,125189,125975
Inbal,F,100,16,0,16
Robenson,M,100,0,10,10
Simrat,F,100,103,0,103
Kandle,F,100,5,0,5
Marvin,M,99,719,109917,110636
Keyondria,F,100,15,0,15
Drusella,F,100,5,0,5
Tobin,M,99,48,4675,4723
Bernerd,M,100,0,119,119
Kemry,F,100,5,0,5
Rushank,M,100,0,5,5
Trachell,F,100,6,0,6
Reynalda,F,100,198,0,198
Bensley,M,100,0,7,7
Rylie,F,94,14404,963,15367
Dominika,F,100,542,0,542
Ulisis,M,100,0,12,12
Leshaundra,F,100,5,0,5
Tyvon,M,100,0,741,741
Serriah,F,100,13,0,13
Lear,M,56,23,29,52
Janyla,F,100,1046,0,1046
Arinda,F,100,10,0,10
Zachory,M,100,0,732,732
Yalanda,F,100,652,0,652
Ahnaya,F,100,16,0,16
Davalyn,F,100,16,0,16
Latoyah,F,100,43,0,43
Hafso,F,100,5,0,5
Dejae,F,100,70,0,70
Neilie,F,100,8,0,8
Anshuman,M,100,0,38,38
Maylanie,F,100,12,0,12
Dervin,M,100,0,152,152
Natalle,F,100,21,0,21
Lialah,F,100,5,0,5
Yessica,F,100,3656,0,3656
Gerick,M,100,0,11,11
Jamesly,M,100,0,7,7
Kandra,F,100,1329,0,1329
Revel,M,94,5,74,79
Jenniferanne,F,100,29,0,29
Mykhi,M,100,0,51,51
Jaheim,M,100,5,3375,3380
Saladin,M,100,0,164,164
Tzipa,F,100,19,0,19
Shannan,F,94,5160,317,5477
Dassy,F,100,10,0,10
Rona,F,100,3708,0,3708
Melchior,M,100,0,10,10
Shaelea,F,100,5,0,5
Domanique,F,72,375,146,521
Sesley,F,100,23,0,23
Fleet,M,100,0,39,39
Sumara,F,100,31,0,31
Natanael,M,100,0,1387,1387
Jelon,M,100,0,22,22
Iracema,F,100,61,0,61
Augus,M,100,0,8,8
Deara,F,100,188,0,188
Demery,F,80,20,5,25
Keyilah,F,100,11,0,11
Yudi,F,100,26,0,26
Gwendoyln,F,100,7,0,7
Enjamin,M,100,0,16,16
Ayviana,F,100,5,0,5
Nathanie,M,100,0,64,64
Tumekia,F,100,5,0,5
Tyjay,M,100,0,86,86
Hakeen,M,100,0,68,68
Evarose,F,100,29,0,29
Demaine,M,100,0,6,6
Shelicia,F,100,22,0,22
Lorde,F,100,5,0,5
Devlan,M,100,0,29,29
Aliyyah,F,100,212,0,212
Moniya,F,100,29,0,29
Tauriel,F,100,20,0,20
Jodey,M,65,50,93,143
Veleda,F,100,78,0,78
Regginae,F,100,13,0,13
Teisha,F,100,1240,0,1240
Idali,F,100,251,0,251
Nicoly,F,100,5,0,5
Menda,F,100,22,0,22
Zaheem,M,100,0,36,36
Jimmica,F,100,5,0,5
Tamalia,F,100,5,0,5
Marcon,M,100,0,6,6
Younus,M,100,0,17,17
Aliz,F,100,112,0,112
Louisiana,F,100,42,0,42
Zyaun,M,100,0,5,5
Brittany,F,100,356473,1078,357551
Custodio,M,100,0,6,6
Shaunetta,F,100,25,0,25
Kynder,F,100,6,0,6
Jahleil,M,100,0,8,8
Tanyea,F,100,6,0,6
Fayaz,M,100,0,5,5
Duban,M,100,0,11,11
Cassi,F,100,2254,0,2254
Treon,M,100,0,242,242
Maryln,F,100,96,0,96
Eito,M,100,0,15,15
Jannean,F,100,7,0,7
Brogen,M,100,0,140,140
Jayshon,M,100,0,388,388
Rithvika,F,100,7,0,7
Nayshawn,M,100,0,146,146
Yazline,F,100,10,0,10
Brailynn,F,97,451,12,463
Amarissa,F,100,374,0,374
Bauer,M,100,0,332,332
Jozeph,M,100,0,85,85
Pennylane,F,100,28,0,28
Tundra,F,100,36,0,36
Kenika,F,100,51,0,51
Stephfan,M,100,0,5,5
Charo,F,98,238,6,244
Suheily,F,100,57,0,57
Hopemarie,F,100,11,0,11
Vidya,F,100,363,0,363
Kearn,F,100,5,0,5
Lakenia,F,100,17,0,17
Trenay,F,100,26,0,26
Itzhak,M,100,0,28,28
Will,M,100,32,17776,17808
Azareth,F,100,5,0,5
Keyrra,F,100,12,0,12
Areyana,F,100,155,0,155
Tequia,F,100,68,0,68
Zanaria,F,100,160,0,160
Nyana,F,100,358,0,358
Tacoya,F,100,71,0,71
Issabel,F,100,26,0,26
Lachanda,F,100,328,0,328
Kalese,F,100,101,0,101
Jeton,M,100,0,30,30
Edwing,M,100,0,157,157
Roshay,F,100,5,0,5
Alizette,F,100,16,0,16
Alieah,F,100,60,0,60
Dareon,M,98,7,391,398
Drean,M,100,0,21,21
Temani,F,50,10,10,20
Caedin,M,100,0,69,69
Jashanti,F,100,153,0,153
Marielos,F,100,10,0,10
Cyris,M,100,0,231,231
Aayaan,M,100,0,31,31
Sloane,F,96,6406,251,6657
Marhta,F,100,33,0,33
Mahitha,F,100,71,0,71
Telley,M,100,0,45,45
Brekkyn,F,100,5,0,5
Nikash,M,100,0,66,66
Waniya,F,100,33,0,33
Keajia,F,100,5,0,5
Cuahutemoc,M,100,0,146,146
Adaneli,F,100,11,0,11
Tyranny,F,100,22,0,22
Nalla,F,100,70,0,70
Dianette,F,100,33,0,33
Huckleberry,M,100,0,116,116
Soe,M,75,5,15,20
Lamerle,F,100,5,0,5
Bracelyn,F,100,5,0,5
Brewster,M,100,0,121,121
Lillya,F,100,5,0,5
Adrena,F,100,475,0,475
Mirae,F,100,22,0,22
Keaka,M,100,0,40,40
Mcauthur,M,100,0,5,5
Rasa,F,100,91,0,91
Evey,F,100,506,0,506
Pricella,F,100,81,0,81
Jeanmichael,M,100,0,26,26
Gennelle,F,100,6,0,6
Agnesa,F,100,5,0,5
Sarosh,M,100,0,11,11
Miryam,F,100,731,0,731
Susaye,F,100,6,0,6
Sharnese,F,100,82,0,82
Alalah,F,100,5,0,5
Chrystie,F,100,341,0,341
Marvelyn,F,100,12,0,12
Tahir,M,100,0,1295,1295
Rodjanae,F,100,16,0,16
Oyuky,F,100,59,0,59
Imagine,F,100,118,0,118
Syrianna,F,100,78,0,78
Elleanora,F,100,5,0,5
Yosseline,F,100,40,0,40
Jemmah,F,100,17,0,17
Parv,M,100,0,36,36
Shandalyn,F,100,49,0,49
Talajha,F,100,5,0,5
Chrishelle,F,100,145,0,145
Kearstin,F,100,726,0,726
Vivyana,F,100,32,0,32
Merlinda,F,100,450,0,450
Mable,F,100,4452,0,4452
Chelon,F,100,5,0,5
Skiley,F,100,7,0,7
Kwanesha,F,100,23,0,23
Martaveon,M,100,0,6,6
Arko,M,100,0,5,5
Nygel,M,100,0,452,452
Luvia,F,100,62,0,62
Marlenea,F,100,10,0,10
Ariv,M,100,0,62,62
Camellia,F,100,1807,0,1807
Yalitza,F,100,684,0,684
Sydnei,F,100,575,0,575
Daniellee,M,100,0,10,10
Esean,M,100,0,6,6
Juniyah,F,100,20,0,20
Kayanne,F,100,23,0,23
Zeyden,M,100,0,15,15
Kailas,M,100,0,37,37
Jamaicia,F,100,7,0,7
Amaron,M,100,0,5,5
Gimena,F,100,333,0,333
Aukievah,F,100,10,0,10
Sitara,F,100,282,0,282
Kajus,M,100,0,12,12
Ernst,M,100,0,867,867
Catherene,F,100,34,0,34
Shounda,F,100,16,0,16
Abdias,M,100,0,486,486
Bryden,M,98,23,1341,1364
Graysyn,M,100,0,28,28
Finbarr,M,100,0,5,5
Tenishia,F,100,137,0,137
Arsalan,M,100,0,289,289
Krystalynne,F,100,5,0,5
Kobi,M,68,561,1203,1764
Chaaya,F,100,5,0,5
Anterrius,M,100,0,6,6
Shamire,F,55,12,10,22
Antajuan,M,100,0,5,5
Thacher,M,100,0,14,14
Zeyd,M,100,0,13,13
Lilykate,F,100,36,0,36
Siddharth,M,100,0,2295,2295
Kameah,F,100,58,0,58
Jalaun,M,100,0,10,10
Kynsie,F,100,83,0,83
Montserrath,F,100,85,0,85
Reynard,M,100,0,585,585
Keyshawna,F,100,109,0,109
Dionn,M,100,0,5,5
Salih,M,100,0,357,357
Tikera,F,100,5,0,5
Larico,M,100,0,144,144
Dajuon,M,100,0,5,5
Vasti,F,100,191,0,191
Sharvae,F,100,9,0,9
Muhammadamin,M,100,0,5,5
Tequana,F,100,5,0,5
Verneisha,F,100,5,0,5
Alyncia,F,100,16,0,16
Tierre,M,76,117,370,487
Jersain,M,100,0,18,18
Rejeana,F,100,263,0,263
Kmiyah,F,100,36,0,36
Evonna,F,100,294,0,294
Thurl,M,100,0,38,38
Nao,F,89,85,10,95
Damielle,F,100,5,0,5
Mathilda,F,100,793,0,793
Neftaly,M,67,170,348,518
Leeannah,F,100,5,0,5
Octavien,M,100,0,23,23
Dakim,M,100,0,17,17
Hussin,M,100,0,6,6
Loreyna,F,100,11,0,11
Tanila,F,100,8,0,8
Kyrell,M,100,0,545,545
Trinley,F,100,8,0,8
Shaquelia,F,100,5,0,5
Pedra,F,100,12,0,12
Yensi,F,100,29,0,29
Nelsy,F,100,217,0,217
Kadesh,M,100,0,20,20
Maali,F,100,11,0,11
Maranda,F,100,11152,0,11152
Debro,F,100,24,0,24
Johnlucas,M,100,0,10,10
Marquella,F,100,33,0,33
Matesha,F,100,11,0,11
Cicley,F,100,74,0,74
Kerrington,F,79,619,162,781
Mavrick,M,100,0,721,721
Khaliliah,F,100,6,0,6
Merrell,M,89,53,446,499
Voss,M,100,0,8,8
Jahmiyah,F,100,57,0,57
Shenade,F,100,6,0,6
Geneviev,F,100,9,0,9
Alina,F,100,24133,0,24133
Normon,M,100,0,10,10
Franca,F,100,354,0,354
Remmy,M,58,75,105,180
Taziya,F,100,31,0,31
Isarely,F,100,6,0,6
Uzuri,F,100,10,0,10
Avanell,F,100,21,0,21
Dajon,M,96,70,1541,1611
Samaire,F,100,22,0,22
Marueen,F,100,26,0,26
Paytience,F,100,54,0,54
Kitsy,F,100,5,0,5
Natalin,F,100,64,0,64
Sheiva,F,100,5,0,5
Bailley,F,100,71,0,71
Tinelle,F,100,6,0,6
Glover,M,100,0,220,220
Mackensey,F,100,119,0,119
Sherlean,F,100,21,0,21
Azelea,F,100,32,0,32
Danicah,F,100,12,0,12
Ryou,M,100,0,5,5
Leiden,M,100,0,21,21
Tearia,F,100,140,0,140
Chrishya,F,100,5,0,5
Clemmie,M,57,247,326,573
Fayette,F,96,307,14,321
Jabrien,M,100,0,16,16
Adilyn,F,100,1183,0,1183
Shaquillie,M,100,0,5,5
Dashiya,F,100,33,0,33
Jervaughn,M,100,0,5,5
Myleka,F,100,71,0,71
Drazen,M,100,0,35,35
Kayleeann,F,100,194,0,194
Ramiele,F,100,10,0,10
Christianna,F,100,2744,0,2744
Shyanna,F,100,1595,0,1595
Maeby,F,100,58,0,58
Petrea,F,100,43,0,43
Taziyah,F,89,98,12,110
Mathhew,M,100,0,133,133
Rotimi,M,100,0,5,5
Sahib,M,99,5,406,411
Shardey,F,100,32,0,32
Lumen,F,94,108,7,115
Philena,F,100,56,0,56
Nareen,F,100,10,0,10
Alawna,F,100,72,0,72
Makaiyla,F,100,28,0,28
Thela,F,100,5,0,5
Shimeeka,F,100,5,0,5
Zoriana,F,100,78,0,78
Niti,F,100,64,0,64
Muhmmad,M,100,0,5,5
Rondarious,M,100,0,15,15
Tashana,F,100,846,0,846
Roselani,F,100,67,0,67
Jmir,M,100,0,6,6
Kookie,F,100,5,0,5
Kadeija,F,100,10,0,10
Jitu,M,100,0,7,7
Latronya,F,100,10,0,10
Latrise,F,100,171,0,171
Nerya,F,100,5,0,5
Mcconnell,M,100,0,5,5
Tynita,F,100,44,0,44
Chritina,F,100,48,0,48
Zahir,M,100,7,1920,1927
Braydin,M,99,11,869,880
Joshuaa,M,100,0,5,5
Angeal,M,100,0,5,5
Ianmichael,M,100,0,64,64
Jesusangel,M,100,0,19,19
Rand,M,96,83,2229,2312
Celleste,F,100,11,0,11
Vandella,F,100,44,0,44
Berlynn,F,100,331,0,331
Nayha,F,100,12,0,12
Natonya,F,100,203,0,203
Yohance,M,100,0,370,370
Joliette,F,100,16,0,16
Kaikane,M,100,0,14,14
Kalyan,M,100,0,116,116
Sharya,F,100,53,0,53
Cy,M,100,10,2940,2950
Annalisa,F,100,5031,0,5031
Alajhia,F,100,5,0,5
Lynann,F,100,276,0,276
Chrysoula,F,100,5,0,5
Kyrstie,F,100,60,0,60
Felisha,F,100,5871,0,5871
Anfrenee,M,100,0,23,23
Nicholle,F,100,1837,0,1837
Sheriece,F,100,47,0,47
Mauriella,F,100,5,0,5
Akachi,M,100,0,5,5
Yaylin,F,100,7,0,7
Caitilin,F,100,36,0,36
Kenyi,M,100,0,15,15
Tiny,F,93,499,38,537
Shane,M,98,3402,184309,187711
Hena,F,100,261,0,261
Allex,M,70,71,167,238
Phoua,F,100,99,0,99
Anahy,F,100,1158,0,1158
Nylah,F,100,5458,0,5458
Braelynne,F,100,87,0,87
Treavion,M,100,0,5,5
Ahni,F,100,71,0,71
Jimmel,M,100,0,22,22
Eliezel,M,100,0,11,11
Rahmeir,M,100,0,17,17
Isaira,F,100,11,0,11
Roberto,M,99,652,94765,95417
Demita,F,100,275,0,275
Velencia,F,100,135,0,135
Keairra,F,100,403,0,403
Jillmarie,F,100,8,0,8
Antowne,M,100,0,5,5
Eulalie,F,100,26,0,26
Lakaii,F,100,16,0,16
Skylee,F,100,1612,0,1612
Erianah,F,100,16,0,16
Donnetta,F,100,1301,0,1301
Heathe,F,68,51,24,75
Hadrian,M,100,0,456,456
Jonna,F,100,5076,0,5076
Aryss,F,100,20,0,20
Briane,F,84,296,55,351
Comekia,F,100,6,0,6
Michele,F,99,210796,2128,212924
Emillio,M,100,0,368,368
Valisha,F,100,248,0,248
Quintin,M,100,7,13324,13331
Liriel,F,100,14,0,14
Rohaan,M,100,0,131,131
Oshea,M,94,44,639,683
Pradhyun,M,100,0,5,5
Terion,M,100,0,207,207
Nimai,M,100,0,53,53
Marlecia,F,100,5,0,5
Ahmeir,M,100,0,28,28
Deaunna,F,100,86,0,86
Susano,M,100,0,15,15
Lailiana,F,100,5,0,5
Ithiel,M,100,0,36,36
Demille,M,100,0,10,10
Eletha,F,100,95,0,95
Avalee,F,100,532,0,532
Kristey,F,100,22,0,22
Sarvin,M,100,0,19,19
Kindric,M,100,0,5,5
Jacklyne,F,100,102,0,102
Nasiha,F,100,17,0,17
Oskar,M,100,0,1844,1844
Charley,F,51,5386,5270,10656
Jeneene,F,100,17,0,17
Vyas,M,100,0,18,18
Lilja,F,100,134,0,134
Deondrea,F,56,88,68,156
Shastelyn,F,100,34,0,34
Katreina,F,100,5,0,5
Elvina,F,100,536,0,536
Gloryann,F,100,11,0,11
Abir,M,71,92,224,316
Christasha,F,100,5,0,5
Adelisa,F,100,141,0,141
Cynde,F,100,254,0,254
Yiru,F,100,5,0,5
Jehron,M,100,0,5,5
Ladoris,F,100,113,0,113
Hershel,M,100,0,3185,3185
Manwell,M,100,0,5,5
Syreniti,F,100,13,0,13
Young,M,73,461,1266,1727
Auryanna,F,100,12,0,12
Karyl,F,100,1264,0,1264
Katoya,F,100,189,0,189
Kayte,F,100,495,0,495
Melchor,M,100,0,665,665
Tirina,F,100,5,0,5
Amiah,F,100,2973,0,2973
Quadirah,F,100,21,0,21
Lillie,F,100,25870,50,25920
Kaede,F,85,173,30,203
Cylah,F,100,43,0,43
Nahsir,M,100,0,93,93
Dorthea,F,100,1117,0,1117
Hifza,F,100,20,0,20
Rodriquez,M,100,0,1473,1473
Yojhan,M,100,0,6,6
Amerion,M,100,0,27,27
Purnell,M,100,0,459,459
Presiliano,M,100,0,5,5
Joycie,F,100,97,0,97
Caiah,F,100,12,0,12
Giovannii,M,100,0,5,5
Johnicia,F,100,5,0,5
Jean,F,90,128409,14798,143207
Naaz,F,100,10,0,10
Winson,M,100,0,300,300
Dokken,M,100,0,5,5
Lynix,F,100,15,0,15
Bracken,M,100,0,534,534
Izaha,M,100,0,67,67
Justeen,F,100,252,0,252
Suong,F,100,31,0,31
Krisean,M,100,0,22,22
Kayta,F,100,5,0,5
Niveen,F,100,34,0,34
Eain,M,100,0,70,70
Gemayel,M,100,0,72,72
Jamyah,F,100,892,0,892
Machias,M,100,0,5,5
Larasha,F,100,11,0,11
Jex,M,100,0,45,45
Jai,M,78,957,3481,4438
Madigan,F,100,774,0,774
Neyva,F,100,48,0,48
Jalaiya,F,100,99,0,99
Deldra,F,100,16,0,16
Josejavier,M,100,0,26,26
Mekah,F,100,36,0,36
Jesly,F,100,179,0,179
Maelie,F,100,219,0,219
Kenshayla,F,100,5,0,5
Savanaha,F,100,30,0,30
Daking,M,100,0,39,39
Rosalinde,F,100,40,0,40
Nautia,F,100,81,0,81
Elzina,F,100,16,0,16
Lizbette,F,100,39,0,39
Cyaire,M,100,0,10,10
Zylin,M,100,0,32,32
Naiim,M,100,0,30,30
Lailonie,F,100,36,0,36
Detravious,M,100,0,24,24
Santha,F,100,6,0,6
Coreyonna,F,100,5,0,5
Tabari,M,100,0,408,408
Boise,M,100,0,5,5
Gyra,F,100,5,0,5
Kiawna,F,100,5,0,5
Jalyce,F,100,5,0,5
Alizet,F,100,5,0,5
Maryke,F,100,11,0,11
Saamia,F,100,12,0,12
Bridey,F,100,44,0,44
Gottlob,M,100,0,5,5
Mohini,F,100,140,0,140
Shanikka,F,100,146,0,146
Trischa,F,100,50,0,50
Chrispher,M,100,0,15,15
Braxstyn,M,100,0,6,6
Cristena,F,100,18,0,18
Phenyx,F,100,19,0,19
Caylem,M,100,0,10,10
Adekunle,M,100,0,61,61
Jaxan,M,100,0,70,70
Symirah,F,100,13,0,13
Avaan,M,100,0,5,5
Saidie,F,100,38,0,38
Orey,M,100,0,74,74
Cyerah,F,100,5,0,5
Dois,F,100,5,0,5
Cardero,M,100,0,23,23
Novalei,F,100,14,0,14
Ameli,F,100,87,0,87
Jyla,F,100,72,0,72
Shevella,F,100,5,0,5
Moath,M,100,0,21,21
Yolany,F,100,13,0,13
Reuben,M,100,18,15260,15278
Ziclaly,F,100,5,0,5
Suryansh,M,100,0,17,17
Chumani,F,100,11,0,11
Yesha,F,100,92,0,92
Herminio,M,100,0,1075,1075
Crysta,F,100,1771,0,1771
Osheana,F,100,11,0,11
Khushal,M,100,0,16,16
Ranyia,F,100,63,0,63
Marialis,F,100,60,0,60
Cherone,F,100,7,0,7
Milana,F,100,2918,0,2918
Thiego,M,100,0,5,5
Naethan,M,100,0,77,77
Billi,F,100,1671,5,1676
Airyn,F,94,85,5,90
Roshini,F,100,69,0,69
Zarhiya,F,100,11,0,11
Najely,F,100,52,0,52
Tari,F,98,2124,46,2170
Demyia,F,100,38,0,38
Harshitha,F,100,148,0,148
Macy,F,99,26070,325,26395
Benica,F,100,6,0,6
Dejanira,F,100,100,0,100
Mouhamadou,M,100,0,264,264
Belon,F,100,15,0,15
Nirah,F,100,5,0,5
Chavas,M,100,0,5,5
Tsunade,F,100,5,0,5
Cadedra,F,100,55,0,55
Vipul,M,100,0,70,70
Manbir,M,100,0,17,17
Yoshigei,F,100,21,0,21
Kohana,F,100,115,0,115
Aylan,M,100,0,34,34
Farzeen,F,100,7,0,7
Xane,M,100,0,233,233
Sasuke,M,100,0,64,64
Rosealee,F,100,73,0,73
Adee,F,100,6,0,6
Adesina,F,100,5,0,5
Andalynn,F,100,18,0,18
Consuela,F,100,1614,0,1614
Crawford,M,99,13,1580,1593
Kindel,F,93,66,5,71
Meer,M,100,0,103,103
Gloretha,F,100,5,0,5
Iselin,F,100,5,0,5
Aniyjah,F,100,24,0,24
Dalainee,F,100,6,0,6
Juliahna,F,100,111,0,111
Tabaitha,F,100,27,0,27
Ashantiana,F,100,5,0,5
Nasro,F,100,32,0,32
Siniah,F,100,39,0,39
Tovias,M,100,0,5,5
Tamina,F,100,197,0,197
Eliciana,F,100,5,0,5
Finnleigh,F,100,31,0,31
Etheridge,M,100,0,8,8
Marison,F,100,16,0,16
Gaten,M,100,0,7,7
Antonello,M,100,0,10,10
Kynnadi,F,100,118,0,118
Yzabella,F,100,372,0,372
Neissa,F,100,5,0,5
Tallulah,F,100,1415,0,1415
Dontevious,M,100,0,11,11
Taheim,M,100,0,39,39
Ryen,M,59,786,1126,1912
Rocklin,M,100,0,86,86
Charvik,M,100,0,5,5
Chanoa,F,100,5,0,5
Abyade,F,100,10,0,10
Sime,M,100,0,5,5
Ayaansh,M,100,0,42,42
Zitlaly,F,100,516,0,516
Jaynah,F,100,28,0,28
Kensington,F,96,1277,58,1335
Embrya,F,100,11,0,11
Eldin,M,100,0,382,382
Katelan,F,100,376,0,376
Ehrin,F,60,33,22,55
Augustina,F,100,1014,0,1014
Dubraska,F,100,7,0,7
Silvanus,M,100,0,10,10
Ulysee,M,100,0,108,108
Kily,F,100,15,0,15
Ellisha,F,100,298,0,298
Tarez,M,100,0,100,100
Adam,M,100,1992,517459,519451
Xan,F,53,122,110,232
Selenamarie,F,100,6,0,6
Lyle,M,99,229,22208,22437
Rebba,F,100,27,0,27
Almadelia,F,100,262,0,262
Rayme,F,68,56,26,82
Takyra,F,100,554,0,554
Yohei,M,100,0,34,34
Erdi,M,100,0,20,20
Kenderick,M,100,0,478,478
Tasheema,F,100,126,0,126
Ulrick,M,100,0,85,85
Shumel,M,100,0,5,5
Xareni,F,100,63,0,63
Khenan,M,100,0,7,7
Trejon,M,100,0,308,308
Yamarie,F,100,5,0,5
Robbert,M,100,0,373,373
Tykevion,M,100,0,6,6
Nakaylee,F,100,6,0,6
Annaclara,F,100,56,0,56
Melanye,F,100,262,0,262
Yania,F,100,99,0,99
Marizela,F,100,50,0,50
Katelind,F,100,69,0,69
Zayed,M,100,0,150,150
Naelson,M,100,0,17,17
Loucas,M,100,0,13,13
Delmis,F,100,7,0,7
Teaghen,F,100,18,0,18
Juny,M,100,0,5,5
Jolesha,F,100,7,0,7
Itamar,M,93,16,207,223
Davinah,F,100,9,0,9
Ceclia,F,100,151,0,151
Sharyn,F,100,3194,0,3194
Lorane,F,100,104,0,104
Solstice,F,100,37,0,37
Makenly,F,100,95,0,95
Christpoher,M,100,0,61,61
Merlin,M,90,461,4380,4841
Sherisa,F,100,68,0,68
Yanell,F,100,50,0,50
Odessia,F,100,73,0,73
Atharv,M,100,0,491,491
Rheda,F,100,52,0,52
Jessicalynn,F,100,126,0,126
Jalina,F,100,484,0,484
Sueanne,F,100,382,0,382
Ivane,F,100,27,0,27
Jalisse,F,100,6,0,6
Makena,F,98,4958,84,5042
Marjon,F,80,59,15,74
Keyania,F,100,5,0,5
Rhodella,F,100,5,0,5
Wenzel,M,100,0,7,7
Yehudah,M,100,0,564,564
Onya,F,100,170,0,170
Samaira,F,100,609,0,609
Kiamara,F,100,5,0,5
Johnella,F,100,63,0,63
Maykayla,F,100,126,0,126
Monchello,M,100,0,6,6
Tyrihanna,F,100,71,0,71
Avni,F,100,796,0,796
Halen,M,64,445,786,1231
Kyheem,M,100,0,61,61
Rexford,M,100,0,1021,1021
Elsabeth,F,100,5,0,5
Rasheid,M,100,0,10,10
Givonni,M,100,0,11,11
Elnora,F,100,2670,0,2670
Landy,M,67,227,468,695
Drakkar,M,100,0,142,142
Sharren,F,100,79,0,79
Vega,F,84,308,57,365
Amiliana,F,100,98,0,98
Sieara,F,100,140,0,140
Rula,F,100,91,0,91
Cergio,M,100,0,33,33
Jyoti,F,100,228,0,228
Camryne,F,100,5,0,5
Ngoc,F,92,634,54,688
Lanelle,F,100,725,0,725
Cynia,F,100,172,0,172
Sosefina,F,100,27,0,27
Parul,F,100,98,0,98
Kingson,M,100,0,38,38
Zach,M,100,0,2091,2091
Sneh,M,86,5,31,36
Shabrea,F,100,114,0,114
Sean,M,99,2906,410656,413562
Nadya,F,100,2147,0,2147
Tennisha,F,100,44,0,44
Latravious,M,100,0,165,165
Abdulla,M,100,0,402,402
Shanieka,F,100,220,0,220
Shimere,F,100,43,0,43
Zenda,F,100,272,0,272
Yamiletz,F,100,5,0,5
Signa,F,100,63,0,63
Denece,F,100,167,0,167
Angelese,F,100,25,0,25
Kalaya,F,100,770,0,770
Glender,F,100,45,0,45
Kenette,F,100,5,0,5
Nykerria,F,100,80,0,80
Kyiesha,F,100,146,0,146
Trinity,F,96,69264,2677,71941
Yadrian,M,100,0,23,23
Chabelli,F,100,6,0,6
Margurita,F,100,11,0,11
Liviana,F,100,182,0,182
Jahvel,M,100,0,6,6
Hadasa,F,100,273,0,273
Kourtny,F,100,51,0,51
Tytus,M,100,0,825,825
Lemmy,M,100,0,11,11
Keishia,F,100,258,0,258
Stacey,F,92,146585,13373,159958
Taneka,F,100,1519,0,1519
Barth,M,100,0,334,334
Chamarra,F,100,5,0,5
Camili,F,100,9,0,9
Nishitha,F,100,17,0,17
Juliean,M,100,0,6,6
Briyan,M,100,0,96,96
Wyat,M,100,0,166,166
Darcey,F,95,1908,94,2002
Karona,F,100,8,0,8
Keaundre,M,100,0,112,112
Saline,F,100,16,0,16
Chantalle,F,100,286,0,286
Jaidenn,M,100,0,11,11
Zerita,F,100,30,0,30
Madissyn,F,100,37,0,37
Rony,M,100,0,1547,1547
Gaye,F,100,3635,0,3635
Kaili,F,99,2523,35,2558
Akiko,F,100,377,0,377
Ziquan,M,100,0,65,65
Kelany,F,100,5,0,5
Keyone,M,100,0,21,21
Shehzeen,F,100,6,0,6
Chikamara,F,100,5,0,5
Kenberly,F,100,12,0,12
Hermina,F,100,119,0,119
Kimetra,F,100,19,0,19
Amarylis,F,100,120,0,120
Lizbet,F,100,1190,0,1190
Esley,M,86,5,32,37
Zavia,F,95,109,6,115
Alishea,F,100,183,0,183
Twanisha,F,100,54,0,54
Marionna,F,100,357,0,357
Toisha,F,100,7,0,7
Mileny,F,100,24,0,24
Victori,F,100,40,0,40
Aleza,F,100,67,0,67
Kiane,F,100,46,0,46
Cylar,M,100,0,30,30
Bradi,F,100,604,0,604
Taijha,F,100,19,0,19
Shadia,F,100,673,0,673
Cordarryl,M,100,0,157,157
Akire,F,100,60,0,60
Ashutosh,M,100,0,61,61
Zuleyka,F,100,984,0,984
Latece,F,100,21,0,21
Lameek,M,100,0,33,33
Juley,F,100,75,0,75
Zoeann,F,100,112,0,112
Mayisha,F,100,5,0,5
Cheralyn,F,100,130,0,130
Sumukh,M,100,0,18,18
Vennie,F,70,117,51,168
Cayetana,F,100,18,0,18
Rugayyah,F,100,5,0,5
Mariaceleste,F,100,62,0,62
Ladonda,F,100,5,0,5
Dazhan,M,100,0,5,5
Jennalea,F,100,10,0,10
Dejai,F,100,75,0,75
Calliah,F,100,27,0,27
Wendalyn,F,100,43,0,43
Nishil,M,100,0,27,27
Anastasios,M,100,0,856,856
Colman,M,100,0,512,512
Michaeljay,M,100,0,6,6
Angila,F,100,613,0,613
Kennie,M,83,187,900,1087
Myster,M,100,0,5,5
Christale,F,100,5,0,5
Yailyn,F,100,237,0,237
Nadal,M,100,0,11,11
Olesia,F,100,47,0,47
Avraj,M,100,0,5,5
Trynity,F,100,371,0,371
Itxel,F,100,108,0,108
Kelsie,F,99,17958,130,18088
Alexuis,F,100,35,0,35
Deloyd,M,100,0,15,15
Feng,M,100,0,25,25
Greeley,F,82,23,5,28
Tayani,F,100,5,0,5
Gumecindo,M,100,0,36,36
Genvieve,F,100,5,0,5
Liliannah,F,100,25,0,25
Jessah,F,100,117,0,117
Rezon,M,100,0,5,5
Ajay,M,100,5,3635,3640
Laylan,F,58,7,5,12
Jatonya,F,100,5,0,5
Amvi,F,100,5,0,5
Caaliyah,F,100,11,0,11
Shaliqua,F,100,5,0,5
Trasha,F,100,29,0,29
Iyari,F,96,129,6,135
Zamyah,F,100,167,0,167
Ryanchristopher,M,100,0,45,45
Leighia,F,100,5,0,5
Samy,M,99,5,602,607
Luisiana,F,100,6,0,6
Rylynne,F,100,38,0,38
Khandra,F,100,5,0,5
Adren,M,100,0,239,239
Ahmaria,F,100,33,0,33
Amba,F,100,10,0,10
Dawny,F,100,10,0,10
Abeal,M,100,0,5,5
Macksen,M,100,0,8,8
Jakavian,M,100,0,11,11
Saranda,F,100,93,0,93
Avett,M,96,7,175,182
Scottlyn,F,100,141,0,141
Quanteria,F,100,58,0,58
Amoya,F,100,32,0,32
Adisa,F,58,89,64,153
Verniece,F,100,21,0,21
Bopha,F,100,45,0,45
Cuthbert,M,100,0,6,6
Pauljohn,M,100,0,11,11
India,F,100,19838,27,19865
Alain,M,100,6,3361,3367
Radek,M,100,0,117,117
Evangelin,F,100,43,0,43
Audey,M,100,0,12,12
Jaleiya,F,100,26,0,26
Raji,M,100,0,112,112
Deus,M,100,0,11,11
Jakab,M,100,0,6,6
Cheridyn,F,100,5,0,5
Austreberto,M,100,0,16,16
Kadiatou,F,100,350,0,350
Tahleah,F,100,17,0,17
Ambert,F,100,145,0,145
Darly,M,61,67,104,171
Shilynn,F,100,154,0,154
Magaby,F,100,132,0,132
Weiland,M,100,0,49,49
Camie,F,100,1568,0,1568
Lateek,M,100,0,6,6
Joellen,F,100,4015,0,4015
Shahna,F,100,41,0,41
Reeve,M,81,126,525,651
Raehanna,F,100,7,0,7
Trayven,M,100,0,104,104
Leiyla,F,100,6,0,6
Trenady,F,100,36,0,36
Milika,F,100,105,0,105
Fili,M,100,0,5,5
Jayro,M,100,0,557,557
Charmion,F,100,137,0,137
Adelais,F,100,10,0,10
Kalayah,F,100,410,0,410
Kiahna,F,100,415,0,415
Ilaina,F,100,43,0,43
Caelen,M,87,61,426,487
Taysom,M,100,0,66,66
Marquitha,F,100,5,0,5
Shariq,M,100,0,90,90
Irany,F,100,21,0,21
Donette,F,100,952,0,952
Axyl,M,100,0,103,103
Azana,F,100,136,0,136
Malae,F,100,27,0,27
Tenay,F,100,44,0,44
Jakarius,M,100,0,80,80
Yansi,F,100,15,0,15
Minisha,F,100,6,0,6
Makaylin,F,100,326,0,326
Amr,M,100,0,738,738
Chinwe,F,100,148,0,148
Joplynn,F,100,6,0,6
Dayyan,M,100,0,69,69
Charlynda,F,100,5,0,5
Guthrie,M,100,0,479,479
Brttany,F,100,12,0,12
Bacilio,M,100,0,122,122
Clennon,M,100,0,31,31
Ziggy,M,98,6,333,339
Anailah,F,100,20,0,20
Garney,M,100,0,10,10
Anistasia,F,100,30,0,30
Greenly,F,100,118,0,118
Dashaya,F,100,21,0,21
Tenyce,F,100,5,0,5
Terriq,M,100,0,9,9
Kayloni,F,100,276,0,276
Allateef,M,100,0,5,5
Shykeyla,F,100,6,0,6
Chisholm,M,100,0,11,11
Dailah,F,100,41,0,41
Jermelle,M,100,0,48,48
Genova,F,100,57,0,57
Siah,F,55,97,80,177
Lierra,F,100,6,0,6
Shaynell,F,100,6,0,6
Dhananjay,M,100,0,5,5
Danziel,M,100,0,5,5
Shakya,F,100,178,0,178
Karolyne,F,100,185,0,185
Kareli,F,100,294,0,294
Dairyn,F,100,25,0,25
Aquala,F,100,5,0,5
Breklynn,F,100,8,0,8
Morolaoluwa,F,100,5,0,5
Daryan,M,62,260,419,679
Tsitsiki,F,100,8,0,8
Rhasaan,M,100,0,14,14
Twayne,M,100,0,15,15
Benji,M,96,47,1290,1337
Sinjin,M,100,0,364,364
Marbin,M,100,0,153,153
Itzelt,F,100,6,0,6
Jomaira,F,100,56,0,56
Ayhan,M,100,0,14,14
Charliese,F,100,10,0,10
Kimberlyann,F,100,393,0,393
Joneka,F,100,18,0,18
Teriq,M,100,0,59,59
Douglus,M,100,0,5,5
Kalaijah,F,100,5,0,5
Savior,M,100,0,225,225
Samamtha,F,100,92,0,92
Dunya,F,100,278,0,278
Dianca,F,100,110,0,110
Krishina,F,100,5,0,5
Marelys,F,100,8,0,8
Nazeir,M,100,0,11,11
Jefrey,M,100,0,757,757
Kamile,F,100,158,0,158
Sesen,F,100,20,0,20
Micahla,F,100,40,0,40
Astrea,F,100,34,0,34
Jaliya,F,100,468,0,468
Makaylyn,F,100,183,0,183
Honest,F,61,46,29,75
Healy,F,100,38,0,38
Sheteka,F,100,7,0,7
Tyneil,M,100,0,5,5
Rosalita,F,100,134,0,134
Karidee,F,100,13,0,13
Karsen,M,59,1296,1852,3148
Emiline,F,100,201,0,201
Bradely,M,100,0,60,60
Dmetrius,M,100,0,70,70
Jarianna,F,100,40,0,40
Beonca,F,100,151,0,151
Joshuea,M,100,0,16,16
Kahlea,F,100,182,0,182
Mishon,M,67,28,56,84
Katlynne,F,100,213,0,213
Larua,F,100,207,0,207
Loras,M,100,0,92,92
Ashantai,F,100,10,0,10
Travona,F,100,10,0,10
Winferd,M,100,0,72,72
Camila,F,100,44196,40,44236
Milena,F,100,3740,0,3740
Rhanda,F,100,146,0,146
Pahal,F,100,25,0,25
Kensli,F,100,84,0,84
Zyquez,M,100,0,38,38
Dellana,F,100,5,0,5
Dacien,M,100,0,11,11
Bristal,F,100,179,0,179
Hobbie,M,100,0,5,5
Esgardo,M,100,0,39,39
Landric,M,100,0,23,23
Kortnei,F,100,41,0,41
Tyki,M,100,0,16,16
Samridh,M,100,0,11,11
Joshwa,M,100,0,444,444
Dameon,M,100,0,4003,4003
Jahrell,M,100,0,167,167
Dakotah,M,62,1720,2825,4545
Zymal,F,100,15,0,15
Onyae,F,100,15,0,15
Wick,M,100,0,13,13
Nijal,M,100,0,38,38
Zyonne,M,100,0,5,5
Dain,M,100,0,1802,1802
Renezmee,F,100,17,0,17
Jahyr,M,100,0,5,5
Myeisha,F,100,1087,0,1087
Jaileigh,F,100,50,0,50
Zaren,M,100,0,25,25
Amielle,F,100,10,0,10
Varna,F,100,5,0,5
Free,M,51,44,46,90
Jakarra,F,100,47,0,47
Denvil,M,100,0,16,16
Jahna,F,100,409,0,409
Virgle,M,100,0,305,305
Alisandra,F,100,353,0,353
Amirah,F,100,5175,0,5175
Abhimanyu,M,100,0,142,142
Dori,F,100,4792,0,4792
Shante,F,96,5795,216,6011
Ajavian,M,100,0,12,12
Shalisia,F,100,5,0,5
Camilah,F,100,103,0,103
Brendolyn,F,100,90,0,90
Keimarion,M,100,0,51,51
Agron,M,100,0,133,133
Jaonna,F,100,100,0,100
Shatiek,M,100,0,5,5
Temar,M,100,0,13,13
Aarnav,M,100,0,359,359
Saffire,F,100,32,0,32
Yareni,F,100,349,0,349
Tanushri,F,100,16,0,16
Shevawn,F,100,128,0,128
Alf,M,100,0,139,139
Jazir,M,100,0,131,131
Aryash,M,100,0,14,14
Eugene,M,99,793,115936,116729
Kashay,F,100,183,0,183
Adhem,M,100,0,11,11
Sindy,F,100,2619,0,2619
Nakera,F,100,30,0,30
Diomedes,M,100,0,21,21
Damarquez,M,100,0,5,5
Mario,M,99,1006,125762,126768
Kyndle,F,97,434,12,446
Makelah,F,100,5,0,5
Cosandra,F,100,135,0,135
Zahira,F,100,819,0,819
Refael,M,100,0,130,130
Jerisha,F,100,60,0,60
Kortlynn,F,100,65,0,65
Kath,F,100,38,0,38
Jaqualla,F,100,12,0,12
Jaella,F,100,63,0,63
Keacha,F,100,6,0,6
Aleisha,F,100,2805,0,2805
Culleen,F,100,5,0,5
Solangel,F,100,105,0,105
Shalay,F,100,112,0,112
Star,F,98,6735,105,6840
Marykay,F,100,813,0,813
Amaurie,M,56,68,85,153
Deyvion,M,100,0,24,24
Malayna,F,100,1019,0,1019
Kujuan,M,100,0,6,6
Jamikka,F,100,5,0,5
Prianka,F,100,39,0,39
Meliana,F,100,53,0,53
Joleah,F,100,94,0,94
Shery,F,100,360,0,360
Racqual,F,100,5,0,5
Ikeisha,F,100,69,0,69
Claribelle,F,100,6,0,6
Kinzly,F,100,46,0,46
Latrenda,F,100,485,0,485
Natelee,F,100,6,0,6
Tyner,M,100,0,93,93
Klah,F,100,6,0,6
Shanelly,F,100,31,0,31
Legrant,M,100,0,5,5
Tynia,F,100,565,0,565
Zoeey,F,100,20,0,20
Arquimedes,M,100,0,5,5
Mabil,F,100,5,0,5
Hadya,F,100,15,0,15
Dakeisha,F,100,18,0,18
Jesenia,F,100,4524,6,4530
Shamaiah,F,100,6,0,6
Lealon,M,100,0,32,32
Crisbel,F,100,10,0,10
Melitta,F,100,83,0,83
Leotha,M,61,22,35,57
Kevari,M,100,0,6,6
Harshita,F,100,177,0,177
Tomoka,F,100,11,0,11
Pavithra,F,100,49,0,49
Darvel,M,100,0,19,19
Dundre,M,100,0,5,5
Darrie,M,84,21,109,130
Deiby,M,100,0,5,5
Mehmed,M,100,0,24,24
Annisten,F,100,51,0,51
Zirel,F,100,12,0,12
Adalya,F,100,10,0,10
Kofi,M,100,5,1137,1142
Elaine,F,100,110076,236,110312
Alye,F,100,6,0,6
Illijah,M,100,0,10,10
Kycia,F,100,5,0,5
Kayleana,F,100,88,0,88
Manford,M,100,0,214,214
Maddisen,F,100,499,0,499
Linnette,F,100,1045,0,1045
Holter,M,100,0,6,6
Maksymilian,M,100,0,298,298
Yadel,M,100,0,31,31
Adalay,F,100,87,0,87
Payden,M,67,557,1115,1672
Desmond,M,99,233,28945,29178
Aniiya,F,100,22,0,22
Jaidel,M,100,0,5,5
Jarmall,M,100,0,17,17
Taneria,F,100,15,0,15
Sheyli,F,100,94,0,94
Beckhem,M,100,0,36,36
Zabelle,F,100,5,0,5
Huxlee,F,100,5,0,5
Melora,F,100,323,0,323
Isham,M,100,0,112,112
Tajiana,F,100,44,0,44
Amnah,F,100,100,0,100
Tinnelle,F,100,5,0,5
Daejhun,M,100,0,18,18
Atiyah,F,100,186,0,186
Luisalejandro,M,100,0,11,11
Faelyn,F,100,65,0,65
Irayda,F,100,6,0,6
Krayson,M,100,0,5,5
Tyshae,F,100,229,0,229
Kairi,F,92,2673,240,2913
Mirissa,F,100,222,0,222
Kamarion,M,100,6,1458,1464
Laken,F,82,4373,954,5327
Termaine,M,98,13,660,673
Mallerly,F,100,11,0,11
Genet,F,100,37,0,37
Lanvy,F,100,5,0,5
Crystalin,F,100,31,0,31
Leeam,M,100,0,138,138
Devario,M,100,0,115,115
Yujin,F,100,35,0,35
Eyden,M,97,5,139,144
Josephina,F,100,2064,0,2064
Corrigan,M,82,38,171,209
Amondo,M,100,0,14,14
Ailise,F,100,6,0,6
Kassady,F,100,265,0,265
Alaynna,F,100,441,0,441
Graciee,F,100,12,0,12
Tristam,M,100,0,5,5
Abdirahman,M,100,0,1301,1301
Shadaria,F,100,43,0,43
Lillyrose,F,100,24,0,24
Izaeah,M,100,0,25,25
Jaquwan,M,100,0,10,10
Wilner,M,100,0,27,27
Virlee,F,100,5,0,5
Setareh,F,100,145,0,145
Dajsha,F,100,100,0,100
Ronnald,M,100,0,455,455
Malarie,F,100,727,0,727
Marabelle,F,100,56,0,56
Tylan,M,94,145,2274,2419
Urian,M,100,0,265,265
Rohma,F,100,5,0,5
Okema,F,100,71,0,71
Marlia,F,100,59,0,59
Dortha,F,100,531,0,531
Carvin,M,100,0,459,459
Aroldo,M,100,0,105,105
Sheona,F,100,28,0,28
Joason,M,100,0,5,5
Franchell,F,100,16,0,16
Ranezmay,F,100,7,0,7
Deanise,F,100,10,0,10
Demariana,F,100,5,0,5
Yovanna,F,100,286,0,286
Deari,F,89,40,5,45
Jethroe,M,100,0,6,6
Saharah,F,100,126,0,126
Jinnifer,F,100,148,0,148
Keilia,F,100,5,0,5
Vaneeza,F,100,15,0,15
Megale,M,100,0,5,5
Eryn,F,98,6459,146,6605
Moriana,F,100,5,0,5
Tacari,M,82,17,79,96
Makayia,F,100,90,0,90
Tevyn,M,98,5,232,237
Janarius,M,100,0,24,24
Aquera,F,100,5,0,5
Jonathanmichael,M,100,0,25,25
Elshaddai,M,100,0,6,6
Zymeir,M,100,0,90,90
Wytina,F,100,10,0,10
Sayen,F,100,5,0,5
Markeyta,F,100,46,0,46
Zakarie,M,100,0,142,142
Khmari,M,100,0,39,39
Victorria,F,100,11,0,11
Blerta,F,100,23,0,23
Kaylian,F,100,5,0,5
Sharinda,F,100,5,0,5
Lajoyce,F,100,251,0,251
Dawin,M,100,0,12,12
Mehwish,F,100,46,0,46
Paresh,M,100,0,32,32
Sherlee,F,100,6,0,6
Darnika,F,100,32,0,32
Endri,M,100,0,6,6
Solee,F,100,6,0,6
Madaleine,F,100,182,0,182
Shakeeta,F,100,147,0,147
Jashawn,M,98,34,1938,1972
Addai,M,100,0,16,16
Chariss,F,100,38,0,38
Tiegan,F,70,183,77,260
Yary,F,100,10,0,10
Renezmay,F,100,12,0,12
Shavette,F,100,101,0,101
Denario,M,100,0,95,95
Roynell,M,100,0,20,20
Jazyria,F,100,11,0,11
Shambra,F,100,34,0,34
Jahari,M,91,108,1030,1138
Laquez,M,100,0,20,20
Audryna,F,100,141,0,141
Krysten,F,100,3943,0,3943
Daejuan,M,100,0,47,47
Kahmari,M,71,78,195,273
Dan,M,100,261,60859,61120
Roniyah,F,100,184,0,184
Marissia,F,100,64,0,64
Koleson,M,100,0,81,81
Lekedia,F,100,5,0,5
Arabelle,F,100,741,0,741
Jayvonna,F,100,5,0,5
Josetta,F,100,429,0,429
Leba,F,100,94,0,94
Hervin,M,100,0,53,53
Aava,F,100,68,0,68
Maicey,F,100,69,0,69
Shron,F,100,97,0,97
Burnadette,F,100,101,0,101
Lonzel,M,100,0,5,5
Adhiraj,M,100,0,6,6
Rimya,F,100,6,0,6
Greenleigh,F,100,110,0,110
Zechary,M,100,0,25,25
Briza,F,100,1137,0,1137
Shiyann,F,100,5,0,5
Najilah,F,100,5,0,5
Allye,F,100,199,0,199
Sativa,F,100,564,0,564
Bennette,F,78,40,11,51
Patrese,F,100,123,0,123
Jillion,F,100,22,0,22
Dewaine,M,100,0,306,306
Jalexi,F,100,13,0,13
Paulyn,F,100,5,0,5
Brayson,M,100,0,1512,1512
Dierks,M,100,0,112,112
Javez,M,100,0,15,15
Lauren,F,99,457238,3272,460510
Olvia,F,100,20,0,20
Mikele,F,60,64,42,106
Madlin,F,100,22,0,22
Anysa,F,100,207,0,207
Doniell,F,100,5,0,5
Sharal,F,100,16,0,16
Nysia,F,100,65,0,65
Brandylynn,F,100,6,0,6
Kyven,M,100,0,21,21
Daisymae,F,100,15,0,15
Nir,M,100,0,43,43
Braydon,M,100,23,11755,11778
Ananda,F,96,1532,71,1603
Jaronte,M,100,0,5,5
Naiana,F,100,5,0,5
Lugenia,F,100,187,0,187
Deyon,M,98,11,467,478
Cicero,M,100,0,244,244
Treyonna,F,100,33,0,33
Jenan,F,100,233,0,233
Leylanni,F,100,13,0,13
Danayah,F,100,123,0,123
Ahnesty,F,100,61,0,61
Silton,M,100,0,6,6
Kaina,F,100,204,0,204
Jishnu,M,100,0,56,56
Shelisa,F,100,391,0,391
Cheskel,M,100,0,431,431
Rashawna,F,100,349,0,349
Ladreama,F,100,5,0,5
Delvin,M,99,22,4009,4031
Magali,F,100,3190,6,3196
Zachiary,M,100,0,5,5
Slaten,M,100,0,22,22
Madalin,F,100,435,0,435
Shiheem,M,100,0,75,75
Marely,F,100,2436,0,2436
Jessamarie,F,100,5,0,5
Tanitra,F,100,35,0,35
Effie,F,100,3737,7,3744
Christos,M,100,0,2285,2285
Tresor,F,50,5,5,10
Morghen,F,100,5,0,5
Tru,F,53,731,646,1377
Lutece,F,100,17,0,17
Aubriauna,F,100,55,0,55
Finton,M,100,0,34,34
Lahoma,F,100,479,0,479
Kaysea,F,100,134,0,134
Hattie,F,100,11529,16,11545
Ameliah,F,100,298,0,298
Sacia,F,100,11,0,11
Keree,F,100,5,0,5
Shamari,F,58,953,695,1648
Casia,F,100,211,0,211
Andee,F,100,878,0,878
Mireily,F,100,23,0,23
Artie,M,80,539,2093,2632
Devree,F,100,15,0,15
Uneka,F,100,6,0,6
Daneil,M,97,32,1150,1182
Auralia,F,100,17,0,17
Coire,M,100,0,6,6
Jysiah,M,100,0,7,7
Arnell,M,74,331,938,1269
Elliston,M,100,0,7,7
Cheryal,F,100,126,0,126
Munasar,M,100,0,18,18
Florice,F,100,44,0,44
Kambry,F,100,338,0,338
Kess,F,100,63,0,63
Anjela,F,100,550,0,550
Ane,F,100,255,0,255
Mathyis,M,100,0,5,5
Coreyanna,F,100,12,0,12
Alphonzo,M,100,0,1374,1374
Taundra,F,100,37,0,37
Antionette,F,100,7407,0,7407
Janeliz,F,100,159,0,159
Kourosh,M,100,0,146,146
Antaysia,F,100,5,0,5
Zandyn,M,100,0,27,27
Selvin,M,100,0,928,928
Osaze,M,100,0,76,76
Kevanna,F,100,15,0,15
Emerey,F,100,18,0,18
Analaya,F,100,60,0,60
Pecola,F,100,131,0,131
Daneel,M,100,0,11,11
Saxton,M,100,0,424,424
Juanesha,F,100,16,0,16
Giorgi,M,100,0,40,40
Collett,F,100,41,0,41
Jourdyn,F,82,533,117,650
Peron,M,100,0,5,5
Brishen,M,100,0,7,7
Karnel,M,100,0,5,5
Aking,M,100,0,82,82
Savier,M,100,0,207,207
Jesaiah,M,100,0,139,139
Aleiyah,F,100,312,0,312
Brensen,M,100,0,10,10
Alhan,M,100,0,10,10
Sharon,F,100,467039,1884,468923
Naim,M,100,0,1829,1829
Perette,F,100,16,0,16
Sahily,F,100,74,0,74
Davonya,F,100,16,0,16
Nicolina,F,100,913,0,913
Javares,M,100,0,219,219
Caulen,M,100,0,11,11
Amarielle,F,100,28,0,28
Delberta,F,100,104,0,104
Taryn,F,97,24230,637,24867
Janaris,M,100,0,5,5
Kimorra,F,100,24,0,24
Tuscan,M,100,0,5,5
Tranea,F,100,5,0,5
Quartey,M,100,0,5,5
Tara,F,100,172602,543,173145
Deangilo,M,100,0,14,14
Tatania,F,100,7,0,7
Veera,F,100,143,0,143
Raychell,F,100,163,0,163
Nykeya,F,100,5,0,5
Mekal,M,100,0,17,17
Tajai,M,51,147,155,302
Audrinah,F,100,17,0,17
Vondre,M,100,0,17,17
Amen,M,65,247,466,713
Karinda,F,100,92,0,92
Bryndis,F,100,5,0,5
Rmani,F,69,165,73,238
Allyssah,F,100,11,0,11
Ellene,F,100,136,0,136
Siyona,F,100,245,0,245
Aliceson,F,100,213,0,213
Niccole,F,100,1352,0,1352
Quanetra,F,100,5,0,5
Kaiiden,M,100,0,6,6
Tanavia,F,100,10,0,10
Vaness,F,100,293,0,293
Kenasia,F,100,164,0,164
Concepsion,F,100,5,0,5
Yukary,F,100,5,0,5
Mistala,F,100,5,0,5
Rontarius,M,100,0,5,5
Damasio,M,100,0,6,6
Monira,F,100,10,0,10
Gwendylan,F,100,26,0,26
Ceth,M,100,0,58,58
Tadeo,M,100,0,995,995
Krystopher,M,100,0,653,653
Astryd,F,100,55,0,55
Jarren,M,99,10,1945,1955
Lilleeana,F,100,5,0,5
Tayisha,F,100,5,0,5
Laiklyn,F,100,43,0,43
Randal,M,100,127,26535,26662
Baneza,F,100,77,0,77
Juli,F,100,6092,0,6092
Uniqua,F,100,488,0,488
Burlene,F,100,10,0,10
Jamani,M,54,225,264,489
Kenia,F,100,6851,12,6863
Perl,F,100,320,0,320
Bartolome,M,100,0,26,26
Jezlyn,F,100,117,0,117
Macaylah,F,100,47,0,47
Annabelle,F,100,33777,10,33787
Yoo,F,100,12,0,12
Clairissa,F,100,475,0,475
Amijah,F,100,93,0,93
Kor,M,100,0,5,5
Lucchese,F,100,5,0,5
Jazmein,F,100,5,0,5
Tyle,M,100,0,48,48
Nuriyah,F,100,36,0,36
Rejeania,F,100,5,0,5
Mistey,F,100,72,0,72
Giddeon,M,100,0,30,30
Taryl,M,100,0,5,5
Quanishia,F,100,5,0,5
Anab,F,100,63,0,63
Kattya,F,100,37,0,37
Norhan,F,100,50,0,50
Keyani,F,100,242,0,242
Damone,M,100,0,1165,1165
Shaniquea,F,100,27,0,27
Tralaya,F,100,5,0,5
Prather,M,100,0,12,12
Nani,F,100,391,0,391
Anoki,M,100,0,5,5
Ellea,F,100,36,0,36
Itcel,F,100,40,0,40
Rechel,F,100,144,0,144
Daivik,M,100,0,30,30
Chadron,M,100,0,25,25
Caroyl,F,100,11,0,11
Payal,F,100,668,0,668
Amaryllis,F,100,808,0,808
Eiliana,F,100,49,0,49
Aleaha,F,100,707,0,707
Marqel,M,100,0,23,23
Damareon,M,100,0,134,134
Bellagrace,F,100,74,0,74
Halyna,F,100,5,0,5
Tanari,F,100,11,0,11
Cupid,M,100,0,6,6
Jolanda,F,100,985,0,985
Janise,F,100,1823,0,1823
Vernonica,F,100,44,0,44
Adyline,F,100,54,0,54
Willi,M,100,0,129,129
Dashira,F,100,28,0,28
Kimon,M,100,0,121,121
Dequasha,F,100,5,0,5
Macayla,F,100,2044,0,2044
Maliyah,F,100,8162,0,8162
Romen,M,100,0,282,282
Nyzeria,F,100,17,0,17
Enda,F,100,99,0,99
Dequone,M,100,0,5,5
Jasalyn,F,100,193,0,193
Jakema,F,100,13,0,13
Chondra,F,100,219,0,219
Tirza,F,100,311,0,311
Jakobi,M,98,29,1264,1293
Dalal,F,100,308,0,308
Dezrae,F,100,45,0,45
Juquan,M,100,0,186,186
Kelsye,F,100,112,0,112
Josemaria,M,100,0,483,483
Davanee,F,100,143,0,143
Kwami,M,100,0,34,34
Deedrick,M,100,0,12,12
Sherif,M,100,0,365,365
Cung,M,100,0,41,41
Saroeun,M,100,0,10,10
Nechole,F,100,30,0,30
Jayshaun,M,100,0,540,540
Jozalynn,F,100,70,0,70
Shiho,F,100,10,0,10
Kendly,M,100,0,5,5
Masheka,F,100,23,0,23
Ireon,F,75,15,5,20
Leanda,F,100,215,0,215
Redding,M,100,0,65,65
Gia,F,100,11894,5,11899
Amellia,F,100,450,0,450
Andrae,M,98,41,1960,2001
Paola,F,99,21374,148,21522
Tiane,F,100,71,0,71
Junelle,F,100,164,0,164
Tynetta,F,100,307,0,307
Jerely,F,100,6,0,6
Maizey,F,100,206,0,206
Lyndah,F,100,7,0,7
Janeisa,F,100,5,0,5
Keetra,F,100,11,0,11
Srihith,M,100,0,51,51
Tarrus,M,100,0,12,12
Danysha,F,100,36,0,36
Adlea,F,100,5,0,5
Kataleyah,F,100,38,0,38
Eilyn,F,100,100,0,100
Sharareh,F,100,10,0,10
Gabino,M,100,0,1947,1947
Tegen,M,86,5,32,37
Adelinne,F,100,10,0,10
Mackinzey,F,100,10,0,10
Rockeem,M,100,0,19,19
Addy,F,98,1022,16,1038
Lataija,F,100,44,0,44
Valley,F,100,103,0,103
Olander,M,100,0,68,68
Jacodi,M,100,0,5,5
Hawley,F,80,61,15,76
Itiel,M,100,0,29,29
Anuska,F,100,13,0,13
Charmen,F,100,38,0,38
Sarahelizabeth,F,100,247,0,247
Ryuji,M,100,0,12,12
Clifford,M,99,476,77299,77775
Amillianna,F,100,12,0,12
Johnfrancis,M,100,0,11,11
Nouran,F,100,17,0,17
Vanetta,F,100,899,0,899
Amelda,F,100,32,0,32
Vence,M,100,0,67,67
Chandlyr,F,100,13,0,13
Xamiyah,F,100,5,0,5
Whittley,F,100,64,0,64
Shatona,F,100,88,0,88
Jahshaun,M,100,0,10,10
Joshia,M,100,0,141,141
Jyson,M,100,0,33,33
Phalyn,F,100,40,0,40
Ataja,F,100,6,0,6
Lamicheal,M,100,0,15,15
Sherice,F,100,1505,0,1505
Zeana,F,100,26,0,26
Blaikley,F,100,26,0,26
Florestine,F,100,49,0,49
Brendell,F,79,19,5,24
Angeldavid,M,100,0,11,11
Jameek,M,100,0,120,120
Aislinn,F,100,3038,0,3038
Randarius,M,100,0,49,49
Tate,M,94,912,14909,15821
Toshina,F,100,21,0,21
Gazelle,F,100,38,0,38
Ivana,F,100,5693,0,5693
Olesya,F,100,82,0,82
Naylea,F,100,332,0,332
Elissha,F,100,5,0,5
Laquieta,F,100,12,0,12
Camile,F,100,824,0,824
Exodus,M,87,31,204,235
Rikin,M,100,0,10,10
Lansana,M,100,0,21,21
Shaquila,F,100,405,0,405
Benae,F,100,10,0,10
Burleigh,M,100,0,69,69
Cerys,F,100,147,0,147
Matison,F,100,337,0,337
Ysatis,F,100,24,0,24
Landon,M,99,687,128903,129590
Lougenia,F,100,15,0,15
Tarisha,F,100,237,0,237
Kimberlina,F,100,19,0,19
Gyllian,F,100,29,0,29
Kimsey,M,100,0,43,43
Carmalita,F,100,374,0,374
Luzette,F,100,5,0,5
Lylla,F,100,79,0,79
Sanaiya,F,100,278,0,278
Farouk,M,100,0,176,176
Lareka,F,100,23,0,23
Geneane,F,100,6,0,6
Jaxsen,M,99,6,1038,1044
Dermot,M,100,0,411,411
Zuzu,F,100,137,0,137
Hilaree,F,100,44,0,44
Dorren,F,67,10,5,15
Lana,F,100,37405,5,37410
Jahnay,F,100,179,0,179
Mackinlee,F,100,27,0,27
Kieyana,F,100,18,0,18
Herlaine,F,100,5,0,5
Taymar,M,57,32,42,74
Baggio,M,100,0,12,12
Sandrell,F,100,7,0,7
Moira,F,100,6183,0,6183
Josline,F,100,28,0,28
Kahniya,F,100,22,0,22
Sarahlyn,F,100,17,0,17
Elika,F,100,320,0,320
Mihcael,M,100,0,75,75
Taranique,F,100,5,0,5
Eislee,F,100,8,0,8
Oluwakemi,F,100,216,0,216
Keontez,M,100,0,12,12
Ruark,M,100,0,14,14
Godiva,F,100,5,0,5
Analiesa,F,100,5,0,5
Fremont,M,100,0,48,48
Javontae,M,100,0,1327,1327
Kristiina,F,100,10,0,10
Zacori,M,100,0,10,10
Madelon,F,100,457,0,457
Edelia,F,100,32,0,32
Valin,M,96,5,107,112
Roblyn,F,100,59,0,59
Lecharles,M,100,0,10,10
Adaira,F,100,128,0,128
Tylayshia,F,100,5,0,5
Chaneice,F,100,19,0,19
Mossie,F,100,18,0,18
Jayvian,M,100,0,738,738
Berenice,F,100,6700,11,6711
Amorion,M,100,0,49,49
Asaria,F,100,5,0,5
Alecsander,M,100,0,235,235
Talanda,F,100,53,0,53
Ryenn,F,100,167,0,167
Lima,F,100,13,0,13
Shahn,M,100,0,34,34
Jamyleth,F,100,6,0,6
Tiferet,F,100,15,0,15
Aradia,F,100,99,0,99
Dixee,F,100,15,0,15
Bernda,F,100,5,0,5
Madix,M,100,0,293,293
Drekwon,M,100,0,10,10
Annarae,F,100,46,0,46
Rumor,F,100,42,0,42
Deyanna,F,100,290,0,290
Rattana,M,100,0,7,7
Asucena,F,100,442,0,442
Aoki,F,100,97,0,97
Lauria,F,100,275,0,275
Royalty,F,75,257,84,341
Tonesha,F,100,359,0,359
Quentisha,F,100,6,0,6
Shadavia,F,100,110,0,110
Novel,M,100,0,18,18
Onita,F,100,381,0,381
Murdoch,M,100,0,20,20
Azenet,F,100,14,0,14
Anyeli,F,100,231,0,231
Akshar,M,100,0,358,358
Jalyssia,F,100,11,0,11
Indeya,F,100,38,0,38
Tamai,F,100,16,0,16
Markevus,M,100,0,5,5
Ashai,F,71,15,6,21
Uriyah,M,73,71,192,263
Aryaveer,M,100,0,12,12
Girard,M,100,0,857,857
Zhanaya,F,100,5,0,5
Zahrya,F,100,25,0,25
Berry,M,95,155,2789,2944
Saheli,F,100,46,0,46
Jovante,M,100,0,404,404
Shenica,F,100,132,0,132
Jove,M,100,0,97,97
Samreet,F,100,7,0,7
Zyen,M,100,0,69,69
Sory,M,100,0,5,5
Zayvon,M,100,0,84,84
Jerrison,M,100,0,10,10
Jiaqi,F,100,19,0,19
Josephpatrick,M,100,0,5,5
Topazio,F,100,5,0,5
Venassa,F,100,6,0,6
Ayman,M,98,28,1474,1502
Kearria,F,100,10,0,10
Sameera,F,100,589,0,589
Wakana,F,100,20,0,20
Kesler,M,100,0,181,181
Everard,M,100,0,63,63
Everson,M,100,0,241,241
Katiann,F,100,27,0,27
Hugues,M,100,0,10,10
Lawarren,M,100,0,6,6
Janann,F,100,80,0,80
Kaleth,M,100,0,33,33
Pawnee,F,100,10,0,10
Antroine,M,100,0,12,12
Brailee,F,100,394,0,394
Daejia,F,100,15,0,15
Laurelai,F,100,32,0,32
Aivley,F,100,5,0,5
Tamell,M,100,0,5,5
Deangelio,M,100,0,12,12
Lindsay,F,98,128164,3226,131390
Glennis,F,72,726,283,1009
October,F,100,666,0,666
Layten,M,92,17,206,223
Tieson,M,100,0,6,6
Aadiv,M,100,0,11,11
Mieke,F,100,230,0,230
Dustee,F,100,79,0,79
Jhalen,M,100,0,72,72
Tanija,F,100,315,0,315
Isajah,M,100,0,5,5
Angelyse,F,100,103,0,103
Iffat,F,100,11,0,11
Dotsie,F,100,5,0,5
Carmichael,M,100,0,191,191
Travina,F,100,28,0,28
Xiola,F,100,34,0,34
Grainger,M,100,0,26,26
Novi,F,100,8,0,8
Calik,M,100,0,10,10
Mckai,M,100,0,40,40
Rashona,F,100,22,0,22
Jmia,F,100,12,0,12
Germey,M,100,0,5,5
Jamad,M,100,0,23,23
Laurey,F,100,225,0,225
Tilly,F,100,609,0,609
Jlyssa,F,100,6,0,6
Millani,F,100,28,0,28
Arib,M,100,0,42,42
Taemon,M,100,0,10,10
Ariena,F,100,22,0,22
Tekisha,F,100,340,0,340
Temeko,F,100,5,0,5
Ayona,F,100,278,0,278
Sevren,M,100,0,25,25
Hettie,F,100,533,0,533
Janaira,F,100,6,0,6
Berthold,M,100,0,10,10
Anastasya,F,100,105,0,105
Oakleigh,F,100,259,0,259
Tawnie,F,100,871,0,871
Nastacia,F,100,136,0,136
Samaad,M,100,0,140,140
Rubio,M,100,0,5,5
Shawnell,F,92,248,21,269
Vilmarie,F,100,15,0,15
Hazal,F,100,12,0,12
Lj,M,100,0,143,143
Shauntell,F,100,266,0,266
Myshae,F,100,6,0,6
Alvar,M,100,0,5,5
Twanda,F,100,1351,0,1351
Breydon,M,100,0,512,512
Anacarolina,F,100,121,0,121
Leayah,F,100,23,0,23
Tehya,F,100,1882,0,1882
Avabella,F,100,72,0,72
Emrik,M,100,0,39,39
Olujimi,M,100,0,17,17
Alivya,F,100,226,0,226
Ceji,F,100,15,0,15
Aniruddh,M,100,0,61,61
Quacy,M,100,0,5,5
Indyia,F,100,55,0,55
Shanya,F,100,2028,0,2028
Chastelyn,F,100,158,0,158
Loudes,F,100,6,0,6
Greenlee,F,100,588,0,588
Faelynn,F,100,45,0,45
Farrow,M,100,0,5,5
Coletyn,M,100,0,12,12
Ulani,F,100,191,0,191
Petronila,F,100,5,0,5
Kejaun,M,100,0,15,15
Lashey,F,100,16,0,16
Calev,M,100,0,12,12
Shahd,F,100,432,0,432
Zaydie,F,100,20,0,20
Ikaia,M,100,0,10,10
Herberto,M,100,0,87,87
Jessy,M,71,1715,4113,5828
Alliana,F,100,497,0,497
Herb,M,100,0,846,846
Yuli,F,100,226,0,226
Kendrik,M,100,0,244,244
Wilhem,M,100,0,10,10
Rozelyn,F,100,44,0,44
Towa,M,100,0,5,5
Marquitta,F,100,1146,0,1146
Kiyaan,M,100,0,22,22
Aidia,F,100,39,0,39
Jamora,F,100,46,0,46
Weyland,M,100,0,19,19
Mackel,M,100,0,16,16
Collyn,M,81,167,713,880
Mavryck,M,100,0,8,8
Tanicia,F,100,144,0,144
Kedrick,M,100,0,2006,2006
Jazzariah,F,100,5,0,5
Jaemin,M,100,0,40,40
Garmon,M,100,0,7,7
Lotasha,F,100,15,0,15
Annelouise,F,100,10,0,10
Quion,M,100,0,52,52
Ayia,F,100,16,0,16
Meika,F,100,473,0,473
Cayleen,F,100,81,0,81
Kenrie,M,100,0,5,5
Lazaros,M,100,0,10,10
Yarenys,F,100,5,0,5
Shellia,F,100,361,0,361
Kyrstin,F,100,1268,0,1268
Roandy,M,100,0,5,5
Mikail,M,98,15,718,733
Arseno,M,100,0,5,5
Runette,F,100,32,0,32
Balint,M,100,0,7,7
Aidee,F,100,674,0,674
Morey,M,100,0,244,244
Kyandra,F,100,165,0,165
Ariani,F,100,296,0,296
Zaely,F,100,5,0,5
Najiyyah,F,100,23,0,23
Zara,F,100,6683,0,6683
Candria,F,100,15,0,15
Kimbell,M,100,0,10,10
Bolivia,F,100,5,0,5
Shaleece,F,100,6,0,6
Laurieann,F,100,410,0,410
Diarmuid,M,100,0,11,11
Lagregory,M,100,0,21,21
Bassil,M,100,0,52,52
Ninoska,F,100,106,0,106
Lyasia,F,100,48,0,48
Nolan,M,100,227,70479,70706
Tairyn,F,100,12,0,12
Chitra,F,100,33,0,33
Alizaya,F,100,101,0,101
Mckendra,F,100,53,0,53
Ralphel,M,100,0,25,25
Dhara,F,100,435,0,435
Tamiya,F,100,1571,0,1571
Deycy,F,100,6,0,6
Kavian,M,100,0,89,89
Keenon,M,100,0,533,533
Earlesha,F,100,5,0,5
Jabreya,F,100,5,0,5
Jatin,M,100,0,281,281
Mckinnly,F,100,5,0,5
Leah,F,100,185148,417,185565
Donnivan,M,100,0,60,60
Demyiah,F,100,26,0,26
Veretta,F,100,118,0,118
Kaylaanne,F,100,6,0,6
Laguita,F,100,27,0,27
Mozes,M,100,0,50,50
Tyelor,M,100,0,51,51
Mariangela,F,100,285,0,285
Minya,F,100,12,0,12
Alysiana,F,100,62,0,62
Tana,F,100,8207,6,8213
Honor,F,79,1530,398,1928
Dimond,F,100,230,0,230
Jakaylon,M,100,0,12,12
Shenaya,F,100,48,0,48
Skylah,F,100,1458,0,1458
Cludia,F,100,5,0,5
Kayleen,F,100,6319,0,6319
Christen,F,85,10984,1968,12952
Amory,F,51,384,364,748
Karlei,F,100,155,0,155
Nirmala,F,100,11,0,11
Jamien,M,99,5,435,440
Shakeal,M,100,0,45,45
Meilan,F,100,17,0,17
Anngela,F,100,51,0,51
Ruchelle,F,100,6,0,6
Parisha,F,100,66,0,66
Sacora,F,100,61,0,61
Yurianna,F,100,57,0,57
Mantas,M,100,0,23,23
Renna,F,100,858,0,858
Shenette,F,100,43,0,43
Zoeyjane,F,100,39,0,39
Steen,M,100,0,151,151
Olamae,F,100,7,0,7
Olga,F,100,20502,64,20566
Dietra,F,100,596,0,596
Eddieberto,M,100,0,43,43
Kathleenann,F,100,5,0,5
Syrette,F,100,5,0,5
Jacobus,M,100,0,111,111
Robertine,F,100,23,0,23
Charvis,M,100,0,179,179
Calea,F,100,149,0,149
Daziyah,F,100,159,0,159
Rylend,M,100,0,64,64
Latita,F,100,38,0,38
Zaaliyah,F,100,11,0,11
Oluwadarasimi,F,64,98,56,154
Yusupha,M,100,0,6,6
Corena,F,100,878,0,878
Mehak,F,100,321,0,321
Irais,F,100,535,0,535
Zamarious,M,100,0,5,5
Taggert,M,100,0,133,133
Dorance,M,100,0,19,19
Terrius,M,100,0,162,162
Cadeja,F,100,20,0,20
Teia,F,100,954,0,954
Tazio,M,100,0,13,13
Micahjoseph,M,100,0,5,5
Tyleesha,F,100,6,0,6
Rabekka,F,100,5,0,5
Mcrae,M,83,5,25,30
Renette,F,100,486,0,486
Arieanna,F,100,1075,0,1075
Shelbye,F,100,39,0,39
Anele,F,100,37,0,37
Coni,F,100,393,0,393
Levan,M,100,0,363,363
Alacyia,F,100,5,0,5
Taejah,F,100,102,0,102
Terdell,M,100,0,13,13
Raliegh,M,100,0,58,58
Hadan,M,100,0,5,5
Yandell,M,100,0,143,143
Kolya,M,70,6,14,20
Jimaya,F,100,53,0,53
Lacree,F,100,24,0,24
Hunner,M,100,0,307,307
Teresia,F,100,981,0,981
Keamber,F,100,130,0,130
Jaysha,F,100,314,0,314
Masha,F,100,335,0,335
Evenie,F,100,23,0,23
Airyonna,F,100,61,0,61
Xael,M,100,0,11,11
Zoiee,F,100,88,0,88
Maikayla,F,100,64,0,64
Shalyric,F,100,5,0,5
Myaa,F,100,13,0,13
Cayra,F,100,5,0,5
Eliany,F,100,236,0,236
Jakodi,M,100,0,5,5
Nahla,F,100,1716,0,1716
Hellena,F,100,92,0,92
Raudel,M,100,0,847,847
Heydan,M,100,0,11,11
Sukie,F,100,12,0,12
Jekia,F,100,26,0,26
Jiyan,M,100,0,12,12
Nore,M,81,5,21,26
Lenoard,M,100,0,238,238
Korene,F,100,205,0,205
Ezekiah,M,100,0,33,33
Toula,F,100,82,0,82
Nakema,F,100,75,0,75
Carleshia,F,100,11,0,11
Esam,M,100,0,51,51
Sabrenia,F,100,44,0,44
Sahaan,M,100,0,5,5
Dariel,M,88,358,2523,2881
Sal,M,100,0,2180,2180
Mayerli,F,100,87,0,87
Yaroslava,F,100,10,0,10
Edmondo,M,100,0,5,5
Jamarii,M,100,0,98,98
Niema,F,100,445,0,445
Lencola,F,100,10,0,10
Itzell,F,100,249,0,249
Shaley,F,100,664,0,664
Laiyana,F,100,16,0,16
Casimer,M,100,0,129,129
Wynter,F,98,3306,79,3385
Donti,M,100,0,13,13
Anelly,F,100,64,0,64
Jaiza,F,100,17,0,17
Zakaiyah,F,100,12,0,12
Jennalise,F,100,44,0,44
Alexendria,F,100,15,0,15
Moncerrad,F,100,5,0,5
Nuriya,F,100,47,0,47
Acein,M,100,0,5,5
Simrun,F,100,29,0,29
Zahmiya,F,100,5,0,5
Estefana,F,100,306,0,306
Fidela,F,100,82,0,82
Zolin,M,100,0,6,6
Abduljalil,M,100,0,5,5
Sheara,F,100,10,0,10
Gaeton,M,100,0,5,5
Braylah,F,100,35,0,35
Federick,M,100,0,75,75
Zoeyann,F,100,28,0,28
Hieu,M,96,28,765,793
Montevious,M,100,0,5,5
Juanita,F,100,65381,269,65650
Deanie,F,98,410,10,420
Jermyia,F,100,12,0,12
Kisha,F,100,6607,12,6619
Yahne,F,100,5,0,5
Ytzel,F,100,193,0,193
Sailyn,F,100,17,0,17
Akosha,F,100,5,0,5
Aidelyn,F,100,16,0,16
Lyniah,F,100,182,0,182
Julieann,F,100,2856,0,2856
Erineo,M,100,0,21,21
Tanikia,F,100,59,0,59
Zavious,M,100,0,11,11
Domineek,M,100,0,7,7
Laralyn,F,100,5,0,5
Latasha,F,100,30162,114,30276
Crescentia,F,100,11,0,11
Cordelra,M,100,0,6,6
Parker,M,89,10357,83150,93507
Isioma,F,100,19,0,19
Syron,M,100,0,5,5
Abdulahad,M,100,0,48,48
Sriyan,M,100,0,64,64
Linkoln,M,100,0,180,180
Khaleesi,F,100,785,0,785
Paikea,F,100,13,0,13
Jhovany,M,100,0,412,412
Johndaniel,M,100,0,83,83
Alleyah,F,100,250,0,250
Amar,M,95,166,3302,3468
Lakan,F,100,40,0,40
Senen,M,100,0,15,15
Aracele,F,100,6,0,6
Kayoni,F,100,5,0,5
Deiah,F,100,5,0,5
Jaylend,M,100,0,95,95
Finis,M,100,0,409,409
Inocencia,F,100,49,0,49
Cherilee,F,100,23,0,23
Radarius,M,100,0,22,22
Traig,M,100,0,5,5
Lennart,M,100,0,87,87
Arric,M,100,0,15,15
Dajan,M,100,0,6,6
Braxston,M,100,0,223,223
Martasia,F,100,136,0,136
Tysheem,M,100,0,154,154
Ecko,F,95,89,5,94
Chaena,F,100,6,0,6
Nechelle,F,100,295,0,295
Cruzito,M,100,0,297,297
Quinnlan,M,79,27,100,127
Pasqualino,M,100,0,22,22
Rob,M,100,0,8006,8006
Jodeci,F,52,327,296,623
Layelle,F,100,16,0,16
Tyjanea,F,100,5,0,5
Colwyn,M,100,0,48,48
Sonovia,F,100,5,0,5
Saniyya,F,100,118,0,118
Araceli,F,99,17155,138,17293
Abella,F,100,490,0,490
Appolonia,F,100,73,0,73
Jacobjames,M,100,0,5,5
Ilisa,F,100,175,0,175
Tekeyah,F,100,89,0,89
Gabe,M,100,0,2934,2934
Jaxtyn,M,100,0,151,151
Cejay,M,100,0,131,131
Kymiah,F,100,92,0,92
Nakiah,F,100,546,0,546
Ameryst,F,100,5,0,5
Gamble,M,93,5,65,70
Sakiah,F,100,35,0,35
Jakarri,M,100,0,266,266
Chrissie,F,100,1003,0,1003
Cody,M,98,4845,277558,282403
Aldus,M,100,0,5,5
Hannia,F,100,478,0,478
Geovonni,M,100,0,118,118
Geoff,M,100,0,1471,1471
Josemanuel,M,100,0,1073,1073
Nikkiya,F,100,5,0,5
Ilyjah,M,100,0,17,17
Hafeezah,F,100,34,0,34
Quinshay,F,100,10,0,10
Ellyott,F,100,18,0,18
Tajsa,F,100,6,0,6
Jerrimiah,M,100,0,30,30
Tayshia,F,100,40,0,40
Koree,F,61,344,217,561
Storii,F,100,6,0,6
Dedric,M,99,20,1769,1789
Belky,F,100,25,0,25
Jakara,F,100,442,0,442
Myki,M,100,0,6,6
Kianie,F,100,16,0,16
Teriyah,F,100,51,0,51
Lakitra,F,100,5,0,5
Yoonseo,F,100,5,0,5
Saree,F,100,135,0,135
Asfia,F,100,5,0,5
Mathan,M,100,0,135,135
Kessler,M,82,65,296,361
Syree,M,55,5,6,11
Aaila,F,100,18,0,18
Sotirios,M,100,0,252,252
Jahnaya,F,100,115,0,115
Eiljah,M,100,0,16,16
Sraavya,F,100,5,0,5
Willoughby,M,65,18,33,51
Colisha,F,100,63,0,63
Ellorie,F,100,53,0,53
Chesney,F,94,1895,116,2011
Nailah,F,100,2960,0,2960
Davie,M,84,330,1790,2120
Tiante,F,76,16,5,21
Guilbert,M,100,0,5,5
Stamatis,M,100,0,25,25
Ulyess,M,100,0,23,23
Marcela,F,100,7070,0,7070
Sadiqa,F,100,49,0,49
Oona,F,100,809,0,809
Paitlyn,F,100,37,0,37
Harleyann,F,100,37,0,37
Aryauna,F,100,32,0,32
Keyniah,F,100,11,0,11
Dameko,M,100,0,10,10
Obrien,M,100,0,182,182
Kathyrne,F,100,10,0,10
Quadell,M,100,0,10,10
Nashell,F,100,20,0,20
Havynn,F,100,18,0,18
Kentreal,M,100,0,5,5
Janaina,F,100,5,0,5
Tanna,F,100,3000,0,3000
Syreta,F,100,32,0,32
Ashleyelizabeth,F,100,8,0,8
Keeva,F,100,352,0,352
Bobby,M,97,4363,169620,173983
Edelmira,F,100,424,0,424
Yatzel,F,100,25,0,25
Mikilah,F,100,5,0,5
Karvin,M,100,0,10,10
Pedroluis,M,100,0,6,6
Lizzeth,F,100,526,0,526
Kyara,F,100,2840,0,2840
Gunnarr,M,100,0,13,13
Ersel,M,100,0,12,12
Elizette,F,100,52,0,52
Pessy,F,100,659,0,659
Berwin,M,100,0,6,6
Kristiann,F,100,206,0,206
Lamareon,M,100,0,48,48
Jozy,F,93,67,5,72
Heiden,M,100,0,20,20
Tonnia,F,100,112,0,112
Traysean,M,100,0,6,6
Tremaya,F,100,11,0,11
Hsa,M,100,0,10,10
Abren,M,100,0,6,6
Camoren,M,100,0,8,8
Hendrik,M,100,0,670,670
Kanoi,F,100,5,0,5
Awais,M,100,0,107,107
Jamore,M,100,0,13,13
Teona,F,100,845,0,845
Elyze,F,100,5,0,5
Emry,F,70,865,369,1234
Troy,M,99,2036,186381,188417
Laurett,F,100,5,0,5
Mone,F,100,493,0,493
Chelssy,F,100,11,0,11
Jazma,F,100,109,0,109
Sharlene,F,100,8789,0,8789
Chamya,F,100,119,0,119
Amarye,F,100,8,0,8
Ethanjoseph,M,100,0,9,9
Lakeshea,F,100,5,0,5
Analyssia,F,100,5,0,5
Gwenda,F,100,1578,0,1578
Cithlali,F,100,6,0,6
Widad,F,100,11,0,11
Rhodia,F,100,16,0,16
Ewart,M,100,0,5,5
Wesli,F,100,5,0,5
Renfred,M,100,0,5,5
Jared,M,100,768,195720,196488
Shadajah,F,100,7,0,7
Kaydyn,F,51,182,178,360
Renise,F,100,132,0,132
Keishonna,F,100,12,0,12
Deboah,F,100,44,0,44
Georgiy,M,100,0,35,35
Aaronjacob,M,100,0,5,5
Maisee,F,100,90,0,90
Metzi,F,100,5,0,5
Jasser,M,100,0,36,36
Royaltee,F,100,5,0,5
Crystalle,F,100,56,0,56
Georgeanthony,M,100,0,6,6
Rainn,F,59,72,51,123
Tylaysia,F,100,16,0,16
Audreana,F,100,260,0,260
Liahm,M,100,0,40,40
Annleigh,F,100,26,0,26
Jamiylah,F,100,6,0,6
Skyelynn,F,100,177,0,177
Chesica,F,100,5,0,5
Bettine,F,100,5,0,5
Gillermo,M,100,0,506,506
Natali,F,100,4215,0,4215
Kennetta,F,100,202,0,202
Lamaris,M,100,0,14,14
Jasey,F,99,472,5,477
Lutina,F,100,5,0,5
Maycol,M,100,0,81,81
Chivas,M,100,0,134,134
Breeyana,F,100,11,0,11
Mirabelle,F,100,703,0,703
Ah,F,100,11,0,11
Cherine,F,100,127,0,127
Ferid,M,100,0,5,5
Devony,F,100,123,0,123
Juleen,F,100,335,0,335
Shekevia,F,100,6,0,6
Aizel,M,100,0,5,5
Azaryah,F,75,103,35,138
Anthonique,F,100,16,0,16
Jalenn,M,100,0,10,10
Tomoya,M,100,0,68,68
Jasamine,F,100,264,0,264
Marielle,F,100,3275,0,3275
Kannen,M,100,0,127,127
Raelynn,F,100,7998,7,8005
Cylan,M,100,0,70,70
Shyla,F,100,6651,0,6651
Muadh,M,100,0,86,86
Kaben,M,100,0,6,6
Justyne,F,100,523,0,523
Christle,F,100,526,0,526
Jerneshia,F,100,5,0,5
Tenzley,F,100,6,0,6
Ardiana,F,100,12,0,12
Jahnice,F,100,28,0,28
Dameion,M,100,0,864,864
Evienne,F,100,16,0,16
Jesstina,F,100,18,0,18
Hason,M,100,0,212,212
Careen,F,100,185,0,185
Jathaniel,M,100,0,39,39
Eward,M,100,0,197,197
Julieonna,F,100,30,0,30
Jennae,F,100,350,0,350
Sophia,F,100,269849,362,270211
Reeanna,F,100,61,0,61
Katija,F,100,5,0,5
Zyheem,M,100,0,13,13
Yoel,M,100,0,2653,2653
Ishaan,M,100,0,2610,2610
Lenee,F,100,480,0,480
Isibella,F,100,6,0,6
Lori,F,100,339441,853,340294
Chylah,F,100,12,0,12
Raghav,M,100,0,802,802
Eydi,F,100,5,0,5
Tynnetta,F,100,43,0,43
Lium,M,100,0,25,25
Jacilyn,F,100,381,0,381
Ernesta,F,100,144,0,144
Dalil,M,100,0,5,5
Earnstine,F,100,25,0,25
Drilon,M,100,0,22,22
Shaeann,F,100,5,0,5
Rickyia,F,100,5,0,5
Yona,M,57,195,260,455
Aizha,F,100,7,0,7
Lemont,M,100,0,622,622
Cherif,M,100,0,17,17
Kalill,M,100,0,5,5
Cleason,M,100,0,22,22
Takeshi,M,97,5,191,196
Kasani,F,67,10,5,15
Geordan,M,90,55,523,578
Koral,F,100,693,0,693
Lashone,F,88,396,56,452
Chasadee,F,100,6,0,6
Gamari,M,100,0,6,6
Montina,F,100,214,0,214
Elgina,F,100,5,0,5
Nahzier,M,100,0,13,13
Krystabella,F,100,5,0,5
Saianish,M,100,0,5,5
Jailah,F,100,887,0,887
Dandrae,M,100,0,61,61
Rhondi,F,100,59,0,59
Mircale,F,100,44,0,44
Quennell,M,100,0,5,5
Lanese,F,100,54,0,54
Liezl,F,100,33,0,33
Keeron,M,100,0,11,11
Misaki,F,100,202,0,202
Gerld,M,100,0,16,16
Lamarea,F,100,11,0,11
Greory,M,100,0,31,31
Infantboy,M,100,0,17,17
Issacc,M,100,0,74,74
Jacqualyn,F,100,795,0,795
Krystyl,F,100,88,0,88
Ryma,F,100,5,0,5
Ursala,F,100,92,0,92
Chaysten,M,100,0,7,7
Matlyn,F,100,46,0,46
Taly,F,100,5,0,5
Kinsli,F,100,14,0,14
Markhi,M,100,0,51,51
Brianne,F,100,19948,32,19980
Zakariye,M,100,0,123,123
Tymarius,M,100,0,5,5
Leshe,F,100,6,0,6
Niyona,F,100,11,0,11
Delane,F,53,685,609,1294
Ajacia,F,100,5,0,5
Silvi,F,100,5,0,5
Emeilia,F,100,5,0,5
Imesha,F,100,10,0,10
Kaveri,F,100,46,0,46
Soana,F,100,5,0,5
Keltyn,M,100,0,23,23
Falishia,F,100,13,0,13
Lylee,F,100,91,0,91
Zaryiah,F,100,156,0,156
Avee,F,100,17,0,17
Yailene,F,100,120,0,120
Magdalyn,F,100,450,0,450
Graceanna,F,100,94,0,94
Anyliah,F,100,7,0,7
Hansley,M,100,0,5,5
Shayron,F,50,5,5,10
Majok,M,100,0,6,6
Jartavious,M,100,0,74,74
Jamarkis,M,100,0,66,66
Benedicta,F,100,28,0,28
Naailah,F,100,17,0,17
Zaxton,M,100,0,67,67
Yarisamar,F,100,5,0,5
Algie,M,98,10,454,464
Oluwamayowa,M,100,0,6,6
Quintrell,M,100,0,401,401
Ita,F,100,343,0,343
Jesselee,M,100,0,77,77
Ameliya,F,100,142,0,142
Beesan,F,100,6,0,6
Consandra,F,100,97,0,97
Kmani,M,100,0,10,10
Avron,M,100,0,28,28
Jesscia,F,100,383,0,383
Lamontay,M,100,0,46,46
Loraine,F,100,5328,0,5328
Avalyn,F,100,1409,0,1409
Rayjean,F,100,16,0,16
Kene,M,85,5,28,33
Michielle,F,100,44,0,44
Careron,M,100,0,6,6
Mavelyn,F,100,5,0,5
Edwardo,M,100,0,5735,5735
Tashe,F,100,98,0,98
Serenety,F,100,11,0,11
Kiah,F,93,2731,204,2935
Lorrie,F,100,16647,50,16697
Alishan,M,100,0,25,25
Dieu,F,100,22,0,22
Alay,M,100,0,6,6
Jassiem,M,100,0,24,24
Araia,F,100,29,0,29
Kendyle,F,100,39,0,39
Suzeth,F,100,46,0,46
Travares,M,100,0,85,85
Zayleah,F,100,5,0,5
Shontoya,F,100,6,0,6
Justine,F,93,31581,2339,33920
Timarcus,M,100,0,5,5
Amontay,M,100,0,19,19
Oluwakayode,M,100,0,5,5
Jalaysha,F,100,76,0,76
Elijahjuan,M,100,0,27,27
Bhrianna,F,100,5,0,5
Casyn,M,89,26,207,233
Mailyn,F,100,558,0,558
Ebonne,F,100,41,0,41
Kmyah,F,100,11,0,11
Like,M,100,0,6,6
Liban,M,100,0,314,314
Gaylyn,F,100,263,0,263
Cherilynn,F,100,195,0,195
Divit,M,100,0,44,44
Kahdejah,F,100,8,0,8
Arashel,F,100,6,0,6
Dyoni,F,100,7,0,7
Maela,F,100,117,0,117
Aniyha,F,100,206,0,206
Ladontay,M,100,0,5,5
Annee,F,100,16,0,16
Mazani,F,100,5,0,5
Nga,F,100,349,0,349
Julionna,F,100,155,0,155
Katelynn,F,100,28857,11,28868
Chanity,F,100,11,0,11
Orchid,F,100,134,0,134
Larionna,F,100,5,0,5
Lareta,F,100,6,0,6
Niccoli,M,100,0,6,6
Villa,F,100,67,0,67
Balon,F,100,5,0,5
Marquesa,F,100,75,0,75
Mahkhi,M,100,0,5,5
Ugochukwu,M,100,0,224,224
Krushi,F,100,6,0,6
Gevork,M,100,0,199,199
Arnedra,F,100,5,0,5
Calletano,M,100,0,6,6
Tasa,F,100,42,0,42
Seung,M,100,0,79,79
Kshawn,M,100,0,250,250
Treyvor,M,100,0,31,31
Marqueis,M,100,0,22,22
Jahair,M,100,0,16,16
Naara,F,100,119,0,119
Klayton,M,100,0,1892,1892
Johnas,M,100,0,27,27
Attiana,F,100,13,0,13
Vishwesh,M,100,0,5,5
Jaesha,F,100,46,0,46
Kyvan,M,100,0,16,16
Koorosh,M,100,0,5,5
Trendon,M,100,0,236,236
Alyias,M,100,0,5,5
Disha,F,100,595,0,595
Rimas,M,71,27,65,92
Jalacia,F,100,69,0,69
Zanette,F,100,10,0,10
Herchel,M,100,0,84,84
Zidaan,M,100,0,33,33
Maverix,M,100,0,5,5
Serin,F,100,66,0,66
Mehana,F,100,40,0,40
Caton,M,76,58,182,240
Bing,M,100,0,165,165
Anyila,F,100,5,0,5
Aidenmichael,M,100,0,5,5
Zhoie,F,100,42,0,42
Alayasia,F,100,94,0,94
Azha,F,100,75,0,75
Sardar,M,100,0,5,5
Gabrialla,F,100,10,0,10
Danna,F,99,15751,110,15861
Yonni,M,100,0,11,11
Jemelia,F,100,5,0,5
Lalo,M,100,0,279,279
Macari,M,81,11,48,59
Amaria,F,100,1725,5,1730
Maliyha,F,100,40,0,40
Tyffany,F,100,207,0,207
Decota,M,88,5,36,41
Ardyn,F,100,190,0,190
Teran,M,65,185,349,534
Lindal,M,100,0,6,6
Jayleanna,F,100,14,0,14
Rakeim,M,100,0,29,29
Mykale,M,84,23,124,147
Orestes,M,100,0,315,315
Johnnylee,M,100,0,15,15
Evangelena,F,100,5,0,5
Jesha,F,100,24,0,24
Deja,F,99,15323,86,15409
Bredyn,M,100,0,5,5
Sherilyn,F,100,3172,0,3172
Tharun,M,100,0,49,49
Vanessaanne,F,100,5,0,5
Mylia,F,100,264,0,264
Beauregard,M,100,0,222,222
Camilly,F,100,15,0,15
Reynolds,M,97,23,663,686
Tonice,F,100,5,0,5
Cass,M,91,121,1276,1397
Shenicka,F,100,56,0,56
Sulaymaan,M,100,0,5,5
Jenisha,F,100,212,0,212
Smya,F,100,44,0,44
Reney,M,100,0,5,5
Shampayne,F,100,19,0,19
Lakyrah,F,100,5,0,5
Rinah,F,100,13,0,13
Darrien,M,89,361,2950,3311
Colbi,F,87,427,64,491
Zsofia,F,100,112,0,112
Olushola,M,100,0,16,16
Carmynn,F,100,10,0,10
Olisaemeka,M,100,0,10,10
Embri,F,100,6,0,6
Rashmika,F,100,18,0,18
Cyress,M,100,0,29,29
Dawoud,M,100,0,22,22
Jovell,M,100,0,6,6
Dwania,F,100,5,0,5
Rayhanna,F,100,35,0,35
Chequetta,F,100,5,0,5
Dannay,F,100,5,0,5
Rijul,M,100,0,20,20
Jailine,F,100,379,0,379
Vinny,M,100,0,849,849
Jarad,M,100,0,2083,2083
Ceiara,F,100,49,0,49
Alven,M,100,0,81,81
Sammi,F,97,1427,50,1477
Nikayah,F,100,5,0,5
Jarret,M,100,0,3337,3337
Corson,M,100,0,17,17
Tobiah,M,100,0,450,450
Tatiannah,F,100,11,0,11
Dericka,F,100,399,0,399
Gabbriella,F,100,257,0,257
Auril,F,100,5,0,5
Honesti,F,100,418,0,418
Money,F,82,68,15,83
Tashianna,F,100,171,0,171
Somer,F,100,2180,0,2180
Richman,M,100,0,5,5
Pennington,M,100,0,12,12
Suhanth,M,100,0,6,6
Kathlen,F,100,63,0,63
Mcdaniel,M,100,0,46,46
Kemariah,F,100,16,0,16
Norina,F,100,171,0,171
Richana,F,100,5,0,5
Brytan,M,100,0,10,10
Raphaelle,F,100,19,0,19
Chakela,F,100,5,0,5
Kay,F,98,42714,674,43388
Lygia,F,100,69,0,69
Ratana,M,100,0,14,14
Rohith,M,100,0,267,267
Chigozie,M,95,6,115,121
Jisella,F,100,64,0,64
Angelika,F,100,2572,0,2572
Jacorrian,M,100,0,19,19
Ruger,M,100,0,936,936
Ladarrius,M,100,0,1104,1104
Zaylan,M,100,0,227,227
Creig,M,100,0,332,332
Seasons,F,100,5,0,5
Issys,F,100,42,0,42
Devondre,M,100,0,258,258
Reidar,M,100,0,5,5
Linux,M,100,0,13,13
Drexler,M,100,0,53,53
Tyquasia,F,100,84,0,84
Sonje,F,100,7,0,7
Tashai,F,100,71,0,71
Karissma,F,100,34,0,34
Ryshon,M,100,0,7,7
Rikiyah,F,100,48,0,48
Tylynn,F,91,410,40,450
Kerrey,F,100,11,0,11
Trevyn,M,100,0,679,679
Aydann,M,100,0,11,11
Osinachi,M,100,0,22,22
Branwen,F,100,31,0,31
Adenike,F,100,220,0,220
Denajah,F,100,121,0,121
Tarissa,F,100,247,0,247
Cacey,F,92,200,17,217
Crus,M,100,0,5,5
Natalise,F,100,12,0,12
Alexsys,F,100,160,0,160
Avelin,F,100,26,0,26
Tramiah,F,100,7,0,7
Kaneil,M,100,0,5,5
Makaelah,F,100,98,0,98
Dilylah,F,100,10,0,10
Ferras,M,100,0,5,5
Yoshihiro,M,100,0,20,20
Sharly,F,100,5,0,5
Adian,M,100,0,946,946
Delsean,M,100,0,5,5
Jalin,M,78,460,1654,2114
Guyneth,F,100,5,0,5
Jefford,M,100,0,11,11
Murel,M,100,0,46,46
Airyona,F,100,5,0,5
Samisoni,M,100,0,34,34
Kyndall,F,96,4361,169,4530
Nygeria,F,100,171,0,171
Calvert,M,100,0,849,849
Vannida,F,100,23,0,23
Maggy,F,100,421,0,421
Eriyonna,F,100,69,0,69
Lousia,F,100,5,0,5
Bamidele,M,100,0,21,21
Fabrizzio,M,100,0,112,112
Ladale,M,97,10,292,302
Sharlena,F,100,143,0,143
Britnee,F,100,1684,0,1684
Samrath,M,100,0,18,18
Krystalynn,F,100,224,0,224
Zariea,F,100,17,0,17
Liviya,F,100,111,0,111
Marquettia,F,100,5,0,5
Zoltan,M,100,0,659,659
Seryna,F,100,184,0,184
Kenaya,F,100,42,0,42
Genee,F,100,276,0,276
Bogdana,F,100,6,0,6
Tailyn,F,99,442,5,447
Ragine,F,100,57,0,57
Sequetta,F,100,7,0,7
Clever,M,100,0,54,54
Nicole,F,100,579299,1956,581255
Nazhae,F,100,6,0,6
Lillette,F,100,14,0,14
Romon,M,100,0,330,330
Jazzabella,F,100,17,0,17
Saddiya,F,100,5,0,5
Denese,F,100,1464,0,1464
Markisa,F,100,6,0,6
Ashtian,M,100,0,57,57
Kriston,F,59,720,507,1227
Michellee,F,100,52,0,52
Maram,F,100,582,0,582
Ladelle,F,100,21,0,21
Macario,M,100,0,1667,1667
Dayden,M,100,0,185,185
Naftuly,M,100,0,12,12
Yohan,M,100,0,775,775
Ardra,F,100,95,0,95
Juliaunna,F,100,10,0,10
Latya,F,100,21,0,21
Raschelle,F,100,105,0,105
Cleta,F,100,651,0,651
Jolan,M,74,62,181,243
Geanne,F,100,10,0,10
Cheyane,F,100,173,0,173
Kareana,F,100,5,0,5
Benjamyn,M,100,0,256,256
Joylyn,F,100,327,0,327
Ishant,M,100,0,30,30
Zavanna,F,100,19,0,19
Angad,M,100,0,413,413
Yonason,M,100,0,24,24
Lynnett,F,100,262,0,262
Kayn,M,100,0,77,77
Fathima,F,100,181,0,181
Zan,M,85,94,518,612
Sherica,F,100,648,0,648
Merriam,F,100,53,0,53
Baja,F,100,5,0,5
Kenin,M,100,0,10,10
Camyra,F,100,82,0,82
Maryvel,F,100,5,0,5
Emmely,F,100,365,0,365
Moiz,M,100,0,155,155
Lameen,M,100,0,6,6
Samuelu,M,100,0,11,11
Brevin,M,100,0,992,992
Sanquenetta,F,100,10,0,10
Yasline,F,100,21,0,21
Betzabeth,F,100,236,0,236
Shemaine,F,100,5,0,5
Jada,F,100,61238,237,61475
Ehab,M,100,0,378,378
Jonathyn,M,100,0,263,263
Patrenia,F,100,15,0,15
Saarah,F,100,197,0,197
Zylar,M,100,0,32,32
Joshue,M,100,0,1066,1066
Peppi,F,72,13,5,18
Aeriana,F,100,360,0,360
Leonela,F,100,913,0,913
Anslei,F,100,29,0,29
Owetta,F,100,5,0,5
Patricha,F,100,27,0,27
Tanden,M,100,0,12,12
Elzie,M,99,7,754,761
Antonasia,F,100,17,0,17
Kairos,M,100,0,81,81
Nagi,M,100,0,79,79
Yutzil,F,100,6,0,6
Pene,F,100,5,0,5
Aamira,F,100,212,0,212
Shander,F,100,7,0,7
Iziah,M,100,0,1060,1060
Dvaughn,M,100,0,86,86
Yairi,F,100,41,0,41
Aamirah,F,100,139,0,139
Fahim,M,100,0,394,394
Mahdiya,F,100,65,0,65
Noheli,F,100,114,0,114
Khyrin,M,100,0,56,56
Whysper,F,100,5,0,5
Bly,M,100,0,50,50
Rikardo,M,100,0,17,17
Vitoria,F,100,307,0,307
Alton,M,100,85,19301,19386
Marivella,F,100,6,0,6
Dejaneira,F,100,5,0,5
Morisa,F,100,5,0,5
Donquavious,M,100,0,5,5
Jayco,M,100,0,24,24
Eabha,F,100,16,0,16
Laylla,F,100,19,0,19
Lajla,F,100,17,0,17
Joandri,M,100,0,6,6
Dougles,M,100,0,213,213
Ceana,F,100,265,0,265
Olyve,F,100,18,0,18
Faylinn,F,100,44,0,44
Yogi,M,100,0,110,110
Bavly,M,100,0,13,13
Murlene,F,100,92,0,92
Calliope,F,100,1110,0,1110
Janijah,F,100,69,0,69
Thorin,M,100,0,731,731
Joyanne,F,100,155,0,155
Sadhika,F,100,27,0,27
Nhia,M,87,32,213,245
Lara,F,100,25225,29,25254
Amitiel,F,100,26,0,26
Azariel,M,100,0,66,66
Samiir,M,100,0,24,24
Daneah,F,100,25,0,25
Aunjel,F,100,5,0,5
Mihajlo,M,100,0,18,18
Sabela,F,100,16,0,16
Sariha,F,100,5,0,5
Scotland,M,51,164,172,336
Rasheedat,F,100,5,0,5
Raymeir,M,100,0,5,5
Gioia,F,100,476,0,476
Lajuanna,F,100,69,0,69
Catricia,F,100,73,0,73
Brissa,F,100,2236,0,2236
Destney,F,100,15,0,15
Nicola,F,69,4609,2098,6707
Llyod,M,100,0,10,10
Raybert,M,100,0,6,6
Teyonce,F,100,25,0,25
Aiden,M,99,1711,157918,159629
Sinchana,F,100,5,0,5
Cailen,M,52,185,201,386
America,F,100,10470,0,10470
Denym,M,52,85,91,176
Kaitelyn,F,100,113,0,113
Shahara,F,100,212,0,212
Daquavion,M,100,0,79,79
Helo,M,100,0,11,11
Kaelem,M,100,0,72,72
Elowyn,F,100,78,0,78
Hurbert,M,100,0,93,93
Jasem,M,100,0,10,10
Sharray,F,100,5,0,5
Akaiya,F,100,69,0,69
Otavio,M,100,0,21,21
Quazi,M,100,0,5,5
Archivaldo,M,100,0,7,7
Chantavia,F,100,97,0,97
Zahriah,F,100,59,0,59
Zitlalli,F,100,38,0,38
Annaka,F,100,516,0,516
Deaja,F,100,409,0,409
Calvina,F,100,122,0,122
Nimue,F,100,26,0,26
Alisun,F,100,5,0,5
Janelyn,F,100,43,0,43
Lukesha,F,100,21,0,21
Aksh,M,100,0,63,63
Cheryllee,F,100,6,0,6
Eliav,M,100,0,61,61
Hristina,F,100,48,0,48
Kahlill,M,100,0,5,5
Btittany,F,100,5,0,5
Tyrance,M,100,0,43,43
Ajae,F,73,30,11,41
Vanessah,F,100,16,0,16
Ivyn,M,100,0,15,15
Lenyx,F,76,34,11,45
Caralina,F,100,70,0,70
Silja,F,100,11,0,11
Mariangel,F,100,253,0,253
Callah,F,100,5,0,5
Kaion,M,100,0,17,17
Diary,F,100,10,0,10
Breno,M,100,0,47,47
Lynnetta,F,100,488,0,488
Taimi,F,100,35,0,35
Krystal,F,100,73500,190,73690
Melinda,F,100,127767,337,128104
Jacobalexander,M,100,0,14,14
Mykle,M,100,0,90,90
Idil,F,100,102,0,102
Cariyah,F,100,21,0,21
Morrine,F,100,6,0,6
Nickiyah,F,100,12,0,12
Kaylalynn,F,100,5,0,5
Zaelyn,M,59,109,154,263
Kaui,F,100,11,0,11
Bol,M,100,0,18,18
Jarquez,M,100,0,271,271
Dayshanay,F,100,5,0,5
Elverna,F,100,13,0,13
Trandon,M,100,0,29,29
Honora,F,100,555,0,555
Traycee,F,100,10,0,10
Ramses,M,100,0,2198,2198
Rosalino,M,100,0,10,10
Tyshawna,F,100,194,0,194
Decorius,M,100,0,23,23
Dashawn,M,94,541,8009,8550
Jaiveon,M,100,0,210,210
Azyriah,F,100,69,0,69
Kazimir,M,100,0,94,94
Dennese,F,100,5,0,5
Mitze,F,100,29,0,29
Detavius,M,100,0,32,32
Nashay,F,100,378,0,378
Mikylee,F,100,5,0,5
Damonni,M,100,0,5,5
Skyanna,F,100,31,0,31
Battal,M,100,0,15,15
Shnya,F,100,16,0,16
Kento,M,100,0,344,344
Brantly,M,99,5,633,638
Zyria,F,100,339,0,339
Lindee,F,100,373,0,373
Jumarcus,M,100,0,5,5
Wilona,F,100,10,0,10
Dalonta,M,100,0,22,22
Anjonette,F,100,18,0,18
Damico,M,100,0,70,70
Sol,F,55,1743,1429,3172
Srinivas,M,100,0,64,64
Angelinne,F,100,57,0,57
Torionna,F,100,39,0,39
Tymerius,M,100,0,5,5
Ninoshka,F,100,124,0,124
Mleah,F,100,5,0,5
Aubryanna,F,100,220,0,220
Ermel,M,100,0,5,5
Adiana,F,100,277,0,277
Silke,F,100,42,0,42
Joley,F,100,320,0,320
Sarela,F,100,26,0,26
Kinte,M,95,12,213,225
Jelitza,F,100,91,0,91
Kjon,M,100,0,27,27
Mikaelyn,F,100,75,0,75
Kayani,F,100,83,0,83
Eleana,F,100,1127,0,1127
Ethanmichael,M,100,0,37,37
Kiwana,F,100,260,0,260
Luzmary,F,100,13,0,13
Eliahna,F,100,19,0,19
Ariadnne,F,100,5,0,5
Cederia,F,100,5,0,5
Shymir,M,100,0,53,53
Zackarias,M,100,0,5,5
Jeraldi,F,100,11,0,11
Silia,F,100,18,0,18
Conar,M,100,0,48,48
Rilla,F,100,327,0,327
Latianna,F,100,26,0,26
Kinita,F,100,12,0,12
Heddy,F,100,50,0,50
Erdem,M,100,0,27,27
Kaylynne,F,100,555,0,555
Kirandeep,F,100,114,0,114
Racin,M,100,0,5,5
Jeraline,F,100,41,0,41
Eugenio,M,100,0,3415,3415
Levante,M,100,0,71,71
Jersei,F,100,16,0,16
Ellanie,F,100,58,0,58
Benjermin,M,100,0,160,160
Bowdie,M,100,0,5,5
Nicolia,F,100,18,0,18
Kainat,F,100,67,0,67
Karisha,F,100,355,0,355
Meisha,F,100,1008,0,1008
Damiene,M,100,0,5,5
You,M,100,0,10,10
Montrelle,M,100,0,102,102
Cheray,F,100,128,0,128
Adara,F,100,1550,0,1550
Acesyn,M,100,0,11,11
Glenice,F,100,202,0,202
Rexton,M,100,0,172,172
Cataleah,F,100,30,0,30
Obsidian,M,100,0,5,5
Novak,M,100,0,124,124
Cornella,F,100,41,0,41
Velisa,F,100,153,0,153
Janacia,F,100,22,0,22
Yamisha,F,100,5,0,5
Ashariah,F,100,11,0,11
Saifaldeen,M,100,0,5,5
Asli,F,100,232,0,232
Laniaya,F,100,38,0,38
Chioma,F,100,785,0,785
Yanali,F,100,5,0,5
Kaimilani,F,100,5,0,5
Anastyn,F,100,155,0,155
Grace,F,100,233032,423,233455
Mattigan,F,100,26,0,26
Emmey,F,100,5,0,5
Yostin,M,100,0,181,181
Shantwana,F,100,5,0,5
Nahel,M,100,0,5,5
Johnedward,M,100,0,62,62
Diron,M,100,0,174,174
Rithanya,F,100,5,0,5
Zabian,M,100,0,157,157
Marieana,F,100,5,0,5
Monterrius,M,100,0,76,76
Arzetta,F,100,5,0,5
Mio,F,89,189,23,212
Justene,F,100,153,0,153
Tressy,F,100,171,0,171
Aubriella,F,100,1075,0,1075
Haasan,M,100,0,5,5
Tukesha,F,100,5,0,5
Julietta,F,100,945,0,945
Jesusenrique,M,100,0,6,6
Reshmi,F,100,5,0,5
Taylorjames,M,100,0,5,5
Maleta,F,100,13,0,13
Kaelee,F,100,1048,0,1048
Keona,F,98,2997,65,3062
Carena,F,100,316,0,316
Disiree,F,100,27,0,27
Idelia,F,100,22,0,22
Kyptin,M,100,0,5,5
Yiqing,F,100,5,0,5
Trezon,M,100,0,12,12
Severin,M,100,0,556,556
Yovani,M,99,16,1692,1708
Zerriah,F,100,5,0,5
Junaid,M,100,0,369,369
Iwana,F,100,11,0,11
Kennesha,F,100,366,0,366
Jayman,M,100,0,6,6
Teianna,F,100,32,0,32
Lianny,F,100,137,0,137
Jenney,F,100,458,0,458
Tiffanye,F,100,54,0,54
Jalem,M,100,0,5,5
Tritan,M,100,0,24,24
Naureen,F,100,177,0,177
Jermol,M,100,0,6,6
Bethellen,F,100,5,0,5
Amberjo,F,100,10,0,10
Khalaya,F,100,72,0,72
Yarida,F,100,7,0,7
Denon,M,100,0,46,46
Adellia,F,100,5,0,5
Ceron,M,100,0,11,11
Jemiah,F,66,181,94,275
Chrishawn,M,91,48,480,528
Zoeanna,F,100,5,0,5
Brionne,F,97,438,15,453
Xaveon,M,100,0,32,32
Chayce,M,84,251,1338,1589
Dylon,M,100,0,4224,4224
Jugraj,M,100,0,15,15
Talissa,F,100,400,0,400
Aidalyn,F,100,12,0,12
Gavinn,M,100,0,124,124
Briggston,M,100,0,9,9
Nidia,F,100,2599,0,2599
Samej,M,100,0,5,5
Ryuu,M,100,0,30,30
Amiley,F,100,57,0,57
Queana,F,100,11,0,11
Marieka,F,100,20,0,20
Getsemani,F,97,425,12,437
Fraida,F,100,318,0,318
Obiora,M,100,0,6,6
Babe,M,100,0,21,21
Kaylanni,F,100,46,0,46
Rarity,F,100,15,0,15
Lida,F,100,1284,0,1284
Izic,M,100,0,170,170
Chantrel,F,100,11,0,11
Cathaleya,F,100,15,0,15
Jea,F,100,16,0,16
Towanda,F,100,2132,0,2132
Zaccai,M,100,0,129,129
Adaora,F,100,158,0,158
Tayden,M,91,150,1583,1733
Tranese,F,100,29,0,29
Braylie,F,100,403,0,403
Martajah,F,100,15,0,15
Hamed,M,100,0,439,439
Jamiyah,F,100,2537,0,2537
Kazuhiro,M,100,0,5,5
Resia,F,100,5,0,5
Javanni,M,100,0,68,68
Savione,M,100,0,12,12
Stevena,F,100,5,0,5
Gibram,M,100,0,7,7
Rameisha,F,100,5,0,5
Jacinto,M,100,0,1965,1965
Sundra,F,100,472,0,472
Kambelle,F,100,5,0,5
Kiyelle,F,100,5,0,5
Tyzae,M,100,0,5,5
Lamon,M,100,0,1048,1048
Maricha,F,100,5,0,5
Shravani,F,100,27,0,27
Chyanna,F,100,313,0,313
Senoria,F,100,17,0,17
Cortavious,M,100,0,220,220
Rafi,M,100,0,448,448
Titania,F,100,520,0,520
Chiaki,F,100,22,0,22
Yuyang,M,100,0,5,5
Baelynn,F,100,48,0,48
Glenndora,F,100,5,0,5
Mezmariah,F,100,8,0,8
Cendy,F,100,332,0,332
Abian,M,100,0,12,12
Nikolina,F,100,308,0,308
Juanluis,M,100,0,325,325
Jaemi,F,100,41,0,41
Rome,M,95,89,1539,1628
Azsha,F,100,5,0,5
Samyha,F,100,7,0,7
Skarlette,F,100,133,0,133
Deran,M,100,0,152,152
Abdo,M,100,0,43,43
Daizja,F,100,14,0,14
Aaran,M,100,0,175,175
Patrizio,M,100,0,5,5
Aaliah,F,100,784,0,784
Tashica,F,100,101,0,101
Delcy,F,100,6,0,6
Trieu,M,100,0,15,15
Angelicamarie,F,100,29,0,29
Yonda,F,100,10,0,10
Evlynn,F,100,20,0,20
Adda,F,100,54,0,54
Arlease,F,100,5,0,5
Aiydan,M,100,0,26,26
Habibatou,F,100,5,0,5
Leonidis,M,100,0,11,11
Natae,F,100,19,0,19
Deede,F,100,47,0,47
Uronda,F,100,7,0,7
Lincy,F,100,114,0,114
Porche,F,100,748,0,748
Lataivia,F,100,5,0,5
Yanara,F,100,41,0,41
Sharise,F,100,645,0,645
Tashiona,F,100,5,0,5
Karliyah,F,100,5,0,5
Sophea,F,98,275,5,280
Allysun,F,100,29,0,29
Jeraldine,F,100,1167,0,1167
Halia,F,100,547,0,547
Felton,M,100,0,2967,2967
Japhy,M,100,0,5,5
Kerri,F,99,36771,348,37119
Conna,F,100,61,0,61
Waide,M,100,0,5,5
Arellys,F,100,19,0,19
Damara,F,100,926,0,926
Torence,M,93,5,70,75
Shakaiya,F,100,5,0,5
Caroline,F,100,153015,242,153257
Rawson,M,100,0,52,52
Shadric,M,100,0,11,11
Koalii,M,100,0,22,22
Ohan,M,100,0,5,5
Riko,F,63,60,35,95
Vishwa,M,93,11,149,160
Mardine,F,100,5,0,5
Fillip,M,100,0,22,22
Kealohi,F,100,5,0,5
Emeraude,F,100,41,0,41
Paysli,F,100,18,0,18
Lynzey,F,100,37,0,37
Yadier,M,100,0,413,413
Lejon,M,100,0,230,230
Marwa,F,100,1366,0,1366
Tahja,F,94,233,15,248
Tenielle,F,100,24,0,24
Mazarine,F,100,10,0,10
Yunuen,F,100,263,0,263
Evilynn,F,100,5,0,5
Cypher,M,100,0,27,27
Zailie,F,100,5,0,5
Lonne,M,100,0,39,39
Ariana,F,100,82786,168,82954
Mylicia,F,100,5,0,5
Shaydie,F,100,13,0,13
Trenadi,F,100,5,0,5
Shaquea,F,100,10,0,10
Aashirya,F,100,15,0,15
Chasaty,F,100,11,0,11
Annilyn,F,100,6,0,6
Antarious,M,100,0,10,10
Shnea,F,100,5,0,5
Juventino,M,100,0,1178,1178
Carlese,F,100,5,0,5
Adedayo,M,100,0,31,31
Jarrica,F,100,35,0,35
Tifa,F,100,38,0,38
Charne,F,100,109,0,109
Najih,M,100,0,5,5
Kristofor,M,100,0,805,805
Doylene,F,100,110,0,110
Lafonzo,M,100,0,5,5
Orlena,F,100,151,0,151
Derryk,M,100,0,41,41
Janmarie,F,100,68,0,68
Eyla,F,100,44,0,44
Mahjabeen,F,100,6,0,6
Tiawan,M,100,0,58,58
Dareck,M,100,0,13,13
Zhander,M,100,0,5,5
Oleh,M,100,0,54,54
Clarie,F,100,374,0,374
Yancarlo,M,100,0,35,35
Nyjai,F,100,63,0,63
Sheika,F,100,76,0,76
Kariya,F,100,80,0,80
Jenalyse,F,100,10,0,10
Dynette,F,100,40,0,40
Kennedee,F,100,325,0,325
Nykeira,F,100,16,0,16
Mashayla,F,100,431,0,431
Danney,M,99,5,394,399
Alveria,F,100,40,0,40
Tanaisha,F,100,235,0,235
Daiel,M,100,0,378,378
Saramarie,F,100,91,0,91
Maikol,M,100,0,35,35
Cilas,M,100,0,16,16
Akiel,M,100,0,79,79
Malliyah,F,100,17,0,17
Lianys,F,100,25,0,25
Anberlyn,F,100,47,0,47
Taiden,M,100,0,238,238
Leea,F,100,625,0,625
Derhonda,F,100,101,0,101
Manita,F,100,5,0,5
Dearis,M,100,0,93,93
Dallin,M,100,0,4691,4691
Wanell,F,100,20,0,20
Gannen,M,100,0,19,19
Geroldine,F,100,6,0,6
Madelynne,F,100,1382,0,1382
Jersi,F,100,151,0,151
Merian,F,100,37,0,37
Cosimo,M,100,0,344,344
Marijane,F,100,845,0,845
Jaython,M,100,0,29,29
Malikk,M,100,0,37,37
Britania,F,100,124,0,124
Abdirizak,M,100,0,66,66
Mosheh,M,100,0,22,22
Anevay,F,100,268,0,268
Chele,F,100,86,0,86
Bahareh,F,100,28,0,28
Saveena,F,100,21,0,21
Brycin,M,100,0,170,170
Lyrik,F,62,722,440,1162
Raechell,F,100,67,0,67
Reshelle,F,100,11,0,11
Ellaine,F,100,27,0,27
Luong,M,100,0,5,5
Winthrop,M,100,0,368,368
Ajhani,M,100,0,5,5
Arlen,M,87,494,3388,3882
Quneisha,F,100,6,0,6
Dominicc,M,100,0,12,12
Tatayana,F,100,210,0,210
Yonatan,M,100,0,1907,1907
Rubena,F,100,11,0,11
Sheneta,F,100,21,0,21
Hailey,F,100,144978,237,145215
Tamarrion,M,100,0,10,10
Christionna,F,100,82,0,82
Shalena,F,100,966,0,966
Sandralee,F,100,74,0,74
Draevyn,M,100,0,6,6
Phelisha,F,100,10,0,10
Mysia,F,100,12,0,12
Jeremih,M,100,0,566,566
Hudeyfa,M,100,0,5,5
Irulan,F,100,45,0,45
Alexisjade,F,100,5,0,5
Malanya,F,100,5,0,5
Brysa,F,100,29,0,29
Sharain,F,100,53,0,53
Agnieszka,F,100,226,0,226
Govanny,M,100,0,55,55
Zayon,M,100,0,139,139
Jaimarion,M,100,0,10,10
Denya,F,100,118,0,118
Celena,F,100,4353,0,4353
Jarik,M,100,0,54,54
Neana,F,100,5,0,5
Merolla,F,100,6,0,6
Shaylea,F,100,311,0,311
Lorinda,F,100,3969,0,3969
Philomena,F,100,1516,0,1516
Quanshay,F,100,6,0,6
Madhura,F,100,11,0,11
Quameshia,F,100,12,0,12
Zekira,F,100,6,0,6
Orpha,F,100,348,0,348
Lavine,F,100,5,0,5
Jahlissa,F,100,6,0,6
Candiece,F,100,5,0,5
Nghia,M,98,5,211,216
Duwane,M,100,0,85,85
Tapan,M,100,0,11,11
Vilia,F,100,10,0,10
Betsabe,F,100,720,0,720
Dulcemaria,F,100,540,0,540
Jmichael,M,100,0,65,65
Nevaiah,F,100,18,0,18
Malkia,F,100,220,0,220
Aniha,F,100,5,0,5
Amaani,F,100,33,0,33
Karlysia,F,100,8,0,8
Teralyn,F,100,215,0,215
Mekeshia,F,100,5,0,5
Nathaniell,M,100,0,5,5
Yazmina,F,100,49,0,49
Pura,F,100,85,0,85
Eavie,F,100,6,0,6
Aashi,F,100,423,0,423
Jaxiel,M,100,0,83,83
Thurma,F,100,8,0,8
Gerame,M,100,0,5,5
Keyah,F,100,101,0,101
Moreen,F,100,196,0,196
Hanniel,M,100,0,28,28
Marselino,M,100,0,23,23
Raliek,M,100,0,12,12
Noorhan,F,100,5,0,5
Trenika,F,100,117,0,117
Stevyn,M,100,0,16,16
Quinterrious,M,100,0,12,12
Wilhemenia,F,100,133,0,133
Dasmon,M,100,0,6,6
Demarrion,M,100,0,163,163
Annye,F,100,8,0,8
Vyaan,M,100,0,6,6
Leabeth,F,100,7,0,7
Jerrud,M,100,0,11,11
Juels,M,100,0,6,6
Pasha,F,64,493,279,772
Kimchi,F,100,5,0,5
Tamah,F,100,53,0,53
Kyisha,F,100,216,0,216
Amariyon,M,100,0,58,58
Ilea,F,100,232,0,232
Kianti,F,100,7,0,7
Tzivi,F,100,11,0,11
Alanys,F,100,229,0,229
Glenalee,F,100,9,0,9
Samoria,F,100,58,0,58
Nick,M,100,55,26260,26315
Judyth,F,100,276,0,276
Shylo,F,84,544,101,645
Drako,M,100,0,105,105
Ilona,F,100,1986,0,1986
Aisleigh,F,100,5,0,5
Nevae,F,100,89,0,89
Lula,F,100,6721,5,6726
Stevona,F,100,11,0,11
Keilin,F,72,132,51,183
Monterio,M,100,0,306,306
Willilam,M,100,0,22,22
Yvain,M,100,0,5,5
Keanua,F,100,5,0,5
Wenda,F,100,768,0,768
Vernetia,F,100,5,0,5
Camas,F,100,34,0,34
Tannia,F,100,386,0,386
Shabree,F,100,111,0,111
Neasa,F,100,5,0,5
Suraj,M,100,0,953,953
Khyden,M,100,0,29,29
Edwidge,M,100,0,5,5
Raysa,F,100,121,0,121
Lathisa,F,100,7,0,7
Lamyla,F,100,5,0,5
Leilyn,F,100,43,0,43
Evamae,F,100,6,0,6
Laniya,F,100,2528,0,2528
Kloeigh,F,100,5,0,5
Niyara,F,100,6,0,6
Eboney,F,100,747,0,747
Niambi,F,100,260,0,260
Karin,F,99,24751,135,24886
Nyzeth,F,100,5,0,5
Arben,M,100,0,253,253
Dwyla,F,100,11,0,11
Teodulo,M,100,0,28,28
Avigail,F,100,1258,0,1258
Erubiel,M,100,0,201,201
Ironesha,F,100,24,0,24
Kennetra,F,100,38,0,38
Chey,M,51,72,76,148
Samiullah,M,100,0,10,10
Taishima,F,100,8,0,8
Tykeshia,F,100,90,0,90
Garin,M,100,0,1064,1064
Arieyanna,F,100,45,0,45
Italia,F,100,1877,0,1877
Candido,M,100,0,1441,1441
Leyden,M,100,0,19,19
Airis,F,95,88,5,93
Azjon,M,100,0,5,5
Abdalrahman,M,100,0,138,138
Nels,M,100,0,1674,1674
Ronalyn,F,100,44,0,44
Zakiria,F,100,7,0,7
Juquana,F,100,5,0,5
Donovon,M,100,0,631,631
Tyus,M,100,0,727,727
Sylvio,M,100,0,13,13
Carmesa,F,100,8,0,8
Takina,F,100,89,0,89
Lougene,M,100,0,11,11
Alyvea,F,100,22,0,22
Anshi,F,100,101,0,101
Adrianne,F,100,11969,31,12000
Chaneka,F,100,64,0,64
Emaya,F,100,213,0,213
Tariya,F,100,123,0,123
Garek,M,100,0,117,117
Mondarius,M,100,0,24,24
Tuere,F,100,103,0,103
Silvano,M,100,0,814,814
Tiasia,F,100,447,0,447
Momoko,F,100,137,0,137
Shinese,F,100,9,0,9
Junho,M,100,0,5,5
Mollykate,F,100,7,0,7
Dominyk,M,100,0,139,139
Zia,F,89,1481,178,1659
Shawhin,M,100,0,5,5
Zealand,M,93,15,187,202
Tanzy,F,100,55,0,55
Deviyon,M,100,0,5,5
Laylana,F,100,51,0,51
Copeland,M,89,49,379,428
Ishbel,F,100,5,0,5
Makhii,M,100,0,11,11
Javante,M,100,0,547,547
Bethzabel,F,100,11,0,11
Arryon,F,100,5,0,5
Toy,F,64,535,306,841
Leissa,F,100,16,0,16
Stian,M,100,0,14,14
Datron,M,100,0,144,144
Anaysha,F,100,99,0,99
Syren,F,80,24,6,30
Ashla,F,100,55,0,55
Ratesha,F,100,5,0,5
Myshaun,M,100,0,33,33
Ebenezer,M,98,16,643,659
Moua,M,100,0,167,167
Farzin,M,100,0,5,5
Branwyn,F,100,7,0,7
Rosalena,F,100,130,0,130
Cherre,F,100,62,0,62
Robey,M,100,0,71,71
Ralene,F,100,204,0,204
Chemar,M,100,0,34,34
Khizer,M,100,0,10,10
Tranyce,F,100,11,0,11
Nour,F,82,1779,380,2159
Via,F,100,59,0,59
Karde,M,100,0,6,6
Olla,F,100,21,0,21
Scarlette,F,100,2410,0,2410
Tykie,M,100,0,6,6
Izaah,M,100,0,78,78
Quadarius,M,100,0,359,359
Hishaam,M,100,0,5,5
Laryah,F,100,86,0,86
Rosy,F,100,1176,0,1176
Cassandrea,F,100,23,0,23
Chama,F,100,10,0,10
Camia,F,100,363,0,363
Shatiah,F,100,5,0,5
Galileah,F,100,78,0,78
Schae,F,100,101,0,101
Kaliel,M,100,0,86,86
Shealynn,F,100,701,0,701
Cydnei,F,100,53,0,53
Giavannah,F,100,10,0,10
Crisha,F,100,16,0,16
Jhoan,M,100,0,286,286
Cecylia,F,100,79,0,79
Revena,F,100,10,0,10
Ashauna,F,100,83,0,83
Kasheena,F,100,183,0,183
Gevonte,M,100,0,20,20
Brigitta,F,100,499,0,499
Gilbert,M,99,304,60095,60399
Katinna,F,100,13,0,13
Jemond,M,100,0,5,5
Joymarie,F,100,10,0,10
Kavonna,F,100,35,0,35
Joakim,M,100,0,74,74
Dava,F,100,1288,0,1288
Jolee,F,100,2638,0,2638
Jeffie,M,66,93,179,272
Danyae,F,100,5,0,5
Braeli,F,100,18,0,18
Merrill,M,73,1261,3327,4588
Retta,F,100,876,0,876
Skanda,M,100,0,57,57
Keldan,M,100,0,70,70
Areyon,F,69,33,15,48
Mahmoud,M,100,0,2039,2039
Shuaib,M,100,0,187,187
Jordae,F,100,5,0,5
Render,M,100,0,13,13
Cira,F,100,458,0,458
Maksimus,M,100,0,11,11
Lindzey,F,100,264,0,264
Damali,F,100,333,0,333
Tishera,F,100,5,0,5
Tremont,M,100,0,77,77
Lazell,M,100,0,5,5
Kingstyn,M,100,0,95,95
Necola,F,100,64,0,64
Netha,F,100,48,0,48
Shawkat,M,100,0,6,6
Nautyca,F,100,5,0,5
Quirt,M,100,0,6,6
Tersa,F,100,222,0,222
Sunitha,F,100,5,0,5
Shivan,M,100,0,120,120
Shannikia,F,100,21,0,21
Doyle,M,100,40,11426,11466
Gryffen,M,100,0,12,12
Jacklon,F,100,11,0,11
Quinlyn,F,98,318,6,324
Tashvi,F,100,37,0,37
Vontressa,F,100,11,0,11
Suni,F,100,315,0,315
Emalie,F,100,1027,0,1027
Charde,F,100,568,0,568
Jezlynn,F,100,41,0,41
Ilitia,F,100,11,0,11
Aljandro,M,100,0,45,45
Amiira,F,100,20,0,20
Iuma,F,100,8,0,8
Massa,F,100,75,0,75
Sadaria,F,100,7,0,7
Almanzo,M,100,0,17,17
Kensly,F,93,65,5,70
Domonque,F,100,5,0,5
Montica,F,100,37,0,37
Kryslyn,F,100,74,0,74
Maura,F,100,17614,5,17619
Cariana,F,100,132,0,132
Vahe,M,100,0,216,216
Derike,M,100,0,6,6
Britton,M,78,1487,5158,6645
Cyncere,M,65,114,212,326
Josehua,M,100,0,102,102
Samar,F,61,794,506,1300
Jakson,M,100,0,602,602
Esma,F,100,209,0,209
Maribi,F,100,28,0,28
Jnya,F,100,173,0,173
Calil,M,100,0,123,123
Merielle,F,100,16,0,16
Benjaminjoseph,M,100,0,5,5
Nikyia,F,100,19,0,19
Roshida,F,100,15,0,15
Prayan,M,100,0,21,21
Thanya,F,100,237,0,237
Jenae,F,100,3169,0,3169
Tykiana,F,100,5,0,5
Tyhecia,F,100,5,0,5
Marceia,F,100,16,0,16
Taliyah,F,100,6024,0,6024
Kryton,M,100,0,5,5
Nimesh,M,100,0,67,67
Nong,M,100,0,5,5
Jaycek,M,100,0,25,25
Laquana,F,100,763,0,763
Emmah,F,100,735,0,735
Mergeron,M,100,0,5,5
Elly,F,100,2991,10,3001
Gin,M,68,7,15,22
Sharmine,F,100,11,0,11
Naketa,F,100,259,0,259
Jakiria,F,100,42,0,42
Shealee,F,100,222,0,222
Jaylianis,F,100,23,0,23
Jacques,M,97,242,7598,7840
Simi,F,98,298,6,304
Anuja,F,100,121,0,121
Kayren,F,100,74,0,74
Conan,M,100,0,1695,1695
Jadakiss,M,87,13,88,101
Juliella,F,100,5,0,5
Nazalia,F,100,43,0,43
Cola,F,55,6,5,11
Dalyn,M,67,361,731,1092
Arvella,F,100,264,0,264
Najia,F,100,258,0,258
Nazarene,F,100,37,0,37
Clae,M,100,0,5,5
Phalla,F,100,7,0,7
Deneena,F,100,7,0,7
Etash,M,100,0,5,5
Jarmal,M,100,0,266,266
Nobie,F,100,23,0,23
Analena,F,100,114,0,114
Charlierae,F,100,5,0,5
Lavester,M,100,0,11,11
Remmi,F,100,121,0,121
Stajah,F,100,6,0,6
Breez,F,69,11,5,16
Daltyn,M,100,0,281,281
Elida,F,100,4242,0,4242
Yomara,F,100,181,0,181
Kreighton,M,100,0,26,26
Shaquerra,F,100,5,0,5
Evangeleen,F,100,17,0,17
Aideth,F,100,10,0,10
Aryanni,F,100,6,0,6
Labreshia,F,100,10,0,10
Synovia,F,100,26,0,26
Teddrick,M,100,0,218,218
Sheenamarie,F,100,26,0,26
Vividiana,F,100,6,0,6
Saga,F,100,55,0,55
Younis,M,100,0,134,134
Lafaye,F,100,159,0,159
Chemeka,F,100,82,0,82
Mahki,M,100,0,661,661
Manhattan,F,100,65,0,65
Latazia,F,100,43,0,43
Emidio,M,100,0,137,137
Zorria,F,100,40,0,40
Kenadie,F,100,1468,0,1468
Soriyah,F,100,84,0,84
Josua,M,100,0,750,750
Nakyiah,F,100,63,0,63
Nygil,M,100,0,24,24
Ski,F,95,90,5,95
Lynniah,F,100,67,0,67
Jatayvion,M,100,0,29,29
Bridon,M,100,0,11,11
Xelha,F,100,14,0,14
Saicharan,M,100,0,47,47
Rogan,M,96,42,1117,1159
Audreanna,F,100,513,0,513
Aimani,F,100,5,0,5
Fey,F,100,100,0,100
Kaysin,M,95,5,99,104
Trip,M,100,0,234,234
Keyur,M,100,0,21,21
Hunt,M,100,0,145,145
Leialoha,F,100,75,0,75
Utica,F,100,5,0,5
Matao,M,100,0,30,30
Matilda,F,100,7413,0,7413
Roanna,F,100,373,0,373
Orlando,M,99,242,40335,40577
Eleonore,F,100,164,0,164
Jylen,M,100,0,22,22
Mariluz,F,100,348,0,348
Loria,F,100,1354,0,1354
Nizhonii,F,100,6,0,6
Wil,M,100,0,980,980
Zakori,M,100,0,10,10
Amish,M,100,0,288,288
Alazne,F,100,48,0,48
Janthony,M,100,0,117,117
Faylin,F,100,12,0,12
Nekiya,F,100,18,0,18
Laquite,F,100,5,0,5
Akeisha,F,100,257,0,257
Cru,M,100,0,398,398
Nyalah,F,100,29,0,29
Milira,F,100,23,0,23
Rynell,M,100,0,83,83
Tresta,F,100,5,0,5
Yara,F,100,3072,0,3072
Rabun,M,100,0,5,5
April,F,100,232426,667,233093
Shamare,M,100,0,18,18
Tanekia,F,100,123,0,123
Samanth,F,100,262,0,262
Kashira,F,100,94,0,94
Aeliana,F,100,26,0,26
Koehn,M,100,0,67,67
Ketih,M,100,0,94,94
Nathanyl,M,100,0,103,103
Giovanni,M,99,841,56585,57426
Marcques,M,100,0,80,80
Tuana,F,100,55,0,55
Ry,M,100,0,351,351
Jemil,M,100,0,33,33
Jescie,F,100,5,0,5
Issack,M,100,0,49,49
Josehp,M,100,0,16,16
Sarang,M,56,24,31,55
Paulene,F,100,451,0,451
Sarne,F,100,11,0,11
Laquela,F,100,6,0,6
Danaly,F,100,67,0,67
Chineta,F,100,5,0,5
Lotanna,M,55,5,6,11
Farnaz,F,100,54,0,54
Myleah,F,100,334,0,334
Devonna,F,100,1572,0,1572
Pratyusha,F,100,5,0,5
Sunshine,F,99,4774,37,4811
Trexton,M,100,0,28,28
Arynne,F,100,35,0,35
Deeanne,F,100,369,0,369
Alaizha,F,100,5,0,5
Jametta,F,100,98,0,98
Desery,F,100,6,0,6
Aubreanna,F,100,338,0,338
Nasrallah,M,100,0,8,8
Compton,M,100,0,24,24
Avnish,M,100,0,15,15
Rittal,F,100,5,0,5
Faigy,F,100,2105,0,2105
Toan,M,100,0,400,400
Nonya,F,100,28,0,28
Zyelle,F,100,5,0,5
Ihan,M,100,0,39,39
Elwood,M,100,0,3552,3552
Mccord,M,100,0,14,14
Jahmel,M,100,0,568,568
Shaida,F,100,67,0,67
Abbeygale,F,100,22,0,22
Leionna,F,100,5,0,5
Iain,M,100,0,2548,2548
Marysue,F,100,259,0,259
Ymelda,F,100,22,0,22
Depree,M,100,0,17,17
Rubert,M,100,0,62,62
Kanessa,F,100,43,0,43
Adeline,F,100,15491,5,15496
Aquina,F,100,6,0,6
Healey,F,100,5,0,5
Aibileen,F,100,6,0,6
Keyiana,F,100,27,0,27
Aylissa,F,100,286,0,286
Zeruiah,F,100,26,0,26
Tiant,M,100,0,61,61
Juliessa,F,100,33,0,33
Kenyea,M,100,0,5,5
Radie,F,100,5,0,5
Kamyjah,F,100,5,0,5
Minato,M,100,0,16,16
Rhys,M,93,447,6323,6770
Uganda,F,79,46,12,58
Reni,F,100,113,0,113
Gearold,M,100,0,58,58
Tanor,M,100,0,61,61
Bionca,F,100,715,0,715
Glenton,M,100,0,6,6
Chasta,F,100,312,0,312
Donshae,F,68,27,13,40
Charleta,F,100,30,0,30
Cristell,F,100,13,0,13
Jonhatan,M,100,0,75,75
Keishauna,F,100,38,0,38
Shylon,M,100,0,5,5
Jazleen,F,100,801,0,801
Advita,F,100,21,0,21
Jezabell,F,100,31,0,31
Quinten,M,100,0,6413,6413
Frisco,M,100,0,174,174
Brandise,F,100,15,0,15
Jameika,F,100,265,0,265
Samonte,M,100,0,6,6
Shalanta,F,100,5,0,5
Megh,M,100,0,22,22
Flo,F,100,209,0,209
Raemond,M,100,0,26,26
Coulton,M,100,0,139,139
Anleigh,F,100,6,0,6
Xitlalic,F,100,278,0,278
Kuba,M,100,0,98,98
Deyontae,M,100,0,16,16
Shyrel,F,100,11,0,11
Teshia,F,100,452,0,452
Esosa,F,71,24,10,34
Samerra,F,100,5,0,5
Danette,F,100,10081,0,10081
Rechard,M,100,0,33,33
Chanelly,F,100,5,0,5
Sahmiya,F,100,5,0,5
Makai,M,95,199,3676,3875
Yar,F,100,24,0,24
Quadree,M,100,0,60,60
Tacara,F,100,546,0,546
Ratan,M,100,0,5,5
Azjah,F,100,74,0,74
Iosua,M,100,0,12,12
Margreta,F,100,5,0,5
Ashwath,M,100,0,119,119
Llewyn,M,100,0,38,38
Jamiyha,F,100,16,0,16
Gerritt,M,100,0,221,221
Angeliq,F,100,11,0,11
Xadrian,M,100,0,282,282
Adelind,F,100,19,0,19
Yuriria,F,100,34,0,34
Edgerrin,M,100,0,65,65
Brilie,F,100,10,0,10
Jassmyn,F,100,38,0,38
Ranzel,M,100,0,6,6
Ohanna,F,100,67,0,67
Amith,M,100,0,29,29
Carlaya,F,100,11,0,11
Froylan,M,100,0,572,572
Eleeza,F,100,6,0,6
Charity,F,100,30586,39,30625
Mariyah,F,100,4573,0,4573
Bleu,F,57,45,34,79
Karo,M,100,0,74,74
Kerbi,F,100,47,0,47
Anish,M,100,0,2629,2629
Tiniyah,F,100,18,0,18
Angelean,F,100,14,0,14
Centwane,M,100,0,5,5
Glyniss,F,100,6,0,6
Marki,F,93,359,29,388
Bralee,F,100,66,0,66
Rema,F,100,620,0,620
Kariyah,F,100,172,0,172
Kazlyn,F,100,22,0,22
Venicio,M,100,0,32,32
Caytlen,F,100,5,0,5
Alajha,F,100,29,0,29
Ephratah,F,100,6,0,6
Shamay,F,100,5,0,5
Carlston,M,100,0,5,5
Delisha,F,100,960,0,960
Darelyn,F,100,31,0,31
Sheadon,M,100,0,44,44
Meenah,F,100,5,0,5
Armanee,F,100,28,0,28
Darrett,M,100,0,35,35
Neziah,F,54,74,63,137
Solomia,F,100,81,0,81
Lauretha,F,100,14,0,14
Sabrina,F,100,133417,348,133765
Triniece,F,100,39,0,39
Tayvan,M,100,0,5,5
Kalona,F,100,5,0,5
Elaena,F,100,45,0,45
Robney,M,100,0,5,5
Alverto,M,100,0,141,141
Shelly,F,99,83093,1141,84234
Oden,M,100,0,501,501
Ulysis,M,100,0,22,22
Zakhiya,F,100,5,0,5
Arzella,F,100,32,0,32
Predrag,M,100,0,5,5
Pearlena,F,100,53,0,53
Cressida,F,100,73,0,73
Lachina,F,100,105,0,105
Elessa,F,100,7,0,7
Nahliyah,F,100,6,0,6
Preslie,F,100,1251,0,1251
Jackie,F,61,65326,41204,106530
Liliani,F,100,100,0,100
Wilkinson,M,100,0,10,10
Cordarrius,M,100,0,114,114
Nahtanha,F,100,9,0,9
Keaton,M,94,1051,17491,18542
Humbert,M,100,0,34,34
Chanetta,F,100,80,0,80
Ellexis,F,100,54,0,54
Bansri,F,100,5,0,5
Yuleimi,F,100,10,0,10
Delvecchio,M,100,0,81,81
Zaelah,F,100,13,0,13
Katherene,F,100,198,0,198
Prentis,M,100,0,629,629
Manases,M,100,0,129,129
Rosalynn,F,100,1880,0,1880
Linnet,F,100,124,0,124
Acelino,M,100,0,7,7
Dezirey,F,100,7,0,7
Cyarah,F,100,12,0,12
Markeyla,F,100,38,0,38
Denysha,F,100,22,0,22
Shohn,M,100,0,11,11
Capriana,F,100,28,0,28
Holli,F,100,8554,5,8559
Murphy,M,81,796,3383,4179
Aundray,M,100,0,211,211
Nilofar,F,100,12,0,12
Maylea,F,100,207,0,207
Chloi,F,100,43,0,43
Rakayla,F,100,231,0,231
Alyssamarie,F,100,308,0,308
Cambel,F,100,5,0,5
Lexxus,F,100,228,0,228
Chereen,F,100,26,0,26
Leilanie,F,100,538,0,538
Dannial,M,100,0,39,39
Starlene,F,100,1118,0,1118
Londale,M,100,0,15,15
Evran,M,100,0,5,5
Tamijah,F,100,18,0,18
Xiang,M,100,0,28,28
Javan,M,99,43,3079,3122
Saaniya,F,100,10,0,10
Haidynn,F,100,48,0,48
Maliyani,F,100,35,0,35
Niklaus,M,100,0,399,399
Bayete,M,100,0,5,5
Iliyaas,M,100,0,5,5
Debborrah,F,100,17,0,17
Marcio,M,100,0,305,305
Christal,F,100,9400,0,9400
Shykemmia,F,100,14,0,14
Brennley,F,100,12,0,12
Miriah,F,100,1784,0,1784
Kaynin,M,100,0,7,7
Jamyriah,F,100,56,0,56
Turin,M,100,0,5,5
Dwanye,M,100,0,42,42
Analeah,F,100,616,0,616
Magdeline,F,100,305,0,305
Leahann,F,100,69,0,69
Jymir,M,100,0,67,67
Jenuel,M,100,0,6,6
Analya,F,100,121,0,121
Iram,M,87,97,624,721
Quadrevion,M,100,0,6,6
Stephene,F,100,281,0,281
Saikrishna,M,100,0,7,7
Isadore,M,99,9,869,878
Garrie,M,87,31,200,231
Demetrious,M,97,57,1611,1668
Chrishiya,F,100,5,0,5
Dwann,M,80,5,20,25
Tennielle,F,100,13,0,13
Molinda,F,100,25,0,25
Isahi,M,100,0,134,134
Laneah,F,100,86,0,86
Nuchem,M,100,0,120,120
Trystal,F,100,5,0,5
Moxxi,F,100,11,0,11
Elliotte,F,89,260,33,293
Quiton,M,100,0,22,22
Lakissia,F,100,6,0,6
Day,F,69,127,57,184
Japneet,F,100,11,0,11
Soleia,F,100,33,0,33
Georgeana,F,100,28,0,28
Zakyriah,F,100,6,0,6
Antwand,M,100,0,24,24
Terecita,F,100,43,0,43
Cura,F,100,11,0,11
Kathiria,F,100,36,0,36
Shadi,M,73,240,655,895
Kierah,F,100,354,0,354
Tysheera,F,100,5,0,5
Grisela,F,100,70,0,70
Martiqua,F,100,10,0,10
Ryko,M,100,0,13,13
Atharva,M,100,0,461,461
Karry,F,67,1194,586,1780
Joedy,M,92,15,163,178
Mane,F,100,36,0,36
Arti,F,100,251,0,251
Beza,F,100,92,0,92
Addisan,F,100,16,0,16
Katalyna,F,100,231,0,231
Hildebrando,M,100,0,5,5
Hajira,F,100,63,0,63
Anaeja,F,100,5,0,5
Abriannah,F,100,6,0,6
Eimy,F,100,352,0,352
Dedrie,F,100,7,0,7
Alyscia,F,100,167,0,167
Torstein,M,100,0,6,6
Conroy,M,100,0,196,196
Nayef,M,100,0,35,35
Bolivar,M,100,0,227,227
Coen,M,100,0,2046,2046
Kaleesi,F,100,99,0,99
Tobey,M,71,628,1516,2144
Enzzo,M,100,0,6,6
Wilnelia,F,100,7,0,7
Shalae,F,100,126,0,126
Khushpreet,F,100,14,0,14
Avaline,F,100,92,0,92
Jadn,M,100,0,7,7
Jacobie,M,97,22,757,779
Montrese,F,81,22,5,27
Billion,M,100,0,5,5
Fredrico,M,100,0,191,191
Dawsyn,M,56,174,219,393
Lafarrah,F,100,17,0,17
Delaynie,F,100,272,0,272
Laython,M,100,0,21,21
Aamena,F,100,10,0,10
Cambri,F,100,462,0,462
Delora,F,100,1232,0,1232
Montario,M,100,0,91,91
Danitra,F,100,358,0,358
Giovani,M,100,5,5610,5615
Rahmere,M,100,0,44,44
Hailei,F,100,282,0,282
Daisie,F,100,399,0,399
Coney,M,100,0,20,20
Canessa,F,100,5,0,5
Kassen,M,100,0,19,19
Belem,F,100,281,0,281
Oshay,M,89,39,322,361
Deonte,M,99,41,7419,7460
Khayriyyah,F,100,12,0,12
Kwamel,M,100,0,22,22
Kaidra,F,100,5,0,5
Carmelo,M,100,0,7263,7263
Keishon,M,100,0,250,250
Tonnya,F,100,72,0,72
Brayah,F,100,67,0,67
Terrena,F,100,53,0,53
Atifa,F,100,5,0,5
Daejha,F,100,23,0,23
Arash,M,100,0,805,805
Kharon,M,100,0,196,196
Matthan,M,100,0,233,233
Vader,M,100,0,5,5
Kaeon,M,100,0,6,6
Tyreesha,F,100,66,0,66
Bonetta,F,100,27,0,27
Casaya,F,100,5,0,5
Kymberlynn,F,100,20,0,20
Anyela,F,100,53,0,53
Akeel,M,100,0,79,79
Jenry,M,100,0,57,57
Giya,F,100,15,0,15
Kaivion,M,100,0,28,28
Cartney,F,100,29,0,29
Mishalay,F,100,5,0,5
Lanae,F,100,2464,0,2464
Jarquis,M,100,0,79,79
Elianny,F,100,239,0,239
Jamerica,F,100,89,0,89
Abrionna,F,100,54,0,54
Kortnee,F,100,650,0,650
Mylove,F,100,38,0,38
Debrea,F,100,5,0,5
Adaisha,F,100,119,0,119
Darielle,F,100,793,0,793
Kristy,F,100,69818,179,69997
Artrice,F,100,93,0,93
Shamesha,F,100,30,0,30
Natavion,M,100,0,22,22
Mashae,F,100,10,0,10
Tyreshia,F,100,82,0,82
Ziare,M,80,84,331,415
Orise,M,100,0,5,5
Fawkes,M,100,0,5,5
Abrigail,F,100,26,0,26
Silah,F,100,21,0,21
Demetrices,M,100,0,5,5
Mariane,F,100,500,0,500
Kaidynce,F,98,282,6,288
Stover,M,100,0,5,5
Germarion,M,100,0,5,5
Eann,M,100,0,82,82
Ireka,F,100,7,0,7
Quadeshia,F,100,5,0,5
Jatasia,F,100,72,0,72
Diamonta,M,100,0,5,5
Adriann,F,90,896,98,994
Natachia,F,100,29,0,29
Inaara,F,100,60,0,60
Roshondra,F,100,14,0,14
Squire,M,100,0,95,95
Nasai,M,100,0,5,5
Mckena,F,100,380,0,380
Usvaldo,M,100,0,17,17
Shaneequa,F,100,170,0,170
Kamahri,M,100,0,11,11
Maybrie,F,100,22,0,22
Siraaj,M,100,0,5,5
Haneefah,F,100,164,0,164
Kenzlee,F,100,478,0,478
Sheyanne,F,100,727,0,727
Shaylan,F,85,318,55,373
Kielah,F,100,10,0,10
Slayder,M,100,0,6,6
Wrynn,F,100,5,0,5
Kawehi,F,100,78,0,78
Dajohn,M,100,0,288,288
Collynn,M,100,0,5,5
Chiquitta,F,100,168,0,168
Amanee,F,100,157,0,157
Roddy,M,100,0,1696,1696
Morag,F,100,15,0,15
Kachelle,F,100,5,0,5
Blakeley,F,86,589,96,685
Shulamis,F,100,92,0,92
Mattis,M,100,0,48,48
Aquaisha,F,100,5,0,5
William,M,100,7634,2040682,2048316
Husein,M,100,0,88,88
Dantez,M,100,0,27,27
Traelyn,M,100,0,6,6
Arnissa,F,100,36,0,36
Kalu,M,100,0,12,12
Jylan,M,100,0,84,84
Erini,F,100,20,0,20
Neddie,M,74,6,17,23
Idalmis,F,100,10,0,10
Tajinae,F,100,5,0,5
Torique,M,100,0,5,5
Jenee,F,100,1983,0,1983
Sharief,M,100,0,187,187
Berthena,F,100,8,0,8
Odeal,F,100,7,0,7
Aisha,F,100,19434,27,19461
Shannette,F,100,180,0,180
Chelan,F,100,72,0,72
Elfredia,F,100,19,0,19
Talayja,F,100,10,0,10
Jolina,F,100,650,0,650
Aniq,M,100,0,6,6
Dreya,F,100,132,0,132
Reddick,M,100,0,15,15
Mikko,M,98,10,400,410
Oaklan,M,100,0,13,13
Mikylah,F,100,146,0,146
Charliegh,F,100,28,0,28
Kavik,M,100,0,5,5
Kanise,F,100,29,0,29
Geremy,M,100,0,1148,1148
Muad,M,100,0,158,158
Juleah,F,100,215,0,215
Beautyful,F,100,6,0,6
Mella,F,100,65,0,65
Asjia,F,100,73,0,73
Derrill,M,100,0,393,393
Leilynd,M,100,0,5,5
Lilyian,F,100,107,0,107
Shadawn,F,100,104,0,104
Jacorius,M,100,0,38,38
Rice,M,100,0,27,27
Anthone,M,100,0,130,130
Marisal,F,100,84,0,84
Krystell,F,100,40,0,40
Desiderio,M,100,0,438,438
Khaleem,M,100,0,64,64
Lizel,F,100,13,0,13
Latarsha,F,100,1975,0,1975
Tyi,M,100,0,12,12
Timyia,F,100,15,0,15
Daquinn,M,100,0,5,5
Ronen,M,100,0,481,481
Delyle,M,100,0,5,5
Taysean,M,100,0,208,208
Shakendria,F,100,13,0,13
Macynn,F,100,11,0,11
Tarajhi,F,100,6,0,6
Mainou,F,100,5,0,5
Tajiah,F,100,6,0,6
Jennesa,F,100,29,0,29
Jamiann,F,100,6,0,6
Mlissa,F,100,86,0,86
Payzlie,F,100,27,0,27
Colan,M,100,0,182,182
Jarrard,M,100,0,57,57
Yelixa,F,100,8,0,8
Trulie,F,100,38,0,38
Shonnie,F,100,223,0,223
Kaleinani,F,100,8,0,8
Dafna,F,100,74,0,74
Rubel,M,100,0,23,23
Travisha,F,100,8,0,8
Darrent,M,100,0,15,15
Eghosa,M,100,0,28,28
Harvir,M,100,0,23,23
Launda,F,100,5,0,5
Eurasia,F,100,5,0,5
Ronnye,F,100,5,0,5
Tarica,F,100,99,0,99
Assad,M,100,0,150,150
Remey,M,67,5,10,15
Alantis,F,100,147,0,147
Sevara,F,100,6,0,6
Liora,F,100,587,0,587
Geidy,F,100,18,0,18
Tyshonda,F,100,27,0,27
Kirstyn,F,100,2237,0,2237
Jaydia,F,100,20,0,20
Tangia,F,100,74,0,74
Mar,F,62,305,189,494
Mutaz,M,100,0,23,23
Lizaida,F,100,11,0,11
Ayodeji,M,100,0,199,199
Marcelene,F,100,245,0,245
Markquis,M,100,0,36,36
Itzabelle,F,100,5,0,5
Maeryn,F,100,64,0,64
Toriona,F,100,30,0,30
Ceyonna,F,100,17,0,17
Brennden,M,100,0,73,73
Terria,F,100,1054,0,1054
Kyjuan,M,100,0,445,445
Kester,M,100,0,112,112
Kealin,M,100,0,18,18
Salena,F,100,4703,0,4703
Maliek,M,100,0,918,918
Shaderrica,F,100,11,0,11
Naiyah,F,100,213,0,213
Masie,F,100,181,0,181
Ephron,M,100,0,5,5
Donovan,M,100,205,49295,49500
Cianie,F,100,5,0,5
Shilpa,F,100,573,0,573
Brealynn,F,100,132,0,132
Porcha,F,100,865,0,865
Danesa,F,100,29,0,29
Jaramy,M,100,0,18,18
Chassitty,F,100,5,0,5
Taydum,M,100,0,5,5
Carlann,F,100,5,0,5
Korren,F,100,10,0,10
Avamaria,F,100,15,0,15
Millenna,F,100,5,0,5
Henzley,F,100,6,0,6
Tashfia,F,100,5,0,5
Janier,M,100,0,12,12
Shaquan,M,79,536,1983,2519
Mersadees,F,100,5,0,5
Khyair,M,100,0,6,6
Xaivion,M,100,0,6,6
Kabao,F,100,117,0,117
Jahnise,F,100,6,0,6
Jamse,M,100,0,58,58
Laprincia,F,100,55,0,55
Rishikesh,M,100,0,87,87
Bae,F,82,23,5,28
Diannah,F,100,71,0,71
Zaidyn,M,96,24,544,568
Adlia,M,100,0,6,6
Krysty,F,100,33,0,33
Luicana,F,100,10,0,10
Larya,F,100,60,0,60
Jantz,M,100,0,75,75
Quintell,M,97,5,175,180
Asal,F,100,16,0,16
Aylinn,F,100,102,0,102
Aliyahna,F,100,14,0,14
Enyce,F,100,17,0,17
Demyan,M,100,0,56,56
Lianett,F,100,6,0,6
Aubreerose,F,100,6,0,6
Taide,F,100,25,0,25
Evian,F,51,220,210,430
Tuyen,F,86,160,26,186
Tarver,M,100,0,10,10
Latisa,F,100,535,0,535
Adalius,M,100,0,9,9
Louria,F,100,17,0,17
Dairius,M,100,0,18,18
Jordanne,F,100,607,0,607
Shadestiny,F,100,7,0,7
Rondal,M,100,0,955,955
Krzysztof,M,100,0,445,445
Joseduardo,M,100,0,5,5
Eliyjah,M,100,0,6,6
Darvi,F,100,11,0,11
Etoyi,M,100,0,7,7
Tennille,F,99,2172,15,2187
Amartya,M,100,0,23,23
Carmelle,F,100,269,0,269
Seven,M,70,527,1205,1732
Vindhya,F,100,22,0,22
Shaik,M,100,0,5,5
Joice,F,100,190,0,190
Yandriel,M,100,0,46,46
Maksim,M,100,0,1550,1550
Kasimu,M,100,0,5,5
Kaizley,F,100,87,0,87
Cathyann,F,100,128,0,128
Celestial,F,100,466,0,466
Wykeria,F,100,5,0,5
Shpresa,F,100,16,0,16
Jermone,M,100,0,247,247
Assa,F,100,24,0,24
Enette,F,100,5,0,5
Alecsis,F,100,5,0,5
Minyon,F,100,53,0,53
Lens,M,100,0,5,5
Salimah,F,100,250,0,250
Chennell,F,100,5,0,5
Vangela,F,100,11,0,11
Yamelin,F,100,11,0,11
Phylisa,F,100,6,0,6
Elante,M,100,0,35,35
Mylla,F,100,11,0,11
Sashalee,F,100,5,0,5
Taveyon,M,100,0,10,10
Garlen,M,100,0,15,15
Angalina,F,100,180,0,180
Hadiyah,F,100,445,0,445
Kayky,M,100,0,6,6
Beulah,F,100,3104,0,3104
Laqundra,F,100,5,0,5
Lennette,F,100,312,0,312
Gentrie,F,100,22,0,22
Alisan,F,100,81,0,81
Tasmin,F,100,52,0,52
Nashlly,F,100,5,0,5
Hodan,F,100,189,0,189
Nation,M,97,5,155,160
Kendera,F,100,5,0,5
Jabraun,M,100,0,6,6
Laronica,F,100,123,0,123
English,F,87,265,40,305
Nachum,M,100,0,177,177
Jahon,M,100,0,119,119
Luzdari,F,100,5,0,5
Taishan,M,100,0,10,10
Kiaura,F,100,23,0,23
Hodalis,F,100,10,0,10
Dolleen,F,100,5,0,5
Caneisha,F,100,47,0,47
Brinnley,F,100,146,0,146
Shenikwa,F,100,10,0,10
Kaleemah,F,100,5,0,5
Mon,M,100,0,5,5
Paisha,F,100,5,0,5
Judyann,F,100,182,0,182
Curtus,M,100,0,11,11
Satoko,F,100,17,0,17
Luisdaniel,M,100,0,56,56
Kyshaun,M,100,0,203,203
Myishia,F,100,56,0,56
Gurpal,M,100,0,5,5
Zaaron,M,100,0,16,16
Deshaud,M,100,0,6,6
Cecilia,F,100,59481,152,59633
Pepe,M,100,0,155,155
Cayler,M,100,0,5,5
Shinique,F,100,24,0,24
Aylene,F,100,290,0,290
Manuelito,M,100,0,136,136
Gethsemane,F,100,35,0,35
Inoke,M,100,0,16,16
Lekeia,F,100,11,0,11
Alainey,F,100,16,0,16
Shaska,F,100,10,0,10
Bodhi,M,97,61,2339,2400
Ambir,F,100,5,0,5
Mahde,M,100,0,5,5
Keyante,M,96,6,146,152
Demetricia,F,100,5,0,5
Leighlynn,F,100,10,0,10
Tacia,F,100,103,0,103
Monzerrat,F,99,462,5,467
Scorpio,M,100,0,72,72
Ananyaa,F,100,5,0,5
Izik,M,100,0,521,521
Kelvyn,M,100,0,219,219
Samantaha,F,100,6,0,6
Mikalee,F,100,21,0,21
Nastashia,F,100,119,0,119
Elrod,M,100,0,6,6
Chanteria,F,100,81,0,81
Waylen,M,100,0,559,559
Marylynne,F,100,103,0,103
Dexx,M,100,0,6,6
Lanet,F,100,21,0,21
Suzen,F,100,30,0,30
Meshon,F,100,6,0,6
Barny,M,100,0,5,5
Lashaundra,F,100,480,0,480
Jamaine,M,99,16,1270,1286
Bentlei,F,51,22,21,43
Jibreel,M,100,0,425,425
Clent,M,100,0,98,98
Angelamaria,F,100,5,0,5
Cristyna,F,100,5,0,5
Faryal,F,100,80,0,80
Amana,F,100,276,0,276
Basile,M,100,0,17,17
Keilynn,F,100,87,0,87
Myani,F,100,43,0,43
Culver,M,100,0,10,10
Parmveer,M,100,0,10,10
Trashell,F,100,5,0,5
Jossilyn,F,100,78,0,78
Danele,F,100,46,0,46
Joyana,F,100,7,0,7
Dyona,F,100,10,0,10
Shameika,F,100,837,0,837
Casiyah,F,100,5,0,5
Nedim,M,100,0,84,84
Dixielynn,F,100,13,0,13
Rishil,M,100,0,14,14
Cadia,F,100,34,0,34
Nikkoli,M,100,0,7,7
Jak,M,100,0,266,266
Jenifer,F,100,24897,22,24919
Flora,F,100,11048,6,11054
Talar,F,100,207,0,207
Ambermarie,F,100,76,0,76
Thavy,F,100,17,0,17
Adabel,F,100,26,0,26
Jaanna,F,100,12,0,12
Japera,F,100,21,0,21
Kennice,F,100,65,0,65
Viriginia,F,100,42,0,42
Olukayode,M,100,0,21,21
Maleesa,F,100,5,0,5
Ziyana,F,100,158,0,158
Fabin,M,100,0,15,15
Arwa,F,100,626,0,626
Janalyse,F,100,5,0,5
Sione,M,99,6,1126,1132
Angenita,F,100,10,0,10
Llareli,F,100,15,0,15
Keyandre,M,100,0,171,171
Sunniva,F,100,21,0,21
Cashion,M,100,0,6,6
Samaiyah,F,100,250,0,250
Eliahu,M,100,0,16,16
Joanathan,M,100,0,92,92
Zamara,F,100,345,0,345
Hatley,F,100,42,0,42
Hayzel,F,100,123,0,123
Kandas,F,100,77,0,77
Nadine,F,100,29523,16,29539
Melita,F,100,1377,0,1377
Darely,F,100,132,0,132
Abdulsalam,M,100,0,20,20
Nyemia,F,100,5,0,5
Olexus,F,100,5,0,5
Aaleiyah,F,100,32,0,32
Adiline,F,100,11,0,11
Leevan,M,100,0,5,5
Aniecia,F,100,32,0,32
Nittaya,F,100,11,0,11
Dreamer,F,94,75,5,80
Geraldine,F,100,41453,129,41582
Taonna,F,100,5,0,5
Jmya,F,100,208,0,208
Elexa,F,100,537,0,537
Jenysis,F,100,6,0,6
Nyila,F,100,52,0,52
Davianna,F,100,549,0,549
Marteka,F,100,58,0,58
Valdis,M,100,0,78,78
Ellean,F,100,5,0,5
Daffne,F,100,52,0,52
Osvin,M,100,0,36,36
Cynthis,F,100,60,0,60
Stevenn,M,100,0,6,6
Orie,M,98,10,467,477
Taigen,F,58,36,26,62
Jalayha,F,100,5,0,5
Dondrea,F,82,76,17,93
Latrish,F,100,86,0,86
Dannelle,F,100,371,0,371
Zitlalic,F,100,51,0,51
Sankalp,M,100,0,94,94
Shinequa,F,100,27,0,27
Abbygayl,F,100,6,0,6
Conal,M,100,0,121,121
Hastiin,M,100,0,5,5
Kemanie,F,100,5,0,5
Racel,F,100,10,0,10
Dalen,M,99,16,1691,1707
Afsa,F,100,35,0,35
Viririana,F,100,10,0,10
Teairra,F,100,709,0,709
Camdan,M,100,0,89,89
Jaryan,M,100,0,72,72
Devola,F,100,6,0,6
Sahron,F,100,5,0,5
Long,M,100,0,1801,1801
Arniyah,F,100,18,0,18
Euri,M,100,0,7,7
Josiane,F,100,65,0,65
Bynum,M,100,0,14,14
Ulrich,M,100,0,250,250
Marialisa,F,100,18,0,18
Reona,F,100,131,0,131
Leto,M,100,0,35,35
Patriciaanne,F,100,5,0,5
Myree,F,100,9,0,9
Ashford,M,100,0,326,326
Rollyn,M,100,0,12,12
Innis,M,100,0,32,32
Latress,F,100,19,0,19
Johnnita,F,100,33,0,33
Sereta,F,100,37,0,37
Florie,F,100,117,0,117
Kenjiro,M,100,0,22,22
Yuritzy,F,100,333,0,333
Ranessa,F,100,67,0,67
Rolando,M,100,78,21772,21850
Vanderlei,M,100,0,11,11
Suhaily,F,100,5,0,5
Divisha,F,100,7,0,7
Siyuri,F,100,5,0,5
Antolina,F,100,5,0,5
Leeroy,M,100,0,1589,1589
Lakreisha,F,100,6,0,6
Luciann,F,100,59,0,59
Jermyra,F,100,15,0,15
Frutoso,M,100,0,5,5
Khadisha,F,100,29,0,29
Bracen,M,100,0,64,64
Melodyrose,F,100,6,0,6
Timea,F,100,134,0,134
Christophor,M,100,0,537,537
Jakeem,M,100,0,828,828
Wisler,M,100,0,5,5
Sundiata,M,100,0,103,103
Mesut,M,100,0,6,6
Dontell,M,100,0,188,188
Dejon,M,97,77,2352,2429
Levon,M,94,244,3560,3804
Meleny,F,100,501,0,501
Zanylah,F,100,78,0,78
Xzayvien,M,100,0,6,6
Tyheem,M,100,0,321,321
Suleyman,M,100,0,118,118
Rashard,M,100,0,2483,2483
Judit,F,100,502,0,502
Shakeara,F,100,29,0,29
Carlyne,F,100,70,0,70
Yancarlos,M,100,0,125,125
Aryn,F,87,2377,341,2718
Dakuan,M,100,0,5,5
Donita,F,100,4305,0,4305
Ivy,F,96,32895,1248,34143
Zyra,F,100,345,0,345
Thane,M,100,0,1954,1954
Kamiaya,F,100,16,0,16
Kevinanthony,M,100,0,5,5
Gerita,F,100,5,0,5
Nataya,F,100,637,0,637
Celis,F,100,11,0,11
Marshanti,F,100,6,0,6
Kinlei,F,100,28,0,28
Fleurette,F,100,57,0,57
Sequioa,F,100,52,0,52
Kavi,M,99,5,484,489
Fritzi,F,100,210,0,210
Fontaine,M,58,119,162,281
Marjori,F,100,25,0,25
Bernadino,M,100,0,17,17
Khalina,F,100,17,0,17
Chans,M,100,0,32,32
Henretta,F,100,136,0,136
Daquel,M,100,0,5,5
Jynell,F,100,15,0,15
Kyse,M,100,0,5,5
Jalyiah,F,100,107,0,107
Jahkari,M,100,0,145,145
Tyriece,M,100,0,49,49
Luisangel,M,100,0,1163,1163
Desia,F,100,131,0,131
Jooyoung,M,100,0,5,5
Knut,M,100,0,35,35
Obafemi,M,100,0,5,5
Donnie,M,96,2001,43498,45499
Destined,M,100,0,10,10
Aarnavi,F,100,26,0,26
Wilian,M,100,0,161,161
Allexia,F,100,40,0,40
Tarrah,F,100,1069,0,1069
Bennet,M,97,29,1128,1157
Jeison,M,100,0,244,244
Teesha,F,100,478,0,478
Donivin,M,100,0,77,77
Ozion,M,100,0,5,5
Beighley,F,100,11,0,11
Pattyann,F,100,22,0,22
Signe,F,100,1152,0,1152
Jaxsin,M,100,0,95,95
Kisia,F,100,5,0,5
Lawsyn,F,53,23,20,43
Zamaiya,F,100,5,0,5
Avry,F,51,403,382,785
Nicklas,M,100,0,2255,2255
Jazmariah,F,100,17,0,17
Senia,F,100,328,0,328
Kholby,M,100,0,10,10
Lacci,F,100,5,0,5
Shakeitha,F,100,212,0,212
Starlight,F,100,17,0,17
Desarae,F,100,1744,0,1744
Daycee,F,100,46,0,46
Kydan,M,100,0,45,45
Nekeya,F,100,77,0,77
Mevelyn,F,100,18,0,18
Loralye,F,100,156,0,156
Leelend,M,100,0,23,23
Bethania,F,100,126,0,126
Larra,F,100,215,0,215
Phil,M,100,22,9747,9769
Nikan,M,100,0,27,27
Mikias,M,100,0,67,67
Brantlie,F,100,11,0,11
Sakthi,F,100,5,0,5
Chevalier,M,100,0,27,27
Eseta,F,100,12,0,12
Antoya,F,100,35,0,35
Nyairah,F,100,43,0,43
Antoiniece,F,100,6,0,6
Brady,M,98,1583,79054,80637
Songa,F,100,55,0,55
Manvel,M,100,0,22,22
Yordi,M,100,0,485,485
Merry,F,100,6530,0,6530
Netra,F,100,168,0,168
Mireille,F,100,613,0,613
Sondos,F,100,55,0,55
Malonnie,F,100,10,0,10
Alizae,F,99,775,5,780
Braison,M,100,0,185,185
Charliee,F,100,33,0,33
Taleasha,F,100,15,0,15
Buna,F,100,10,0,10
Reita,F,100,363,0,363
Aidenmatthew,M,100,0,5,5
Phoebie,F,100,33,0,33
Safia,F,100,1000,0,1000
Farhan,M,100,0,1172,1172
Saleen,F,100,668,0,668
Anzleigh,F,100,56,0,56
Kaplan,M,100,0,27,27
Eddis,M,100,0,6,6
Joscar,M,100,0,11,11
Catheryn,F,100,1051,0,1051
Ayra,F,100,333,0,333
Yerucham,M,100,0,5,5
Aliveah,F,100,59,0,59
Tajee,M,70,34,80,114
Skylyr,F,100,37,0,37
Ajanai,F,100,24,0,24
Sariyah,F,100,2297,0,2297
Reeyan,M,100,0,5,5
Demorrio,M,100,0,21,21
Caldwell,M,100,0,136,136
Joah,M,100,0,607,607
Chandara,M,87,6,41,47
Micaleb,M,100,0,5,5
Dulse,F,100,253,0,253
Trimayne,M,100,0,5,5
Isidore,M,100,0,424,424
Tyleke,M,100,0,10,10
Keyon,M,98,101,4996,5097
Paison,F,100,13,0,13
Sheriee,F,100,6,0,6
Cecelio,M,100,0,5,5
Monson,M,100,0,38,38
Nadasha,F,100,5,0,5
French,M,100,0,234,234
Renesmay,F,100,16,0,16
Danina,F,100,41,0,41
Zacharyah,M,100,0,16,16
Kaltrina,F,100,5,0,5
Kenady,F,100,497,0,497
Ginny,F,100,6138,0,6138
Yamil,M,95,64,1238,1302
Khamiyah,F,100,99,0,99
Jodye,F,100,64,0,64
Krystle,F,100,12926,44,12970
Keiry,F,100,1279,0,1279
Magdala,F,100,65,0,65
Jacobthomas,M,100,0,5,5
Abisha,F,100,36,0,36
Tonicka,F,100,6,0,6
Brashad,M,100,0,5,5
Delajah,F,100,6,0,6
Alynn,F,100,327,0,327
Jaharri,M,100,0,10,10
Joran,M,100,0,192,192
Noria,F,100,20,0,20
Markeise,M,100,0,147,147
Orton,M,100,0,5,5
Jamod,M,100,0,5,5
Lynetta,F,100,1297,0,1297
Vinie,F,100,5,0,5
Gartrell,M,100,0,5,5
Hazley,F,100,37,0,37
Nilda,F,100,2672,0,2672
Tyreque,M,100,0,90,90
Juantia,F,100,16,0,16
Eyra,F,100,5,0,5
Virgel,M,100,0,185,185
Julain,M,100,0,10,10
Aunah,F,100,7,0,7
Aeyla,F,100,11,0,11
Synethia,F,100,123,0,123
Aneliz,F,100,192,0,192
Darique,M,100,0,5,5
Yuvia,F,100,394,0,394
Narda,F,100,551,0,551
Nohemy,F,100,328,0,328
Antonina,F,100,1473,0,1473
Aspen,F,91,11289,1079,12368
Genella,F,100,51,0,51
Druce,M,100,0,5,5
Lael,F,71,1362,545,1907
Kanilah,F,100,18,0,18
Fedrick,M,100,0,62,62
Truong,M,100,0,237,237
Tereon,M,100,0,5,5
Jadaveon,M,100,0,14,14
Johnel,M,98,5,240,245
Xaviera,F,100,620,0,620
Kahmir,M,100,0,5,5
Taylynn,F,100,679,0,679
Mico,M,81,18,78,96
Miguel,M,99,957,159995,160952
Atiksh,M,100,0,40,40
Muhib,M,100,0,10,10
Jahnyia,F,100,11,0,11
Meridy,F,100,6,0,6
Gioni,M,100,0,39,39
Trany,F,100,278,0,278
Taiyana,F,100,112,0,112
Sarene,F,100,18,0,18
Spiridoula,F,100,5,0,5
Boyce,M,100,5,1888,1893
Benedetta,F,100,120,0,120
Kalisi,F,100,29,0,29
Kaida,F,100,364,0,364
Aliona,F,100,35,0,35
Keshi,F,100,11,0,11
Joacim,M,100,0,6,6
Zaylene,F,100,5,0,5
Izaak,M,100,0,2230,2230
Federico,M,100,0,6529,6529
Raziah,F,100,146,0,146
Kathllen,F,100,18,0,18
Lucertia,F,100,5,0,5
Jemily,F,100,16,0,16
Tannille,F,100,8,0,8
Granvel,M,100,0,7,7
Tau,M,100,0,23,23
Synia,F,100,381,0,381
Amandajo,F,100,69,0,69
Garius,M,100,0,5,5
Kiing,M,100,0,23,23
Masiela,F,100,24,0,24
Arlisha,F,100,276,0,276
Redena,F,100,23,0,23
Shawnett,F,100,11,0,11
Kayle,F,86,3748,621,4369
Shekhinah,F,100,5,0,5
Elysium,F,88,36,5,41
Kiare,F,84,26,5,31
Corderra,M,100,0,36,36
Youcef,M,100,0,55,55
Celica,F,100,183,0,183
Alaiya,F,100,491,0,491
Victorie,F,100,16,0,16
Jevonte,M,100,0,407,407
Erlin,M,94,11,167,178
Dashia,F,100,892,0,892
Keyren,F,100,5,0,5
Abhishek,M,100,0,753,753
Gicel,F,100,19,0,19
Myheir,M,100,0,5,5
Caulder,M,100,0,20,20
Flannery,F,100,479,0,479
Karron,F,60,239,159,398
Milliana,F,100,198,0,198
Journe,F,100,62,0,62
Iyhana,F,100,6,0,6
Gerber,M,100,0,54,54
Jelayne,F,100,5,0,5
Rakhi,F,100,48,0,48
Kayce,F,95,2722,138,2860
Zymia,F,100,33,0,33
Blynda,F,100,5,0,5
Felicita,F,100,1215,0,1215
Martianna,F,100,5,0,5
Jossalyn,F,100,307,0,307
Mandisa,F,100,374,0,374
Sissie,F,100,21,0,21
Siyana,F,100,90,0,90
Tequita,F,100,150,0,150
Cyriana,F,100,17,0,17
Martay,M,100,0,16,16
Khadeem,M,100,0,78,78
Ivis,F,70,155,66,221
Laquia,F,100,62,0,62
Auraya,F,100,5,0,5
Caz,M,100,0,86,86
Dehja,F,100,12,0,12
Rashika,F,100,130,0,130
Miner,M,100,0,16,16
Deandrae,M,100,0,399,399
Shakwon,M,100,0,10,10
Tiwana,F,100,463,0,463
Jeff,M,100,243,106915,107158
Messiah,M,89,730,6087,6817
Glenn,M,99,864,143337,144201
Kayeden,M,100,0,11,11
Florence,F,100,21135,50,21185
Mihira,F,100,46,0,46
Faline,F,100,93,0,93
Ahlijah,M,100,0,41,41
Caitlyn,F,100,50566,34,50600
Andrik,M,100,0,570,570
Dawneen,F,100,8,0,8
Yosuf,M,100,0,17,17
Romeisha,F,100,6,0,6
Kasia,F,100,1480,0,1480
Janine,F,100,31343,11,31354
Lyla,F,100,18757,0,18757
Jerimee,M,100,0,5,5
Jaylani,F,95,480,23,503
Jarule,M,100,0,25,25
Mato,M,100,0,35,35
Tiannah,F,100,222,0,222
Melaina,F,100,1033,0,1033
Cressie,F,100,37,0,37
Kamree,F,100,347,0,347
Icely,F,100,5,0,5
Cordaro,M,100,0,461,461
Raiana,F,100,93,0,93
Pragyan,M,100,0,12,12
Williard,M,100,0,201,201
Demiya,F,100,227,0,227
Kalyanna,F,100,6,0,6
Jermichael,M,100,0,394,394
Nataija,F,100,24,0,24
Hatty,F,100,10,0,10
Condoleezza,F,100,5,0,5
Kavya,F,100,1236,6,1242
Wrenly,F,100,9,0,9
Dashanta,F,100,15,0,15
Alizandra,F,100,50,0,50
Ericanicole,F,100,5,0,5
Balen,M,100,0,74,74
Janitta,F,100,6,0,6
Tynslee,F,100,37,0,37
Eriq,M,100,0,711,711
Jeryn,M,66,61,121,182
Abrey,F,100,128,0,128
Hermelinda,F,100,1392,0,1392
Reeva,F,100,220,0,220
Leshawna,F,100,8,0,8
Ardythe,F,100,22,0,22
Kahari,M,100,0,348,348
Oluwapelumi,M,58,11,15,26
Neveaha,F,100,26,0,26
Tabor,M,87,82,566,648
Tmarion,M,100,0,10,10
Ramsie,F,100,51,0,51
Litzzy,F,100,43,0,43
Yll,M,100,0,5,5
Solina,F,100,112,0,112
Bristin,F,71,12,5,17
Orvella,F,100,5,0,5
Talula,F,100,208,0,208
Oweda,F,100,10,0,10
Hritik,M,100,0,10,10
Jaquelina,F,100,34,0,34
Lotti,F,100,12,0,12
Jaleasa,F,100,27,0,27
Yaniel,M,100,0,371,371
Rosheda,F,100,44,0,44
Laquida,F,100,130,0,130
Tielor,M,100,0,10,10
Jancie,F,100,158,0,158
Sadonia,F,100,5,0,5
Bilal,M,100,5,4042,4047
Aiylah,F,100,12,0,12
Shoun,M,100,0,6,6
Terriyon,M,100,0,5,5
Nohemi,F,100,1739,0,1739
Mahlah,F,100,5,0,5
Ashleyanne,F,100,67,0,67
Ritvik,M,100,0,401,401
Kjuan,M,100,0,78,78
Adel,M,64,603,1077,1680
Latrae,M,100,0,6,6
Ashtion,M,100,0,6,6
Pada,F,100,5,0,5
Jaiceyon,M,100,0,6,6
Arismel,F,100,5,0,5
Shaniece,F,100,1960,0,1960
Kainani,F,100,27,0,27
Tavyn,M,92,12,130,142
Aleishia,F,100,10,0,10
Jasya,F,100,11,0,11
Lyndsy,F,100,621,0,621
Shyan,F,96,805,35,840
Santy,M,100,0,12,12
Starr,F,98,8119,175,8294
Shlomy,M,100,0,10,10
Jalexus,F,100,107,0,107
Alexzander,M,100,0,5449,5449
Jasi,F,70,26,11,37
Skiilar,F,100,6,0,6
Monette,F,100,932,0,932
Cynae,F,100,19,0,19
Tysaiah,M,100,0,5,5
Izabell,F,100,999,0,999
Raigan,F,100,688,0,688
Tayla,F,100,4611,0,4611
Jhovanny,M,100,0,245,245
Belmaris,F,100,11,0,11
Pamara,F,100,5,0,5
Jaston,M,100,0,215,215
Sotero,M,100,0,476,476
Daivion,M,100,0,254,254
Dejahnay,F,100,7,0,7
Akadian,M,100,0,5,5
Tekeyla,F,100,21,0,21
Rashelle,F,100,1331,0,1331
Arien,M,55,375,458,833
Thuyvy,F,100,5,0,5
Umer,M,100,0,286,286
Oran,M,100,0,1493,1493
Renitta,F,100,28,0,28
Youssouf,M,100,0,158,158
Laquandria,F,100,29,0,29
Aliyan,M,63,11,19,30
Zevon,M,100,0,49,49
Arilene,F,100,27,0,27
Jinaya,F,100,5,0,5
Zamya,F,100,837,0,837
Edmee,F,100,7,0,7
Dashel,M,98,6,372,378
Yoselynn,F,100,33,0,33
Mignon,F,100,1116,0,1116
Sheresse,F,100,11,0,11
Zakaya,F,100,60,0,60
Zaveon,M,100,0,246,246
Saryna,F,100,120,0,120
Kahdeem,M,100,0,6,6
Savar,M,100,0,6,6
Isabelle,F,100,56938,20,56958
Helga,F,100,824,0,824
Braxsten,M,100,0,6,6
Annajulia,F,100,60,0,60
Myisha,F,100,1550,0,1550
Renya,F,100,43,0,43
Alaura,F,100,1279,0,1279
Zevi,M,100,0,22,22
Kahryn,F,100,5,0,5
Irelan,F,100,35,0,35
Mikayleigh,F,100,5,0,5
Shamikka,F,100,17,0,17
Jerissa,F,100,45,0,45
Diamante,M,70,237,554,791
Carilynn,F,100,12,0,12
Latoia,F,100,288,0,288
Teri,F,100,42179,207,42386
Savannahgrace,F,100,5,0,5
Raybon,M,100,0,21,21
Jeanenne,F,100,198,0,198
Hartlyn,F,100,75,0,75
Tung,M,100,0,221,221
Annayeli,F,100,6,0,6
Esraa,F,100,59,0,59
Zebedee,M,100,0,667,667
Mckensi,F,100,139,0,139
Grove,M,100,0,17,17
Salwa,F,100,506,0,506
Kenlin,M,100,0,5,5
Emberley,F,100,40,0,40
Daquanna,F,100,18,0,18
Jameon,M,100,0,62,62
Tilton,M,100,0,133,133
Sharav,M,100,0,6,6
Zyani,F,100,5,0,5
Taily,F,100,10,0,10
Quiriat,F,100,5,0,5
Chinaza,F,100,51,0,51
Ellice,F,100,343,0,343
Haddley,F,100,6,0,6
Aul,M,100,0,46,46
Mirely,F,100,75,0,75
Dvyne,F,100,12,0,12
Haythem,M,100,0,6,6
Keegen,M,100,0,266,266
Anaviah,F,100,5,0,5
Jerious,M,100,0,5,5
Ciya,F,100,21,0,21
Yasmany,M,100,0,10,10
Daryen,M,73,14,38,52
Averyl,F,100,16,0,16
Candon,M,100,0,122,122
Taiquan,M,100,0,116,116
Keimyah,F,100,19,0,19
Dailyn,F,77,751,220,971
Radin,M,100,0,36,36
Hamaad,M,100,0,5,5
Liadan,F,100,65,0,65
Jahseer,M,100,0,5,5
Tycee,F,100,24,0,24
Lashona,F,100,419,0,419
Jerianna,F,100,6,0,6
Tryp,M,100,0,6,6
Nyzair,M,100,0,7,7
Gagik,M,100,0,8,8
Olaniyan,M,100,0,6,6
Quasia,F,100,51,0,51
Ayaana,F,100,86,0,86
Timeria,F,100,6,0,6
Naiyeli,F,100,11,0,11
Eliotte,F,100,24,0,24
Lakissa,F,100,6,0,6
Zakyia,F,100,120,0,120
Islah,F,100,6,0,6
Raeshaun,M,100,0,146,146
Jamahri,M,100,0,48,48
Kaihan,M,100,0,6,6
Lismari,F,100,6,0,6
Edwina,F,100,6424,0,6424
Kalinda,F,100,376,0,376
Gwendol,F,100,17,0,17
Shayvon,F,85,28,5,33
Tristica,F,100,6,0,6
Klever,M,100,0,90,90
Danyne,F,100,6,0,6
Ashni,F,100,67,0,67
Jakirra,F,100,31,0,31
Gaylee,F,100,36,0,36
Eutimio,M,100,0,126,126
Rahmin,M,100,0,5,5
Maxwel,M,100,0,244,244
Jashun,M,100,0,264,264
Edmanuel,M,100,0,17,17
Darwyn,M,100,0,450,450
Magdalena,F,100,12533,10,12543
Stephaine,F,100,4155,0,4155
Ratasha,F,100,80,0,80
Ajournee,F,100,13,0,13
Doris,F,99,71424,404,71828
Rogue,F,53,207,181,388
Marymar,F,100,35,0,35
Quanshae,F,100,6,0,6
Yennhi,F,100,15,0,15
Saleh,M,100,0,1008,1008
Yazmeen,F,100,447,0,447
Zylee,F,100,58,0,58
Liesa,F,100,392,0,392
Ariely,F,100,140,0,140
Kemara,F,100,104,0,104
Mariquita,F,100,18,0,18
Dorrel,M,100,0,5,5
Jarlene,F,100,26,0,26
Chansler,M,100,0,5,5
Conlee,M,67,21,42,63
Sadiya,F,100,263,0,263
Amyrie,F,100,116,0,116
Deloris,F,100,10711,6,10717
Zaylah,F,100,220,0,220
Tessi,F,100,69,0,69
Talynn,F,99,465,5,470
Delrick,M,100,0,64,64
Myhanh,F,100,14,0,14
Avleen,F,100,84,0,84
Angellee,F,100,98,0,98
Merrilee,F,100,1204,0,1204
Demeir,M,100,0,12,12
Tandice,F,100,5,0,5
Mikela,F,100,740,0,740
Esias,M,100,0,115,115
Analisse,F,100,223,0,223
Analeya,F,100,49,0,49
Jimmylee,M,100,0,79,79
Hyla,F,100,236,0,236
Kaylob,M,100,0,290,290
Khattab,M,100,0,5,5
Iliyah,F,100,239,0,239
Taneishia,F,100,12,0,12
Exavion,M,100,0,10,10
Ellasia,F,100,5,0,5
Omarious,M,100,0,12,12
Latese,F,100,88,0,88
Maedot,F,100,7,0,7
Ralyn,F,100,117,0,117
Jarran,M,100,0,5,5
Robine,F,100,37,0,37
Okpara,M,100,0,5,5
Seanjohn,M,100,0,5,5
Andreah,F,100,397,0,397
Reneta,F,100,167,0,167
Wadee,M,100,0,5,5
Shareca,F,100,10,0,10
Anibelle,F,100,7,0,7
Natarsha,F,100,501,0,501
Strange,F,100,17,0,17
Harjap,F,100,5,0,5
Nalynn,F,100,5,0,5
Dallion,M,100,0,6,6
Tisa,F,100,1410,0,1410
Cee,F,100,18,0,18
Nesiah,F,94,76,5,81
Trell,M,100,0,66,66
Lashiyah,F,100,6,0,6
Elah,F,100,143,0,143
Analys,F,100,69,0,69
Jakenya,F,100,39,0,39
Patsie,F,100,96,0,96
Travez,M,100,0,76,76
Kassia,F,100,647,0,647
Bridgid,F,100,445,0,445
Elma,F,99,3048,20,3068
Martice,M,95,15,300,315
Temitope,F,67,229,112,341
Innocent,M,100,0,22,22
Timani,F,100,12,0,12
Malaky,M,100,0,51,51
Jostin,M,100,0,552,552
Shaleigha,F,100,10,0,10
Beyah,F,100,5,0,5
Rielly,F,55,244,196,440
Talona,F,100,25,0,25
Danalyn,F,100,55,0,55
Aharshi,M,100,0,5,5
Omya,F,100,56,0,56
Zef,M,100,0,39,39
Emmelina,F,100,36,0,36
Tawheed,M,100,0,5,5
Shaqueel,M,100,0,5,5
Shishir,M,100,0,66,66
Tomo,M,100,0,7,7
Alene,F,100,1728,0,1728
Kharley,F,100,5,0,5
Neasia,F,100,67,0,67
Kloye,F,100,10,0,10
Temiloluwa,F,64,156,88,244
Antiwan,M,100,0,58,58
Riannah,F,100,77,0,77
Kipenie,F,100,5,0,5
Consuello,F,100,63,0,63
Keithrick,M,100,0,18,18
Heng,M,100,0,16,16
Yiana,F,100,5,0,5
Yasirah,F,100,30,0,30
Teague,M,98,32,1346,1378
Darbey,F,100,25,0,25
Joshualee,M,100,0,32,32
Trinisa,F,100,13,0,13
Dmorea,M,100,0,30,30
Zoye,F,100,65,0,65
Rusty,M,97,517,16878,17395
Alysin,F,100,10,0,10
Ayahna,F,100,91,0,91
Lareco,M,100,0,5,5
Jeanel,F,100,15,0,15
Jakori,M,99,5,386,391
Ezrah,M,78,141,514,655
Vidal,M,100,10,3286,3296
Korena,F,100,456,0,456
Natesha,F,100,363,0,363
Zakeem,M,100,0,15,15
Trinidy,F,96,763,33,796
Nemesis,F,100,141,0,141
Cortne,F,100,58,0,58
Amela,F,100,293,0,293
Fana,F,100,12,0,12
Polaris,F,100,5,0,5
Evalee,F,100,257,0,257
Selinda,F,100,425,0,425
Yoyo,F,100,30,0,30
Oni,F,100,173,0,173
Shekira,F,100,159,0,159
Tkara,F,100,5,0,5
Carcyn,F,100,5,0,5
Kairav,M,100,0,63,63
Deltina,F,100,6,0,6
Ethanmatthew,M,100,0,18,18
Jaydel,M,100,0,21,21
Tilford,M,100,0,155,155
Ireta,F,100,23,0,23
Tewanna,F,100,55,0,55
Ceazia,F,100,94,0,94
Avanish,M,100,0,59,59
Eilleen,F,100,225,0,225
Kierstin,F,100,3176,0,3176
Murad,M,100,0,672,672
Andel,M,100,0,12,12
Morrell,M,100,0,348,348
Markez,M,100,0,272,272
Croy,M,100,0,28,28
Rhodena,F,100,5,0,5
Jeyli,F,100,62,0,62
Lataunya,F,100,61,0,61
Iantha,F,100,140,0,140
Jashonna,F,100,33,0,33
Amandip,M,100,0,6,6
Starlin,M,68,41,86,127
Quita,F,100,119,0,119
Kowsar,F,100,31,0,31
Daelynn,F,97,594,21,615
Renia,F,100,542,0,542
Tymeir,M,100,0,57,57
Averii,F,100,20,0,20
Johanne,F,100,722,0,722
Joesha,F,100,18,0,18
Kemaj,M,100,0,5,5
Weatherly,F,100,15,0,15
Dajshia,F,100,5,0,5
Temeka,F,100,1414,5,1419
Tava,F,100,430,0,430
Daved,M,100,0,184,184
Jakalah,F,100,5,0,5
Synthea,F,100,10,0,10
Nivin,M,100,0,5,5
Leeasia,F,100,137,0,137
Mekia,F,100,181,0,181
Zachery,M,100,38,29095,29133
Sidhant,M,100,0,88,88
Davarian,M,100,0,29,29
Hawaii,F,100,10,0,10
Arnelle,F,100,148,0,148
Shalma,F,100,18,0,18
Joao,M,100,0,1427,1427
Demarrie,M,100,0,8,8
Senad,M,100,0,36,36
Markcus,M,100,0,196,196
Libby,F,100,11317,5,11322
Griselda,F,99,8475,61,8536
Brylinn,F,100,34,0,34
Kennia,F,100,655,0,655
Jadene,F,100,65,0,65
Akeyla,F,100,309,0,309
Glennice,F,100,5,0,5
Xyaire,M,100,0,25,25
Dusin,M,100,0,5,5
Aahil,M,100,0,329,329
Jakyre,M,100,0,5,5
Hiilani,F,100,95,0,95
Ugo,M,100,0,89,89
Sophiyah,F,100,20,0,20
Terrez,M,100,0,150,150
Shray,M,100,0,86,86
Naymar,M,100,0,6,6
Trenica,F,100,6,0,6
Rahn,M,100,0,338,338
Grabiela,F,100,427,0,427
Bianny,F,100,7,0,7
Shandrell,F,100,86,0,86
Leedell,M,100,0,15,15
Kandrea,F,100,25,0,25
Vandana,F,100,93,0,93
Makalei,F,100,5,0,5
Wreatha,F,100,10,0,10
Napat,M,100,0,5,5
Catalyna,F,100,60,0,60
Shaine,M,81,222,962,1184
Bruk,M,100,0,43,43
Areliz,F,100,67,0,67
Zaeden,M,100,0,216,216
Daiten,M,100,0,11,11
Irvyn,M,100,0,17,17
Trenna,F,100,633,0,633
Syion,M,100,0,10,10
Aiken,M,100,0,195,195
Jorley,F,100,35,0,35
Neila,F,100,821,0,821
Kelvy,M,100,0,5,5
Gant,M,100,0,23,23
Kayline,F,100,110,0,110
Tayyibah,F,100,5,0,5
Markiee,M,100,0,5,5
Roberrt,M,100,0,11,11
Taraf,F,100,5,0,5
Kelana,F,100,41,0,41
Bas,F,100,5,0,5
Clowie,F,100,49,0,49
Miana,F,100,466,0,466
Desarea,F,100,82,0,82
Bon,M,100,0,220,220
Cheramie,F,100,46,0,46
Jolita,F,100,115,0,115
Tyrianna,F,100,238,0,238
Quason,M,100,0,28,28
Anaila,F,100,12,0,12
Jashira,F,100,61,0,61
Teaja,F,100,33,0,33
Shiela,F,100,3651,0,3651
Malu,F,100,66,0,66
Sreekar,M,100,0,85,85
Rhamir,M,100,0,5,5
Norean,F,100,17,0,17
Majerle,F,100,22,0,22
Gerome,M,100,0,1057,1057
Priyanshi,F,100,33,0,33
Jonanthony,M,100,0,154,154
Daise,F,100,5,0,5
Andreea,F,100,257,0,257
Lashonne,F,100,65,0,65
Aprell,F,100,19,0,19
Khing,M,100,0,22,22
Rayiona,F,100,11,0,11
Nickesha,F,100,23,0,23
Torrie,F,83,2774,586,3360
Yaretci,F,100,5,0,5
Keylea,F,100,5,0,5
Prescott,M,100,5,1036,1041
Keimara,F,100,7,0,7
Aviendha,F,100,105,0,105
Khadesia,F,100,25,0,25
Trevionne,M,100,0,64,64
Konya,F,91,62,6,68
Troylynn,F,100,52,0,52
Tahler,F,100,10,0,10
Lila,F,100,27609,0,27609
Tashun,M,100,0,57,57
Burnestine,F,100,5,0,5
Damichael,M,100,0,92,92
Diaja,F,100,52,0,52
Mailey,F,100,333,0,333
Veroncia,F,100,359,0,359
Kaielle,F,100,6,0,6
Sophiamae,F,100,5,0,5
Shambrea,F,100,5,0,5
Nekeda,F,100,10,0,10
Yeiren,M,100,0,44,44
Jaydy,F,100,132,0,132
Kerilynn,F,100,33,0,33
Anacia,F,100,5,0,5
Iralynn,F,100,5,0,5
Rupali,F,100,27,0,27
Jeffary,M,100,0,35,35
Analyce,F,100,91,0,91
Jermere,M,100,0,23,23
Madeliz,F,100,12,0,12
Rhody,M,100,0,14,14
Keyen,M,100,0,68,68
Tametha,F,100,85,0,85
Jushawn,M,100,0,11,11
Tremiyah,F,100,10,0,10
Jesika,F,100,1257,0,1257
Jadean,F,75,15,5,20
Suleica,F,100,8,0,8
Tioluwani,M,100,0,5,5
Shenitha,F,100,42,0,42
Rokeshia,F,100,16,0,16
Biel,M,100,0,5,5
Yazlynn,F,100,71,0,71
Altonio,M,100,0,194,194
Genean,F,100,92,0,92
Julin,F,100,5,0,5
Cerri,F,100,5,0,5
Beyda,F,100,6,0,6
Seiya,M,100,0,67,67
Daysan,M,100,0,5,5
Denyla,F,100,69,0,69
Tanicka,F,100,115,0,115
Kalab,M,100,0,425,425
Froilan,M,100,0,478,478
Eleasar,M,100,0,32,32
Merik,M,100,0,237,237
Morrigan,F,100,606,0,606
Sunjay,M,100,0,49,49
Dextin,M,100,0,15,15
Jahmani,M,100,0,100,100
Torien,M,100,0,83,83
Maxine,F,100,21340,13,21353
Dreyson,M,100,0,202,202
Rapunzel,F,100,9,0,9
Brettly,M,100,0,11,11
Brijido,M,100,0,11,11
Taisiya,F,100,43,0,43
Chrisalyn,F,100,12,0,12
Taqiyyah,F,100,5,0,5
Miyisha,F,100,14,0,14
Kaylaann,F,100,173,0,173
Jermica,F,100,48,0,48
Fallynn,F,100,37,0,37
Joplyn,F,100,24,0,24
Sharnell,F,100,599,0,599
Redick,M,100,0,13,13
Ryanjacob,M,100,0,12,12
Zacarion,M,100,0,6,6
Ethynn,M,100,0,5,5
Ameiya,F,100,5,0,5
Lige,M,100,0,180,180
Marrissa,F,100,1439,0,1439
Abygail,F,100,2262,0,2262
Pavneet,F,100,5,0,5
Nansy,F,100,11,0,11
Dav,M,100,0,5,5
Renji,M,100,0,38,38
Verity,F,100,697,0,697
Jahnyla,F,100,51,0,51
Vachel,M,100,0,10,10
Shedrich,M,100,0,5,5
Psalms,F,78,54,15,69
Cortaz,M,100,0,12,12
Thailynn,F,100,10,0,10
Ahava,F,100,182,0,182
Noomi,F,100,22,0,22
Mashaya,F,100,11,0,11
Bertram,M,100,0,2269,2269
Amilee,F,100,128,0,128
Mariamu,F,100,6,0,6
Manjit,F,100,10,0,10
Diellza,F,100,11,0,11
Haleigha,F,100,46,0,46
Obi,M,100,0,64,64
Rubith,F,100,24,0,24
Ryanne,F,100,2715,0,2715
Salar,M,100,0,95,95
Mekeba,F,100,30,0,30
Dartagnan,M,100,0,911,911
Benuel,M,100,0,636,636
Sabirah,F,100,48,0,48
Brizza,F,100,90,0,90
Kalun,M,100,0,5,5
Jusin,M,100,0,48,48
Ever,M,76,855,2684,3539
Coryana,F,100,10,0,10
Leisa,F,100,4910,0,4910
Jameslee,M,100,0,18,18
Danity,F,100,147,0,147
Daemien,M,100,0,118,118
Chrisotpher,M,100,0,108,108
Nahomy,F,100,770,0,770
Elgar,M,100,0,23,23
Jarone,M,100,0,58,58
Louwana,F,100,10,0,10
Zalea,F,100,69,0,69
Kort,M,100,0,432,432
Ontario,M,100,0,812,812
Tiyanah,F,100,10,0,10
Emeliah,F,100,6,0,6
Nandhini,F,100,26,0,26
Lisvet,F,100,103,0,103
Srihitha,F,100,107,0,107
Annacatherine,F,100,18,0,18
Tyane,F,100,6,0,6
Elee,F,100,11,0,11
Larna,F,100,110,0,110
Shajuana,F,100,241,0,241
Maryorie,F,100,18,0,18
Lakara,F,100,79,0,79
Maymuna,F,100,52,0,52
Jayr,M,100,0,95,95
Jonnae,F,100,251,0,251
Trendell,M,100,0,30,30
Eugenia,F,100,11859,10,11869
Roper,M,100,0,308,308
Coleten,M,100,0,13,13
Margarit,F,100,5,0,5
Nyarie,F,100,15,0,15
Sidrah,F,100,202,0,202
Wardean,F,100,5,0,5
Aamil,M,100,0,17,17
Madee,F,100,19,0,19
Solara,F,100,324,0,324
Rosebella,F,100,17,0,17
Momo,F,100,49,0,49
Kaliey,F,100,5,0,5
Annalisse,F,100,165,0,165
Elexus,F,100,1259,0,1259
Timaeus,M,100,0,7,7
Hank,M,100,0,8765,8765
Tannah,F,100,253,0,253
Samariya,F,100,98,0,98
Ebelin,F,100,358,0,358
Deliyah,F,100,166,0,166
Ashlley,F,100,104,0,104
Zeyneb,F,100,10,0,10
Michaela,F,100,47573,69,47642
Naquelle,F,100,6,0,6
Arianah,F,100,730,0,730
Sacoyia,F,100,5,0,5
Lakessa,F,100,29,0,29
Bethannie,F,100,138,0,138
Dorlis,F,100,6,0,6
Suanne,F,100,1061,0,1061
Kynslei,F,100,28,0,28
Eilish,F,100,243,0,243
Staci,F,100,25419,60,25479
Marsel,M,100,0,51,51
Tres,M,99,5,389,394
Jahya,F,100,17,0,17
Ladonja,F,100,5,0,5
Aubreyrose,F,100,5,0,5
Milaina,F,100,51,0,51
Mackaylah,F,100,5,0,5
Reade,M,100,0,134,134
Kaeliana,F,100,11,0,11
Umu,F,100,14,0,14
Paisly,F,100,122,0,122
Armilda,F,100,5,0,5
Yuka,F,100,351,0,351
Socorro,F,92,3489,285,3774
Laveen,F,100,5,0,5
Malyah,F,100,162,0,162
Vally,F,100,6,0,6
Lamesha,F,100,579,0,579
Haillie,F,100,357,0,357
Delana,F,100,3585,0,3585
Quiandra,F,100,5,0,5
Kristena,F,100,747,0,747
Carlyon,F,100,290,0,290
Iliany,F,100,61,0,61
Graycee,F,100,379,0,379
Oba,M,100,0,37,37
Zoeie,F,100,66,0,66
Teneke,F,100,5,0,5
Jamasia,F,100,5,0,5
Anshveer,M,100,0,5,5
Leigham,M,100,0,12,12
Juman,F,100,16,0,16
Krissy,F,100,2072,0,2072
Tylena,F,100,48,0,48
Duy,M,100,0,788,788
Navaya,F,100,210,0,210
Miken,M,100,0,67,67
Rashidi,M,100,0,90,90
Zacaria,F,81,114,27,141
Zake,M,100,0,5,5
Leslye,F,100,2172,0,2172
Yohana,F,100,857,0,857
Zaid,M,100,0,3360,3360
Nata,F,100,9,0,9
Annalia,F,100,521,0,521
Eamonn,M,100,0,1037,1037
Jaedyn,F,58,2357,1710,4067
Yusra,F,100,957,0,957
Sahira,F,100,402,0,402
Creo,M,100,0,5,5
Jaydeep,M,100,0,14,14
Deannea,F,100,5,0,5
Yalonda,F,100,1076,0,1076
Daionna,F,100,120,0,120
Eros,M,100,0,859,859
Alycia,F,100,9581,0,9581
Nyemah,F,100,142,0,142
Alyx,F,89,1063,126,1189
Omero,M,100,0,457,457
Lashon,F,70,1534,662,2196
Lashanya,F,100,17,0,17
Montee,M,100,0,51,51
Domenique,F,74,539,187,726
Nollie,F,92,77,7,84
Tein,M,100,0,5,5
Mayerly,F,100,98,0,98
Chaunce,M,100,0,101,101
Jakeveon,M,100,0,6,6
Terron,M,99,32,2314,2346
Janeiry,F,100,28,0,28
Mallissa,F,100,123,0,123
Tyazia,F,100,10,0,10
Talesia,F,100,23,0,23
Danyelle,F,99,5625,37,5662
Anandi,F,100,71,0,71
Jacquelynn,F,100,4193,0,4193
Jazia,F,100,67,0,67
Isabellamarie,F,100,125,0,125
Keuna,F,100,53,0,53
Brennae,F,100,6,0,6
Jonpierre,M,100,0,10,10
Chevie,F,75,50,17,67
Chibuikem,M,100,0,88,88
Zaybree,F,100,18,0,18
Wendall,M,100,6,1447,1453
Sydia,F,100,10,0,10
Naseem,M,80,237,949,1186
Kandys,F,100,5,0,5
Lilienne,F,100,38,0,38
Arreanna,F,100,21,0,21
Sarahya,F,100,5,0,5
Kemaria,F,100,115,0,115
Lyliah,F,100,32,0,32
Raiquan,M,100,0,89,89
Jiyu,F,100,6,0,6
Enola,F,100,815,0,815
Malynda,F,100,897,0,897
Mijael,M,100,0,6,6
Calizza,F,100,8,0,8
Yuda,M,100,0,16,16
Gleb,M,100,0,84,84
Zackary,M,100,7,29338,29345
Kasch,M,100,0,119,119
Luther,M,100,57,17607,17664
Jenicka,F,100,157,0,157
Nakesia,F,100,30,0,30
Casara,F,100,118,0,118
Menachem,M,100,0,4859,4859
Nayiri,F,100,12,0,12
Kaymon,M,100,0,66,66
Rafe,M,100,0,1660,1660
Shaylah,F,100,850,0,850
Citialli,F,100,5,0,5
Sophany,F,100,11,0,11
Kimbler,F,100,10,0,10
Karif,M,100,0,10,10
Daquasia,F,100,13,0,13
Branlee,M,100,0,6,6
Tamaiah,F,100,5,0,5
Neta,F,100,664,0,664
Laroya,F,100,29,0,29
Samhita,F,100,322,0,322
Anberlynn,F,100,5,0,5
Fulton,M,100,0,971,971
Sherlie,F,100,60,0,60
Mandel,M,100,0,473,473
Rochely,F,100,11,0,11
Nasra,F,100,179,0,179
Damori,M,100,0,5,5
Tais,F,100,402,0,402
Tomica,F,100,574,0,574
Kwentin,M,100,0,24,24
Esteve,M,100,0,28,28
Mison,M,100,0,20,20
Kayzia,F,100,12,0,12
Aneah,F,100,10,0,10
Ediberto,M,100,0,330,330
Darries,M,100,0,5,5
Alvinia,F,100,22,0,22
Breyson,M,100,0,104,104
Aalicia,F,100,5,0,5
Thaden,M,100,0,55,55
Zhariya,F,100,18,0,18
Tracen,M,100,0,339,339
Yanixa,F,100,36,0,36
Cohlton,M,100,0,10,10
Tamela,F,100,7156,0,7156
Jamorion,M,100,0,92,92
Lagretta,F,100,91,0,91
Jervon,M,100,0,459,459
Treshia,F,100,6,0,6
Zayn,M,99,11,1206,1217
Makaelynn,F,100,16,0,16
Kannon,M,98,40,1962,2002
Margree,F,100,10,0,10
Crysania,F,100,7,0,7
Fuquan,M,100,0,224,224
Browdy,M,100,0,5,5
Cathie,F,100,4105,0,4105
Malek,M,100,6,1830,1836
Fury,F,100,5,0,5
Julane,F,100,162,0,162
Kieu,F,100,145,0,145
Addelina,F,100,11,0,11
Laurentino,M,100,0,6,6
Karstin,M,67,5,10,15
Oghenetega,M,100,0,5,5
Kaylea,F,100,2877,0,2877
Zaela,F,100,38,0,38
Yankarlo,M,100,0,6,6
Novian,M,100,0,36,36
Delethia,F,100,11,0,11
Jhael,M,100,0,16,16
Ismel,M,100,0,11,11
Shary,F,100,307,0,307
Krisy,F,100,81,0,81
Kallie,F,100,9021,0,9021
Royelle,F,100,37,0,37
Bai,F,50,5,5,10
Romilda,F,100,17,0,17
Amori,F,58,247,180,427
Bernette,F,100,365,0,365
Jahmeir,M,100,0,213,213
Sekou,M,100,0,844,844
Issabell,F,100,16,0,16
Rodrigo,M,100,5,20820,20825
Giordana,F,100,84,0,84
Isaah,M,100,0,403,403
Caili,F,100,81,0,81
Mikayah,F,100,124,0,124
Junathean,M,100,0,10,10
Navina,F,100,54,0,54
Nimrah,F,100,34,0,34
Sriram,M,100,0,441,441
Greylyn,F,100,7,0,7
Jomal,M,100,0,17,17
Tyeishia,F,100,5,0,5
Zyrian,M,100,0,10,10
York,M,100,0,540,540
Dahlilah,F,100,14,0,14
Rikuto,M,100,0,17,17
Moices,M,100,0,26,26
Deborh,F,100,143,0,143
Deforrest,M,100,0,26,26
Leata,F,100,9,0,9
Dalva,F,100,5,0,5
Ulyssee,M,100,0,5,5
Syaire,M,94,6,94,100
Shakalia,F,100,5,0,5
Jacqualine,F,100,1670,0,1670
Giovoni,M,100,0,70,70
Skilah,F,100,13,0,13
Emmabella,F,100,5,0,5
Amorie,F,82,185,41,226
Valoria,F,100,63,0,63
Azar,M,100,0,44,44
Kiannah,F,100,229,0,229
Jennesis,F,100,56,0,56
Ronaldinho,M,100,0,30,30
Geneine,F,100,5,0,5
Naomee,F,100,58,0,58
Avelyn,F,100,482,0,482
Youki,M,100,0,5,5
Franciscojr,M,100,0,5,5
Meira,F,100,927,0,927
Ryahn,M,100,0,5,5
Nofer,M,100,0,14,14
Jalexa,F,100,40,0,40
Sharva,M,100,0,5,5
Vidia,F,100,27,0,27
Corri,F,96,666,27,693
Cypress,F,58,409,295,704
Chandal,F,100,40,0,40
Jayia,F,100,19,0,19
Zeljko,M,100,0,6,6
Ikira,F,100,11,0,11
Jaleeya,F,100,101,0,101
Sahmiyah,F,100,12,0,12
Zoann,F,100,51,0,51
Shaunea,F,100,6,0,6
Delainee,F,100,108,0,108
Kalvyn,M,100,0,89,89
Jeris,M,70,72,168,240
Barba,F,100,71,0,71
Nokia,F,100,5,0,5
Haide,F,100,152,0,152
Tymiesha,F,100,5,0,5
Tavier,M,100,0,48,48
Kane,M,100,24,9897,9921
Tianni,F,100,143,0,143
Taffi,F,100,43,0,43
Keiandre,M,100,0,99,99
Traniya,F,100,158,0,158
Amorita,F,100,73,0,73
Alicianna,F,100,143,0,143
Redge,M,100,0,6,6
Heavenlei,F,100,11,0,11
Maxton,M,100,0,2007,2007
Decara,F,100,5,0,5
Rosyln,F,100,44,0,44
Konstantinos,M,100,0,1653,1653
Izaac,M,100,0,2077,2077
Antwanae,F,100,10,0,10
Shaun,M,96,3071,68201,71272
Akenya,F,100,10,0,10
Glenard,M,100,0,29,29
Takiya,F,100,990,0,990
Genaveve,F,100,44,0,44
Latwanda,F,100,37,0,37
Kelene,F,100,44,0,44
Baudelia,F,100,21,0,21
Sumaiyya,F,100,5,0,5
Japaul,M,100,0,11,11
Shyquan,M,100,0,144,144
Birda,F,100,51,0,51
Alixon,F,100,6,0,6
Benedek,M,100,0,5,5
Dozier,M,100,0,55,55
Zyann,F,100,157,0,157
Jardyn,F,100,28,0,28
Pragathi,F,100,5,0,5
Yatziri,F,100,576,0,576
Rigg,M,100,0,12,12
Phong,M,99,5,934,939
Brianica,F,100,23,0,23
Samnatha,F,100,53,0,53
Rahshawn,M,100,0,90,90
Cathia,F,100,34,0,34
Grandin,M,100,0,7,7
Dakera,F,100,10,0,10
Sonji,F,100,904,0,904
Chamique,F,100,27,0,27
Crystalyn,F,100,647,0,647
Merleah,F,100,5,0,5
Crhistopher,M,100,0,45,45
Keni,F,73,200,73,273
Diarra,F,79,286,78,364
Mennah,F,100,16,0,16
Jeneen,F,100,1079,0,1079
Dejontae,M,100,0,5,5
Hashley,F,100,5,0,5
Jonnelle,F,100,48,0,48
Maxxamus,M,100,0,5,5
Caynan,M,100,0,32,32
Cevanna,F,100,5,0,5
Rechy,F,100,48,0,48
Meyana,F,100,18,0,18
Lexiss,F,100,52,0,52
Shykila,F,100,18,0,18
Yaiza,F,100,162,0,162
Erol,M,100,0,434,434
Brysan,M,100,0,98,98
Kanora,F,100,5,0,5
Jillanne,F,100,56,0,56
Chikezie,M,100,0,22,22
Abiyah,F,50,5,5,10
Branon,M,100,0,240,240
Jahaud,M,100,0,5,5
Nixon,M,96,119,2623,2742
Aftan,F,100,109,0,109
Khila,F,100,119,0,119
Corlyn,F,100,22,0,22
Liliah,F,100,103,0,103
Shaw,M,97,35,986,1021
Mikelle,F,98,790,17,807
Kandie,F,100,1040,0,1040
Tagg,M,100,0,72,72
Montay,M,100,0,256,256
Leeani,F,100,25,0,25
Jannelly,F,100,84,0,84
Keyry,F,100,95,0,95
Besan,F,100,46,0,46
Moeez,M,100,0,16,16
Chidima,F,100,11,0,11
Tavone,M,100,0,66,66
Farra,F,100,113,0,113
Zakria,M,100,0,11,11
Aubreyann,F,100,33,0,33
Alianis,F,100,31,0,31
Frankin,M,100,0,28,28
Jasslyn,F,100,103,0,103
Tyaunna,F,100,12,0,12
Rockson,M,100,0,5,5
Laquicha,F,100,5,0,5
Roman,M,100,199,45497,45696
Lamera,F,100,5,0,5
Dennishia,F,100,5,0,5
Karmela,F,100,110,0,110
Vilda,F,100,5,0,5
Kelaine,F,100,6,0,6
Sly,M,100,0,66,66
Alexismarie,F,100,75,0,75
Willeen,F,100,38,0,38
Jaquory,M,100,0,5,5
Tequlia,F,100,72,0,72
Lauar,M,100,0,5,5
Vivi,F,100,433,0,433
Krystalyn,F,100,440,0,440
Kender,M,100,0,6,6
Ashika,F,100,214,0,214
Lawrenc,M,100,0,26,26
Gracelyn,F,100,6551,0,6551
Ariane,F,100,3297,5,3302
Kashona,F,100,6,0,6
Atticus,M,99,34,5982,6016
Marrick,M,100,0,5,5
Kailoni,F,100,68,0,68
Lina,F,100,9942,5,9947
Anijia,F,100,5,0,5
Shreyan,M,100,0,210,210
Tekoah,F,100,12,0,12
Reesha,F,100,76,0,76
Mahagony,F,100,207,0,207
Rojan,M,100,0,5,5
Kimia,F,100,427,0,427
Lejend,M,100,0,18,18
Brunell,M,100,0,5,5
Kennis,M,87,65,435,500
Mileni,F,100,5,0,5
Karleen,F,100,1847,0,1847
Senikka,F,100,6,0,6
Jujhar,M,100,0,48,48
Javoris,M,100,0,387,387
Rujul,M,100,0,5,5
Zayyan,M,100,0,37,37
Antony,M,100,0,9031,9031
Jacoba,F,100,130,0,130
Paitynn,F,100,182,0,182
Axia,F,100,11,0,11
Giovonie,M,100,0,5,5
Thamas,M,100,0,59,59
Jayana,F,100,859,0,859
Dajanae,F,100,674,0,674
Ailina,F,100,12,0,12
Maliaya,F,100,11,0,11
Elynne,F,100,6,0,6
Shiraz,M,68,57,119,176
Ayanah,F,100,385,0,385
Latarya,F,100,22,0,22
Curtney,F,100,5,0,5
Jamaryon,M,100,0,13,13
Natane,F,100,94,0,94
Zerena,F,100,15,0,15
Marlene,F,100,60955,148,61103
Azka,F,100,40,0,40
Kadesia,F,100,91,0,91
Tremain,M,100,0,929,929
Rekiyah,F,100,6,0,6
Sim,M,100,0,433,433
Davron,M,100,0,37,37
Jahnea,F,100,46,0,46
Temarcus,M,100,0,8,8
Nona,F,100,4786,0,4786
Menasha,M,100,0,5,5
Jaskiran,F,100,50,0,50
Shaune,M,57,335,444,779
Aavah,F,100,28,0,28
Shiyana,F,100,10,0,10
Camri,F,100,513,0,513
Izhar,M,100,0,35,35
Charma,F,100,190,0,190
Conrad,M,100,0,17498,17498
Frey,M,100,0,9,9
Litonya,F,100,26,0,26
Meridyth,F,100,39,0,39
Jahmai,M,100,0,232,232
Dannielynn,F,100,47,0,47
Jasias,M,100,0,29,29
Keffer,M,100,0,7,7
Louella,F,100,2328,0,2328
Danelys,F,100,19,0,19
Lilymarie,F,100,50,0,50
Shizuka,F,100,7,0,7
Junie,F,99,437,5,442
Maxxwell,M,100,0,194,194
Alyxandrea,F,100,48,0,48
Saleth,F,100,8,0,8
Shacola,F,100,71,0,71
Micheleen,F,100,5,0,5
Conie,F,100,12,0,12
Adeyemi,M,100,0,102,102
Savalas,M,100,0,102,102
Lakoda,M,60,65,98,163
Harpreet,F,50,254,249,503
Annikka,F,100,35,0,35
Akesha,F,100,133,0,133
Menaal,F,100,78,0,78
Henly,F,100,13,0,13
Cashden,M,100,0,18,18
Husai,M,100,0,5,5
Kymara,F,100,55,0,55
Yoshi,M,75,36,110,146
Abena,F,100,540,0,540
Cianah,F,100,5,0,5
Abdurrahman,M,100,0,657,657
Cloud,M,100,0,236,236
Gregoire,M,100,0,78,78
Trishawn,F,55,12,10,22
Broc,M,100,0,2375,2375
Jhani,F,100,19,0,19
Ayelin,F,100,36,0,36
Coby,M,96,349,8154,8503
Floriberto,M,100,0,5,5
Alzada,F,100,11,0,11
Markyla,F,100,43,0,43
Luxx,F,100,6,0,6
Zikora,M,62,6,10,16
Qais,M,100,0,153,153
Carmin,F,97,757,25,782
Zarrin,F,100,5,0,5
Arkan,M,100,0,27,27
Elisia,F,100,1591,0,1591
Danari,M,79,8,30,38
Abubakary,M,100,0,10,10
Andelyn,F,100,127,0,127
Amaree,M,57,511,679,1190
Sigfrido,M,100,0,5,5
Kalven,M,100,0,112,112
Alexaray,F,100,5,0,5
Carmeron,M,100,0,166,166
Zadyn,M,100,0,203,203
Reigna,F,100,122,0,122
Jhace,M,100,0,79,79
Nisiah,M,100,0,6,6
Carnelius,M,100,0,89,89
Governor,M,100,0,50,50
Sosuke,M,100,0,19,19
Vaden,M,100,0,278,278
Charron,F,87,340,50,390
Colsen,M,100,0,259,259
Teoshia,F,100,11,0,11
Dorcia,F,100,23,0,23
Jadaiah,F,100,5,0,5
Nail,M,100,0,33,33
Tamaree,F,100,7,0,7
Sairi,F,100,6,0,6
Makalie,F,100,37,0,37
Mikella,F,100,318,0,318
Kamaris,M,100,0,10,10
Honestie,F,100,56,0,56
Eleisha,F,100,162,0,162
Reya,F,100,736,0,736
Latarshia,F,100,65,0,65
Wynette,F,100,654,0,654
Luisfelipe,M,100,0,63,63
Darrnell,M,100,0,78,78
Fianna,F,100,144,0,144
Katrica,F,100,17,0,17
Ramzey,M,100,0,133,133
Kdynce,F,100,25,0,25
Shadany,F,100,6,0,6
Dezarey,F,100,27,0,27
Raseel,F,100,27,0,27
Liasia,F,100,15,0,15
Brycen,M,100,21,8773,8794
Neo,M,100,0,1266,1266
Conner,M,98,767,48154,48921
Xazavier,M,100,0,5,5
Adarien,M,100,0,15,15
Kallista,F,100,724,0,724
Rianne,F,100,828,0,828
Shruthi,F,100,447,0,447
Kila,F,99,860,5,865
Candle,F,100,24,0,24
Shaeleigh,F,100,161,0,161
Jhosue,M,100,0,10,10
Seairah,F,100,5,0,5
Kierslyn,F,100,5,0,5
Mateja,F,78,67,19,86
Ayomikun,M,66,26,51,77
Yola,F,100,36,0,36
Brenyn,M,74,37,108,145
Milyn,F,100,61,0,61
Dejanee,F,100,265,0,265
Thania,F,100,1314,0,1314
Enaiya,F,100,13,0,13
Ayriel,F,100,144,0,144
Kayly,F,100,411,0,411
Devron,M,100,0,849,849
Melodye,F,100,674,0,674
Divia,F,100,11,0,11
Khaliyah,F,100,937,0,937
Tyaire,M,97,5,139,144
Mckel,F,50,5,5,10
Donnice,F,100,107,0,107
Jalill,M,100,0,12,12
Rigley,M,83,12,57,69
Sebastin,M,100,0,91,91
Tamas,M,100,0,96,96
Shirron,F,100,5,0,5
Derly,M,100,0,35,35
Shannay,F,100,16,0,16
Peyton,F,58,58567,43191,101758
Muhsin,M,100,0,248,248
Brycson,M,100,0,15,15
Cortnie,F,100,864,0,864
Lanautica,F,100,49,0,49
Angeliki,F,100,298,0,298
Dakota,M,75,27741,82298,110039
Eutiquio,M,100,0,5,5
Cniya,F,100,39,0,39
Jecaryous,M,100,0,59,59
Hildegard,F,100,146,0,146
Karyah,F,100,9,0,9
Dalonda,F,100,63,0,63
Sterlyn,M,100,0,28,28
Ailisa,F,100,12,0,12
Paulla,F,100,203,0,203
Starleigh,F,100,23,0,23
Jazier,M,100,0,110,110
Eadie,F,100,21,0,21
Rilee,F,89,2464,318,2782
Kewin,M,100,0,19,19
Charlita,F,100,418,0,418
Sharmia,F,100,5,0,5
Yuv,M,100,0,5,5
Tekyra,F,100,5,0,5
Kayde,F,61,312,200,512
Abdulah,M,100,0,75,75
Tracylee,F,100,12,0,12
Kush,M,100,0,988,988
Raashi,F,100,8,0,8
Myleisha,F,100,5,0,5
Qujuan,M,100,0,5,5
Joanthony,M,100,0,95,95
Aubriann,F,100,10,0,10
Frenchie,F,83,175,35,210
Luiseduardo,M,100,0,45,45
Keison,M,100,0,90,90
Hassiem,M,100,0,5,5
Katrien,F,100,16,0,16
Na,F,87,223,34,257
Talyah,F,100,342,0,342
Zamiel,M,100,0,5,5
Elizzabeth,F,100,7,0,7
Emilyne,F,100,12,0,12
Keora,F,100,70,0,70
Roxas,M,100,0,89,89
Humza,M,100,0,967,967
Velvie,F,100,17,0,17
Hollynn,F,100,45,0,45
Naideline,F,100,10,0,10
Ayumu,M,100,0,6,6
Alegra,F,100,327,0,327
Philbert,M,100,0,576,576
Jayvonn,M,100,0,40,40
Mobeen,M,100,0,21,21
Brecklyn,F,100,339,0,339
Jaramie,M,100,0,106,106
Zlatan,M,100,0,63,63
Chanler,M,72,155,397,552
Mantra,M,100,0,5,5
Sharmin,F,100,363,0,363
Cariann,F,100,281,0,281
Nelie,F,100,5,0,5
Sorren,M,100,0,28,28
Safir,M,100,0,56,56
Kaitlan,F,100,1119,0,1119
Eldion,M,100,0,5,5
Naaya,F,100,14,0,14
Caylani,F,100,12,0,12
Dniah,F,100,5,0,5
Seraiah,F,98,247,6,253
Mccain,M,100,0,52,52
Shervonne,F,100,17,0,17
Rhydian,M,100,0,11,11
Natifah,F,100,10,0,10
Dreighton,M,100,0,5,5
Sua,F,100,107,0,107
Arzel,M,100,0,10,10
Tempess,F,100,11,0,11
Syrah,F,100,133,0,133
Samba,M,100,0,98,98
Yenis,F,100,20,0,20
Deonza,F,100,14,0,14
Trentin,M,100,0,1182,1182
Tarion,M,100,0,43,43
Elinam,F,100,8,0,8
Yussef,M,100,0,132,132
Tendai,M,100,0,5,5
Babette,F,100,2312,5,2317
Lajada,F,100,164,0,164
Shyrene,F,100,5,0,5
Rachelle,F,100,32308,37,32345
Layne,M,74,3490,9731,13221
Keoka,F,100,47,0,47
Margie,F,100,26340,37,26377
Slader,M,100,0,49,49
Baiden,M,100,0,41,41
Tequisha,F,100,90,0,90
Elic,M,100,0,16,16
Taaliyah,F,100,192,0,192
Jakalynn,F,100,5,0,5
Dnijah,F,100,7,0,7
Shemar,M,100,6,2097,2103
Kameo,F,100,116,0,116
Kwabene,M,100,0,8,8
Maryelaine,F,100,5,0,5
Eladia,F,100,89,0,89
Keanthony,M,100,0,181,181
Derion,M,95,49,878,927
Abrham,M,100,0,126,126
Marliegh,F,100,5,0,5
Ross,M,100,245,57978,58223
Jackman,M,100,0,33,33
Nakoma,F,54,43,36,79
Mikkayla,F,100,57,0,57
Edner,M,100,0,7,7
Kilolo,F,100,16,0,16
Kimya,F,100,662,0,662
Vadell,M,100,0,5,5
Xitlaly,F,100,1443,0,1443
Shela,F,100,1186,0,1186
Seprina,F,100,6,0,6
Gabrianna,F,100,364,0,364
Zyin,M,100,0,6,6
Fatim,F,100,86,0,86
Daneli,F,100,90,0,90
Ekam,M,59,93,136,229
Emree,F,100,452,0,452
Ija,F,100,21,0,21
Pranavi,F,100,315,0,315
Azmariah,F,100,12,0,12
Leahgrace,F,100,5,0,5
Vaishvi,F,100,5,0,5
Rykan,M,100,0,16,16
Mileidy,F,100,158,0,158
Chrishad,M,100,0,5,5
Marquila,F,100,23,0,23
Imraan,M,100,0,128,128
Shalaina,F,100,87,0,87
Aramus,M,100,0,6,6
Lukus,M,100,0,801,801
Jashan,M,97,5,181,186
Christianpaul,M,100,0,13,13
Nur,F,77,321,98,419
Makoa,M,100,0,476,476
Regnold,M,100,0,5,5
Kader,M,100,0,20,20
Dazza,F,100,7,0,7
Azaira,F,100,54,0,54
Xzayvier,M,100,0,223,223
Jame,M,84,408,2129,2537
Oreoluwa,F,62,144,89,233
Lakota,F,53,1272,1149,2421
Vaishnav,M,100,0,47,47
Ahmarion,M,100,0,67,67
Kharan,M,100,0,5,5
Danitza,F,100,795,0,795
Jessaca,F,100,179,0,179
Jamial,M,100,0,5,5
Eddison,M,100,0,252,252
Jeila,F,100,53,0,53
Lucynda,F,100,56,0,56
Anijha,F,100,54,0,54
Maronica,F,100,13,0,13
Seleste,F,100,687,0,687
Shida,F,100,6,0,6
Rolman,M,100,0,6,6
Haniyyah,F,100,142,0,142
Sahl,M,100,0,11,11
Marivic,F,100,16,0,16
Liani,F,100,505,0,505
Natilee,F,100,436,0,436
Arela,F,100,6,0,6
Laileen,F,100,5,0,5
Kenysha,F,100,38,0,38
Jennya,F,100,5,0,5
Dhyana,F,100,57,0,57
Aadi,M,98,16,667,683
Tudor,M,100,0,48,48
Saivion,M,100,0,71,71
Elese,F,100,219,0,219
Makaih,M,100,0,44,44
Laylynn,F,100,42,0,42
Jakeyah,F,100,10,0,10
Maddoc,M,100,0,42,42
Merola,F,100,5,0,5
Eivan,M,100,0,27,27
Zishan,M,100,0,27,27
Josaphina,F,100,6,0,6
Nahriah,F,100,46,0,46
Semirah,F,100,15,0,15
Berneda,F,100,49,0,49
Isibeal,F,100,14,0,14
Annyston,F,100,13,0,13
Iliah,F,100,21,0,21
Deniko,M,100,0,19,19
Haiely,F,100,10,0,10
Caslyn,F,100,17,0,17
Madilynne,F,100,354,0,354
Talayiah,F,100,6,0,6
Kysan,M,100,0,11,11
Shiniece,F,100,11,0,11
Trevvor,M,100,0,5,5
Zeidy,F,100,69,0,69
Evona,F,100,35,0,35
Racquell,F,100,35,0,35
Edel,M,94,22,373,395
Daundra,F,100,5,0,5
Christianjohn,M,100,0,17,17
Natassja,F,100,271,0,271
Bernadett,F,100,174,0,174
Marycruz,F,100,430,0,430
Cylena,F,100,6,0,6
Lemel,M,100,0,16,16
Elix,M,100,0,6,6
Keiden,M,100,0,216,216
Saquon,M,100,0,15,15
Juanangel,M,100,0,160,160
Lycrecia,F,100,5,0,5
Tynleigh,F,100,69,0,69
Tambresha,F,100,5,0,5
Baylei,F,100,319,0,319
Yoseli,F,100,29,0,29
Margorie,F,100,243,0,243
Izumi,F,100,64,0,64
Daphney,F,100,1351,0,1351
Aleksandria,F,100,23,0,23
Ranaya,F,100,48,0,48
Preanna,F,100,15,0,15
Laquoia,F,100,10,0,10
Jeryme,M,100,0,10,10
Markandrew,M,100,0,34,34
Aditri,F,100,104,0,104
Abriyah,F,100,6,0,6
Johneka,F,100,10,0,10
Rayjanae,F,100,6,0,6
Hayam,F,100,5,0,5
Celeste,F,100,48166,45,48211
Rene,M,68,19568,40980,60548
Thedore,M,100,0,284,284
Avrumy,M,100,0,13,13
Clearnce,M,100,0,79,79
Demorian,M,100,0,26,26
Quamaine,M,100,0,341,341
Egbert,M,100,0,220,220
Laniyah,F,100,2376,0,2376
Zahriya,F,100,44,0,44
Haile,F,82,782,174,956
Kostantinos,M,100,0,239,239
Evalise,F,100,99,0,99
Ronak,M,99,6,829,835
Kameesha,F,100,45,0,45
Lachelle,F,100,2374,0,2374
Hiromy,F,100,40,0,40
Ladaveon,M,100,0,5,5
Carsten,M,100,0,1732,1732
Dniel,M,100,0,22,22
Darlana,F,100,6,0,6
Lamica,F,100,63,0,63
Kataria,F,100,5,0,5
Delos,M,100,0,196,196
Carisa,F,100,2983,0,2983
Tshai,F,100,5,0,5
Breonah,F,100,30,0,30
Yesania,F,100,6,0,6
Braelei,F,100,7,0,7
Rhae,F,100,41,0,41
Issa,M,80,332,1340,1672
Jadaisha,F,100,30,0,30
Ishitha,F,100,29,0,29
Molina,F,100,183,0,183
Aamar,M,100,0,5,5
Zanyia,F,100,192,0,192
Tamon,M,100,0,190,190
Ferlando,M,100,0,91,91
Manrique,M,100,0,50,50
Gopika,F,100,5,0,5
Novis,F,100,5,0,5
Mailinh,F,100,24,0,24
Aketzalli,F,100,5,0,5
Chaisson,M,100,0,5,5
Jenyla,F,100,11,0,11
Rankin,M,100,0,91,91
Chaniyah,F,100,256,0,256
Tatyana,F,100,9936,0,9936
Nitra,F,100,35,0,35
Genette,F,100,351,0,351
Faiga,F,100,800,0,800
Christyana,F,100,196,0,196
Israa,F,100,383,0,383
Josephe,M,100,0,31,31
Chasten,M,98,5,245,250
Khalei,M,58,5,7,12
Maxcine,F,100,330,0,330
Rhelda,F,100,10,0,10
Nyssa,F,100,1561,0,1561
Kinlea,F,100,43,0,43
Averell,M,100,0,22,22
Angeleque,F,100,46,0,46
Yorvin,M,100,0,5,5
Kharee,M,100,0,68,68
Laticha,F,100,146,0,146
Asusena,F,100,684,0,684
Kaon,M,100,0,5,5
Dejah,F,100,2945,5,2950
Lakeasha,F,100,272,0,272
Acen,M,100,0,228,228
Rayeann,F,100,13,0,13
Ismenia,F,100,49,0,49
Kamberly,F,100,5,0,5
Fabyan,M,100,0,81,81
Madiha,F,100,271,0,271
Chaniya,F,100,606,0,606
Deshawnda,F,100,60,0,60
Edgar,M,100,408,85104,85512
Terica,F,100,1033,0,1033
Shunika,F,100,41,0,41
Merzedes,F,100,5,0,5
Keymara,F,100,5,0,5
Beri,F,100,17,0,17
Mailah,F,100,17,0,17
Lasondra,F,100,539,0,539
Daevian,M,100,0,10,10
Jacklynne,F,100,33,0,33
Roxeann,F,100,16,0,16
Martavion,M,100,0,182,182
Chailynn,F,100,5,0,5
Okoye,M,100,0,51,51
Nha,M,100,0,5,5
Lillibeth,F,100,22,0,22
Daeqwon,M,100,0,10,10
Carren,F,100,301,0,301
Flash,M,100,0,7,7
Biridiana,F,100,533,0,533
Amillian,F,100,31,0,31
Tandria,F,100,39,0,39
Ralana,F,100,6,0,6
Yugo,M,100,0,35,35
Caralyne,F,100,11,0,11
Dewaun,M,100,0,135,135
Chloie,F,100,1094,0,1094
Taionna,F,100,27,0,27
Solomiya,F,100,42,0,42
Seritta,F,100,5,0,5
Quinnly,F,100,9,0,9
Micky,M,83,470,2255,2725
Eurika,F,100,81,0,81
Sokol,M,100,0,5,5
Carolyn,F,100,266414,764,267178
Justess,F,100,17,0,17
Miquesha,F,100,6,0,6
Shawndelle,F,100,5,0,5
Jalaycia,F,100,15,0,15
Jeremyh,M,100,0,5,5
Anggie,F,100,22,0,22
Bentz,M,100,0,5,5
Makita,F,100,309,0,309
Tacori,F,62,58,36,94
Ephrem,M,100,0,121,121
Tatelynn,F,100,10,0,10
Dristi,F,100,13,0,13
Dashonda,F,100,126,0,126
Mariesha,F,100,128,0,128
Alitza,F,100,269,0,269
Emersyn,F,99,3476,50,3526
Tanihya,F,100,11,0,11
Kammeron,M,100,0,16,16
Eustaquio,M,100,0,22,22
Linleigh,F,100,17,0,17
Kemyatta,F,100,5,0,5
Daxon,M,100,0,433,433
Asadbek,M,100,0,11,11
Izsabella,F,100,57,0,57
Destiny,F,100,140222,468,140690
Tyrel,M,100,0,3253,3253
Chrstina,F,100,38,0,38
Katiana,F,100,875,0,875
Christe,F,100,331,0,331
Mearah,F,100,13,0,13
Cliford,M,100,0,46,46
Pomposo,M,100,0,5,5
Omarri,M,100,0,57,57
Gerrel,M,100,0,21,21
Satavia,F,100,6,0,6
Gianluca,M,100,0,2022,2022
Les,M,99,32,2536,2568
Relda,F,100,111,0,111
Benoit,M,100,0,143,143
Robert,M,100,10462,2546476,2556938
Naki,M,91,5,50,55
Ronnesha,F,100,259,0,259
Lishia,F,100,28,0,28
Terriana,F,100,569,0,569
Enza,F,100,376,0,376
Shayra,F,100,133,0,133
Kemarie,F,100,22,0,22
Polette,F,100,92,0,92
Coralina,F,100,16,0,16
Mahali,F,100,10,0,10
Raneka,F,100,38,0,38
Charnai,F,100,16,0,16
Shalliyah,F,100,5,0,5
Sejla,F,100,118,0,118
Erielle,F,100,340,0,340
Suhayb,M,100,0,174,174
Sebatian,M,100,0,40,40
Jayre,F,100,12,0,12
Mathais,M,100,0,24,24
Lyna,F,100,755,0,755
Jarius,M,100,0,1636,1636
Tyriese,M,100,0,8,8
Deshanti,F,100,99,0,99
Takai,M,83,48,236,284
Kel,M,100,0,184,184
Shareema,F,100,22,0,22
Manfred,M,100,0,797,797
Derlis,M,100,0,5,5
Mlynn,F,100,37,0,37
Nelita,F,100,5,0,5
Mckayli,F,100,5,0,5
Ahlai,F,100,5,0,5
Carvis,M,100,0,23,23
Renaud,M,100,0,50,50
Avalia,F,100,5,0,5
Creedan,M,100,0,5,5
Merwin,M,100,0,241,241
Nabilah,F,100,68,0,68
Sarim,M,100,0,171,171
Marisel,F,100,414,0,414
Hadja,F,100,109,0,109
Sumalee,F,100,5,0,5
Jhada,F,100,78,0,78
Jaksen,M,100,0,54,54
Ezreal,M,100,0,26,26
Thelda,F,100,22,0,22
Cadejah,F,100,10,0,10
Kolie,F,100,42,0,42
Maysea,F,100,5,0,5
Gerald,M,99,1095,196150,197245
Mixtli,F,100,67,0,67
Tesean,M,100,0,126,126
Aderinsola,F,100,21,0,21
Shristi,F,100,65,0,65
Jocoby,M,100,0,7,7
Myon,M,100,0,33,33
Lochlain,M,100,0,17,17
Tarus,M,100,0,534,534
Dervon,M,100,0,27,27
Jossue,M,100,0,607,607
Sary,F,93,67,5,72
Tramari,M,100,0,5,5
Journy,F,100,14,0,14
Shealin,F,100,27,0,27
Tacie,F,100,116,0,116
Cath,F,100,11,0,11
Jayvia,F,100,6,0,6
Kimiah,F,100,59,0,59
Cecia,F,100,122,0,122
Jazzilynn,F,100,7,0,7
Olav,M,100,0,5,5
Jazzman,F,91,240,24,264
Aariv,M,100,0,95,95
Khadence,F,100,5,0,5
Nakiesha,F,100,260,0,260
Latiesha,F,100,308,0,308
Emmakate,F,100,137,0,137
Donovann,M,100,0,24,24
Shakobe,M,100,0,6,6
Carlyssia,F,100,5,0,5
Kurtlyn,F,100,5,0,5
Johnattan,M,100,0,91,91
Maleaya,F,100,5,0,5
Klinton,M,100,0,563,563
Alera,F,100,210,0,210
Jamson,M,100,0,5,5
Jaonte,M,100,0,8,8
Annazette,F,100,20,0,20
Dareian,M,100,0,5,5
Rhiley,F,71,535,223,758
Niyasia,F,100,24,0,24
Linnard,M,100,0,5,5
Gayland,M,100,0,577,577
Kashyia,F,100,17,0,17
Lectoria,F,100,10,0,10
Ysrael,M,100,0,12,12
Dequentin,M,100,0,6,6
Marivi,F,100,37,0,37
Jashala,F,100,6,0,6
Tomiah,F,100,5,0,5
Ellynor,F,100,6,0,6
Glenda,F,100,62939,138,63077
Mardi,F,99,777,6,783
Ritage,F,100,6,0,6
Yaxye,M,100,0,5,5
Lashandria,F,100,12,0,12
Rawly,M,100,0,6,6
Yamilett,F,100,369,0,369
Zyllah,F,100,7,0,7
Juanmartin,M,100,0,12,12
Naleea,F,100,5,0,5
Shiri,F,100,205,0,205
Phan,M,57,15,20,35
Manolito,M,100,0,111,111
Mercedita,F,100,12,0,12
Coyer,M,100,0,13,13
Katerena,F,100,5,0,5
Armanni,M,83,11,54,65
Elideth,F,100,46,0,46
Samarya,F,100,38,0,38
Jowanna,F,100,217,0,217
Sesario,M,100,0,5,5
Orlen,M,100,0,18,18
Quaniya,F,100,97,0,97
Anajulia,F,100,108,0,108
Jyshon,M,100,0,5,5
Drury,M,100,0,74,74
Christyne,F,100,210,0,210
Coretta,F,100,2047,0,2047
Thailan,M,100,0,124,124
Chicago,M,100,0,34,34
Tomaka,F,100,29,0,29
Dancy,F,100,14,0,14
Malaisha,F,100,130,0,130
Kanoelani,F,100,79,0,79
Anvitha,F,100,312,0,312
Madylen,F,100,13,0,13
Ahriya,F,100,24,0,24
Apostolis,M,100,0,5,5
Erix,M,100,0,12,12
Dominesha,F,100,16,0,16
Alise,F,100,2925,0,2925
Rayah,F,100,614,0,614
Evelyn,F,100,173479,631,174110
Kristan,F,90,5449,599,6048
Rolunda,F,100,7,0,7
Decatur,M,100,0,12,12
Zoeh,F,100,22,0,22
Aylenne,F,100,5,0,5
Gerniya,F,100,5,0,5
Gerek,M,100,0,15,15
Arelly,F,100,250,0,250
Luismanuel,M,100,0,101,101
Alman,M,100,0,23,23
Jshin,M,100,0,5,5
Lucielle,F,100,82,0,82
Jinny,F,100,723,0,723
Zymaria,F,100,13,0,13
Yavier,M,100,0,65,65
Secoya,F,100,26,0,26
Airanna,F,100,55,0,55
Lexxi,F,100,220,0,220
Celimar,F,100,6,0,6
Kymir,M,100,0,145,145
Amarhi,F,100,5,0,5
Stefano,M,100,0,2487,2487
Nikera,F,100,52,0,52
Zecharyah,M,100,0,5,5
Kaisey,F,100,96,0,96
Minetta,F,100,22,0,22
Danny,M,99,1297,224591,225888
Jolet,F,100,15,0,15
Kemori,M,64,5,9,14
Andhy,M,100,0,21,21
Jaxyn,M,75,146,443,589
Timthoy,M,100,0,18,18
Yossef,M,100,0,101,101
Starbuck,M,100,0,11,11
Litonia,F,100,5,0,5
Mckaylin,F,100,75,0,75
Raily,M,58,5,7,12
Demarkus,M,100,0,1111,1111
Annalese,F,100,321,0,321
Evvie,F,100,50,0,50
Quandre,M,100,0,115,115
Bakr,M,100,0,5,5
Tiaja,F,100,140,0,140
Chalie,F,100,10,0,10
Forrest,M,99,361,23993,24354
Tamula,F,100,196,0,196
Audrone,F,100,5,0,5
Keil,M,100,0,312,312
Bralei,F,100,6,0,6
Skailar,F,100,6,0,6
Herschell,M,100,0,270,270
Rahini,F,100,15,0,15
Tanaejah,F,100,18,0,18
Stacyann,F,100,90,0,90
Takaila,F,100,10,0,10
Milad,M,100,0,300,300
Dvonte,M,100,0,409,409
Rashaundra,F,100,13,0,13
Chealsie,F,100,44,0,44
Khalib,M,100,0,157,157
Jed,M,100,0,7550,7550
Lucetta,F,100,57,0,57
Aubriannah,F,100,10,0,10
Rosabelle,F,100,166,0,166
Nyveah,F,100,20,0,20
Betul,F,100,82,0,82
Amir,M,98,353,22696,23049
Trenedy,F,100,13,0,13
Axtyn,M,100,0,42,42
Madisonrose,F,100,11,0,11
Jaylem,M,100,0,6,6
Traviona,F,100,18,0,18
Denero,M,100,0,10,10
Krishma,F,100,19,0,19
Adaleya,F,100,11,0,11
Shauntaya,F,100,5,0,5
Nhan,M,99,5,335,340
Jerene,F,100,216,0,216
Gizel,F,100,250,0,250
Jailia,F,100,42,0,42
Kechia,F,100,154,0,154
Colletta,F,100,167,0,167
Kinsee,F,100,22,0,22
Syrae,F,100,22,0,22
Mikaeyla,F,100,5,0,5
Cordon,M,100,0,55,55
Janieka,F,100,12,0,12
Aza,F,85,218,39,257
Adbiel,M,100,0,15,15
Khloemarie,F,100,6,0,6
Akeriah,F,100,5,0,5
Avyan,M,100,0,130,130
Anya,F,100,14130,0,14130
Glynna,F,100,121,0,121
Nalini,F,100,267,0,267
Renika,F,100,359,0,359
Eldana,F,100,202,0,202
Xzayden,M,100,0,23,23
Sallye,F,100,261,0,261
Kayeleigh,F,100,55,0,55
Medha,F,100,672,0,672
Leyre,F,100,5,0,5
Shloke,M,100,0,6,6
Lyricc,F,100,13,0,13
Varda,F,100,5,0,5
Johnathin,M,100,0,159,159
Radha,F,100,663,0,663
Ilan,M,99,27,1891,1918
Alesya,F,100,43,0,43
Jhaden,M,100,0,78,78
Ruslana,F,100,6,0,6
Mariabelen,F,100,91,0,91
Tiere,F,100,5,0,5
Jeramyah,M,100,0,185,185
Nayaly,F,100,6,0,6
Tramal,M,100,0,5,5
Mikaela,F,100,16511,0,16511
Lequesha,F,100,10,0,10
Alexxys,F,100,37,0,37
Joia,F,100,412,0,412
Naleigha,F,100,49,0,49
Lisabeth,F,100,1178,0,1178
Miachel,M,100,0,189,189
Ivars,M,100,0,28,28
Rydell,M,100,0,377,377
Ladina,F,100,179,0,179
Ticia,F,100,100,0,100
Mysty,F,100,66,0,66
Kanavis,M,100,0,14,14
Yesenia,F,99,37910,314,38224
Aleasa,F,100,23,0,23
Analisha,F,100,37,0,37
Markuz,M,100,0,18,18
Rodeny,M,100,0,23,23
Taleia,F,100,154,0,154
Thornell,M,100,0,22,22
Mackynzie,F,100,286,0,286
Justi,F,77,17,5,22
Kamoni,F,62,179,109,288
Daiyaan,M,100,0,26,26
Keijon,M,100,0,6,6
Clevette,F,100,6,0,6
Vaunda,F,100,23,0,23
Jamaiyah,F,100,67,0,67
Marlayne,F,100,17,0,17
Zayceon,M,100,0,5,5
Tankia,F,100,7,0,7
Auryana,F,100,11,0,11
Jeanmarco,M,100,0,5,5
Irmgard,F,100,18,0,18
Bobbisue,F,100,11,0,11
Dynasha,F,100,5,0,5
Tiniqua,F,100,6,0,6
Oldair,M,100,0,5,5
Locklyn,F,93,135,10,145
Raynier,M,100,0,22,22
Jawone,M,100,0,21,21
Rembert,M,100,0,108,108
Norm,M,100,0,375,375
Tmia,F,100,28,0,28
Krishay,M,100,0,51,51
Taccara,F,100,129,0,129
Jahkye,M,100,0,34,34
Siena,F,100,5970,0,5970
Chabria,F,100,5,0,5
Mateyo,M,100,0,5,5
Cricket,F,100,538,0,538
Jaydee,F,56,472,369,841
Vian,M,72,22,56,78
Khalida,F,100,58,0,58
Iiana,F,100,6,0,6
Katylyn,F,100,15,0,15
Yahdira,F,100,60,0,60
Tkeya,F,100,78,0,78
Aslynn,F,100,231,0,231
Belah,F,100,10,0,10
Demtrius,M,100,0,60,60
Amelia,F,100,107636,110,107746
Kendalyn,F,100,702,0,702
Flint,M,100,0,1699,1699
Ossie,M,66,267,514,781
Liiam,M,100,0,6,6
Lealah,F,100,24,0,24
Kerryn,F,100,187,0,187
Jaxper,M,100,0,5,5
Ayatt,F,100,6,0,6
Dechanel,F,100,5,0,5
Ellawyn,F,100,17,0,17
Shriya,F,100,1332,0,1332
Deleshia,F,100,24,0,24
Demaurion,M,100,0,79,79
Paycen,F,61,42,27,69
Danijel,M,100,0,6,6
Curtissa,F,100,13,0,13
Makeba,F,100,702,0,702
Shawndria,F,100,6,0,6
Madrox,M,100,0,5,5
Jemari,M,100,0,218,218
Niveyah,F,100,17,0,17
Klarrisa,F,100,11,0,11
Penelopi,F,100,30,0,30
Shauntina,F,100,36,0,36
Jahkai,M,100,0,242,242
Jerric,M,100,0,66,66
Nisean,M,100,0,5,5
Chastina,F,100,26,0,26
Skylier,M,56,48,62,110
Kisan,M,100,0,5,5
Jyonna,F,100,5,0,5
Nyvaeh,F,100,8,0,8
Debroah,F,100,1410,0,1410
Trevoris,M,100,0,22,22
Radwan,M,100,0,82,82
Darissa,F,100,46,0,46
Bilaal,M,100,0,79,79
Monique,F,100,77623,377,78000
Zaysean,M,100,0,5,5
Kyndahl,F,100,99,0,99
Karissa,F,100,18909,0,18909
Anilu,F,100,38,0,38
Zalie,F,100,34,0,34
Thaina,F,100,26,0,26
Orfa,F,100,10,0,10
Raneesha,F,100,19,0,19
Asra,F,100,130,0,130
Ryne,M,99,31,4060,4091
Jarlyn,F,100,11,0,11
Burel,M,100,0,5,5
Solange,F,100,1264,0,1264
Salihah,F,100,75,0,75
Tenicka,F,100,11,0,11
Augie,M,100,0,366,366
Myriana,F,100,15,0,15
Genni,F,100,61,0,61
Shimara,F,100,6,0,6
Cyron,M,100,0,40,40
Frederich,M,100,0,265,265
Art,M,100,0,2948,2948
Joeanthony,M,100,0,263,263
Andalyn,F,100,71,0,71
Houda,F,100,97,0,97
Eviana,F,100,327,0,327
Caynen,M,100,0,37,37
Chaiden,M,100,0,11,11
Kymberley,F,100,106,0,106
Abedalrahman,M,100,0,11,11
Falona,F,100,19,0,19
Kerynn,F,100,6,0,6
Jinayah,F,100,5,0,5
Kelecia,F,100,5,0,5
Naadira,F,100,24,0,24
Gisela,F,100,3701,0,3701
Faisal,M,100,0,1577,1577
Hava,F,100,206,0,206
Trishan,M,100,0,5,5
Khamir,M,100,0,26,26
Shayne,M,79,2677,10220,12897
Timaree,F,100,10,0,10
Zariah,F,99,6632,51,6683
Khadra,F,100,33,0,33
Torie,F,91,2709,268,2977
Razariah,F,100,5,0,5
Japree,M,100,0,5,5
Jhoniel,M,100,0,5,5
Tyaja,F,100,26,0,26
Jazzlene,F,100,77,0,77
Delvontae,M,100,0,11,11
Trenese,F,100,72,0,72
Rollie,M,100,0,1083,1083
Macady,F,100,36,0,36
Breyn,F,100,5,0,5
Lawyer,M,100,0,231,231
Clarity,F,100,322,0,322
Lalonnie,F,100,53,0,53
Koey,F,100,25,0,25
Amjed,M,100,0,28,28
Shaline,F,100,11,0,11
Sonnette,F,100,10,0,10
Tucson,M,100,0,5,5
Bonna,F,100,265,0,265
Ume,F,100,5,0,5
Sherifat,F,100,5,0,5
Chicquita,F,100,63,0,63
Brayston,M,100,0,5,5
Hasanah,F,100,5,0,5
Semahj,M,100,0,6,6
Stephano,M,100,0,416,416
Ferdy,M,100,0,12,12
Ziar,M,100,0,10,10
Zamarria,F,100,12,0,12
Jarquavius,M,100,0,11,11
Rihaan,M,100,0,44,44
Jahiro,M,100,0,19,19
Aimie,F,100,548,0,548
Trinetta,F,100,126,0,126
Ajani,M,90,172,1548,1720
Janetha,F,100,5,0,5
Asharie,F,100,42,0,42
Sudhanva,M,100,0,5,5
Armoni,F,61,1131,719,1850
Josephene,F,100,34,0,34
Eartha,F,100,1292,5,1297
Klariza,F,100,11,0,11
Yeraldin,F,100,315,0,315
Makyrah,F,100,39,0,39
Payson,M,58,596,837,1433
Marlika,F,100,5,0,5
Albee,F,100,5,0,5
Loyde,M,100,0,117,117
Kristiana,F,100,2469,0,2469
Tyheisha,F,100,5,0,5
Yadhir,M,100,0,14,14
Soua,F,65,105,56,161
Teidra,F,100,5,0,5
Timothyjames,M,100,0,46,46
Tirese,M,100,0,5,5
Kervin,M,100,0,1353,1353
Alaxander,M,100,0,20,20
Seantyler,M,100,0,5,5
Anatoli,M,100,0,6,6
Iylan,F,100,5,0,5
Shloimy,M,100,0,178,178
Jovona,F,100,55,0,55
Chandar,M,52,12,13,25
Cinde,F,100,192,0,192
Kaylann,F,100,30,0,30
Sibella,F,100,18,0,18
Rhonesha,F,100,7,0,7
Anamia,F,100,5,0,5
Rakeem,M,100,0,1800,1800
Niomie,F,100,47,0,47
Sharika,F,100,1295,0,1295
Fardy,M,100,0,13,13
Demien,M,100,0,11,11
Siddeeq,M,100,0,10,10
Terraneisha,F,100,5,0,5
Daigen,M,100,0,6,6
Avontae,M,100,0,185,185
Kharissa,F,100,58,0,58
Shiffy,F,100,19,0,19
Palmer,M,79,812,2999,3811
Zaidin,M,100,0,82,82
Jemira,F,100,6,0,6
Kekai,M,100,0,68,68
Fetina,F,100,5,0,5
Savoeun,F,100,5,0,5
Shavonda,F,100,1117,0,1117
Syreena,F,100,13,0,13
Stefenie,F,100,40,0,40
Onassis,M,100,0,18,18
Miyari,F,100,7,0,7
Tamiera,F,100,48,0,48
Quadarrious,M,100,0,5,5
Kiomy,F,100,6,0,6
Jabaree,M,100,0,124,124
Gillermina,F,100,30,0,30
Kysa,F,100,167,0,167
Brianalee,F,100,5,0,5
Tione,F,56,15,12,27
Maylan,F,100,30,0,30
Lynita,F,100,354,0,354
Nazavier,M,100,0,6,6
Seoyeon,F,100,5,0,5
Desmone,M,87,6,41,47
Tyneesha,F,100,53,0,53
Rondia,F,100,71,0,71
Bakary,M,100,0,90,90
Helmut,M,100,0,263,263
Kindall,F,93,561,45,606
Keltie,F,100,57,0,57
Risa,F,100,3793,0,3793
Ustin,M,100,0,113,113
Kijon,M,100,0,33,33
Aonna,F,100,5,0,5
Myron,M,99,211,21900,22111
Joshuaryan,M,100,0,17,17
Yazlene,F,100,36,0,36
Jeremiahs,M,100,0,5,5
Kandace,F,100,5991,0,5991
Charly,F,64,1688,950,2638
Enoc,M,100,0,813,813
Sukaina,F,100,68,0,68
Jeffreyjames,M,100,0,5,5
Payzli,F,100,13,0,13
Stefaney,F,100,19,0,19
Saafir,M,100,0,77,77
Solaris,F,100,65,0,65
Hazyl,F,100,50,0,50
Alesea,F,100,12,0,12
Deair,M,100,0,10,10
Kord,M,100,0,368,368
Frannie,F,100,160,0,160
Saalim,M,100,0,11,11
Shatifah,F,100,8,0,8
Laxavier,M,100,0,11,11
Rebella,F,100,15,0,15
Ashaun,M,100,0,124,124
Kwamayne,M,100,0,5,5
Eizley,F,100,10,0,10
Kayshla,F,100,57,0,57
Janmarco,M,100,0,13,13
Anachristina,F,100,45,0,45
Sinya,F,100,17,0,17
Rosemaire,F,100,16,0,16
Jiapsi,F,100,7,0,7
Acsa,F,100,70,0,70
Amaje,M,100,0,23,23
Aenea,F,100,7,0,7
Kaamilah,F,100,10,0,10
Chrishonna,F,100,12,0,12
Thesa,F,100,5,0,5
Addilynn,F,100,1171,0,1171
Jahmall,M,100,0,5,5
Whyatt,M,100,0,258,258
Anfisa,F,100,11,0,11
Zhianna,F,100,5,0,5
Iycess,F,100,5,0,5
Isobelle,F,100,66,0,66
Aalok,M,100,0,10,10
Naylin,F,100,110,0,110
Wister,M,100,0,11,11
Darald,M,100,0,70,70
Dailon,M,100,0,169,169
Chelzie,F,100,6,0,6
Vigo,M,100,0,5,5
Heleen,F,100,22,0,22
Jalea,F,100,567,0,567
Salina,F,100,6484,0,6484
Creasie,F,100,5,0,5
Rakai,M,100,0,5,5
Jadea,F,100,337,0,337
Eathon,M,100,0,76,76
Deseri,F,100,92,0,92
Janilah,F,100,116,0,116
Nathael,M,100,0,5,5
Deeshawn,M,100,0,13,13
Curteria,F,100,5,0,5
Javanta,M,100,0,5,5
Liana,F,100,12924,0,12924
Danis,M,84,15,77,92
Emellia,F,100,6,0,6
Deonshay,F,100,6,0,6
Daliyla,F,100,5,0,5
Melody,F,100,83824,164,83988
Trenden,M,100,0,84,84
Machelle,F,100,3146,0,3146
Boy,M,100,0,569,569
Alexsander,M,100,0,1076,1076
Daison,M,100,0,83,83
Rickisha,F,100,48,0,48
Selestine,F,100,12,0,12
Dejuan,M,99,40,5034,5074
Ryleigh,F,98,17553,285,17838
Quateria,F,100,17,0,17
Knoah,M,100,0,106,106
Neasha,F,100,42,0,42
Esdras,M,100,0,885,885
Amiliah,F,100,29,0,29
Tyller,M,76,46,142,188
Smanatha,F,100,26,0,26
Margeart,F,100,23,0,23
Shealeen,F,100,11,0,11
Taityana,F,100,5,0,5
Ermina,F,100,43,0,43
Eliana,F,100,25881,22,25903
Shawyn,F,100,5,0,5
Melaysia,F,100,93,0,93
Sealtiel,M,100,0,5,5
Hartli,F,100,5,0,5
Rodin,M,100,0,19,19
Delvion,M,100,0,6,6
Priscila,F,100,3971,0,3971
Terresia,F,100,5,0,5
Ramira,F,100,37,0,37
Cyrenity,F,100,24,0,24
Shaynne,F,100,6,0,6
Zaliyah,F,100,404,0,404
Makensie,F,100,615,0,615
Mariko,F,99,1136,6,1142
Danyl,M,54,59,70,129
Norely,F,100,77,0,77
Bryli,F,100,142,0,142
Azazel,M,100,0,74,74
Lemual,M,100,0,8,8
Emmajane,F,100,105,0,105
Staton,M,100,0,73,73
Diyaa,F,100,10,0,10
Marrietta,F,100,81,0,81
Osagie,M,100,0,31,31
Nasma,F,100,14,0,14
Oneil,M,100,0,910,910
Hayla,F,100,353,0,353
Arabel,F,100,76,0,76
Marrisa,F,100,1050,0,1050
Datrick,M,100,0,10,10
Kalex,M,100,0,13,13
Saryia,F,100,30,0,30
Kristil,F,100,10,0,10
Nataley,F,100,501,0,501
Therease,F,100,5,0,5
Jerniya,F,100,52,0,52
Kimbria,F,100,69,0,69
Kabren,M,100,0,26,26
Aalias,M,100,0,5,5
Sedney,F,100,5,0,5
Seriyah,F,100,142,0,142
Alexendra,F,100,13,0,13
Ambernicole,F,100,23,0,23
Antoinette,F,100,39290,46,39336
Collier,M,93,80,1105,1185
Deloise,F,100,983,0,983
Mahaley,F,100,277,0,277
Jaemie,F,100,10,0,10
Kewaun,M,100,0,56,56
Camori,F,100,11,0,11
Horald,M,100,0,5,5
Armani,M,56,5985,7662,13647
Mayumi,F,100,435,0,435
Sailor,F,85,1282,229,1511
Callia,F,100,417,0,417
Lynnelle,F,100,285,0,285
Seraphine,F,100,212,0,212
Izaiyah,M,100,0,177,177
Brand,M,93,18,239,257
Isau,M,100,0,10,10
Yuhan,F,100,21,0,21
Korde,M,100,0,103,103
Kaedn,M,100,0,5,5
Jullia,F,100,97,0,97
Emmalisa,F,100,6,0,6
Avontay,M,100,0,25,25
Aaliya,F,100,1010,0,1010
Tawnjai,F,100,5,0,5
Tyeasha,F,100,208,0,208
Jailyne,F,100,132,0,132
Myren,M,100,0,14,14
Branham,M,100,0,8,8
Shauney,F,100,6,0,6
Alexx,M,64,194,347,541
Sharo,F,100,11,0,11
Francess,F,100,39,0,39
Jaybriel,M,100,0,10,10
Chelsay,F,100,49,0,49
Mekaela,F,100,105,0,105
Dahndray,M,100,0,13,13
Zadiel,M,100,0,20,20
Quiency,M,100,0,11,11
Conswello,F,100,35,0,35
Ostyn,M,100,0,16,16
Dantee,M,100,0,5,5
Analyz,F,100,7,0,7
Seras,F,100,5,0,5
Domineke,M,100,0,14,14
Rosetta,F,100,8777,0,8777
Khalii,F,100,6,0,6
Danel,M,65,147,271,418
Dannilyn,F,100,5,0,5
Fadumo,F,100,239,0,239
Berenger,M,100,0,5,5
Kerby,M,87,122,821,943
Farryn,F,100,120,0,120
Alyssea,F,100,6,0,6
Darquise,M,100,0,6,6
Haydenn,F,77,20,6,26
Ryoma,M,100,0,75,75
Enija,F,100,13,0,13
Auryn,M,77,11,37,48
Kenly,F,85,358,64,422
Muhaimin,M,100,0,5,5
Nicolly,F,100,54,0,54
Maaria,F,100,29,0,29
Nailea,F,100,815,0,815
Kamilia,F,100,159,0,159
Emiliah,F,100,23,0,23
Keywanda,F,100,15,0,15
Deralyn,F,100,5,0,5
Amaryah,F,100,114,0,114
Geniah,F,100,55,0,55
Tekelia,F,100,67,0,67
Seleni,F,100,41,0,41
Bettina,F,100,5087,0,5087
Malise,F,100,30,0,30
Saori,F,100,304,0,304
Covey,M,96,5,123,128
Takelia,F,100,163,0,163
Natalyah,F,100,166,0,166
Takeisha,F,100,1048,0,1048
Dorsa,F,100,46,0,46
Jhovanni,M,100,0,25,25
Dryver,M,100,0,7,7
Lynnaya,F,100,22,0,22
Larkyn,F,100,205,0,205
Leontre,M,100,0,5,5
Bodhan,M,100,0,5,5
Yaseer,M,100,0,10,10
Walidah,F,100,15,0,15
Kemiah,F,100,123,0,123
Fatisha,F,100,62,0,62
Ileena,F,100,11,0,11
Periann,F,100,32,0,32
Tomiko,F,99,553,7,560
Emem,F,100,5,0,5
Dolline,F,100,18,0,18
Eryanna,F,100,53,0,53
Armetrice,F,100,5,0,5
Lexanni,F,100,6,0,6
Umair,M,100,0,383,383
Jahzon,M,100,0,5,5
Elicia,F,100,3914,0,3914
Jealousy,F,100,21,0,21
Dinah,F,100,7359,0,7359
Markan,F,100,16,0,16
Saliou,M,100,0,83,83
Bethaney,F,100,631,0,631
Rosalea,F,100,156,0,156
Kyri,F,63,358,209,567
Nava,F,100,720,0,720
Aylanna,F,100,5,0,5
Konner,M,97,113,4266,4379
Cashe,F,66,68,35,103
Sherianne,F,100,16,0,16
Aerianna,F,100,337,0,337
Edelyn,F,100,223,0,223
Ethanalexander,M,100,0,24,24
Crucita,F,100,41,0,41
Zedek,M,100,0,5,5
Aireanna,F,100,296,0,296
Kwamane,M,100,0,130,130
Michalyn,F,100,18,0,18
Tyneice,F,100,5,0,5
Cabela,F,100,56,0,56
Sainabou,F,100,10,0,10
Liya,F,100,1050,0,1050
Webb,M,100,0,622,622
Trask,M,100,0,107,107
Kamariya,F,100,135,0,135
Bralan,M,100,0,6,6
Carie,F,100,4120,0,4120
Rayli,F,76,65,20,85
Maung,M,100,0,5,5
Sigal,F,100,31,0,31
Ladanna,F,100,5,0,5
Montessa,F,100,23,0,23
Yasuhiro,M,100,0,6,6
Damariana,F,100,14,0,14
Mizraim,M,100,0,108,108
Virgene,F,100,36,0,36
Jahmair,M,100,0,37,37
Pedrohenrique,M,100,0,99,99
Chaos,M,100,0,73,73
Trayshaun,M,100,0,21,21
Briceidy,F,100,25,0,25
Siannah,F,100,25,0,25
Emillianna,F,100,7,0,7
Anistin,F,100,7,0,7
Bracelynn,F,100,5,0,5
Yomaris,F,100,107,0,107
Lency,F,100,24,0,24
Alette,F,100,46,0,46
Rockston,M,100,0,6,6
Aubreyanna,F,100,266,0,266
Evonne,F,100,3567,0,3567
Lerita,F,100,5,0,5
Xyana,F,100,6,0,6
Mariaemilia,F,100,5,0,5
Dravon,M,100,0,104,104
Alonte,M,98,6,393,399
Britne,F,100,282,0,282
Shaunice,F,100,609,0,609
Trevares,M,100,0,5,5
Gisely,F,100,5,0,5
Khalyl,M,100,0,47,47
Shawndale,M,85,28,158,186
Debbe,F,100,215,0,215
Phoung,F,100,5,0,5
Lorali,F,100,293,0,293
Rashun,M,97,18,521,539
Sheronda,F,100,1300,0,1300
Ria,F,100,3111,0,3111
Granville,M,100,0,1302,1302
Syrinity,F,100,6,0,6
Farrin,F,88,115,15,130
Aunna,F,100,335,0,335
Tameira,F,100,5,0,5
Bennetta,F,100,136,0,136
Avelynn,F,100,127,0,127
Lucienna,F,100,5,0,5
Shrenik,M,100,0,14,14
Panchita,F,100,5,0,5
Kailyn,F,99,11662,72,11734
Treneice,F,100,49,0,49
Kaimipono,M,100,0,12,12
Amberlea,F,100,127,0,127
Keele,F,100,14,0,14
Zaragosa,M,100,0,5,5
Jaqualin,M,100,0,82,82
Verneta,F,100,17,0,17
Dilyla,F,100,6,0,6
Kamore,F,100,18,0,18
Tayce,M,100,0,5,5
Damaurion,M,100,0,12,12
Shekera,F,100,77,0,77
Deatrice,F,100,604,0,604
Yarethzi,F,100,75,0,75
Roza,F,100,200,0,200
Kashmiere,F,100,6,0,6
Bishop,M,100,5,3503,3508
Aniesa,F,100,85,0,85
Sabriana,F,100,28,0,28
Payshance,F,100,6,0,6
Laidy,F,100,5,0,5
Kilburn,M,100,0,5,5
Vinson,M,100,0,2736,2736
Jaivien,M,100,0,24,24
Leroya,F,100,8,0,8
Itzamar,F,100,113,0,113
Rubbie,F,100,98,0,98
Rachmiel,M,100,0,5,5
Delmore,M,100,0,17,17
Laeisha,F,100,10,0,10
Nikkia,F,99,1440,12,1452
Rutu,F,100,10,0,10
Shiree,F,100,631,0,631
Jolett,F,100,33,0,33
Aaniah,F,100,33,0,33
Buruk,M,100,0,5,5
Breyen,M,100,0,27,27
Vyvian,F,100,23,0,23
Elizabethe,F,100,10,0,10
Bastion,M,100,0,55,55
Vincci,F,100,6,0,6
Kirie,F,100,46,0,46
Zyking,M,100,0,6,6
Mayleah,F,100,20,0,20
Keandrae,M,100,0,10,10
Fernie,M,100,0,269,269
Keshae,F,100,39,0,39
Darry,M,100,0,1381,1381
Kadmiel,M,100,0,33,33
Janiecia,F,100,22,0,22
Catelyn,F,100,2112,0,2112
Qui,M,100,0,23,23
Stefani,F,100,6732,0,6732
Rommell,M,100,0,51,51
Jarique,M,100,0,5,5
Sreeya,F,100,26,0,26
Eastin,M,97,10,286,296
Tarek,M,100,0,1867,1867
Malaika,F,100,1916,0,1916
Kamiyha,F,100,6,0,6
Haviland,F,100,19,0,19
Cyan,F,86,909,152,1061
Francia,F,100,616,0,616
Khaelynn,F,100,5,0,5
Malasha,F,100,90,0,90
Khalik,M,100,0,194,194
Ivyunna,F,100,14,0,14
Personna,F,100,5,0,5
Allissia,F,100,37,0,37
Savon,M,96,66,1456,1522
Haivyn,F,100,37,0,37
Lailany,F,100,99,0,99
Jaliyha,F,100,29,0,29
Keyun,M,100,0,55,55
Nakeea,F,100,10,0,10
Ashyiah,F,100,5,0,5
Muneera,F,100,30,0,30
Dalaysha,F,100,30,0,30
Abbigail,F,100,10799,5,10804
Darquan,M,100,0,28,28
Naloni,F,100,25,0,25
Arsalaan,M,100,0,6,6
Jaeonna,F,100,39,0,39
Roshika,F,100,10,0,10
Anina,F,100,455,0,455
Sameerah,F,100,422,0,422
Grisham,M,100,0,23,23
Lucion,M,100,0,26,26
Reann,F,100,458,0,458
Jatavion,M,100,0,257,257
Tynika,F,100,312,0,312
Lataya,F,100,752,0,752
Romonda,F,100,101,0,101
Braelin,M,56,181,235,416
Demba,M,100,0,45,45
Kenjuan,M,100,0,37,37
Giyanna,F,100,13,0,13
Dhalia,F,100,189,0,189
Jetzibe,F,100,14,0,14
Elvia,F,100,5666,10,5676
Jazaiah,M,64,10,18,28
Gitzel,F,100,50,0,50
Yareily,F,100,6,0,6
Jaykub,M,100,0,64,64
Mykhel,M,100,0,5,5
Denai,F,100,128,0,128
Giahan,F,100,5,0,5
Meshawn,F,100,102,0,102
Jakelia,F,100,5,0,5
Dixie,F,99,16754,121,16875
Mckaleigh,F,100,5,0,5
Dublin,M,78,59,209,268
Kanyae,M,100,0,18,18
Diena,F,100,10,0,10
Keyonni,F,100,49,0,49
Vir,M,100,0,177,177
Jayz,M,100,0,43,43
Tasanee,F,100,48,0,48
Crandall,M,100,0,237,237
Dalayla,F,100,102,0,102
Lateka,F,100,171,0,171
Karelly,F,100,137,0,137
Kishauna,F,100,17,0,17
Seann,M,99,5,517,522
Rhye,M,100,0,5,5
Aleeana,F,100,5,0,5
Aaronisha,F,100,6,0,6
Mark,M,100,4059,1272083,1276142
Deneil,F,100,15,0,15
Mykalla,F,100,5,0,5
Jahida,F,100,51,0,51
Raef,M,100,0,273,273
Parish,M,75,268,804,1072
Kever,M,100,0,5,5
Adari,M,100,0,5,5
Kallin,M,83,24,115,139
Niccolas,M,100,0,184,184
Quameisha,F,100,16,0,16
Marson,M,100,0,16,16
Phylica,F,100,11,0,11
Dulcinea,F,100,257,0,257
Falando,M,100,0,12,12
Dartanya,F,100,11,0,11
Rydge,M,100,0,66,66
Royanne,F,100,59,0,59
Huntley,M,78,82,296,378
Seniyah,F,100,144,0,144
Brynlynn,F,100,53,0,53
Annelyse,F,100,271,0,271
Kimaya,F,100,723,0,723
Jaquaya,F,100,67,0,67
Shataya,F,100,195,0,195
Witt,M,100,0,107,107
Vinna,F,100,5,0,5
Dejun,M,100,0,5,5
Tenisa,F,100,19,0,19
Gracelynn,F,100,3691,0,3691
Taley,F,100,11,0,11
Piya,F,100,85,0,85
Faylee,F,100,16,0,16
Pejman,M,100,0,5,5
Camay,F,100,72,0,72
Taijuan,M,100,0,64,64
Stalin,M,100,0,85,85
Rosalind,F,100,15085,0,15085
Randilynn,F,100,41,0,41
Jakaleb,M,100,0,55,55
Alick,M,100,0,36,36
Daysie,F,100,89,0,89
Tyrees,M,100,0,61,61
Maxeen,F,100,18,0,18
Cassiel,M,79,21,79,100
Samone,F,100,2049,5,2054
Archisha,F,100,23,0,23
Shawnese,F,100,173,0,173
Maeghen,F,100,32,0,32
Chanse,M,98,16,996,1012
Sothea,M,69,8,18,26
Faiyaz,M,100,0,20,20
Ayin,F,100,5,0,5
Milek,M,100,0,24,24
Khaliek,M,100,0,5,5
Tarnell,M,100,0,6,6
Lattie,M,85,5,29,34
Yarlyn,F,100,5,0,5
Marigrace,F,100,151,0,151
Xyra,F,100,6,0,6
Verah,F,100,12,0,12
Kaire,M,90,6,52,58
Nancie,F,100,1654,0,1654
Sindie,F,100,10,0,10
Deryan,M,100,0,47,47
Nhyira,F,100,29,0,29
Shetera,F,100,7,0,7
Rindy,F,100,119,0,119
Jinwoo,M,100,0,10,10
Vinisha,F,100,58,0,58
Wulfric,M,100,0,17,17
Cittlaly,F,100,6,0,6
Izaic,M,100,0,6,6
Gema,F,100,1955,0,1955
Philmon,M,100,0,5,5
Jacquan,M,100,0,440,440
Chanc,M,100,0,110,110
Benney,M,100,0,30,30
Eliverto,M,100,0,5,5
Semayah,F,100,5,0,5
Yeremiah,M,100,0,24,24
Aidenn,M,100,0,144,144
Ilithya,F,100,7,0,7
Contrella,F,100,7,0,7
Latandra,F,100,98,0,98
Que,M,100,0,46,46
Katonna,F,100,5,0,5
Emric,M,100,0,22,22
Maccoy,M,100,0,85,85
Filipe,M,100,0,378,378
Latonja,F,100,684,0,684
Emmalouise,F,100,6,0,6
Katria,F,100,103,0,103
Arlyss,F,100,5,0,5
Hanlee,F,100,5,0,5
Oneal,M,100,0,1194,1194
Emmielou,F,100,6,0,6
Yzamar,F,100,6,0,6
Graceelizabeth,F,100,5,0,5
Alieyah,F,100,57,0,57
Praharsh,M,100,0,5,5
Yendy,F,100,6,0,6
Yasseen,M,100,0,64,64
Adamma,F,100,5,0,5
Lessia,F,100,23,0,23
Mishonda,F,100,6,0,6
Pape,M,100,0,104,104
Zykia,F,100,438,0,438
Eyian,M,100,0,8,8
Kwesi,M,100,0,719,719
Thinh,M,100,0,222,222
Puja,F,100,811,0,811
Siddh,M,100,0,67,67
Jayveion,M,100,0,74,74
Leaann,F,100,451,0,451
Akeya,F,100,212,0,212
Nabihah,F,100,30,0,30
Jaelyne,F,100,142,0,142
Allianah,F,100,21,0,21
Keymoni,F,63,64,37,101
Shelbea,F,100,54,0,54
Kanden,M,100,0,134,134
Yavian,M,100,0,17,17
Taevon,M,100,0,579,579
Emier,M,100,0,5,5
Trustin,M,100,0,491,491
Aryam,F,95,199,10,209
Aljawhara,F,100,6,0,6
Jonel,M,51,301,318,619
Jamirya,F,100,5,0,5
Despina,F,100,1030,0,1030
Less,M,100,0,19,19
Azsa,F,100,5,0,5
Ronnasia,F,100,11,0,11
Kelsha,F,100,139,0,139
Alexxia,F,100,106,0,106
Jerick,M,100,0,658,658
Xuri,F,100,6,0,6
Svend,M,100,0,16,16
Vear,F,100,35,0,35
Shaquile,M,94,7,120,127
Stevenson,M,100,0,1267,1267
Ivoryana,F,100,5,0,5
Mikera,F,100,50,0,50
Oleksandr,M,100,0,15,15
Maleke,M,100,0,195,195
Jasline,F,100,337,0,337
Jaik,M,100,0,6,6
Kesar,F,100,6,0,6
Courtland,M,93,198,2805,3003
Makaio,M,100,0,533,533
Shaquane,F,50,5,5,10
Jacobe,M,100,0,1152,1152
Daviyah,F,100,6,0,6
Shanecqua,F,100,15,0,15
Tyshaun,M,100,5,1705,1710
Earlisha,F,100,98,0,98
Shantra,F,100,14,0,14
Ashleynicole,F,100,239,0,239
Felis,M,100,0,15,15
Catlyn,F,100,601,0,601
Sandr,F,100,5,0,5
Ketura,F,100,179,0,179
Jock,M,100,0,848,848
Tilley,F,100,60,0,60
Kearrah,F,100,22,0,22
Sanat,M,100,0,55,55
Kadavion,M,100,0,5,5
Tyjohn,M,100,0,33,33
Shanica,F,100,409,0,409
Corteney,F,100,8,0,8
Shanila,F,100,25,0,25
Zanaa,F,100,5,0,5
Demetrik,M,100,0,27,27
Shivang,M,100,0,32,32
Crystella,F,100,11,0,11
Lowery,M,100,0,124,124
Jadalynn,F,100,517,0,517
Sherri,F,100,81103,176,81279
Nirvan,M,100,0,133,133
Lidija,F,100,7,0,7
Anavictoria,F,100,164,0,164
Tyeshawn,M,100,0,11,11
Keilan,M,95,43,883,926
Cia,F,100,70,0,70
Omaru,M,100,0,5,5
Dezaria,F,100,79,0,79
Azria,F,100,7,0,7
Pendleton,M,100,0,7,7
Daniellah,F,100,6,0,6
Adiba,F,100,101,0,101
Alegandro,M,100,0,439,439
Everett,M,99,229,37572,37801
Mcgwire,M,100,0,97,97
Daedric,M,100,0,15,15
Dannan,F,100,26,0,26
Ronne,M,55,31,38,69
Jerid,M,100,0,858,858
Sondra,F,100,15740,0,15740
Anadela,F,100,8,0,8
Caoilainn,F,100,86,0,86
Gania,F,100,6,0,6
Qays,M,100,0,22,22
Regina,F,100,133563,490,134053
Devonee,F,100,17,0,17
Khare,M,100,0,5,5
Marycarol,F,100,28,0,28
Jahniah,F,100,84,0,84
Kaidin,M,97,11,339,350
Lakrystal,F,100,38,0,38
Lorik,M,100,0,30,30
Haiti,F,100,16,0,16
Millia,F,100,5,0,5
Hoyte,M,100,0,5,5
Sahriya,F,100,6,0,6
Jovantae,M,100,0,19,19
Katriona,F,100,87,0,87
Seanpatrick,M,100,0,245,245
Delsy,F,100,97,0,97
Avalon,F,99,2350,23,2373
Guled,M,100,0,92,92
Tomasina,F,100,309,0,309
Auron,M,100,0,323,323
Undria,F,100,5,0,5
Zafir,M,100,0,184,184
Ethaneal,M,100,0,5,5
Amida,F,100,6,0,6
Katarina,F,100,7823,0,7823
Zayanna,F,100,92,0,92
Elliyanna,F,100,5,0,5
Jeries,M,100,0,5,5
Elissia,F,100,253,0,253
Dejamarie,F,100,6,0,6
Ladante,M,100,0,16,16
Deshona,F,100,46,0,46
Valerie,F,100,230820,660,231480
Aukai,M,100,0,41,41
Shateka,F,100,95,0,95
Tonoa,F,100,38,0,38
Wykeshia,F,100,10,0,10
Johnanthony,M,100,0,459,459
Yanderi,F,100,13,0,13
Jem,F,67,62,31,93
Cono,M,100,0,10,10
Tifeoluwa,M,100,0,6,6
Frica,F,100,16,0,16
Mikali,F,100,27,0,27
Seeley,M,73,67,178,245
Alimah,F,100,39,0,39
Jacarra,F,100,95,0,95
Emercyn,F,100,36,0,36
Shakemmia,F,100,5,0,5
Keanya,F,100,15,0,15
Yazayra,F,100,5,0,5
Vitali,M,100,0,73,73
Leshelle,F,100,17,0,17
Janhavi,F,100,39,0,39
Nayla,F,100,1661,0,1661
Tlalli,F,100,11,0,11
Vadim,M,100,0,404,404
Nadaly,F,100,17,0,17
Nyiasia,F,100,6,0,6
Nalei,F,100,6,0,6
Satoria,F,100,134,0,134
Cawanna,F,100,6,0,6
Amarise,F,100,73,0,73
Darell,M,100,10,3822,3832
Schell,M,58,5,7,12
Latarcha,F,100,34,0,34
Darina,F,100,470,0,470
Jabrayah,F,100,6,0,6
Esthefania,F,100,17,0,17
Naquasia,F,100,6,0,6
Averleigh,F,100,22,0,22
Mikha,M,100,0,13,13
Shakyiah,F,100,5,0,5
Tylre,M,100,0,15,15
Lillyannah,F,100,34,0,34
Remo,M,100,0,378,378
Marlita,F,100,195,0,195
Rashamel,M,100,0,6,6
Takima,F,100,95,0,95
Yamilez,F,100,23,0,23
Jadda,F,100,99,0,99
Bobbie,F,89,42704,5269,47973
Amro,M,100,0,180,180
Trevahn,M,100,0,24,24
Naszir,M,100,0,132,132
Keiveon,M,100,0,6,6
Amry,F,100,61,0,61
Annagrace,F,100,532,0,532
Tranya,F,100,18,0,18
Ascension,M,100,0,37,37
Chelesy,F,100,6,0,6
Trayce,M,61,208,331,539
Shaemus,M,100,0,12,12
Mordy,M,100,0,6,6
Faydra,F,100,169,0,169
Ellysia,F,100,49,0,49
Contrena,F,100,5,0,5
Jaazaniah,F,67,10,5,15
Shaniyah,F,100,2559,0,2559
Labella,F,100,79,0,79
Lynford,M,100,0,80,80
Ayano,F,100,114,0,114
Idel,M,100,0,5,5
Linas,M,100,0,117,117
Andrw,M,100,0,51,51
Franshesca,F,100,73,0,73
Raihaanah,F,100,5,0,5
Virat,M,100,0,59,59
Takasha,F,100,58,0,58
Lylah,F,100,3157,0,3157
Jykeria,F,100,38,0,38
Darcus,F,93,149,11,160
Shontoria,F,100,12,0,12
Nichlas,M,100,0,268,268
Theodus,M,100,0,85,85
Derika,F,100,440,0,440
Tigerlily,F,100,196,0,196
Janiza,F,100,5,0,5
Mundy,F,100,11,0,11
Lynell,F,69,1573,696,2269
Reniqua,F,100,6,0,6
Cerese,F,100,10,0,10
Raynee,F,100,371,0,371
Millen,M,100,0,20,20
Delyn,F,84,57,11,68
Cassel,M,100,0,15,15
Angelli,F,100,323,0,323
Aylah,F,100,749,0,749
Chaquetta,F,100,52,0,52
Ramarion,M,100,0,33,33
Ashtyn,F,82,4901,1080,5981
Sadia,F,100,1084,0,1084
Stesha,F,100,132,0,132
Journei,F,100,575,0,575
Shanay,F,100,1415,0,1415
Koedy,M,100,0,5,5
Narissa,F,100,726,0,726
Mervin,M,100,0,4547,4547
Sanovia,F,100,45,0,45
Dywan,M,100,0,25,25
Kiyen,M,100,0,35,35
Ryuichi,M,100,0,11,11
Janeida,F,100,5,0,5
Sofiagrace,F,100,17,0,17
Kolten,M,100,0,3678,3678
Taviona,F,100,22,0,22
Yulander,F,100,10,0,10
Princemichael,M,100,0,15,15
Lashaon,F,100,6,0,6
Inaki,M,100,0,153,153
Steveland,M,100,0,21,21
Erikson,M,100,0,237,237
Jaquoia,F,100,11,0,11
Dioselin,F,100,31,0,31
Breeaunna,F,100,5,0,5
Constantina,F,100,512,0,512
Shekerra,F,100,7,0,7
Amarrah,F,100,65,0,65
Tyzell,M,100,0,7,7
Cadi,F,100,232,0,232
Granite,M,100,0,67,67
Ceren,F,100,52,0,52
Markeria,F,100,88,0,88
Kaydience,F,100,31,0,31
Gaije,M,100,0,14,14
Marquietta,F,100,12,0,12
Shadaya,F,100,123,0,123
Wynn,M,71,589,1424,2013
Nytrell,M,100,0,5,5
Pang,F,98,615,11,626
Chrislynn,F,100,266,0,266
Palestine,F,100,20,0,20
Rhayne,F,100,70,0,70
Brashawn,M,100,0,34,34
Rinnah,F,100,85,0,85
Ailine,F,100,82,0,82
Dianita,F,100,5,0,5
Jaquinn,M,100,0,40,40
Miles,M,100,173,58044,58217
Olajumoke,F,100,23,0,23
Jermil,M,100,0,12,12
Karole,F,100,582,0,582
Chinonye,F,100,11,0,11
Heartlynn,F,100,10,0,10
Delfred,M,100,0,22,22
Abhirup,M,100,0,10,10
Coryne,F,100,11,0,11
Marcea,F,100,209,0,209
Anjelyn,F,100,5,0,5
Eunise,F,100,34,0,34
Dzenan,M,100,0,13,13
Brytanie,F,100,7,0,7
Yusmeri,F,100,5,0,5
Nashyla,F,100,5,0,5
Norbu,M,100,0,6,6
Zaavan,M,100,0,16,16
Laval,M,100,0,166,166
Braylynne,F,100,8,0,8
Sharrah,F,100,21,0,21
Lakeeva,F,100,13,0,13
Shaterika,F,100,52,0,52
Jaquella,F,100,17,0,17
Maruf,M,100,0,6,6
Genae,F,100,292,0,292
Amita,F,100,441,0,441
Aleeah,F,100,978,0,978
Annabellah,F,100,5,0,5
Necko,M,100,0,5,5
Ashtan,F,55,119,96,215
Elynna,F,100,5,0,5
Raeshon,M,100,0,48,48
Kahtai,M,100,0,5,5
Mekell,M,100,0,30,30
Decorion,M,100,0,55,55
Raschel,F,100,51,0,51
Kayl,M,89,24,193,217
Fallon,F,96,8162,315,8477
Romano,M,100,0,267,267
Tradarius,M,100,0,119,119
Ellissa,F,100,476,0,476
Ayat,F,100,562,0,562
Nahlah,F,100,15,0,15
Arletha,F,100,839,0,839
Leatha,F,100,1758,0,1758
Kaisa,F,100,518,0,518
Jeriann,F,100,237,0,237
Nassir,M,100,0,546,546
Vernetta,F,100,1518,0,1518
Najya,F,100,16,0,16
Thekla,F,100,11,0,11
Brenika,F,100,5,0,5
Folasade,F,100,330,0,330
Tammila,F,100,5,0,5
Evelisse,F,100,56,0,56
Kyelee,F,100,25,0,25
Jovin,M,100,0,110,110
Cashton,M,100,0,922,922
Haruna,F,100,72,0,72
Aloha,F,100,184,0,184
Galia,F,100,277,0,277
Sharitha,F,100,12,0,12
Kaleeah,F,100,70,0,70
Jarena,F,100,7,0,7
Jonus,M,100,0,186,186
Kamrynn,F,97,538,19,557
Caycen,M,100,0,22,22
Taquasha,F,100,45,0,45
Kenzey,F,100,150,0,150
Jabdiel,M,100,0,17,17
Kyreek,M,100,0,7,7
Kamorah,F,100,250,0,250
Lech,M,100,0,5,5
Savannha,F,100,193,0,193
Jayhden,M,100,0,5,5
Hazael,M,100,0,359,359
Aziel,M,99,5,518,523
Taylre,F,100,60,0,60
Zellah,F,100,5,0,5
Shing,F,50,5,5,10
Chasitie,F,100,274,0,274
Anthony,M,99,6124,1200977,1207101
Edrena,F,100,33,0,33
Gauri,F,100,417,0,417
Pawel,M,100,0,441,441
Daviona,F,100,240,0,240
Lyndzy,F,100,6,0,6
Ileanna,F,100,266,0,266
Shaquez,M,85,5,28,33
Ein,M,100,0,194,194
Khamisi,M,100,0,5,5
Ladarius,M,100,0,4122,4122
Jaylynne,F,100,318,0,318
Dacen,M,100,0,60,60
Shanaria,F,100,39,0,39
Ayani,F,100,244,0,244
Ceianna,F,100,5,0,5
Dacarri,M,100,0,18,18
Kaesyn,M,79,24,93,117
Jerri,F,98,13682,247,13929
Jadlyn,F,100,55,0,55
Eeman,F,100,6,0,6
Alilyana,F,100,22,0,22
Kypton,M,100,0,122,122
Kemaury,M,100,0,51,51
Aliani,F,100,71,0,71
Rondel,M,100,0,317,317
Makda,F,100,50,0,50
Arely,F,100,8135,0,8135
Juliuz,M,100,0,10,10
Aafreen,F,100,5,0,5
Jarico,M,100,0,5,5
Ireyanna,F,100,6,0,6
Jacier,M,100,0,47,47
Khawlah,F,100,5,0,5
Shere,F,100,242,0,242
Catch,M,100,0,18,18
Decarri,M,100,0,6,6
Gaelen,M,90,18,156,174
Morice,M,100,0,20,20
Kirpa,F,100,25,0,25
Fateemah,F,100,5,0,5
Rodneisha,F,100,174,0,174
Makih,M,100,0,77,77
Jolicia,F,100,62,0,62
Elona,F,100,718,0,718
Keno,M,100,0,512,512
Keysa,F,100,54,0,54
Sherris,F,100,5,0,5
Elanah,F,100,68,0,68
Toyana,F,100,5,0,5
Josclyn,F,100,56,0,56
Robere,M,100,0,5,5
Merli,F,100,19,0,19
Romir,M,100,0,123,123
Britiny,F,100,66,0,66
Adalinn,F,100,18,0,18
Cameca,F,100,6,0,6
Lian,F,50,684,671,1355
Preslei,F,100,74,0,74
Sharikka,F,100,5,0,5
Lilit,F,100,260,0,260
Lucciano,M,100,0,210,210
Brohdy,M,100,0,5,5
Zuriana,F,100,6,0,6
Patriece,F,100,85,0,85
Felicitas,F,100,765,0,765
Gard,M,100,0,10,10
Tiari,F,100,56,0,56
Vlora,F,100,44,0,44
Alora,F,100,3608,0,3608
Marleny,F,100,1062,0,1062
Shanana,F,100,12,0,12
Nygee,M,100,0,10,10
Delinia,F,100,7,0,7
Aryaan,M,100,0,103,103
Librada,F,100,150,0,150
Gericho,M,100,0,6,6
Lomar,M,100,0,17,17
Yanesha,F,100,7,0,7
Dhrithi,F,100,30,0,30
Elleri,F,100,17,0,17
Jvier,M,100,0,5,5
Tuan,M,100,0,1372,1372
Yifan,M,88,5,36,41
Chelsealynn,F,100,5,0,5
Claude,M,99,232,24661,24893
Ulric,M,100,0,258,258
Emerii,F,100,6,0,6
Shene,F,100,92,0,92
Melissa,F,100,743750,2491,746241
Tomeica,F,100,9,0,9
Honestii,F,100,30,0,30
Tyjai,M,54,77,92,169
Yoandy,M,100,0,34,34
Any,F,100,615,0,615
Jadayah,F,100,23,0,23
Srikar,M,100,0,455,455
Rayneisha,F,100,139,0,139
Annaluiza,F,100,16,0,16
Phyllistine,F,100,72,0,72
Semir,M,100,0,174,174
Etolia,F,100,5,0,5
Zayleen,F,100,6,0,6
Micquel,M,100,0,5,5
Shalease,F,100,16,0,16
Yunes,M,100,0,10,10
Mrinalini,F,100,5,0,5
Puneet,M,51,155,160,315
Claybon,M,100,0,22,22
Virl,M,100,0,6,6
Kaislee,F,100,48,0,48
Thecla,F,100,34,0,34
Eldean,M,59,12,17,29
Aliaha,F,100,29,0,29
Manpreet,F,62,338,203,541
Reeba,F,100,11,0,11
Gulian,M,100,0,10,10
Nashonda,F,100,76,0,76
Darmesha,F,100,10,0,10
Laqueena,F,100,149,0,149
Ladislado,M,100,0,6,6
Darrall,M,100,0,179,179
Lakeita,F,100,292,0,292
Aaradhya,F,100,222,0,222
Jaretzi,F,100,171,0,171
December,F,100,1254,0,1254
Karlene,F,100,2837,0,2837
Jaricka,F,100,5,0,5
Hamadi,M,100,0,46,46
Brahim,M,100,0,63,63
Jakelyne,F,100,21,0,21
Alveta,F,100,67,0,67
Devetta,F,100,69,0,69
Milee,F,100,364,0,364
Sharn,M,53,23,26,49
Ronya,F,100,261,0,261
Chalice,F,100,254,0,254
Anasa,F,100,13,0,13
Mohnish,M,100,0,40,40
Russia,F,100,93,0,93
Channie,F,100,96,0,96
Azalynn,F,100,50,0,50
Vivia,F,100,148,0,148
Abrahm,M,100,0,599,599
Cristion,M,100,0,43,43
Laraye,F,100,5,0,5
Ramson,M,100,0,5,5
Cranston,M,100,0,259,259
Kensleigh,F,100,274,0,274
Kio,M,100,0,5,5
Shaena,F,100,534,0,534
Gianlucas,M,100,0,66,66
Heily,F,100,479,0,479
Jaymar,M,100,0,386,386
Chisty,F,100,5,0,5
Marshayla,F,100,193,0,193
Eirene,F,100,111,0,111
Jahri,M,100,0,54,54
Cashtin,M,100,0,5,5
Jenavecia,F,100,45,0,45
Matteson,F,92,110,10,120
Mitali,F,100,117,0,117
Thy,F,100,345,0,345
Lucille,F,100,27254,22,27276
Elisiah,M,100,0,27,27
Dorwin,M,100,0,37,37
Itzely,F,100,5,0,5
Denyia,F,100,11,0,11
Damera,F,100,5,0,5
Emmasofia,F,100,16,0,16
Maeva,F,100,295,0,295
Lenora,F,100,12031,0,12031
Dorell,M,100,0,136,136
Shawnika,F,100,158,0,158
Jabahri,M,100,0,9,9
Jovia,F,100,26,0,26
Naser,M,100,0,331,331
Meleesa,F,100,5,0,5
Sujan,M,100,0,24,24
Everleigh,F,100,1247,0,1247
Bilma,F,100,45,0,45
Rakib,M,100,0,6,6
Madex,M,100,0,56,56
Emillee,F,100,89,0,89
Lanikai,F,100,16,0,16
Symphanie,F,100,73,0,73
Fynlee,F,100,109,0,109
Josette,F,100,5261,0,5261
Piney,F,100,6,0,6
Zoegrace,F,100,11,0,11
Analyse,F,100,573,0,573
Mazell,F,100,17,0,17
Kaliah,F,100,1451,0,1451
Andriah,F,100,15,0,15
Cable,M,100,0,127,127
Deondrae,M,100,0,243,243
Tameria,F,100,675,0,675
Akila,F,100,569,0,569
Mccartney,F,70,212,92,304
Jeronimo,M,100,0,1408,1408
Shaunelle,F,100,31,0,31
Mosese,M,100,0,42,42
Donnaven,M,100,0,16,16
Agila,F,100,11,0,11
Bascom,M,100,0,53,53
Quisean,M,100,0,6,6
Kenyata,F,73,820,301,1121
Claudya,F,100,5,0,5
Doll,F,100,63,0,63
Rubie,F,100,1178,0,1178
Claudel,M,100,0,33,33
Daniella,F,100,25122,6,25128
Hananiah,F,62,29,18,47
Rahwa,F,100,29,0,29
Gardina,F,100,5,0,5
Darrellyn,F,100,5,0,5
Geraldina,F,100,85,0,85
Gaurav,M,100,0,661,661
Shalia,F,100,546,0,546
Shaefer,M,100,0,7,7
Chirsty,F,100,85,0,85
Shakye,M,100,0,5,5
Edgel,M,100,0,16,16
Abilynn,F,100,6,0,6
Ahnah,F,100,5,0,5
Neco,M,81,38,164,202
Shahryar,M,100,0,10,10
Dejhon,M,100,0,18,18
Fin,M,100,0,85,85
Teremy,M,100,0,5,5
Rejoice,F,100,86,0,86
Dhivya,F,100,10,0,10
Sequena,F,100,29,0,29
Lili,F,100,3067,0,3067
Aldan,M,100,0,160,160
Collie,M,88,45,315,360
Rotha,M,100,0,6,6
Akiles,M,100,0,38,38
Jaisal,M,100,0,6,6
Sundos,F,100,5,0,5
Adaysia,F,100,22,0,22
Wylde,M,100,0,5,5
Jester,M,100,0,27,27
Bryson,M,100,214,46383,46597
Tyjanay,F,100,6,0,6
Dmyah,F,100,10,0,10
Axell,M,100,0,300,300
Rinesha,F,100,5,0,5
Macarena,F,100,118,0,118
Kitsia,F,100,6,0,6
Leaunna,F,100,10,0,10
Marquea,F,100,15,0,15
Arbay,F,100,10,0,10
Lamark,M,100,0,490,490
Akram,M,100,0,762,762
Katyana,F,100,64,0,64
Yaksh,M,100,0,7,7
Damare,M,100,0,113,113
Allayah,F,100,260,0,260
Graiden,M,100,0,74,74
Ivion,M,100,0,16,16
Shakisha,F,100,234,0,234
Hugh,M,100,34,26519,26553
Lawander,F,100,12,0,12
Lazerick,M,100,0,39,39
Jacorion,M,100,0,108,108
Sumaya,F,100,1255,0,1255
Sumanth,M,100,0,30,30
Aqila,F,100,12,0,12
Macade,M,100,0,40,40
Shannika,F,100,42,0,42
Decarter,M,100,0,6,6
Admiral,M,100,0,36,36
Kalyana,F,100,39,0,39
Antaeus,M,100,0,70,70
Ido,M,100,0,107,107
Jaleeah,F,100,96,0,96
Ladaris,M,100,0,19,19
Lyssa,F,100,1401,0,1401
Abdulazeez,M,100,0,25,25
Kyller,M,100,0,10,10
Jakarion,M,100,0,27,27
Maudine,F,100,101,0,101
Nafi,M,100,0,38,38
Akeen,M,100,0,226,226
Aneshia,F,100,377,0,377
Anahis,F,100,187,0,187
Abira,F,100,10,0,10
Janesse,F,100,20,0,20
Skyland,M,100,0,18,18
Danniell,F,100,122,0,122
Andreca,F,100,5,0,5
Dusharme,F,100,5,0,5
Kedarian,M,100,0,5,5
Breeana,F,100,1678,0,1678
Sabrin,F,100,188,0,188
Antvan,M,100,0,7,7
Yisrael,M,100,0,800,800
Theral,M,100,0,5,5
Raekwon,M,100,6,2119,2125
Kywon,M,100,0,28,28
Dixon,M,100,0,1659,1659
Zymire,M,100,0,94,94
Mynia,F,100,13,0,13
Michille,F,100,132,0,132
Raiah,F,100,45,0,45
Johnnay,F,100,85,0,85
Baer,M,100,0,64,64
Montae,M,100,0,539,539
Astara,F,100,25,0,25
Virginia,F,100,157264,473,157737
Shadyn,F,55,6,5,11
Kolyn,M,100,0,169,169
Ismeralda,F,100,15,0,15
Epimenio,M,100,0,47,47
Marvene,F,100,112,0,112
Latrea,F,100,10,0,10
Cranford,M,100,0,16,16
Ronnee,F,100,10,0,10
Cage,M,100,0,782,782
Latedra,F,100,31,0,31
Lavren,F,100,396,0,396
Docia,F,100,100,0,100
Jaason,M,100,0,22,22
Lasheena,F,100,478,0,478
Severiano,M,100,0,505,505
Teagun,M,100,0,54,54
Sande,F,92,182,16,198
Katelina,F,100,16,0,16
Tamieka,F,100,643,0,643
Earic,M,100,0,11,11
Keionna,F,100,626,0,626
Dalayni,F,100,11,0,11
Lauden,M,100,0,10,10
Penda,F,100,61,0,61
Marleene,F,100,10,0,10
Almee,F,100,134,0,134
Mathai,M,57,10,13,23
Semeka,F,100,26,0,26
Dainelle,F,100,67,0,67
Quantasia,F,100,119,0,119
Calypso,F,100,167,0,167
Jhancarlos,M,100,0,15,15
Azariana,F,100,6,0,6
Mililani,F,100,20,0,20
Tyion,M,100,0,261,261
Bethenny,F,100,79,0,79
Minka,F,100,240,0,240
Daleigh,F,100,44,0,44
Brittinie,F,100,69,0,69
Juancarlos,M,100,0,3417,3417
Rossetta,F,100,10,0,10
Breckan,M,100,0,104,104
Braxson,M,100,0,41,41
Jamarques,M,100,0,90,90
Joydan,F,100,80,0,80
Jaseena,F,100,11,0,11
Makenley,F,100,170,0,170
Jamieann,F,100,42,0,42
Unnamed,M,57,243,326,569
Paulett,F,100,298,0,298
Brenea,F,100,10,0,10
Zaviar,M,100,0,19,19
Sahai,F,100,5,0,5
Pennee,F,100,24,0,24
Yarazet,F,100,5,0,5
Jayceeon,M,100,0,15,15
Breyauna,F,100,10,0,10
Yaileny,F,100,8,0,8
Abrian,M,98,5,263,268
Amanuel,M,100,0,381,381
Nithilan,M,100,0,35,35
Jaymeir,M,100,0,11,11
Jiah,F,100,85,0,85
Wyler,M,100,0,20,20
Lonnel,M,100,0,70,70
Freddye,F,100,5,0,5
Maezie,F,100,45,0,45
Ciersten,F,100,6,0,6
Yoleth,F,100,8,0,8
Keean,M,100,0,305,305
Gesele,F,100,6,0,6
Uday,M,100,0,159,159
Lavatrice,F,100,7,0,7
Maud,F,100,292,0,292
Joahan,M,100,0,143,143
Baye,F,100,47,0,47
Javareon,M,100,0,5,5
Yeng,M,81,98,426,524
Cora,F,100,34980,19,34999
Tahliah,F,100,19,0,19
Sanayah,F,100,207,0,207
Tivoli,F,100,5,0,5
Doresha,F,100,10,0,10
Danalynn,F,100,33,0,33
Milanya,F,100,53,0,53
Raelyn,F,100,6231,20,6251
Ronel,M,99,6,404,410
Azarie,F,94,80,5,85
Raffaele,M,100,0,784,784
Raayan,M,100,0,10,10
Hafsa,F,100,1274,0,1274
Aliyannah,F,100,19,0,19
Somara,F,100,90,0,90
Mckaleb,M,100,0,5,5
Jaeda,F,100,2341,0,2341
Ahlaysia,F,100,10,0,10
Freya,F,100,2669,0,2669
Tygh,M,100,0,5,5
Kensi,F,100,404,0,404
Delonzo,M,100,0,16,16
Mckinlea,F,100,6,0,6
Messina,F,100,117,0,117
Deepthi,F,100,12,0,12
Samyog,M,100,0,6,6
Phyllis,F,100,89806,193,89999
Maylen,F,100,427,0,427
Nayia,F,100,31,0,31
Cija,F,100,6,0,6
Elasha,F,100,62,0,62
Jerryl,M,96,6,129,135
Sopheya,F,100,19,0,19
Kailor,M,100,0,7,7
Najila,F,100,5,0,5
Najmo,F,100,62,0,62
Wadeeah,F,100,8,0,8
Preslee,F,98,1973,35,2008
Beyunka,F,100,5,0,5
Shanneka,F,100,5,0,5
Lonnie,M,95,2870,54146,57016
Arami,F,100,11,0,11
Terrina,F,100,420,0,420
Andrya,F,100,117,0,117
Sirine,F,100,14,0,14
Abe,M,100,0,2542,2542
Laneyah,F,100,8,0,8
Jerson,M,100,0,956,956
Dauntae,M,100,0,57,57
Jamirion,M,100,0,11,11
Jeniene,F,100,34,0,34
Aron,M,98,355,14859,15214
Akshadha,F,100,20,0,20
Hye,F,100,68,0,68
Candiss,F,100,270,0,270
Akeesha,F,100,11,0,11
Jakil,M,100,0,21,21
Lamier,M,100,0,20,20
Miabella,F,100,989,0,989
Latavea,F,100,5,0,5
Brayn,M,100,0,193,193
Nilam,F,100,76,0,76
Terrin,M,58,394,538,932
Veyron,M,100,0,10,10
Gurjot,M,96,6,153,159
Kanishk,M,100,0,104,104
Torey,M,67,1408,2795,4203
Julyan,M,100,0,290,290
Gennavive,F,100,6,0,6
Jacobo,M,100,0,2321,2321
Imahni,F,100,38,0,38
Shewana,F,100,19,0,19
Merced,M,86,69,439,508
Edrina,F,100,42,0,42
Mykhal,M,100,0,15,15
Malai,F,100,106,0,106
Shontina,F,100,47,0,47
Tayloranne,F,100,79,0,79
Arkeria,F,100,12,0,12
Alainna,F,100,590,0,590
Kehly,F,100,21,0,21
Jasonanthony,M,100,0,5,5
Shelbe,F,100,336,0,336
Aleyse,F,100,11,0,11
Lucila,F,100,1781,0,1781
Blakelee,F,95,376,18,394
Huber,M,100,0,175,175
Jenavy,F,100,10,0,10
Chavi,F,100,41,0,41
Lydale,M,100,0,5,5
Cubby,M,100,0,34,34
Jarrid,M,100,0,1193,1193
Nubia,F,100,1873,0,1873
Akaylah,F,100,156,0,156
Baker,M,96,41,1045,1086
Gautham,M,100,0,278,278
Thaxton,M,100,0,92,92
Maizen,M,100,0,10,10
Graziella,F,100,432,0,432
Kamuela,M,100,0,252,252
Prosper,M,100,0,118,118
Kalyx,M,100,0,11,11
Emaan,F,96,644,27,671
Roshanna,F,100,167,0,167
Yosemite,F,100,5,0,5
Jovann,M,94,6,98,104
Morio,M,100,0,55,55
Consetta,F,100,20,0,20
Dahn,F,76,16,5,21
Charylene,F,100,5,0,5
Pantaleon,M,100,0,15,15
Jillene,F,100,593,0,593
Lawona,F,100,29,0,29
Resham,F,100,5,0,5
Malgorzata,F,100,81,0,81
Darweshi,M,100,0,8,8
Giovante,M,100,0,23,23
Nyheim,M,100,0,77,77
Everado,M,100,0,120,120
Cimone,F,100,196,0,196
Tavonta,M,100,0,12,12
Mckenize,F,100,194,0,194
Krsna,M,100,0,10,10
Airel,F,100,272,0,272
Aleiha,F,100,5,0,5
Alezay,F,100,37,0,37
Devar,M,100,0,20,20
Yeraldi,F,100,157,0,157
Hennie,F,100,22,0,22
Derianna,F,100,38,0,38
Nisarg,M,100,0,10,10
Junpei,M,100,0,6,6
Zulma,F,100,1586,0,1586
Setayesh,F,100,17,0,17
Priest,M,100,0,279,279
Hanford,M,100,0,35,35
Dakwan,M,100,0,82,82
Jernei,F,100,15,0,15
Tihani,F,100,24,0,24
Tomomi,F,100,50,0,50
Myndee,F,100,21,0,21
Lavonne,F,98,5762,106,5868
Seidi,F,100,17,0,17
Jessenya,F,100,140,0,140
Melchizedek,M,100,0,254,254
Kamorra,F,100,35,0,35
Sarem,F,100,15,0,15
Jmyra,F,100,5,0,5
Corinthia,F,100,1006,0,1006
Cecelie,F,100,31,0,31
Ansar,M,100,0,64,64
Shahera,F,100,18,0,18
Hadiya,F,100,615,0,615
Conard,M,100,0,155,155
Aneris,F,100,7,0,7
Alliah,F,100,496,0,496
Leland,M,99,202,23886,24088
Andreniki,F,100,14,0,14
Thony,M,100,0,5,5
Ellynn,F,100,5,0,5
Dasaan,M,100,0,6,6
Yacob,M,100,0,108,108
Faviola,F,100,1936,0,1936
Mariaclara,F,100,171,0,171
Hany,M,88,5,37,42
Meleena,F,100,178,0,178
Timetrius,M,100,0,5,5
Aban,M,100,0,16,16
Keitaro,M,100,0,30,30
Vivika,F,100,146,0,146
Deveraux,M,100,0,6,6
Elpidio,M,100,0,559,559
Arnett,M,92,48,531,579
Frenesi,F,100,8,0,8
Jole,F,91,53,5,58
Dalonna,F,100,5,0,5
Jiyah,F,100,165,0,165
Falan,F,100,137,0,137
Mayrely,F,100,5,0,5
Patty,F,100,38126,59,38185
Jamaiya,F,100,259,0,259
Darnee,M,100,0,5,5
Kanard,M,100,0,44,44
Janeiro,M,100,0,6,6
Anza,F,100,10,0,10
Hezekiah,M,100,5,4240,4245
Dzeneta,F,100,5,0,5
Alhanouf,F,100,10,0,10
Zarmina,F,100,6,0,6
Zaliya,F,100,24,0,24
Shakeya,F,100,718,0,718
Andreas,M,99,49,6666,6715
Lisamaria,F,100,17,0,17
Evanjames,M,100,0,5,5
Angelik,F,100,185,0,185
Sharneka,F,100,13,0,13
Michelleann,F,100,44,0,44
Nerva,F,100,5,0,5
Tynishia,F,100,36,0,36
Hannahjo,F,100,6,0,6
Teylor,F,88,327,45,372
Zollie,M,94,11,167,178
Julep,F,100,5,0,5
Shazil,M,100,0,24,24
Gloriana,F,100,471,0,471
Julye,F,100,23,0,23
Orysia,F,100,11,0,11
Makeena,F,100,36,0,36
Vernesha,F,100,104,0,104
Duchess,F,100,107,0,107
Kaiyanna,F,100,11,0,11
Rozlynn,F,100,418,0,418
Yvana,F,100,60,0,60
Samaah,F,100,5,0,5
Jearl,M,97,5,164,169
Arnesh,M,100,0,22,22
Waldemar,M,100,0,513,513
Ayesha,F,100,4961,0,4961
Jazmyn,F,100,8123,0,8123
Rosmery,F,100,230,0,230
Ludwin,M,100,0,148,148
Pammela,F,100,6,0,6
Miasia,F,100,478,0,478
Eyvan,M,100,0,5,5
Yekusiel,M,100,0,36,36
Francoise,F,100,455,0,455
Kameria,F,100,99,0,99
Mira,F,100,6980,5,6985
Terald,M,100,0,55,55
Cuitlahuac,M,100,0,22,22
Kener,M,100,0,42,42
Gracy,F,100,985,0,985
Lazarick,M,100,0,12,12
Ijanay,F,100,12,0,12
Doralee,F,100,187,0,187
Mumtas,F,100,6,0,6
Rileyanne,F,100,24,0,24
Rosezina,F,100,12,0,12
Coleone,M,100,0,5,5
Luck,M,100,0,5,5
Zymira,F,100,37,0,37
Sinue,M,100,0,10,10
Tykell,M,100,0,33,33
Olyver,M,100,0,72,72
Monse,F,100,27,0,27
Carrion,M,100,0,5,5
Dauson,M,100,0,36,36
Shauntoria,F,100,5,0,5
Kaytlan,F,100,87,0,87
Leshunda,F,100,15,0,15
Aynslie,F,100,33,0,33
Vignesh,M,100,0,246,246
Angelleah,F,100,11,0,11
Munisa,F,100,12,0,12
Vickie,F,100,98958,325,99283
Zoria,F,100,325,0,325
Tionah,F,100,5,0,5
Radi,M,100,0,6,6
Mykaylah,F,100,92,0,92
Tenzing,M,77,16,54,70
Destini,F,100,7298,0,7298
Shemeeka,F,100,59,0,59
Ammanuel,M,100,0,38,38
Radiance,F,100,212,0,212
Rusell,M,100,0,50,50
Shinee,F,100,5,0,5
Tayjuan,M,100,0,10,10
Valeria,F,100,52536,105,52641
Shacoria,F,100,170,0,170
Tayem,M,100,0,14,14
Bettie,F,100,4881,5,4886
Adaline,F,100,1721,0,1721
Ornie,M,100,0,5,5
Janyi,F,100,6,0,6
Masami,F,100,5,0,5
Miricale,F,100,6,0,6
Romanda,F,100,106,0,106
Kadra,F,100,82,0,82
Dayanari,F,100,15,0,15
Shellane,F,100,28,0,28
Knya,F,100,49,0,49
Jacquette,F,100,158,0,158
Amalio,M,100,0,131,131
Syaira,F,100,5,0,5
Davide,M,100,0,744,744
Shanii,F,100,5,0,5
Arvel,M,100,0,400,400
Rickey,M,99,511,56739,57250
Jimm,M,100,0,22,22
Donnovan,M,100,0,495,495
Harlym,F,79,60,16,76
Ayleen,F,100,3782,0,3782
Tatiyanna,F,100,483,0,483
Coray,M,100,0,54,54
Terranc,M,100,0,6,6
Lilias,F,100,5,0,5
Loid,M,100,0,5,5
Jazilynn,F,100,12,0,12
Mozella,F,100,336,0,336
Kristabelle,F,100,24,0,24
Sheryll,F,100,1134,0,1134
Briggette,F,100,184,0,184
Kamareon,M,100,0,61,61
Zaveion,M,100,0,54,54
Davaeh,F,100,20,0,20
Rheuben,M,100,0,5,5
Pia,F,100,2552,0,2552
Lilliana,F,100,12366,0,12366
Ramaj,M,100,0,81,81
Maks,M,100,0,180,180
Tresure,F,100,54,0,54
Soterios,M,100,0,5,5
Cyrilla,F,100,46,0,46
Fredi,M,96,34,815,849
Cedra,F,100,75,0,75
Keondrea,F,100,5,0,5
Sharitta,F,100,54,0,54
Annastin,F,100,21,0,21
Amma,F,100,214,0,214
Sully,M,59,292,412,704
Ellizabeth,F,100,98,0,98
Nastia,F,100,5,0,5
Yarisbel,F,100,75,0,75
Tiamara,F,100,17,0,17
Simone,F,98,22347,403,22750
Shukri,F,91,156,15,171
Balin,M,100,0,378,378
Vylet,F,100,41,0,41
Garbriel,M,100,0,31,31
Keylli,F,100,12,0,12
Rushabh,M,100,0,49,49
Mahrukh,F,100,72,0,72
Ayane,F,100,210,0,210
Elysia,F,100,3405,7,3412
Lakeidra,F,100,152,0,152
Kendell,M,70,1767,4164,5931
Jeananne,F,100,266,0,266
Rodert,M,100,0,37,37
Conall,M,100,0,437,437
Sherye,F,100,37,0,37
Manreet,F,100,85,0,85
Endia,F,100,1070,0,1070
Ramond,M,100,0,1085,1085
Dayjon,M,100,0,37,37
Germain,M,95,42,782,824
Terita,F,100,96,0,96
Johara,F,100,54,0,54
Gwenyth,F,100,2129,0,2129
Mata,F,100,39,0,39
Lynnanne,F,100,35,0,35
Sakariye,M,100,0,37,37
Dejavion,M,100,0,5,5
Aujanae,F,100,188,0,188
Jereme,M,100,0,2202,2202
Shionna,F,100,11,0,11
Danique,F,100,123,0,123
Jeneine,F,100,5,0,5
Lavondia,F,100,5,0,5
Leiliana,F,100,83,0,83
Analeiah,F,100,12,0,12
Destri,F,84,26,5,31
Trintiy,F,100,12,0,12
Monna,F,100,379,0,379
Adidas,M,100,0,16,16
Modou,M,100,0,50,50
Oluwademilade,M,64,61,110,171
Kobina,M,100,0,12,12
Sterlin,M,100,0,499,499
Reiter,M,100,0,12,12
Kasiah,F,100,188,0,188
Lyndzie,F,100,138,0,138
Jahidi,M,100,0,5,5
Helaman,M,100,0,170,170
Edricka,F,100,11,0,11
Cailie,F,100,199,0,199
Tomatra,M,100,0,6,6
Kleah,F,100,16,0,16
Prissy,F,100,28,0,28
Iskander,M,100,0,30,30
Kine,F,100,8,0,8
Alexxa,F,100,608,0,608
Monday,F,100,30,0,30
Sanela,F,100,77,0,77
Shaquanna,F,100,873,0,873
Krishaun,M,87,6,41,47
Teygan,F,64,27,15,42
Dailany,F,100,7,0,7
Brynn,F,98,19163,319,19482
Ishmeet,F,100,5,0,5
Jerzee,F,100,258,0,258
Carlye,F,100,1050,0,1050
Hasaun,M,100,0,11,11
Amyliah,F,100,6,0,6
Canek,M,100,0,12,12
Paytin,F,93,457,36,493
Salama,F,100,12,0,12
Giorgina,F,100,26,0,26
Persephanie,F,100,103,0,103
Stevy,F,87,33,5,38
Ileta,F,100,11,0,11
Jceion,M,100,0,19,19
Angelluis,M,100,0,22,22
Noehmi,F,100,28,0,28
Idamae,F,100,34,0,34
Chelcee,F,100,238,0,238
Alessi,F,100,20,0,20
Adrihana,F,100,5,0,5
Miabelle,F,100,27,0,27
Jhayce,M,100,0,12,12
Lazhane,F,100,5,0,5
Brieonna,F,100,154,0,154
Shellena,F,100,52,0,52
Blancaestela,F,100,5,0,5
Varion,M,100,0,7,7
Monasia,F,100,137,0,137
Callahan,M,67,394,812,1206
Taea,F,100,52,0,52
Viraat,M,100,0,47,47
Manon,F,99,667,5,672
Kallyn,F,100,315,0,315
Aten,M,100,0,5,5
Mihael,M,100,0,22,22
Akir,M,100,0,48,48
Jaesean,M,100,0,123,123
Shantelle,F,100,2636,0,2636
Chamira,F,100,27,0,27
Osric,M,100,0,89,89
Eyvonne,F,100,457,0,457
Xiamara,F,100,69,0,69
Josephjohn,M,100,0,5,5
Mesha,F,100,1183,0,1183
Lonn,M,100,0,345,345
Shemya,F,100,33,0,33
Mylaa,F,100,5,0,5
Luisarmando,M,100,0,5,5
Rahsheed,M,100,0,12,12
Marita,F,100,3028,0,3028
Tanzia,F,100,20,0,20
Leng,M,98,5,324,329
Deeken,M,100,0,5,5
Aliyha,F,100,231,0,231
Kayshia,F,100,42,0,42
Jazalyn,F,100,315,0,315
Ferren,F,100,5,0,5
Soraide,F,100,5,0,5
Tehani,F,100,419,0,419
Demitry,M,100,0,47,47
Myrra,F,100,5,0,5
Sharone,F,77,510,150,660
Chadijah,F,100,6,0,6
Petie,M,100,0,11,11
Marette,F,100,17,0,17
Delaina,F,100,1444,0,1444
Nikson,M,100,0,11,11
Kaydynce,F,100,105,0,105
Ursulla,F,100,10,0,10
Shirret,F,100,5,0,5
Jkobi,M,100,0,5,5
Srinithi,F,100,23,0,23
Kymbella,F,100,5,0,5
Natalierose,F,100,6,0,6
Kapresha,F,100,11,0,11
Quashon,M,100,0,151,151
Milahn,F,100,23,0,23
Catcher,M,100,0,143,143
Carlous,M,100,0,424,424
Daysean,M,100,0,124,124
Rd,M,100,0,5,5
Desmariah,F,100,15,0,15
Jaimar,M,100,0,21,21
Coree,F,69,376,166,542
Sherona,F,100,22,0,22
Geof,M,100,0,21,21
Cashious,M,100,0,16,16
Hartlee,F,100,116,0,116
Kinya,F,100,342,0,342
Matthew,M,100,5414,1520004,1525418
Triscilla,F,100,7,0,7
Anatoly,M,100,0,16,16
Harmon,M,99,11,1750,1761
Leeric,M,100,0,5,5
Wyndi,F,100,173,0,173
Wrenda,F,100,5,0,5
Kylese,F,100,5,0,5
Charlton,M,100,5,2733,2738
Jospeh,M,100,0,1359,1359
Kariona,F,100,5,0,5
Taivion,M,100,0,50,50
Tretha,F,100,10,0,10
Bassheva,F,100,79,0,79
Jatiana,F,100,10,0,10
Sherl,F,100,336,0,336
Akanksha,F,100,154,0,154
Kenyla,F,100,11,0,11
Evalyn,F,100,2890,0,2890
Kathina,F,100,12,0,12
Baiba,F,100,5,0,5
Valita,F,100,84,0,84
Daimien,M,100,0,123,123
Jaimarie,F,100,70,0,70
Jani,F,95,1476,79,1555
Aribella,F,100,413,0,413
Linc,M,100,0,166,166
Kameya,F,100,37,0,37
Nyjel,M,100,0,33,33
Jeral,M,98,5,255,260
Donat,M,100,0,29,29
Josephyne,F,100,43,0,43
Katsumi,F,100,5,0,5
Dardi,F,100,14,0,14
Darriah,F,100,8,0,8
Prescilla,F,100,791,0,791
Shaunn,M,100,0,76,76
Jamyria,F,100,191,0,191
Sullivan,M,91,538,5623,6161
Melinah,F,100,24,0,24
Daisjah,F,100,15,0,15
Bianna,F,100,138,0,138
Lahela,F,100,196,0,196
Gargi,F,100,96,0,96
Jesten,M,100,0,82,82
Dennard,M,100,0,148,148
Macia,F,100,15,0,15
Suvanna,F,100,11,0,11
Jesslene,F,100,5,0,5
Zed,M,100,0,219,219
Casimiro,M,100,0,566,566
Toka,F,100,34,0,34
Bethanne,F,100,1244,0,1244
Marjorie,F,100,42670,53,42723
Hajari,M,100,0,6,6
Pujan,M,100,0,42,42
Keshawnna,F,100,36,0,36
Dhiago,M,100,0,5,5
Vanson,M,100,0,20,20
Maurissa,F,100,633,0,633
Mahaylee,F,100,5,0,5
Tisean,M,100,0,13,13
Mehkai,M,100,0,104,104
Guisell,F,100,5,0,5
Kahleesi,F,100,22,0,22
Kerim,M,100,0,163,163
Dreyanna,F,100,7,0,7
Lemorris,M,100,0,5,5
Vili,M,100,0,5,5
Jaycion,M,100,0,308,308
Tysheena,F,100,99,0,99
Rayonah,F,100,5,0,5
Anneliz,F,100,20,0,20
Zakirah,F,100,186,0,186
Desseray,F,100,10,0,10
Nizhoni,F,100,562,0,562
Egla,F,100,6,0,6
Arieyana,F,100,53,0,53
Esmael,M,100,0,27,27
Nemo,M,100,0,29,29
Laurabelle,F,100,5,0,5
Missael,M,100,0,394,394
Easten,M,100,0,300,300
Thurgood,M,100,0,5,5
Tailer,F,95,193,10,203
Joedon,M,100,0,6,6
Remedy,F,97,149,5,154
Neleh,F,100,110,0,110
Jeremyiah,M,100,0,11,11
Kaarina,F,100,17,0,17
Tayte,M,79,96,372,468
Kendel,F,51,772,748,1520
Sherrene,F,100,5,0,5
Shunteria,F,100,22,0,22
Jazaniah,F,100,5,0,5
Bethanny,F,100,215,0,215
Allyzon,F,100,45,0,45
Dalia,F,100,10622,6,10628
Donika,F,100,402,0,402
Cordero,M,99,9,1657,1666
Damine,M,100,0,40,40
Daril,M,100,0,103,103
Anasia,F,100,813,0,813
Kasondra,F,100,874,0,874
Desriee,F,100,5,0,5
Jayleena,F,100,61,0,61
Jawaher,F,100,15,0,15
Prabhnoor,F,54,20,17,37
Jaterious,M,100,0,5,5
Zachai,M,100,0,12,12
Joleesa,F,100,29,0,29
Dajee,F,100,10,0,10
Damaiya,F,100,27,0,27
Nokomis,F,100,35,0,35
Ahaziah,M,100,0,5,5
Leyver,M,100,0,7,7
Midge,F,100,445,0,445
Taniha,F,100,6,0,6
Javiair,M,100,0,5,5
Delandre,M,100,0,5,5
Katherline,F,100,6,0,6
Maher,M,100,0,755,755
Yaris,F,100,82,0,82
Jaccob,M,100,0,573,573
Aunalee,F,100,28,0,28
Lanor,F,100,8,0,8
Fayza,F,100,11,0,11
Shaianna,F,100,45,0,45
Bille,F,100,5,0,5
Jaie,F,85,29,5,34
Ingred,F,100,18,0,18
Ronnelle,F,70,16,7,23
Timeah,F,100,5,0,5
Aleecya,F,100,5,0,5
Joniesha,F,100,17,0,17
Krysta,F,100,6476,0,6476
Jl,M,100,0,22,22
Bethzabeth,F,100,5,0,5
Jakiera,F,100,157,0,157
Pragna,F,100,42,0,42
Earlean,F,100,556,0,556
Baylian,M,100,0,7,7
Ravion,M,80,12,47,59
Kraven,M,100,0,109,109
Dakira,F,100,51,0,51
Tesslyn,F,100,38,0,38
Zannie,M,86,10,60,70
Sherlin,F,100,689,0,689
Retina,F,100,158,0,158
Nathyn,M,100,0,353,353
Annaleigh,F,100,1378,0,1378
Nadeige,F,100,19,0,19
Tahan,M,100,0,6,6
Cherod,M,100,0,6,6
Shalla,F,100,91,0,91
Breale,F,100,34,0,34
Iasha,F,100,120,0,120
Sem,M,100,0,172,172
Ameeya,F,100,5,0,5
Lyron,M,100,0,5,5
Liley,F,100,70,0,70
Farad,M,100,0,14,14
Haille,F,100,322,0,322
Dietrick,M,100,0,189,189
Valicity,F,100,17,0,17
Berwyn,M,100,0,48,48
Timmia,F,100,89,0,89
Edrei,M,100,0,73,73
Tylique,M,100,0,95,95
Elta,F,100,41,0,41
Shakila,F,100,536,0,536
Toni,F,99,86595,1283,87878
Cyriah,F,100,83,0,83
Thaliyah,F,100,45,0,45
Onnika,F,100,65,0,65
Jaren,M,95,253,4656,4909
Jewliana,F,100,15,0,15
Kondwani,M,100,0,11,11
Breeanne,F,100,344,0,344
Blythe,F,96,3656,165,3821
Reneka,F,100,142,0,142
Evion,M,100,0,12,12
Javean,M,100,0,12,12
Jasmari,F,100,16,0,16
Lizhet,F,100,5,0,5
Knoxx,M,100,0,98,98
Kaiyon,M,100,0,62,62
Courtez,M,100,0,92,92
Andriana,F,100,1617,0,1617
Condola,F,100,12,0,12
Nataniah,F,100,5,0,5
Leandros,M,100,0,5,5
Kenlee,F,97,1226,40,1266
Jakeil,M,100,0,18,18
Khadejha,F,100,7,0,7
Zarena,F,100,15,0,15
Mabinty,F,100,5,0,5
Mylen,M,100,0,72,72
Jarrold,M,100,0,23,23
Judon,M,100,0,5,5
Michalea,F,100,45,0,45
Aaron,M,99,4087,529412,533499
Leondro,M,100,0,55,55
Jalieah,F,100,5,0,5
Tyfani,F,100,7,0,7
Tiffanee,F,100,596,0,596
Elizaida,F,100,6,0,6
Brehea,F,100,5,0,5
Shameaka,F,100,48,0,48
Dantoinette,F,100,6,0,6
Makhyla,F,100,36,0,36
Nyoka,F,100,670,0,670
Ivyanna,F,100,293,0,293
Rayella,F,100,6,0,6
Kanecia,F,100,50,0,50
Caro,F,100,75,0,75
Adreyan,M,100,0,97,97
Chaylen,F,100,27,0,27
Enid,F,100,2630,0,2630
Roniah,F,100,21,0,21
Allora,F,100,313,0,313
Earl,M,99,533,78161,78694
Jazmene,F,100,94,0,94
Johntavious,M,100,0,198,198
Ederick,M,100,0,5,5
Sufia,F,100,34,0,34
Stevon,M,100,0,690,690
Chanthy,M,100,0,5,5
Fatiha,F,100,60,0,60
Dashaan,M,100,0,5,5
Jashua,M,100,0,1612,1612
Valencio,M,100,0,5,5
Wendey,F,100,7,0,7
Kolia,F,100,5,0,5
Elonte,M,100,0,11,11
Rowden,M,100,0,5,5
Eva,F,100,93560,269,93829
Shakiara,F,100,93,0,93
Oluwakorede,M,100,0,5,5
Darrilyn,F,100,51,0,51
Jassiel,M,98,5,294,299
Navneet,F,90,244,28,272
Cindell,F,100,5,0,5
Shelton,M,98,162,8197,8359
Shantha,F,100,7,0,7
Isavela,F,100,11,0,11
Aquanis,M,100,0,5,5
Kiylee,F,100,142,0,142
Deandray,M,100,0,9,9
Darryell,M,100,0,17,17
Leslei,F,100,52,0,52
Suzzanne,F,100,581,0,581
Keiliany,F,100,11,0,11
Dominee,F,100,5,0,5
Esbeidy,F,100,239,0,239
Breeannah,F,100,5,0,5
Arnaz,M,100,0,21,21
Pascuala,F,100,11,0,11
Jericko,M,100,0,12,12
Jalein,M,100,0,10,10
Liese,F,100,144,0,144
Romolo,M,100,0,32,32
Jernae,F,100,16,0,16
Mabree,F,100,23,0,23
Brena,F,100,721,0,721
Sadiel,M,100,0,47,47
Aneliese,F,100,124,0,124
Trysha,F,100,27,0,27
Alperen,M,100,0,6,6
Gordon,M,100,172,59956,60128
Arahi,F,100,5,0,5
Caliber,M,100,0,71,71
Deauntae,M,100,0,27,27
Elham,F,97,226,7,233
Brandn,M,100,0,38,38
Ziyadah,F,100,5,0,5
Tramel,M,100,0,475,475
Cace,M,100,0,58,58
Dedrek,M,100,0,5,5
Alazay,F,100,247,0,247
Jaimey,F,83,120,25,145
Lulah,F,100,16,0,16
Ranya,F,100,769,0,769
Christphor,M,100,0,261,261
Tishonna,F,100,5,0,5
Jakkob,M,100,0,5,5
Achaia,F,100,62,0,62
Roxene,F,100,56,0,56
Zakaiya,F,100,59,0,59
Hassell,M,100,0,51,51
Niel,M,100,0,840,840
Essam,M,100,0,69,69
Mitsie,F,100,5,0,5
Bernida,F,100,17,0,17
Hodaya,F,100,111,0,111
Avamonroe,F,100,5,0,5
Yahna,F,100,5,0,5
Errol,M,100,0,5601,5601
Brycie,F,100,6,0,6
Hansell,M,100,0,6,6
Sheana,F,100,623,0,623
Letty,F,100,1352,0,1352
Demond,M,100,25,5522,5547
Patrica,F,100,6592,5,6597
Jicela,F,100,5,0,5
Chynia,F,100,25,0,25
Donnia,F,100,278,0,278
Lolitta,F,100,35,0,35
Lavelle,M,82,399,1844,2243
Ebonie,F,100,2637,0,2637
Naiema,F,100,38,0,38
Mckayle,F,100,22,0,22
Gudalupe,F,81,21,5,26
Nichoals,M,100,0,74,74
Delontae,M,100,0,156,156
Madylan,F,100,40,0,40
Elisabella,F,100,51,0,51
Pierston,M,100,0,5,5
Logyn,F,54,173,150,323
Dayatra,F,100,49,0,49
Lakieshia,F,100,5,0,5
Maddyx,M,51,90,93,183
Jacoria,F,100,140,0,140
Giovanie,M,100,0,83,83
Canton,M,100,0,327,327
Galicia,F,100,5,0,5
Altay,M,100,0,19,19
Amarrion,M,100,0,108,108
Emanuelly,F,100,21,0,21
Kmarie,F,100,17,0,17
Brisia,F,100,305,0,305
Wyland,M,100,0,168,168
Tekeshia,F,100,103,0,103
Estera,F,100,84,0,84
Shauni,F,100,265,0,265
Michalla,F,100,136,0,136
Marquetta,F,100,1950,0,1950
Renesha,F,100,425,0,425
Samanvita,F,100,6,0,6
Ahlayna,F,100,12,0,12
Sophat,M,100,0,22,22
Meabh,F,100,5,0,5
Leasie,F,100,11,0,11
Tilan,M,100,0,6,6
Maebelle,F,100,54,0,54
Darlo,M,100,0,5,5
Zulema,F,100,2862,0,2862
Jaqual,M,100,0,17,17
Taliah,F,100,2269,0,2269
Atira,F,100,286,0,286
Yu,F,51,359,349,708
Kadjah,F,100,16,0,16
Jaeanna,F,100,48,0,48
Yelaina,F,100,5,0,5
Inia,F,100,7,0,7
Josbel,M,100,0,5,5
Motunrayo,F,100,21,0,21
Kat,F,100,21,0,21
Lamanuel,M,100,0,5,5
Candice,F,100,64880,155,65035
Baldo,M,100,0,58,58
Sieria,F,100,5,0,5
Ellye,F,100,12,0,12
Claretha,F,100,489,0,489
Rheanne,F,100,141,0,141
Christopoher,M,100,0,13,13
Dashai,F,100,38,0,38
Diamond,F,94,31577,1946,33523
Amerissa,F,100,5,0,5
Arlissa,F,100,68,0,68
Zaylaa,F,100,23,0,23
Elezabeth,F,100,5,0,5
Kinyatta,F,100,45,0,45
Jenave,F,100,5,0,5
Dona,F,99,7600,44,7644
Lona,F,100,3293,0,3293
Jarvis,M,99,107,14954,15061
Li,F,70,251,108,359
Jessabelle,F,100,20,0,20
Lowella,F,100,6,0,6
Yusayrah,F,100,5,0,5
Bathsheba,F,100,336,0,336
Rylah,F,100,80,0,80
Diany,F,100,60,0,60
Yusuf,M,100,0,5529,5529
Khaina,F,100,18,0,18
Ayeisha,F,100,137,0,137
Seanta,F,100,5,0,5
Eziel,M,100,0,17,17
Exavior,M,100,0,69,69
Duchein,M,100,0,7,7
Yanill,F,100,22,0,22
Kylissa,F,100,16,0,16
Kristyna,F,100,707,0,707
Meili,F,100,244,0,244
Wahaj,M,100,0,5,5
Zannah,F,100,51,0,51
Daon,M,100,0,16,16
Vimal,M,100,0,97,97
Erissa,F,100,19,0,19
Kaaron,F,100,5,0,5
Tacarra,F,100,343,0,343
Aurieona,F,100,10,0,10
Quinlee,F,100,37,0,37
Angella,F,100,3267,0,3267
Airionna,F,100,35,0,35
Courtne,F,100,81,0,81
Natalye,F,100,314,0,314
Shatarah,F,100,5,0,5
Mizael,M,100,0,382,382
Breia,F,100,386,0,386
Aarna,F,100,830,0,830
Deontai,M,100,0,49,49
Loza,F,100,33,0,33
Josephine,F,100,66159,111,66270
Issey,M,100,0,17,17
Laelle,F,100,65,0,65
Azlaan,M,100,0,24,24
Theoni,F,100,5,0,5
Monissa,F,100,5,0,5
Dmitris,M,100,0,5,5
Biyanka,F,100,5,0,5
Francies,F,100,134,0,134
Allan,M,100,157,52699,52856
Tyaisha,F,100,120,0,120
Clorine,F,100,5,0,5
Carmina,F,100,1013,0,1013
Caitlin,F,100,110413,283,110696
Tiffanyamber,F,100,38,0,38
Rossana,F,100,879,0,879
Giavanna,F,100,3482,0,3482
Jazzel,F,100,54,0,54
Sahit,M,100,0,18,18
Lakosha,F,100,12,0,12
Shamel,M,86,155,968,1123
Kristhel,F,100,6,0,6
Tenyia,F,100,7,0,7
Elzena,F,100,11,0,11
Nyara,F,100,128,0,128
Cassian,M,100,0,135,135
Cerinity,F,100,52,0,52
Tin,M,100,0,412,412
Reianna,F,100,102,0,102
Kyrone,M,100,0,20,20
Shawntal,F,100,33,0,33
Erienne,F,100,133,0,133
Kaedance,F,100,105,0,105
Klee,F,100,335,0,335
Atzhiri,F,100,27,0,27
Merima,F,100,17,0,17
Desmen,M,100,0,151,151
Johnrussell,M,100,0,7,7
Tiala,F,100,5,0,5
Atalia,F,100,438,0,438
Dynell,M,91,6,58,64
Labree,F,100,14,0,14
Cemal,M,100,0,7,7
Sueann,F,100,1668,0,1668
Adilen,F,100,54,0,54
Samariyah,F,100,66,0,66
Diaz,M,100,0,75,75
Caterin,F,100,171,0,171
Renaye,F,100,137,0,137
Sahan,M,100,0,42,42
Guage,M,100,0,102,102
Rebeccah,F,100,1553,0,1553
Daxtyn,M,100,0,107,107
Ralique,M,100,0,6,6
Harshit,M,100,0,36,36
Fatimatou,F,100,19,0,19
Jocelene,F,100,9,0,9
Zikayla,F,100,5,0,5
Mileidi,F,100,15,0,15
Xyler,M,100,0,125,125
Hemal,M,100,0,31,31
Tykira,F,100,285,0,285
Thalassa,F,100,6,0,6
Loy,M,81,256,1124,1380
Krisopher,M,100,0,5,5
Kendria,F,100,1024,0,1024
Jilleen,F,100,133,0,133
Tramelle,M,100,0,16,16
Zandur,M,100,0,5,5
Nkemjika,M,100,0,5,5
Nashrah,F,100,5,0,5
Rhome,M,100,0,10,10
Kaneidra,F,100,5,0,5
Shermar,M,100,0,93,93
Kingdom,M,100,0,48,48
Ronesia,F,100,15,0,15
Rolston,M,100,0,5,5
Satara,F,100,314,0,314
Gen,M,90,6,57,63
Tynea,F,100,17,0,17
Dari,F,95,504,26,530
Laquitia,F,100,18,0,18
Latravion,M,100,0,113,113
Sonyia,F,100,194,0,194
Shakieta,F,100,12,0,12
Whitnye,F,100,5,0,5
Branisha,F,100,47,0,47
Shekeya,F,100,6,0,6
Georgian,F,100,78,0,78
Callandra,F,100,6,0,6
Soma,F,57,52,39,91
Ortensia,F,100,21,0,21
Yairon,M,100,0,6,6
Niajah,F,100,159,0,159
Abdulmalek,M,100,0,5,5
Jasmere,F,100,24,0,24
Najm,M,100,0,28,28
Lazaria,F,100,420,0,420
Rontavious,M,100,0,163,163
Jossie,F,97,557,17,574
Hiren,M,100,0,123,123
Beno,M,100,0,5,5
Evyn,F,54,698,602,1300
Sorcha,F,100,198,0,198
Jamyron,M,100,0,91,91
Zaia,F,100,74,0,74
Aylynn,F,100,7,0,7
Torris,M,99,5,347,352
Peregrina,F,100,5,0,5
Shakiera,F,100,379,0,379
Marlenia,F,100,16,0,16
Ieshia,F,100,1650,0,1650
Rodrigus,M,100,0,50,50
Casper,M,100,0,1662,1662
Inaayah,F,100,5,0,5
Deric,M,100,0,4531,4531
Coffy,F,100,16,0,16
Bredan,M,100,0,20,20
Cayde,M,100,0,187,187
Crusoe,M,100,0,10,10
Neavah,F,100,8,0,8
Shequille,M,100,0,30,30
Ashmita,F,100,29,0,29
Meher,F,99,362,5,367
Poetry,F,100,87,0,87
Gunar,M,100,0,43,43
Chuma,M,100,0,5,5
Semora,F,100,6,0,6
Jayanne,F,100,5,0,5
Juanya,M,100,0,63,63
Daquandre,M,100,0,10,10
Jenabelle,F,100,7,0,7
Verneal,F,50,5,5,10
Yuito,M,100,0,5,5
Darold,M,100,0,1899,1899
Wyetta,F,100,22,0,22
Hailyn,F,100,323,0,323
Dalaynee,F,100,11,0,11
Orlene,F,100,52,0,52
Kevine,M,100,0,12,12
Kimwana,F,100,8,0,8
Kadee,F,100,977,0,977
Trejuan,M,100,0,62,62
Arni,F,100,7,0,7
Lasonja,F,100,452,0,452
Zaleigha,F,100,10,0,10
Ramzee,M,71,5,12,17
Shaquon,M,91,13,124,137
Alyxzander,M,100,0,10,10
Bobbye,F,99,674,5,679
Chaynce,M,100,0,35,35
Adarsh,M,100,0,483,483
Oriah,F,97,185,5,190
Camala,F,100,196,0,196
Alianne,F,100,5,0,5
Teyanah,F,100,5,0,5
Derise,F,100,15,0,15
Paule,F,100,18,0,18
Jamique,M,100,0,15,15
Francie,F,100,1207,0,1207
Nahmir,M,100,0,24,24
Anner,F,85,66,12,78
Tiffinie,F,100,304,0,304
Tobiloba,M,100,0,6,6
Deanca,F,100,6,0,6
Niobi,F,100,6,0,6
Moneke,F,100,26,0,26
Jaeceon,M,100,0,80,80
Naseer,M,100,0,334,334
Ife,F,100,181,0,181
Justinne,F,100,13,0,13
Shreya,F,100,3901,0,3901
Jamarey,M,100,0,10,10
Nalaya,F,100,252,0,252
Zaleah,F,100,134,0,134
Tacoria,F,100,24,0,24
Rahman,M,100,0,1044,1044
Anistynn,F,100,17,0,17
Taquon,M,100,0,21,21
Allonzo,M,100,0,5,5
Jaylie,F,100,682,0,682
Elinah,F,100,15,0,15
Addasyn,F,100,100,0,100
Marketta,F,100,859,0,859
Audrina,F,100,6400,0,6400
Alika,M,54,456,534,990
Norma,F,99,74665,490,75155
Zachary,M,100,1497,517541,519038
Shniya,F,100,29,0,29
Janayiah,F,100,11,0,11
Tasheona,F,100,6,0,6
Dasan,M,100,0,499,499
Brixley,F,100,14,0,14
Ladanian,M,100,0,96,96
Oyuki,F,100,152,0,152
Ahmon,M,100,0,166,166
Titiana,F,100,562,0,562
Loreana,F,100,10,0,10
Michail,M,100,0,525,525
Belize,F,100,18,0,18
Ahzaria,F,100,34,0,34
Charesse,F,100,38,0,38
Serafin,M,100,0,1238,1238
Judithann,F,100,61,0,61
Dannalyn,F,100,5,0,5
Jecory,M,100,0,38,38
Eron,M,90,134,1201,1335
Rondy,M,100,0,377,377
Ran,M,92,5,58,63
Laeken,F,100,5,0,5
Abdikadir,M,100,0,114,114
Ladarrien,M,100,0,12,12
Akhiya,F,100,5,0,5
Adedeji,M,100,0,43,43
Muneeb,M,100,0,221,221
Zauria,F,100,76,0,76
Ulis,M,100,0,17,17
Kortlin,M,100,0,10,10
Cambrya,F,100,6,0,6
Aolanis,F,100,177,0,177
Kamal,M,99,25,2484,2509
Charise,F,100,2145,0,2145
Moniquie,F,100,11,0,11
Ameilia,F,100,160,0,160
Kieshia,F,100,38,0,38
Marey,F,100,10,0,10
Marieann,F,100,113,0,113
Jarom,M,100,0,1167,1167
Adaria,F,100,98,0,98
Jocabed,F,100,166,0,166
Arbaaz,M,100,0,15,15
Skeeter,M,91,13,125,138
Violet,F,100,37340,20,37360
Kimbrly,F,100,44,0,44
Maylee,F,100,2022,0,2022
Makiyah,F,99,2483,20,2503
Shardee,F,100,51,0,51
Jakii,M,100,0,6,6
Kennidy,F,100,316,0,316
Corrina,F,100,5389,0,5389
Emonte,M,100,0,128,128
Jian,M,96,17,364,381
Morea,F,100,21,0,21
Charlene,F,100,85096,258,85354
Humphery,M,100,0,6,6
Kaeto,M,100,0,7,7
Haydn,M,82,326,1517,1843
Ralynn,F,100,160,0,160
Joci,F,100,92,0,92
Jalanda,F,100,40,0,40
Traylin,M,100,0,35,35
Seveah,F,100,6,0,6
Saadiya,F,100,61,0,61
Adebayo,M,100,0,104,104
Nichelle,F,100,5407,5,5412
Jalayah,F,100,857,0,857
Emerita,F,100,123,0,123
Tiomthy,M,100,0,5,5
Maraam,F,100,5,0,5
Alexsandra,F,100,2267,0,2267
Jahier,M,100,0,19,19
Kennecia,F,100,6,0,6
Leanetta,F,100,5,0,5
Murle,M,100,0,6,6
Jeinny,F,100,10,0,10
Enedino,M,100,0,23,23
Sidda,F,100,90,0,90
Jacora,F,100,112,0,112
Nkara,F,100,5,0,5
Dasa,F,100,10,0,10
Kheli,F,100,5,0,5
Jamarya,F,100,12,0,12
Ashlinn,F,100,282,0,282
Hanalee,F,100,5,0,5
Kelbi,F,100,237,0,237
Rihan,F,60,32,21,53
Meltem,F,100,5,0,5
Mason,M,99,2561,220969,223530
Kunal,M,100,0,1200,1200
Roxton,M,100,0,5,5
Myles,M,100,124,31582,31706
Raytheon,M,100,0,5,5
Seline,F,100,261,0,261
Charlse,M,100,0,14,14
Deshawn,M,92,1183,14275,15458
Rusten,M,100,0,26,26
Greydon,M,100,0,221,221
Najeebah,F,100,15,0,15
Chynthia,F,100,5,0,5
Westlee,M,100,0,93,93
Rodaina,F,100,5,0,5
Narali,F,100,39,0,39
Malillani,F,100,7,0,7
Briggett,F,100,67,0,67
Kaydia,F,100,5,0,5
Viky,F,100,24,0,24
Kimalee,F,100,32,0,32
Laeyah,F,100,5,0,5
Mykenzee,F,100,11,0,11
Aalivia,F,100,47,0,47
Trystyn,M,70,79,185,264
Martrail,M,100,0,5,5
Edriel,M,100,0,19,19
Kenlea,F,100,72,0,72
Anatolia,F,100,6,0,6
Aaliyahmarie,F,100,22,0,22
Leeo,M,100,0,5,5
Bria,F,100,13024,55,13079
Sorin,M,97,5,140,145
Elchanan,M,100,0,46,46
Chelsi,F,100,3965,0,3965
Carmetta,F,100,15,0,15
Sidalee,F,100,19,0,19
Kyshon,M,100,0,73,73
Moishe,M,100,0,896,896
Mannie,M,98,5,307,312
Yemaya,F,100,110,0,110
Nicomedes,M,100,0,5,5
Gipsy,F,100,10,0,10
Macson,M,100,0,6,6
Pataricia,F,100,13,0,13
Prynceton,M,100,0,18,18
Jashelle,F,100,6,0,6
Reynold,M,100,0,1878,1878
Esperansa,F,100,382,0,382
Deresha,F,100,25,0,25
Reneasha,F,100,34,0,34
Waylan,M,100,0,673,673
Rainbow,F,100,397,0,397
Motez,M,100,0,5,5
Cassen,M,100,0,11,11
Tykirra,F,100,6,0,6
Kashton,M,100,0,727,727
Andreana,F,100,1749,0,1749
Mackie,M,83,94,455,549
Yaili,F,100,5,0,5
Kalayna,F,100,45,0,45
Timicka,F,100,7,0,7
Tonye,F,100,68,0,68
Brizzia,F,100,5,0,5
Sherlyne,F,100,108,0,108
Bradson,M,100,0,5,5
Ruhama,F,100,48,0,48
Enilda,F,100,6,0,6
Malquan,M,100,0,5,5
Maryury,F,100,5,0,5
Jaylynn,F,94,7161,443,7604
Chadrick,M,100,0,2324,2324
Eveana,F,100,5,0,5
Delmonta,M,100,0,5,5
Kintrell,M,100,0,5,5
Tellis,M,100,0,219,219
Latrez,M,100,0,36,36
Larine,F,100,10,0,10
Darrington,M,100,0,36,36
Aundra,M,70,366,838,1204
Kaeleigh,F,100,1220,0,1220
Ned,M,100,0,5945,5945
Donnamaria,F,100,62,0,62
Sabih,M,100,0,5,5
Tyber,M,100,0,5,5
Gabriellamarie,F,100,5,0,5
Masa,F,94,110,7,117
Elohim,M,100,0,75,75
Ronit,M,57,327,438,765
Jeniece,F,100,503,0,503
Kunta,M,97,8,303,311
Tej,M,100,0,483,483
Alonya,F,100,17,0,17
Aeson,M,100,0,234,234
Abdullah,M,100,0,5702,5702
Naiara,F,100,205,0,205
Dezyah,F,100,6,0,6
Nyeasha,F,100,21,0,21
Sridhar,M,100,0,13,13
Dalston,M,100,0,30,30
Dasiya,F,100,34,0,34
Czarina,F,100,342,0,342
Carlos,M,99,1753,254700,256453
Decia,F,100,23,0,23
Remonda,F,100,16,0,16
Ryleah,F,100,78,0,78
Cahari,M,100,0,5,5
Krystof,M,100,0,10,10
Deniah,F,100,58,0,58
Ohani,M,100,0,6,6
Kelveon,M,100,0,5,5
Fidelio,M,100,0,6,6
Elantra,F,100,123,0,123
Jullie,F,100,407,0,407
Soli,F,100,40,0,40
Anisten,F,100,103,0,103
Smita,F,100,134,0,134
Mackenze,F,100,82,0,82
Domnic,M,100,0,100,100
Siobahn,F,100,77,0,77
Mihir,M,100,0,1161,1161
Jaival,M,100,0,5,5
Teneal,F,100,39,0,39
Tamberlyn,F,100,61,0,61
Zinnia,F,100,1019,0,1019
Anaisabel,F,100,108,0,108
Jonai,F,97,147,5,152
Merisa,F,100,555,0,555
Louri,F,100,59,0,59
Khilynn,F,100,28,0,28
Dellan,M,100,0,5,5
Laurien,F,100,16,0,16
Jannike,F,100,6,0,6
Chavy,F,100,304,0,304
Sanjay,M,100,0,2254,2254
Xitlali,F,100,1726,0,1726
Sharlyn,F,100,1155,0,1155
Dajour,M,96,23,547,570
Sadique,M,100,0,5,5
Indra,F,96,615,25,640
Marshawna,F,100,31,0,31
Tunya,F,100,258,0,258
Janko,M,100,0,5,5
Jayandre,M,100,0,6,6
Alecxa,F,100,18,0,18
Ramata,F,100,103,0,103
Aleenah,F,100,196,0,196
Zlaty,F,100,118,0,118
Martese,M,100,0,227,227
Shantia,F,100,1088,0,1088
Dijonnae,F,100,19,0,19
Alizia,F,100,134,0,134
Tippany,F,100,6,0,6
Anyka,F,100,26,0,26
Envee,F,100,16,0,16
Quanae,F,100,30,0,30
Eriberto,M,100,0,2278,2278
Dallyce,F,100,32,0,32
Graysin,M,100,0,47,47
Nashai,F,100,21,0,21
Shawntina,F,100,101,0,101
Srujan,M,100,0,32,32
Alexnadra,F,100,8,0,8
Galena,F,100,100,0,100
Iori,M,100,0,69,69
Omotayo,M,62,10,16,26
Aislee,F,100,55,0,55
Chardonay,F,100,80,0,80
Dorica,F,100,5,0,5
Biron,M,100,0,6,6
Senaya,F,100,45,0,45
Mykailah,F,100,17,0,17
Michall,M,100,0,137,137
Tiffny,F,100,95,0,95
Osha,F,78,269,75,344
Jaciana,F,100,33,0,33
Dayza,F,100,26,0,26
Claudea,F,100,5,0,5
Tremal,M,100,0,5,5
Jollette,F,100,5,0,5
Ilirida,F,100,5,0,5
Kipley,M,100,0,22,22
Tehra,F,100,46,0,46
Izeah,M,100,0,266,266
Danyael,M,100,0,69,69
Devayah,F,100,5,0,5
Janaiya,F,100,493,0,493
Jaymi,F,100,1290,5,1295
Adalae,F,100,114,0,114
Grishma,F,100,28,0,28
Aladin,M,100,0,6,6
Ichael,M,100,0,390,390
Baris,M,100,0,11,11
Givon,M,100,0,30,30
Esmirna,F,100,64,0,64
Nyshawn,M,100,0,176,176
Myloh,M,100,0,6,6
Brockston,M,100,0,10,10
Glorine,F,100,11,0,11
Taurian,M,100,0,55,55
Lachic,F,100,7,0,7
Kincaid,M,100,0,322,322
Romere,M,100,0,25,25
Tison,M,100,0,169,169
Quashia,F,100,7,0,7
Omera,F,100,22,0,22
Kestyn,M,100,0,6,6
Alaetra,F,100,28,0,28
Josep,M,100,0,125,125
Tino,M,100,0,1607,1607
Kenndrick,M,100,0,12,12
Elliora,F,100,5,0,5
Kymbree,F,100,34,0,34
Tensley,F,100,112,0,112
Keishanna,F,100,20,0,20
Shiniah,F,100,5,0,5
Ioan,M,100,0,80,80
Jalissia,F,100,60,0,60
Bonique,F,100,5,0,5
Gilad,M,100,0,286,286
Brndon,M,100,0,29,29
Elisabethe,F,100,5,0,5
Cassandre,F,100,547,0,547
Chasidy,F,100,2171,0,2171
Saydee,F,100,1104,0,1104
Sharyia,F,100,5,0,5
Yi,M,58,104,146,250
Southern,F,100,17,0,17
Esabelle,F,100,30,0,30
Matthewalexande,M,100,0,11,11
Arriyah,F,100,68,0,68
Bonny,F,98,4439,83,4522
Erinmarie,F,100,15,0,15
Konstance,F,100,278,0,278
Makyra,F,100,272,0,272
Chalsea,F,100,120,0,120
Haedyn,F,64,282,158,440
Jarmel,M,100,0,179,179
Anesha,F,100,795,0,795
Lizzete,F,100,103,0,103
Joelyne,F,100,5,0,5
Adanya,F,100,135,0,135
Emalyn,F,100,925,0,925
Lynessa,F,100,89,0,89
Chonna,F,100,10,0,10
Feliks,M,100,0,20,20
Esben,M,100,0,27,27
Makalynn,F,100,127,0,127
Destaney,F,100,317,0,317
Sricharan,M,100,0,71,71
Lajessica,F,100,53,0,53
Kaelub,M,100,0,26,26
Lanyia,F,100,241,0,241
Ladavia,F,100,86,0,86
Jonice,F,100,96,0,96
Londonmarie,F,100,13,0,13
Mariaangelica,F,100,11,0,11
Rahasia,F,100,5,0,5
Anaiya,F,100,1575,0,1575
Daesy,F,100,5,0,5
Spandan,M,100,0,5,5
Markeeta,F,100,388,0,388
Tyneika,F,100,6,0,6
Xiadani,F,100,51,0,51
Ryken,M,99,5,417,422
Jaquell,M,98,5,226,231
Raeya,F,100,191,0,191
Daniele,F,83,3541,716,4257
Alfrida,F,100,29,0,29
Tamel,M,100,0,83,83
Millan,M,95,5,100,105
Chalet,F,100,70,0,70
Norrine,F,100,43,0,43
Shanden,M,100,0,39,39
Redia,F,100,43,0,43
Sheldyn,F,52,12,11,23
Jeilynn,F,100,12,0,12
Graylyn,F,84,27,5,32
Vanida,F,100,35,0,35
Britany,F,100,6230,0,6230
Boney,M,100,0,5,5
Rober,M,100,0,350,350
Maniyah,F,100,526,0,526
Shumeka,F,100,20,0,20
Nahila,F,100,10,0,10
Catherine,F,100,351517,907,352424
Icie,F,100,46,0,46
Leodis,M,100,0,212,212
Buckley,M,100,0,441,441
Cheylynn,F,100,52,0,52
Thira,F,100,5,0,5
Brailon,M,100,0,68,68
Suzanne,F,100,158207,370,158577
Dea,F,100,1360,5,1365
Addilyne,F,100,26,0,26
Heman,M,100,0,5,5
Maybree,F,100,110,0,110
Ivah,F,100,32,0,32
Keath,M,100,0,223,223
Kanedra,F,100,16,0,16
Rhon,M,100,0,36,36
Meleya,F,100,6,0,6
Nishka,F,100,342,0,342
Debanhi,F,100,403,0,403
Jocely,F,100,31,0,31
Ariadna,F,100,2133,0,2133
Raynah,F,100,190,0,190
Marangely,F,100,32,0,32
Leiby,M,100,0,39,39
Johusa,M,100,0,5,5
Arleen,F,100,5825,0,5825
Shailah,F,100,160,0,160
Dontre,M,100,0,462,462
Chakeria,F,100,10,0,10
Arlethea,F,100,11,0,11
Farrel,M,100,0,340,340
Berania,F,100,62,0,62
Larysa,F,100,155,0,155
Shiron,F,73,88,32,120
Roggie,M,100,0,10,10
Raisa,F,100,1043,0,1043
Cherrica,F,100,10,0,10
Amauris,M,100,0,63,63
Catalea,F,100,38,0,38
Ysabela,F,100,113,0,113
Angelgabriel,M,100,0,238,238
Vernisa,F,100,5,0,5
Darious,M,100,0,1419,1419
Angelyna,F,100,530,0,530
Kyleek,M,100,0,5,5
Laneta,F,100,88,0,88
Zevan,M,100,0,7,7
Ahking,M,100,0,9,9
Yeslie,F,100,27,0,27
Mui,F,100,5,0,5
Kentlee,F,65,20,11,31
Zadien,M,100,0,27,27
Marshala,F,100,24,0,24
Sanvika,F,100,43,0,43
Tranecia,F,100,15,0,15
Lusvin,M,100,0,5,5
Ellieanna,F,100,141,0,141
Tonaya,F,100,11,0,11
Teara,F,100,1254,0,1254
Lashann,F,100,93,0,93
Say,F,71,47,19,66
Sharnetta,F,100,121,0,121
Chambers,M,100,0,10,10
Remley,F,100,6,0,6
Tehilah,F,100,6,0,6
Random,M,100,0,135,135
Jamerian,M,100,0,18,18
Kurk,M,100,0,213,213
Truby,F,100,5,0,5
Benecia,F,100,25,0,25
Alahni,F,100,117,0,117
Mijoy,F,100,5,0,5
Giany,F,100,5,0,5
Ludovic,M,100,0,20,20
Ajiana,F,100,17,0,17
Teah,F,100,1329,0,1329
Allistair,M,100,0,16,16
Chericka,F,100,6,0,6
Kione,M,100,0,31,31
Andros,M,100,0,82,82
Jerrion,M,100,0,251,251
Prescious,F,100,76,0,76
Zakary,M,100,0,5182,5182
Janyiah,F,100,362,0,362
Yameli,F,100,68,0,68
Lewie,M,100,0,177,177
Kendarious,M,100,0,213,213
Keilah,F,100,1308,0,1308
Toshika,F,100,66,0,66
Theophilia,F,100,5,0,5
Yker,M,100,0,12,12
Adrianny,F,100,16,0,16
Nyriah,F,100,109,0,109
Vilena,F,100,10,0,10
Chrisaun,M,100,0,5,5
Rejoyce,F,100,7,0,7
Adalia,F,100,1316,0,1316
Modesta,F,100,612,0,612
Rosealie,F,100,36,0,36
Annelee,F,100,7,0,7
Charona,F,100,5,0,5
Bryar,M,82,233,1096,1329
Rogelio,M,100,66,21641,21707
Suma,F,100,53,0,53
Kyhiem,M,100,0,5,5
Joely,F,100,1521,0,1521
Jerel,M,100,0,3263,3263
Kojo,M,100,0,264,264
Romika,F,100,27,0,27
Chalynn,F,100,5,0,5
Deniyah,F,100,321,0,321
Shannee,F,100,5,0,5
Decarius,M,100,0,16,16
Ahlina,F,100,36,0,36
Jeannicole,F,100,5,0,5
Mumtahina,F,100,5,0,5
Distin,M,100,0,5,5
Hussien,M,100,0,248,248
Kenet,M,100,0,23,23
Kymisha,F,100,10,0,10
Arriel,F,100,310,0,310
Dany,M,90,111,1053,1164
Luisdavid,M,100,0,86,86
Genisha,F,100,34,0,34
Kinzee,F,100,187,0,187
Jennabel,F,100,5,0,5
Parmeet,M,100,0,5,5
Jermell,M,100,0,577,577
Alethia,F,100,1543,0,1543
Jru,M,100,0,12,12
Delrico,M,100,0,253,253
Tanganika,F,100,61,0,61
Scheryl,F,100,262,0,262
Magena,F,100,5,0,5
Dykeria,F,100,5,0,5
Bonifacio,M,100,0,863,863
Seraya,F,100,66,0,66
Kylynn,F,98,764,13,777
Victorio,M,100,0,437,437
Dimitri,M,99,99,7092,7191
Sita,F,100,382,0,382
Shatorya,F,100,5,0,5
Abryana,F,100,161,0,161
Jamilla,F,100,1056,0,1056
Jermyah,M,51,18,19,37
Markenzie,F,100,26,0,26
Tayyaba,F,100,5,0,5
Eber,M,100,0,716,716
Mikenya,F,100,5,0,5
Peola,F,100,5,0,5
Najea,F,100,19,0,19
Yener,M,100,0,10,10
Voni,F,100,43,0,43
Maryse,F,100,100,0,100
Nikola,M,79,533,1993,2526
Dania,F,100,6485,5,6490
Malea,F,100,2070,0,2070
Adwoa,F,100,168,0,168
Karyss,F,100,66,0,66
Baldwin,M,100,0,347,347
Torell,M,100,0,63,63
Hayoung,F,100,18,0,18
Latiffa,F,100,11,0,11
Tykera,F,100,174,0,174
Jionny,M,100,0,23,23
Dreonna,F,100,86,0,86
Charlott,F,100,248,0,248
Jerjuan,M,100,0,17,17
Clerance,M,100,0,5,5
Erica,F,100,228139,1025,229164
Mithun,M,100,0,17,17
Bryen,M,100,0,408,408
Davares,M,100,0,5,5
Kadiedra,F,100,22,0,22
Larris,M,100,0,11,11
Lucillie,F,100,48,0,48
Ericia,F,100,449,0,449
Akiyah,F,100,368,0,368
Katelin,F,100,8808,0,8808
Brittneyann,F,100,17,0,17
Kenon,M,100,0,401,401
Jizzelle,F,100,55,0,55
Evangline,F,100,24,0,24
Atziry,F,100,373,0,373
Nitara,F,100,89,0,89
Ivylynn,F,100,24,0,24
Tenley,F,100,3960,0,3960
Beautifull,F,100,152,0,152
Caileb,M,100,0,200,200
Fermon,M,100,0,29,29
Sepehr,M,100,0,38,38
Sinem,F,100,17,0,17
Taijay,M,100,0,6,6
Gina,F,100,149880,399,150279
Kassidey,F,100,28,0,28
Thary,F,100,12,0,12
Maleiya,F,100,59,0,59
Lynnzee,F,100,44,0,44
Drue,M,59,616,882,1498
Greenlea,F,100,15,0,15
Nicolaas,M,100,0,377,377
Justinian,M,100,0,78,78
Shimira,F,100,16,0,16
Loyal,M,93,76,1037,1113
Emerich,M,100,0,5,5
Sohrob,M,100,0,15,15
Roisin,F,100,558,0,558
Rusti,F,100,350,0,350
Calese,F,100,10,0,10
Jianne,F,100,5,0,5
Rhyane,F,100,6,0,6
Adysun,F,100,5,0,5
Shamar,M,96,249,5353,5602
Renita,F,100,7218,0,7218
Danyalle,F,100,25,0,25
Prakruti,F,100,5,0,5
Emmerson,F,88,1400,199,1599
Chedrick,M,100,0,20,20
Jackia,F,100,6,0,6
Lavor,M,100,0,43,43
Zakera,F,100,21,0,21
Dhiya,F,100,84,0,84
Danieka,F,100,7,0,7
Ahrya,F,100,13,0,13
Corley,F,58,281,200,481
Hemali,F,100,17,0,17
Elexes,F,100,5,0,5
Shakerria,F,100,119,0,119
Toia,F,100,74,0,74
Amandine,F,100,61,0,61
Jairdan,M,100,0,17,17
Davit,M,100,0,140,140
Shema,F,100,35,0,35
Frieda,F,100,3312,0,3312
Chayden,M,98,6,244,250
Chano,M,100,0,23,23
Kelseyanne,F,100,5,0,5
Marcandre,M,100,0,6,6
Ien,M,100,0,16,16
Stacee,F,100,1633,0,1633
Amariea,F,100,20,0,20
Hasiel,M,100,0,5,5
Nirav,M,100,0,430,430
Emmye,F,100,5,0,5
Aqib,M,100,0,144,144
Jazariah,F,100,235,0,235
Teriya,F,100,6,0,6
Passion,F,100,2048,0,2048
Serrita,F,100,57,0,57
Jaymie,F,89,3342,405,3747
Kriyansh,M,100,0,5,5
Teresina,F,100,82,0,82
Keyler,M,100,0,90,90
Domenica,F,100,1769,0,1769
Charece,F,100,17,0,17
Jvonne,M,100,0,6,6
Jayze,M,100,0,10,10
Stanislaus,M,100,0,134,134
Toray,M,100,0,5,5
Aceson,M,100,0,97,97
Dontravious,M,100,0,101,101
Caden,M,99,792,53020,53812
Yun,F,74,73,26,99
Mareka,F,100,40,0,40
Sherrey,F,100,56,0,56
Kahlani,F,100,37,0,37
Deeva,F,100,5,0,5
Leeander,M,100,0,5,5
Jaydenjames,M,100,0,5,5
Tyce,M,100,0,1762,1762
Niylah,F,100,248,0,248
Mickelle,F,100,144,0,144
Adithya,M,100,0,477,477
Tarelle,M,100,0,23,23
Okeema,F,100,5,0,5
Annaelizabeth,F,100,20,0,20
Ruzanna,F,100,5,0,5
Yashekia,F,100,10,0,10
Lynnann,F,100,296,0,296
Alyria,F,100,107,0,107
Mikyle,M,100,0,210,210
Paulette,F,100,28901,25,28926
Jaidan,M,60,557,853,1410
Talee,F,100,10,0,10
Kyila,F,100,26,0,26
Rodrickus,M,100,0,63,63
Zamarie,F,62,8,5,13
Narai,F,100,15,0,15
Daeveon,M,100,0,189,189
Hawwaa,F,100,6,0,6
Inioluwa,F,64,81,46,127
Adrieana,F,100,121,0,121
Brynnly,F,100,74,0,74
Gerarda,F,100,78,0,78
Anahii,F,100,8,0,8
Jayron,M,100,0,507,507
Sayanna,F,100,5,0,5
Assitan,F,100,10,0,10
Basem,M,100,0,95,95
Barris,M,100,0,5,5
Joda,F,100,77,0,77
Mickia,F,100,13,0,13
Rahja,M,54,6,7,13
Dawnmarie,F,100,723,0,723
Audin,M,100,0,5,5
Jherrica,F,100,10,0,10
Jasmir,M,77,6,20,26
Arriyanah,F,100,6,0,6
Devory,F,100,44,0,44
Irineo,M,100,0,279,279
Sabian,M,97,21,787,808
Reizel,F,100,84,0,84
Shawneka,F,100,5,0,5
Detria,F,100,287,0,287
Nouman,M,100,0,21,21
Berend,M,100,0,5,5
Wm,M,100,0,688,688
Jodianne,F,100,20,0,20
Jacgueline,F,100,6,0,6
Accalia,F,100,69,0,69
Dalano,M,100,0,17,17
Wizdom,M,100,0,5,5
Tamaine,M,100,0,6,6
Musah,M,100,0,5,5
Heron,M,99,5,435,440
Gerrianne,F,100,111,0,111
Chalino,M,100,0,33,33
Record,M,100,0,6,6
Nyquan,M,100,0,147,147
Antheny,M,100,0,5,5
Reminisce,F,100,18,0,18
Jeanpaul,M,100,0,1624,1624
Antwain,M,100,0,2242,2242
Madielyn,F,100,6,0,6
Rosezanna,F,100,6,0,6
Crystine,F,100,28,0,28
Kiamesha,F,100,103,0,103
Silina,F,100,8,0,8
Karna,F,99,438,6,444
Shaquann,M,100,0,13,13
Marini,F,100,5,0,5
Cordel,M,100,0,415,415
Janecia,F,100,340,0,340
Saya,F,100,779,0,779
Declynn,F,100,38,0,38
Adisynn,F,100,73,0,73
Ashliegh,F,100,418,0,418
Yasuko,F,100,5,0,5
Custer,M,100,0,5,5
Ashlay,F,100,57,0,57
Promisse,F,100,7,0,7
Shrena,F,100,13,0,13
Melrose,F,100,198,0,198
Ilhan,F,77,211,64,275
Mylisa,F,100,94,0,94
Ammon,M,100,0,3141,3141
Niriah,F,100,11,0,11
Lemarr,M,100,0,26,26
Sherronda,F,100,195,0,195
Maireli,F,100,5,0,5
Deiana,F,100,13,0,13
Akirra,F,100,71,0,71
Deyton,M,100,0,238,238
Teressia,F,100,39,0,39
Joden,M,100,0,89,89
Lyvia,F,100,377,0,377
Telecia,F,100,200,0,200
Kashad,M,100,0,21,21
Demarion,M,100,0,2784,2784
Tenny,F,50,21,21,42
Jadira,F,100,463,0,463
Shaniquah,F,100,47,0,47
Tawanya,F,100,54,0,54
Darragh,M,82,35,164,199
Yuina,F,100,5,0,5
Jahzlynn,F,100,5,0,5
Cathirine,F,100,10,0,10
Farzad,M,100,0,85,85
Joselito,M,100,0,742,742
Tashawna,F,100,899,0,899
Shaffer,M,100,0,43,43
Keduse,M,100,0,5,5
Criss,M,83,98,470,568
Traylon,M,100,0,228,228
Charlisse,F,100,24,0,24
Jamarqus,M,100,0,31,31
Meghen,F,100,135,0,135
Rinyah,F,100,6,0,6
Lequetta,F,100,10,0,10
Bella,F,100,40498,34,40532
Daisi,F,100,172,0,172
Jeramie,M,99,41,3321,3362
Danah,F,100,886,0,886
Shevonda,F,100,54,0,54
Cathalene,F,100,21,0,21
Nazire,M,100,0,65,65
Isabelly,F,100,46,0,46
Lakizzy,F,100,11,0,11
Miah,F,100,6340,10,6350
Chyrel,F,100,206,0,206
Joselina,F,100,44,0,44
Julis,M,85,5,29,34
Tangella,F,100,22,0,22
Moxon,M,100,0,26,26
Zae,M,100,0,50,50
Tasean,M,98,5,241,246
Simion,M,100,0,31,31
Mackala,F,100,5,0,5
Pal,M,94,10,145,155
Jennifr,F,100,106,0,106
Tressie,F,100,1279,0,1279
Nacier,M,100,0,7,7
Zerrick,M,100,0,318,318
Cor,M,100,0,7,7
Rommy,M,77,9,30,39
Maiana,F,100,41,0,41
Mckella,F,100,16,0,16
Travionne,M,100,0,5,5
Rosaline,F,100,1229,0,1229
Duvan,M,100,0,74,74
Khadiyah,F,100,5,0,5
Laquala,F,100,10,0,10
Glenetta,F,100,46,0,46
Vonetta,F,100,835,0,835
Osiris,M,65,739,1391,2130
Sneha,F,100,1331,0,1331
Arpa,F,100,5,0,5
Tasneem,F,100,960,0,960
Tyleik,M,100,0,34,34
Rodel,M,100,0,97,97
Zeyana,F,100,5,0,5
Sandreka,F,100,5,0,5
Norlin,M,100,0,5,5
Avyn,F,55,157,131,288
Hazin,M,100,0,6,6
Donquell,M,100,0,11,11
Mylynda,F,100,5,0,5
Javontay,M,100,0,295,295
Kaicee,F,100,82,0,82
Larresha,F,100,17,0,17
Kelleyann,F,100,5,0,5
Kanyan,M,100,0,5,5
Keyrin,F,100,20,0,20
Swara,F,100,278,0,278
Milbrey,F,100,5,0,5
Madia,F,100,165,0,165
Bergan,F,100,53,0,53
Athanasia,F,100,430,0,430
Mumtaz,F,100,109,0,109
Xitlalli,F,100,274,0,274
Rhiyana,F,100,7,0,7
Kenora,F,100,106,0,106
Auner,M,100,0,12,12
Avigdor,M,100,0,310,310
Stefoni,F,100,9,0,9
Zeon,M,100,0,23,23
Aranzazu,F,100,17,0,17
Candyce,F,100,2663,0,2663
Janelie,F,100,66,0,66
Allexis,F,100,402,0,402
Gerelene,F,100,6,0,6
Faviana,F,100,35,0,35
Kieva,F,100,26,0,26
Izamara,F,100,5,0,5
Oriyah,F,100,40,0,40
Sorina,F,100,136,0,136
Valada,F,100,15,0,15
Aleka,F,100,211,0,211
Una,F,100,1631,0,1631
Rajanee,F,100,68,0,68
Leilanii,F,100,21,0,21
Adasyn,F,100,147,0,147
Touger,M,100,0,47,47
Anitrice,F,100,11,0,11
Adiella,F,100,27,0,27
Keldrin,M,100,0,5,5
Dontrelle,M,100,0,72,72
Zykierra,F,100,12,0,12
Eriah,F,100,16,0,16
Melky,M,100,0,5,5
Lanaiyah,F,100,30,0,30
Jonaton,M,100,0,15,15
Jaiceon,M,100,0,196,196
Anarely,F,100,89,0,89
Daaimah,F,100,17,0,17
Abed,M,100,0,187,187
Kimberlly,F,100,184,0,184
Lucrecia,F,100,815,0,815
Cohutta,M,100,0,5,5
Lauchlin,M,100,0,5,5
Aneth,F,100,208,0,208
Sache,F,100,62,0,62
Velvet,F,100,2852,0,2852
Soline,F,100,6,0,6
Triniya,F,100,10,0,10
Miricle,F,100,55,0,55
Maddyn,F,95,379,22,401
Lynwood,M,100,0,1741,1741
Lynnsie,F,100,103,0,103
Johonna,F,100,102,0,102
Dezani,F,100,5,0,5
Janaysha,F,100,109,0,109
Lakish,F,100,38,0,38
Aerowyn,F,100,11,0,11
Xia,F,100,477,0,477
Ione,F,100,928,0,928
Eribella,F,100,10,0,10
Laquincia,F,100,10,0,10
Wina,F,100,13,0,13
Rodderick,M,100,0,220,220
Tinsley,F,98,1470,32,1502
Yarielys,F,100,87,0,87
Ulysse,M,100,0,5,5
Teva,F,88,113,16,129
Dickie,M,96,73,1875,1948
Catana,F,100,11,0,11
Thomasmichael,M,100,0,11,11
Preesha,F,100,16,0,16
Lesley,F,91,31897,2968,34865
Nesbitt,M,100,0,5,5
Karletta,F,100,112,0,112
Sragvi,F,100,5,0,5
Otelia,F,100,160,0,160
Khiana,F,100,336,0,336
Stina,F,100,85,0,85
Tichelle,F,100,33,0,33
Yarelyn,F,100,34,0,34
Hovig,M,100,0,11,11
Raylyn,F,95,618,33,651
Anoop,M,91,19,200,219
Annalyse,F,100,1194,0,1194
Tinia,F,100,387,0,387
Nikaylah,F,100,5,0,5
Daiwik,M,100,0,38,38
Shoney,F,69,11,5,16
Axil,M,100,0,24,24
Fredrick,M,99,235,38521,38756
Toyka,F,100,11,0,11
Rayon,M,97,11,396,407
Charlisia,F,100,5,0,5
Tennasyn,F,100,10,0,10
Dalin,M,94,27,416,443
Yulene,F,100,6,0,6
Ciaran,M,98,30,1369,1399
Suave,M,100,0,45,45
Romie,M,71,219,535,754
Yoselyne,F,100,13,0,13
Alaxandra,F,100,21,0,21
Teaundra,F,100,18,0,18
Kahala,F,100,5,0,5
Keenyn,M,100,0,5,5
Shaquella,F,100,107,0,107
Kesley,F,90,546,62,608
Lacurtis,M,100,0,6,6
Kynesha,F,100,67,0,67
Izzibella,F,100,18,0,18
Adalena,F,100,258,0,258
Sevilla,F,100,77,0,77
Joseph,M,100,6562,1645771,1652333
Sikander,M,100,0,5,5
Ailey,F,100,609,0,609
Javita,F,100,29,0,29
Aniseto,M,100,0,10,10
Trinice,F,100,36,0,36
Sten,M,100,0,158,158
Johnmark,M,100,0,471,471
Sabree,F,94,262,18,280
Annaly,F,100,354,0,354
Temicka,F,100,19,0,19
Kashaf,F,100,8,0,8
Janin,F,100,87,0,87
Sierah,F,100,203,0,203
Ashburn,M,100,0,5,5
Mishel,F,100,228,0,228
Samuela,M,54,22,26,48
Latanya,F,100,9820,23,9843
Sander,M,92,79,885,964
Andrenette,F,100,10,0,10
Daneen,F,100,1182,0,1182
Joshuajoseph,M,100,0,5,5
Dashiell,M,99,11,1700,1711
Wala,F,100,6,0,6
Tahjay,M,100,0,76,76
Fatouma,F,100,17,0,17
Yachica,F,100,6,0,6
Djenaba,F,100,29,0,29
Blandina,F,100,18,0,18
Antoinese,F,100,5,0,5
Charette,F,100,5,0,5
Wai,M,66,88,174,262
Antwane,M,100,0,853,853
Khalilah,F,100,1503,0,1503
Rajah,M,67,152,308,460
Mariona,F,100,207,0,207
Cing,F,100,199,0,199
Arkeisha,F,100,26,0,26
Shoronda,F,100,11,0,11
Maxey,M,100,0,72,72
Jerrian,M,100,0,68,68
Mavel,F,100,22,0,22
Koreen,F,100,622,0,622
Kirra,F,100,2085,0,2085
Tifiny,F,100,11,0,11
Anjalee,F,100,146,0,146
Nysaiah,M,100,0,28,28
Kilian,M,98,21,877,898
Samer,M,100,5,1334,1339
Sushma,F,100,5,0,5
Erynn,F,100,1510,0,1510
Latoysha,F,100,33,0,33
Daks,M,100,0,6,6
Amisha,F,100,748,0,748
Eshika,F,100,47,0,47
Sharieff,M,100,0,33,33
Dawnda,F,100,6,0,6
Parvathy,F,100,11,0,11
Lehanna,F,100,23,0,23
Fayga,F,100,10,0,10
Lekeya,F,100,86,0,86
Aidsa,F,100,30,0,30
Arminta,F,100,68,0,68
Ajah,F,100,1258,0,1258
Lineth,F,100,121,0,121
Mazzi,F,100,8,0,8
Dontaysha,F,100,5,0,5
Namir,M,100,0,401,401
Zamorah,F,100,33,0,33
Gussie,F,87,812,122,934
Colista,F,100,10,0,10
Cheena,F,100,41,0,41
Tathiana,F,100,26,0,26
Desta,F,100,295,0,295
Justus,M,91,635,6527,7162
Tonay,F,100,7,0,7
Moaaz,M,100,0,23,23
Mamadu,M,100,0,5,5
Shanan,F,86,745,123,868
Julee,F,100,2568,0,2568
Geovonnie,M,100,0,26,26
Leveda,F,100,19,0,19
Katanya,F,100,116,0,116
Cytnhia,F,100,5,0,5
Christyonna,F,100,10,0,10
Jayko,M,100,0,99,99
Davene,F,97,167,5,172
Tarijah,F,100,8,0,8
Adlih,F,100,20,0,20
Shantrese,F,100,11,0,11
Joseadrian,M,100,0,5,5
Dellon,M,100,0,34,34
Raequel,F,100,5,0,5
Judey,F,100,5,0,5
Shiwana,F,100,6,0,6
Melynn,F,100,44,0,44
Danamarie,F,100,163,0,163
Majenta,F,100,7,0,7
Lailene,F,100,12,0,12
Jakaylah,F,100,215,0,215
Ephriam,M,100,0,379,379
Donjay,M,100,0,6,6
Sharolyn,F,100,983,0,983
Esthela,F,100,311,0,311
Suzzie,F,100,5,0,5
Margery,F,100,2763,0,2763
Jaevon,M,100,0,436,436
Seanne,F,100,61,0,61
Lakeish,F,100,44,0,44
Sayed,M,100,0,423,423
Katerina,F,100,6059,0,6059
Magalis,F,100,11,0,11
Eston,M,100,0,795,795
Zujey,F,100,28,0,28
Shanobia,F,100,5,0,5
Sindee,F,100,66,0,66
Foster,M,98,82,4629,4711
Anamari,F,100,85,0,85
Echo,F,98,3180,75,3255
Aailyah,F,100,172,0,172
Rayshawna,F,100,21,0,21
Avonlee,F,100,6,0,6
Barak,M,100,0,796,796
Augusten,M,100,0,67,67
Carrel,M,100,0,26,26
Nyair,M,100,0,67,67
Marivel,F,100,2073,0,2073
Tiayana,F,100,28,0,28
Nyaijah,F,100,5,0,5
Kordai,M,100,0,53,53
Sovanna,F,74,17,6,23
Alyssia,F,100,4511,0,4511
Tashena,F,100,332,0,332
Michaelangelo,M,100,0,1125,1125
Terilyn,F,100,617,0,617
Latusha,F,100,47,0,47
Polet,F,100,47,0,47
Doe,F,100,27,0,27
Jaheam,M,100,0,10,10
Nereida,F,100,3543,6,3549
Reign,F,66,846,432,1278
Dreven,M,100,0,16,16
Mickale,M,100,0,35,35
Hannahlee,F,100,33,0,33
Jodyne,F,100,5,0,5
Demiracle,F,100,5,0,5
Louetta,F,100,282,0,282
Domonigue,F,100,8,0,8
Shaunese,F,100,17,0,17
Garren,M,99,17,1675,1692
Justyn,M,97,131,4078,4209
Annaliza,F,100,210,0,210
Othella,F,100,79,0,79
Suhavi,F,100,17,0,17
Bobie,F,93,187,15,202
Doron,M,100,0,592,592
Cossette,F,100,46,0,46
Albara,M,100,0,6,6
Adayla,F,100,29,0,29
Keidra,F,100,372,0,372
Depaul,M,100,0,56,56
Giovanna,F,100,9934,0,9934
Raylei,F,100,48,0,48
Dimon,F,83,49,10,59
Nyiah,F,100,196,0,196
Tepanga,F,100,5,0,5
Lizah,F,100,12,0,12
Kiwanda,F,100,44,0,44
Avalie,F,100,56,0,56
Nymeria,F,100,5,0,5
Arnald,M,100,0,5,5
Shoko,F,100,30,0,30
Pita,M,100,0,11,11
Ciclali,F,100,53,0,53
Nacy,F,100,35,0,35
Salazar,M,100,0,5,5
Dlyla,F,100,31,0,31
Hilah,F,100,10,0,10
Benz,M,100,0,42,42
Kaje,M,100,0,29,29
Comisha,F,100,7,0,7
Analisia,F,100,163,0,163
Quame,M,100,0,65,65
Dalas,M,66,10,19,29
Marqueal,M,100,0,5,5
Yiesha,F,100,6,0,6
Jennifere,F,100,10,0,10
Keyontae,M,96,13,350,363
Metin,M,100,0,18,18
Dnyla,F,100,65,0,65
Sanijah,F,100,46,0,46
Itsamari,F,100,5,0,5
Breonka,F,100,15,0,15
Joyice,F,100,103,0,103
Janna,F,100,14342,0,14342
Fedra,F,100,65,0,65
Robertmichael,M,100,0,17,17
Kassius,M,100,0,203,203
Tujuana,F,100,155,0,155
Harbour,F,80,20,5,25
Jahi,M,100,0,678,678
Damira,F,100,152,0,152
Kaelynne,F,100,158,0,158
Terykah,F,100,7,0,7
Garie,F,50,5,5,10
Davia,F,100,1056,0,1056
Arashdeep,M,100,0,10,10
Janaja,F,100,25,0,25
Rontavia,F,100,5,0,5
Zineb,F,100,76,0,76
Shelva,F,100,242,0,242
Hajrah,F,100,34,0,34
Isac,M,100,0,2441,2441
Lenox,M,83,95,464,559
Noureen,F,100,11,0,11
Shantea,F,100,215,0,215
Hyatt,M,90,29,261,290
Kekoa,M,98,22,1355,1377
Arnold,M,100,126,33811,33937
Leina,F,100,489,0,489
Ichard,M,100,0,10,10
Shanine,F,100,54,0,54
Coryon,M,100,0,44,44
Yanil,F,100,66,0,66
Vickey,F,98,5037,108,5145
Jakwaun,M,100,0,5,5
Jamis,M,100,0,201,201
Angellica,F,100,386,0,386
Lizzieann,F,100,10,0,10
Ronderick,M,100,0,5,5
Carnita,F,100,55,0,55
Klark,M,89,6,49,55
Fischer,M,100,0,1245,1245
Endi,M,100,0,96,96
Keshan,M,100,0,57,57
Williiam,M,100,0,30,30
Aubreyona,F,100,17,0,17
Devone,M,85,118,695,813
Micahi,M,100,0,23,23
Maclovia,F,100,5,0,5
Lauralynn,F,100,89,0,89
Taleka,F,100,6,0,6
Monzerath,F,100,46,0,46
Heliodoro,M,100,0,147,147
Eresmia,F,100,5,0,5
Franchezca,F,100,6,0,6
Jeaninne,F,100,183,0,183
Zaykeese,M,100,0,13,13
Sandrea,F,100,541,0,541
George,M,99,2883,480163,483046
Reason,M,85,10,57,67
Zmaya,F,100,8,0,8
Raymon,M,100,0,3777,3777
Myrl,M,83,37,177,214
Hulda,F,100,92,0,92
Alexaner,M,100,0,28,28
Avianca,F,100,28,0,28
Corrinn,F,100,33,0,33
Elih,M,100,0,74,74
Chelly,F,100,152,0,152
Evalene,F,100,43,0,43
Virak,M,100,0,25,25
Ana,F,99,92319,579,92898
Ranee,F,100,1329,0,1329
Cherity,F,100,229,0,229
Cathalia,F,100,5,0,5
Darreon,M,100,0,324,324
Somona,F,100,5,0,5
Kayron,M,82,51,227,278
Freada,F,100,18,0,18
Laily,F,100,42,0,42
Poppie,F,100,6,0,6
Ryler,M,100,0,285,285
Gerrica,F,100,96,0,96
Liela,F,100,138,0,138
Kolee,F,100,10,0,10
Chalette,F,100,11,0,11
Yasheca,F,100,6,0,6
Rixton,M,100,0,9,9
Sunflower,F,100,6,0,6
Chalsey,F,100,76,0,76
Sooner,F,100,10,0,10
Rayleen,F,100,968,0,968
Barclay,M,96,24,607,631
Success,M,69,13,29,42
Sheridon,F,100,6,0,6
Stony,M,100,0,261,261
Lataura,F,100,7,0,7
Karel,F,63,702,407,1109
Tykerra,F,100,11,0,11
Evalynne,F,100,103,0,103
Gradie,M,87,5,34,39
Ninamarie,F,100,162,0,162
Emin,M,100,0,274,274
Lamarion,M,100,0,874,874
Kemisha,F,100,168,0,168
Meoshia,F,100,88,0,88
Jaspreet,F,60,380,252,632
Jahnavi,F,100,331,0,331
Thaleia,F,100,19,0,19
Owain,M,100,0,101,101
Absalom,M,100,0,142,142
Deana,F,100,21901,14,21915
Corine,F,100,3663,0,3663
Franck,M,100,0,131,131
Lindaann,F,100,65,0,65
Brydin,M,100,0,6,6
Somalia,F,100,114,0,114
Nicco,M,99,5,785,790
Teronica,F,100,23,0,23
Damon,M,99,316,58495,58811
Sinatra,M,100,0,18,18
Hanae,F,100,77,0,77
Adin,M,97,86,2394,2480
Shekima,F,100,34,0,34
Risha,F,100,741,0,741
Alejandria,F,100,101,0,101
Javelyn,F,100,5,0,5
Endra,F,100,5,0,5
Nioma,F,100,7,0,7
Selika,F,100,10,0,10
Bianey,F,100,594,0,594
Aneea,F,100,12,0,12
Asiya,F,100,1024,0,1024
Lennie,M,70,758,1811,2569
Onnie,M,52,141,155,296
Daeisha,F,100,5,0,5
Gurveen,F,100,5,0,5
Camelle,F,100,107,0,107
Cristhofer,M,100,0,51,51
Jassem,M,100,0,5,5
Quinteria,F,100,85,0,85
Varian,M,100,0,278,278
Anil,M,100,0,1133,1133
Tiago,M,100,0,1440,1440
Dezaree,F,100,166,0,166
Vania,F,100,2310,0,2310
Shasa,F,100,5,0,5
Taknisha,F,100,6,0,6
Sridevi,F,100,7,0,7
Denesa,F,100,26,0,26
Jeziel,M,100,0,226,226
Kiea,F,100,10,0,10
Liddy,F,100,40,0,40
Cademon,M,100,0,12,12
Maivy,F,100,7,0,7
Teshawn,M,93,26,343,369
Tashyla,F,100,10,0,10
Dwyane,M,100,0,1102,1102
Isolina,F,100,34,0,34
Zimir,M,100,0,40,40
Shynisha,F,100,6,0,6
Yani,F,77,166,50,216
Nickon,M,100,0,5,5
Eero,M,100,0,130,130
Zandre,M,100,0,27,27
Theoden,M,100,0,110,110
Lashanti,F,100,349,0,349
Senchal,F,100,7,0,7
Brynnan,F,100,144,0,144
Khaya,F,100,182,0,182
Samah,F,100,346,0,346
Angelyssa,F,100,17,0,17
Yvelle,F,100,5,0,5
Moody,M,100,0,76,76
Bryna,F,100,1186,0,1186
Giacobbe,M,100,0,16,16
Trinitie,F,100,284,0,284
Beuford,M,100,0,7,7
Christianjoshua,M,100,0,5,5
Myrikal,F,100,105,0,105
Maeleigh,F,100,303,0,303
Terrane,M,100,0,5,5
Jozi,F,100,133,0,133
Obed,M,100,0,2874,2874
Shawntaya,F,100,24,0,24
Gralyn,M,100,0,38,38
Zyeria,F,100,40,0,40
Elroy,M,100,0,2482,2482
Kenner,M,100,0,275,275
Dadrian,M,100,0,576,576
Quindarious,M,100,0,55,55
Tasheia,F,100,21,0,21
Sabrine,F,100,320,0,320
Jateria,F,100,31,0,31
Aeralynn,F,100,31,0,31
Nurit,F,100,5,0,5
Abish,F,100,17,0,17
Elijia,M,100,0,8,8
Laronda,F,100,2289,0,2289
Merena,F,100,6,0,6
Azlan,M,97,8,243,251
Alivia,F,100,22156,10,22166
Shantinique,F,100,91,0,91
Seka,F,100,6,0,6
Aleli,F,100,105,0,105
Aadrika,F,100,10,0,10
Animesh,M,100,0,17,17
Nannie,F,100,988,0,988
Biran,M,100,0,164,164
Sharaya,F,100,419,0,419
Amneh,F,100,28,0,28
Rosangel,F,100,49,0,49
Doborah,F,100,11,0,11
Kitina,F,100,60,0,60
Jaksyn,M,100,0,19,19
Procopio,M,100,0,6,6
Kolleen,F,100,985,0,985
Yalani,F,100,40,0,40
Teofilo,M,100,0,646,646
Sharees,F,100,5,0,5
Haegan,M,100,0,6,6
Samala,F,100,57,0,57
Teairah,F,100,18,0,18
Nicolee,F,100,22,0,22
Carista,F,100,5,0,5
Shaylee,F,100,6009,0,6009
Demondre,M,100,0,302,302
Tyquell,M,100,0,33,33
Berri,F,100,6,0,6
Sonai,F,100,17,0,17
Ree,F,96,133,5,138
Elliyana,F,100,25,0,25
Stpehanie,F,100,109,0,109
Yoselyn,F,100,1484,0,1484
Tanaiya,F,100,166,0,166
Tarina,F,100,803,0,803
Mariahna,F,100,5,0,5
Mackinnon,M,100,0,25,25
Jysir,M,100,0,10,10
Syretha,F,100,6,0,6
Kortny,F,100,82,0,82
Micheala,F,100,1409,0,1409
Ahsir,M,100,0,6,6
Atreya,M,70,6,14,20
Riggin,M,100,0,282,282
Jabier,M,100,0,331,331
Adyanna,F,100,11,0,11
Deddrick,M,100,0,123,123
Essa,M,94,20,294,314
Dollinda,F,100,30,0,30
Danixa,F,100,37,0,37
Leeonna,F,100,28,0,28
Brittney,F,100,81538,265,81803
Kagome,F,100,14,0,14
Lalla,F,100,33,0,33
Paradice,F,100,11,0,11
Traeshon,M,100,0,6,6
Justinlee,M,100,0,38,38
Taevin,M,100,0,99,99
Shastity,F,100,7,0,7
Lilylynn,F,100,5,0,5
Dearron,M,100,0,12,12
Sindi,F,100,618,0,618
Jasuan,M,100,0,5,5
Charyl,F,100,602,0,602
Annelisa,F,100,202,0,202
Deyna,F,100,134,0,134
Lorene,F,100,7623,10,7633
Najeh,M,100,0,91,91
Aide,F,100,1840,0,1840
Sundari,F,100,26,0,26
Bethzaida,F,100,320,0,320
Makenleigh,F,100,53,0,53
Kermit,M,100,0,4902,4902
Labyron,M,100,0,23,23
Canace,F,100,5,0,5
Jeshuah,M,100,0,36,36
Remiel,M,100,0,72,72
Avonta,M,100,0,31,31
Brainard,M,100,0,55,55
Kongmeng,M,100,0,264,264
Damian,M,100,321,72292,72613
Kenzi,F,99,1985,20,2005
Enny,F,100,12,0,12
Mazy,F,100,120,0,120
Mahalie,F,100,74,0,74
Arvion,M,100,0,5,5
Lotte,F,100,28,0,28
Bohdan,M,100,0,637,637
Ulysess,M,100,0,157,157
Realynn,F,100,21,0,21
Rosette,F,100,543,0,543
Kazuma,M,100,0,150,150
Luca,M,96,754,16760,17514
Dejonae,F,100,38,0,38
Gerlene,F,100,49,0,49
Amauria,F,100,140,0,140
Damaria,F,83,340,69,409
Aubriegh,F,100,54,0,54
Kimmora,F,100,108,0,108
Peri,F,100,2056,10,2066
Yetunde,F,100,192,0,192
Zorie,F,100,25,0,25
Marin,F,87,4629,717,5346
Sanam,F,100,400,0,400
Keadra,F,100,10,0,10
Andro,M,100,0,42,42
Arryanna,F,100,153,0,153
Mazi,F,75,70,23,93
Abrien,M,100,0,27,27
Amely,F,100,235,0,235
Najee,M,85,417,2429,2846
Keaisa,F,100,16,0,16
Sashe,F,100,19,0,19
Toniqua,F,100,122,0,122
Birgit,F,100,269,0,269
Tyara,F,100,508,0,508
Lemon,M,95,10,182,192
Artice,M,84,10,52,62
Aaronda,F,100,5,0,5
Eligah,M,100,0,488,488
Shannel,F,100,1226,0,1226
Emmalin,F,100,408,0,408
Odali,F,100,40,0,40
Maelena,F,100,27,0,27
Brandonmichael,M,100,0,30,30
Koraline,F,100,83,0,83
Rashann,M,100,0,59,59
Shabsi,M,100,0,28,28
Tatrina,F,100,5,0,5
Azam,M,100,0,126,126
Delara,F,100,47,0,47
Freddi,M,60,47,70,117
Delfa,F,100,11,0,11
Sebrina,F,100,2080,0,2080
Jenel,F,100,510,0,510
Kaisei,M,100,0,67,67
Jhanya,F,100,15,0,15
Sirvon,M,100,0,5,5
Marilou,F,100,1388,0,1388
Iesha,F,100,7404,15,7419
Katon,M,100,0,35,35
Shaneque,F,100,120,0,120
Keyston,M,100,0,61,61
Tanyel,F,100,17,0,17
Domingue,F,78,68,19,87
Jaysea,F,100,6,0,6
Lashina,F,100,56,0,56
Zakylah,F,100,13,0,13
Achintya,M,100,0,29,29
Pailey,F,100,32,0,32
Nayelii,F,100,8,0,8
Parke,M,100,0,315,315
Mandisha,F,100,10,0,10
Brandylee,F,100,27,0,27
Yeabsera,F,100,5,0,5
Shamia,F,100,1412,0,1412
Tandi,F,100,602,0,602
Delmont,M,100,0,97,97
Lakina,F,100,178,0,178
Navaeh,F,100,1003,0,1003
Cheriah,F,100,5,0,5
Charlina,F,100,156,0,156
Tomorra,F,100,6,0,6
Shebra,F,100,63,0,63
Shanett,F,100,6,0,6
Zeiden,M,100,0,9,9
Lonell,M,100,0,597,597
Gamir,M,100,0,5,5
Trishalana,F,100,5,0,5
Samora,F,98,295,5,300
Martravius,M,100,0,5,5
Chineme,F,100,5,0,5
Brigg,M,100,0,123,123
Leelou,F,100,6,0,6
Monta,M,60,296,442,738
Charone,F,76,16,5,21
Sanjaya,M,73,13,36,49
Zyshonne,M,100,0,101,101
Eliane,F,100,386,0,386
Suprina,F,100,111,0,111
Adamarys,F,100,201,0,201
Shmiel,M,100,0,462,462
Malorey,F,100,47,0,47
Zaida,F,100,2855,0,2855
Kialey,F,100,39,0,39
Pahoua,F,100,148,0,148
Kaashif,M,100,0,12,12
Dmari,M,100,0,349,349
Aniaha,F,100,5,0,5
Rhyla,F,100,11,0,11
Niva,F,100,229,0,229
Corneilius,M,100,0,48,48
Valle,F,100,24,0,24
Braedan,M,100,0,866,866
Daviya,F,100,11,0,11
Imanii,F,100,92,0,92
Grigor,M,100,0,148,148
Tiffanie,F,100,8978,0,8978
Ophelia,F,100,4275,0,4275
Frans,M,100,0,95,95
Angelyn,F,100,1892,0,1892
Aurie,F,100,163,0,163
Lizandro,M,100,0,711,711
Gerlisa,F,100,5,0,5
Rajen,M,100,0,5,5
Amarionna,F,100,139,0,139
Latonza,F,100,10,0,10
Jalese,F,100,41,0,41
Lyrissa,F,100,22,0,22
Jaevaughn,M,100,0,5,5
Mylon,M,100,0,301,301
Rendall,M,100,0,47,47
Pariz,F,100,11,0,11
Gerard,M,100,75,35446,35521
Yoshio,M,100,0,163,163
Ilanah,F,100,12,0,12
Oseph,M,100,0,67,67
Talisia,F,100,22,0,22
Latevin,M,100,0,11,11
Loch,M,100,0,26,26
Javiar,M,100,0,59,59
Roline,F,100,6,0,6
Quierra,F,100,168,0,168
Karima,F,100,1322,0,1322
Bioleta,F,100,15,0,15
Elmar,M,100,0,34,34
Ziniah,F,100,5,0,5
Fox,M,99,7,1301,1308
Soane,M,100,0,25,25
Chantele,F,100,419,0,419
Vontavious,M,100,0,47,47
Marabeth,F,100,55,0,55
Zackaria,M,100,0,293,293
Juleon,M,100,0,65,65
Shanona,F,100,5,0,5
Enderson,M,100,0,12,12
Chezarae,M,60,6,9,15
Ailen,F,100,208,0,208
Jabree,M,81,70,298,368
Iliyan,M,100,0,24,24
Valeen,F,100,129,0,129
Sumedha,F,100,152,0,152
Roxine,F,100,111,0,111
Venelope,F,100,17,0,17
Kasper,M,100,0,528,528
Tajia,F,100,204,0,204
Connery,M,100,0,145,145
Welker,M,100,0,5,5
Edwardine,F,100,11,0,11
Samvit,M,100,0,22,22
Shalesa,F,100,9,0,9
Telford,M,100,0,62,62
Balqis,F,100,6,0,6
Yasmen,F,100,224,0,224
Saumya,F,98,215,5,220
Quinnten,M,100,0,81,81
Teliea,F,100,9,0,9
Diny,F,100,5,0,5
Kaiba,M,100,0,8,8
Terissa,F,100,234,0,234
Shalecia,F,100,26,0,26
Tiney,F,100,11,0,11
Ajayah,F,100,5,0,5
Dionte,M,99,26,2882,2908
Charme,F,100,10,0,10
Cellina,F,100,20,0,20
Equilla,F,100,227,0,227
Alisse,F,100,162,0,162
Leelynn,M,62,36,59,95
Shayeeda,F,100,12,0,12
Adianna,F,100,193,0,193
Marckus,M,100,0,65,65
Awan,M,100,0,29,29
Dawndra,F,100,10,0,10
Afreen,F,100,178,0,178
Jerod,M,100,0,5908,5908
Nkenge,F,100,122,0,122
Flabio,M,100,0,31,31
Kiyana,F,100,1331,0,1331
Tajana,F,100,91,0,91
Marelly,F,100,66,0,66
Analy,F,100,1453,0,1453
Kmarion,M,100,0,74,74
Nilynn,F,100,20,0,20
Derrion,M,97,45,1247,1292
Julissia,F,100,43,0,43
Litha,F,100,10,0,10
Laurale,F,100,10,0,10
Talaijah,F,100,23,0,23
Jobe,M,100,0,956,956
Hameed,M,100,0,144,144
Grissom,M,100,0,21,21
Shondria,F,100,58,0,58
Eliel,M,100,0,1798,1798
Brittiani,F,100,12,0,12
Juanramon,M,100,0,13,13
Lizandra,F,100,484,0,484
Caile,F,100,11,0,11
Mishika,F,100,96,0,96
Jaye,F,70,2079,882,2961
Ericsson,M,100,0,26,26
Geraldyne,F,100,43,0,43
Jazmone,F,100,5,0,5
Essiah,M,100,0,19,19
Jhasmin,F,100,10,0,10
Klowi,F,100,6,0,6
Bretta,F,100,414,0,414
Gaurika,F,100,5,0,5
Kinnley,F,100,198,0,198
Lyelah,F,100,5,0,5
Yeslin,F,100,161,0,161
Afiyah,F,100,17,0,17
Jenyce,F,100,15,0,15
Latissue,F,100,5,0,5
Michelly,F,100,13,0,13
Wang,M,100,0,70,70
Adger,M,100,0,5,5
Mataeo,M,100,0,61,61
Madely,F,100,12,0,12
Kialie,F,100,6,0,6
Resheka,F,100,5,0,5
Verlee,F,100,42,0,42
Tamarsha,F,100,6,0,6
Enika,F,100,5,0,5
Belvia,F,100,135,0,135
Milany,F,100,63,0,63
Merideth,F,100,1596,0,1596
Anayra,F,100,6,0,6
Rokesha,F,100,17,0,17
Yeltsin,M,100,0,15,15
Cheridan,F,100,106,0,106
Akeema,F,100,108,0,108
Raiyn,F,100,16,0,16
Roechelle,F,100,11,0,11
Trinda,F,100,297,0,297
Krrish,M,100,0,72,72
Nalea,F,100,40,0,40
Jareb,M,100,0,72,72
Nelena,F,100,6,0,6
Ceasar,M,100,0,2751,2751
Jizzel,F,100,17,0,17
Helissa,F,100,5,0,5
Quienten,M,100,0,6,6
Suz,F,100,13,0,13
Ilhaan,F,100,12,0,12
Kareema,F,100,770,0,770
Talysa,F,100,20,0,20
Buchanan,M,100,0,16,16
Hoke,M,100,0,97,97
Nishan,M,100,0,263,263
Tache,F,100,70,0,70
Suzzette,F,100,582,0,582
Jleah,F,100,5,0,5
Shaydee,F,100,24,0,24
Vikie,F,100,16,0,16
Deklin,M,100,0,262,262
Vic,M,100,0,1433,1433
Nikoll,M,100,0,6,6
Justinmichael,M,100,0,46,46
Haidyn,F,74,1330,479,1809
Blyss,F,100,87,0,87
Asheley,F,100,786,0,786
Inah,F,100,6,0,6
Whittni,F,100,52,0,52
Narae,F,100,5,0,5
Kenzly,F,100,63,0,63
Lavonnie,F,100,6,0,6
Aspynn,F,100,92,0,92
Aymen,M,94,17,281,298
Jameiah,F,100,10,0,10
Rosana,F,100,2007,0,2007
Domonica,F,100,10,0,10
Jairah,F,100,17,0,17
Oluwaseyifunmi,F,55,6,5,11
Antoin,M,100,0,532,532
Bethyl,F,100,5,0,5
Owens,M,100,0,198,198
Chidera,F,66,320,162,482
Anjaliyah,F,100,5,0,5
Ousainou,M,100,0,10,10
Yaely,F,100,5,0,5
Beyanka,F,100,10,0,10
Jordie,M,84,22,116,138
Zavyer,M,100,0,16,16
Olevia,F,100,367,0,367
Enara,F,100,13,0,13
Shanah,F,100,295,0,295
Camora,F,100,315,0,315
Nadaleigh,F,100,5,0,5
Rushell,F,100,39,0,39
Oreanna,F,100,11,0,11
Jermaul,M,100,0,5,5
Heide,F,100,2073,0,2073
Zenetta,F,100,15,0,15
Shonski,M,100,0,5,5
Ciri,F,100,34,0,34
Jenya,F,100,141,0,141
Kaelene,F,100,72,0,72
Aaliana,F,100,7,0,7
Firdaws,F,100,11,0,11
Daissy,F,100,143,0,143
Kaare,M,100,0,23,23
Crysany,F,100,7,0,7
Mariessa,F,100,36,0,36
Zaim,M,100,0,85,85
Gevena,F,100,13,0,13
Dashyra,F,100,5,0,5
Lutisha,F,100,138,0,138
Miriana,F,100,84,0,84
Adaleena,F,100,41,0,41
Cinnamon,F,100,2021,0,2021
Kertis,M,100,0,11,11
Laniqua,F,100,87,0,87
Yarielis,F,100,209,0,209
Shemieka,F,100,6,0,6
Naviana,F,100,13,0,13
Aneres,F,100,45,0,45
Koleton,M,100,0,274,274
Shelanda,F,100,125,0,125
Neelima,F,100,7,0,7
Rajaee,M,100,0,15,15
Ladacia,F,100,13,0,13
Kaenon,M,100,0,10,10
Andrienna,F,100,5,0,5
Algenis,M,100,0,64,64
Kernie,M,100,0,5,5
Latee,M,100,0,10,10
Maredith,F,100,29,0,29
Tashaunda,F,100,19,0,19
Yaneisi,F,100,29,0,29
Lilley,F,100,301,0,301
Chanah,F,100,179,0,179
Jenessa,F,100,2894,0,2894
Marleana,F,100,40,0,40
Lavance,M,100,0,242,242
Shaneshia,F,100,5,0,5
Mayci,F,100,559,0,559
Trechelle,F,100,21,0,21
Sharniece,F,100,144,0,144
Janilee,F,100,18,0,18
Channan,F,100,12,0,12
Dawain,M,100,0,7,7
Deelilah,F,100,5,0,5
Jovian,M,98,5,266,271
Korion,M,100,0,76,76
Grizelda,F,100,166,0,166
Regginald,M,100,0,130,130
Ldarius,M,100,0,5,5
Branesha,F,100,25,0,25
Charlice,F,100,20,0,20
Randi,F,96,28229,1123,29352
Larah,F,100,182,0,182
Shirleen,F,100,1139,0,1139
Gilverto,M,100,0,64,64
Tyryn,M,100,0,15,15
Kemon,M,100,0,455,455
Haydon,M,94,59,985,1044
Jahmaree,M,100,0,5,5
Tempestt,F,100,643,0,643
Cardelia,F,100,56,0,56
Tiawanda,F,100,5,0,5
Desjambra,F,100,9,0,9
Ariyal,F,100,6,0,6
Rauljr,M,100,0,5,5
Darnecia,F,100,28,0,28
Abhik,M,100,0,10,10
Hadie,F,100,23,0,23
Laylyn,F,100,5,0,5
Elenamarie,F,100,11,0,11
Navtej,M,100,0,12,12
Mead,M,100,0,44,44
Roby,M,98,29,1288,1317
Sundara,F,100,11,0,11
Aboubacar,M,100,0,264,264
Adrianna,F,100,41179,18,41197
Jasin,M,100,0,330,330
Marquisia,F,100,38,0,38
Kimberland,F,100,6,0,6
Shiquan,M,100,0,120,120
Justiz,M,100,0,10,10
Rosandra,F,100,5,0,5
Isabeya,F,100,5,0,5
Shirlena,F,100,105,0,105
Tieysha,F,100,6,0,6
Aanshi,F,100,47,0,47
Hayslee,F,100,7,0,7
Edona,F,100,80,0,80
Janelly,F,100,1655,0,1655
Jisselle,F,100,323,0,323
Breontae,M,100,0,6,6
Theresia,F,100,989,0,989
Smaya,F,100,13,0,13
Holliann,F,100,35,0,35
Meiling,F,100,303,0,303
Nirva,F,100,5,0,5
Haadiyah,F,100,5,0,5
Destyne,F,100,433,0,433
Griffey,M,100,0,10,10
Jaquala,F,100,200,0,200
Gola,F,100,5,0,5
Marlou,F,100,10,0,10
Jerrolyn,F,100,5,0,5
Marquett,M,100,0,79,79
Julion,M,100,0,222,222
Nykea,F,100,44,0,44
Gianpaolo,M,100,0,165,165
Hubbard,M,100,0,116,116
Kaycin,M,100,0,13,13
Micol,F,100,16,0,16
Caylob,M,100,0,58,58
Sweet,F,100,65,0,65
Reshana,F,100,5,0,5
Coronda,F,100,43,0,43
Dyral,M,100,0,18,18
Jandre,M,100,0,34,34
Ramesha,F,100,74,0,74
Cythia,F,100,405,0,405
Umaya,F,100,5,0,5
Manthan,M,100,0,5,5
Susy,F,100,1066,0,1066
Onaje,M,100,0,101,101
Corinna,F,100,6278,0,6278
Cymphony,F,100,13,0,13
Kiria,F,100,19,0,19
Kanyjah,F,100,6,0,6
Silis,M,100,0,20,20
Shalya,F,100,27,0,27
Harlene,F,100,265,0,265
Jasella,F,100,10,0,10
Adrialys,F,100,16,0,16
Rekesha,F,100,17,0,17
Laderick,M,100,0,6,6
Montesha,F,100,12,0,12
Johniesha,F,100,6,0,6
Meco,F,50,43,43,86
Kreig,M,100,0,180,180
Qualyn,M,100,0,57,57
Umut,M,100,0,18,18
Lennyx,F,79,22,6,28
Mekayla,F,100,1573,0,1573
Juanmarcos,M,100,0,12,12
Alysson,F,100,984,0,984
Shardasha,F,100,7,0,7
Jeffey,M,100,0,150,150
Stepheny,F,100,390,0,390
Cartavious,M,100,0,57,57
Eliazar,M,100,0,1568,1568
Garnette,F,100,167,0,167
Aiyonna,F,100,206,0,206
Ramal,M,100,0,105,105
Hillarie,F,100,329,0,329
Zarielle,F,100,70,0,70
Polett,F,100,10,0,10
Zorica,F,100,16,0,16
Litasha,F,100,25,0,25
Annyssa,F,100,54,0,54
Youlanda,F,100,838,0,838
Tamirra,F,100,125,0,125
Haleena,F,100,14,0,14
Mani,M,94,5,72,77
Terriyana,F,100,15,0,15
Kalet,M,100,0,18,18
Kitty,F,100,5418,0,5418
Nelli,F,100,194,0,194
Allynn,F,100,15,0,15
Sookie,F,100,37,0,37
Jainy,F,100,5,0,5
Maraiah,F,100,21,0,21
Hetvi,F,100,36,0,36
Marios,M,100,0,89,89
Negan,F,100,6,0,6
Kayelynn,F,100,290,0,290
Catine,F,100,6,0,6
Sophiamarie,F,100,152,0,152
Taranisha,F,100,6,0,6
Bernel,M,100,0,15,15
Ivo,M,100,0,359,359
Jersy,F,100,12,0,12
Armstrong,M,100,0,34,34
Chaquan,M,84,5,26,31
Kyelan,M,100,0,10,10
Caitline,F,100,16,0,16
Anshita,F,100,11,0,11
Matayah,F,100,55,0,55
Advik,M,100,0,357,357
Kainen,M,100,0,609,609
Kaii,M,100,0,15,15
Sacramento,M,100,0,66,66
Shamona,F,100,220,0,220
Aeriona,F,100,46,0,46
Nathalee,F,100,152,0,152
Brittant,F,100,20,0,20
Ajayden,M,100,0,10,10
Cion,M,100,0,27,27
Jeane,F,100,1225,0,1225
Vaneta,F,100,40,0,40
Vauna,F,100,5,0,5
Ashish,M,100,0,871,871
Khadesha,F,100,25,0,25
Davyion,M,100,0,18,18
Jimma,F,100,70,0,70
Maddi,F,100,375,0,375
Marreo,M,100,0,29,29
Eddward,M,100,0,13,13
Gersain,M,100,0,6,6
Sharlize,F,100,94,0,94
Nateal,F,100,5,0,5
Deneane,F,100,104,0,104
Necie,F,100,7,0,7
Lyela,F,100,11,0,11
Morayo,F,100,64,0,64
Camily,F,100,37,0,37
Allexandria,F,100,5,0,5
Nishaan,M,100,0,37,37
Jorome,M,100,0,5,5
Starlah,F,100,5,0,5
Terrain,M,100,0,5,5
Ahmet,M,100,0,451,451
Dovonte,M,100,0,12,12
Keyunta,M,67,5,10,15
Roba,F,100,6,0,6
Matthieu,M,100,0,847,847
Sontee,F,100,70,0,70
Katlen,F,100,75,0,75
Halsten,M,100,0,13,13
Derrisha,F,100,64,0,64
Cossandra,F,100,20,0,20
Magarita,F,100,15,0,15
Rudd,M,100,0,5,5
Amilyn,F,100,20,0,20
Henrri,M,100,0,10,10
Kayisha,F,100,6,0,6
Clestine,F,100,21,0,21
Sadiemae,F,100,21,0,21
Suki,F,100,290,0,290
Jakayia,F,100,6,0,6
Delayne,F,92,509,45,554
Deeksha,F,100,221,0,221
Buck,M,100,0,2925,2925
Ladashia,F,100,79,0,79
Jermall,M,100,0,70,70
Jaymya,F,100,5,0,5
Alyannah,F,100,67,0,67
Nakel,F,100,5,0,5
Cardia,F,100,13,0,13
Naomie,F,100,1216,0,1216
Sukhman,M,58,52,71,123
Areej,F,100,331,0,331
Ronald,M,100,2549,626014,628563
Yashira,F,100,476,0,476
Katheine,F,100,47,0,47
Sauannah,F,100,5,0,5
Shaima,F,100,168,0,168
Sira,F,100,143,0,143
Camerin,M,69,236,532,768
Osby,M,100,0,19,19
Azelie,F,100,20,0,20
Jarexy,F,100,11,0,11
Marylyn,F,100,1109,0,1109
Dakoda,M,81,628,2611,3239
Sheary,F,100,5,0,5
Nikina,F,100,20,0,20
Marnae,F,100,154,0,154
Hrithika,F,100,10,0,10
Curtis,M,99,1181,184089,185270
Neisha,F,100,1030,0,1030
Holyn,F,100,19,0,19
Reyonna,F,100,99,0,99
Yolonda,F,100,3707,0,3707
Henslee,F,100,45,0,45
Emele,F,100,6,0,6
Dollena,F,100,5,0,5
Tamkia,F,100,130,0,130
Jorien,M,100,0,7,7
Bohen,M,100,0,5,5
Patzy,F,100,40,0,40
Keashia,F,100,82,0,82
Kalief,M,100,0,182,182
Caylum,M,100,0,28,28
Farren,F,69,572,259,831
Diondray,M,100,0,6,6
Michalle,F,100,294,0,294
Reinald,M,100,0,5,5
Remee,F,100,25,0,25
Foye,M,100,0,9,9
Betzabel,F,100,37,0,37
Elice,F,100,186,0,186
Jacorie,M,100,0,141,141
Haochen,M,100,0,5,5
Tonda,F,100,2254,0,2254
Annalee,F,100,4217,0,4217
Audia,F,100,49,0,49
Kipp,M,100,5,2023,2028
Verdene,F,100,6,0,6
Vardhan,M,100,0,8,8
Kymberlyn,F,100,97,0,97
Emmee,F,100,33,0,33
Abla,F,100,11,0,11
Sathwik,M,100,0,5,5
Khanh,M,57,293,392,685
Yafet,M,100,0,253,253
Darinda,F,100,205,0,205
Jonnathon,M,100,0,52,52
Adal,M,100,0,311,311
Neils,M,100,0,32,32
Lysander,M,100,0,397,397
Cotenia,F,100,6,0,6
Samijah,F,100,15,0,15
Daishawn,M,100,0,495,495
Nolie,F,100,11,0,11
Shavae,F,100,10,0,10
Keenya,F,100,280,0,280
Anneliese,F,100,4316,0,4316
Viraj,M,100,0,625,625
Kartier,M,95,5,86,91
Isela,F,100,4813,0,4813
Tanasha,F,100,606,0,606
Tolga,M,100,0,33,33
Finley,F,60,7416,4909,12325
Eliyohu,M,100,0,90,90
Jamell,M,96,75,1955,2030
Jordanna,F,100,753,0,753
Dareld,M,100,0,16,16
Diezel,M,100,0,204,204
Herod,M,100,0,5,5
Tinka,F,100,10,0,10
Vyctorya,F,100,5,0,5
Giles,M,100,0,1928,1928
Bertrum,M,100,0,85,85
Adwin,M,100,0,45,45
Harlow,F,88,2992,402,3394
Punit,M,100,0,22,22
Blease,M,100,0,21,21
Peony,F,100,31,0,31
Breianne,F,100,11,0,11
Emmalee,F,100,7106,0,7106
Dashun,M,100,0,477,477
Rainie,F,100,510,0,510
Lashuna,F,100,139,0,139
Hyram,M,100,0,10,10
Jerita,F,100,89,0,89
Cadel,M,100,0,122,122
Ginneh,F,100,6,0,6
Maslah,M,100,0,12,12
Praylee,F,100,5,0,5
Denease,F,100,42,0,42
Marcena,F,100,93,0,93
Isel,F,100,253,0,253
Dmitrius,M,100,0,34,34
Orman,M,100,0,141,141
Duante,M,100,0,135,135
Qynn,F,100,5,0,5
Elinore,F,100,233,0,233
Romal,M,100,0,10,10
Zarayah,F,100,71,0,71
Aliziah,F,100,5,0,5
Jalita,F,100,15,0,15
Zaion,M,100,0,53,53
Unknown,M,51,7604,7759,15363
Gelena,F,100,95,0,95
Ariiana,F,100,5,0,5
Georganna,F,100,793,0,793
Nam,M,100,0,1232,1232
Zamaurion,M,100,0,8,8
Bek,M,100,0,5,5
Annaruth,F,100,5,0,5
Ryotaro,M,100,0,37,37
Trenette,F,100,15,0,15
Joua,F,100,65,0,65
Diedrick,M,100,0,10,10
Heywood,M,100,0,63,63
Trampis,M,100,0,29,29
Opeyemi,F,61,30,19,49
Olina,F,100,140,0,140
Lovena,F,100,117,0,117
Menno,M,100,0,695,695
Nyasiah,F,100,159,0,159
Raheam,M,100,0,16,16
Tanner,M,98,1981,85941,87922
Solenn,F,100,5,0,5
Laderrian,M,100,0,5,5
Aydriana,F,100,31,0,31
Lajeanna,F,100,21,0,21
Margare,F,100,6,0,6
Thyron,M,100,0,5,5
Lamere,M,100,0,59,59
Katina,F,100,11051,34,11085
Shayni,F,100,10,0,10
Shauntel,F,99,908,10,918
Scott,M,100,2566,750638,753204
Monetta,F,100,99,0,99
Dawanda,F,100,249,0,249
Adones,M,100,0,5,5
Stu,M,100,0,55,55
Ellyssa,F,100,280,0,280
Rayshaud,M,100,0,21,21
Lachisa,F,100,5,0,5
Chiquita,F,100,5949,6,5955
Yailynn,F,100,12,0,12
Kirtland,M,100,0,7,7
Raniya,F,100,1139,0,1139
Dectrick,M,100,0,7,7
Jadesola,F,100,52,0,52
Sussie,F,100,48,0,48
Lundon,F,70,228,97,325
Ester,F,98,6581,135,6716
Soffia,F,100,86,0,86
Tineka,F,100,255,0,255
Kimanh,F,100,56,0,56
Jaydi,F,100,101,0,101
Joie,F,91,2039,208,2247
Rosicela,F,100,24,0,24
Naderge,F,100,10,0,10
Taraus,M,100,0,17,17
Mell,M,63,43,74,117
Markiel,M,100,0,28,28
Fantaisa,F,100,5,0,5
Sharlon,F,100,63,0,63
Arther,M,100,0,776,776
Kaimere,M,100,0,5,5
Nikka,F,100,392,0,392
Mariapaula,F,100,86,0,86
Aslyn,F,100,294,0,294
Alieu,M,100,0,136,136
Marli,F,100,1742,0,1742
Kerrilynn,F,100,80,0,80
Kiaundra,F,100,35,0,35
Regino,M,100,0,640,640
Joeanna,F,100,317,0,317
Alik,M,98,5,272,277
Davahn,M,100,0,5,5
Jaxxen,M,100,0,63,63
Ryliee,F,100,56,0,56
Pebbles,F,100,874,0,874
Bain,M,100,0,196,196
Gennaro,M,100,0,1238,1238
Otho,M,100,0,401,401
Rin,F,100,98,0,98
Elsworth,M,100,0,85,85
Gareld,M,100,0,40,40
Celynn,F,100,7,0,7
Christophe,M,100,0,4361,4361
Johnlee,M,100,0,40,40
Ceilidh,F,100,107,0,107
Marnie,F,100,5404,0,5404
Marke,M,97,5,159,164
Seleen,F,100,68,0,68
Taylie,F,100,226,0,226
Cindia,F,100,407,0,407
Betanya,F,100,17,0,17
Talysha,F,100,25,0,25
Dayle,F,74,1516,537,2053
Vanisa,F,100,12,0,12
Daemen,M,100,0,12,12
Noberto,M,100,0,36,36
Dysean,M,100,0,5,5
Aisa,F,99,474,5,479
Lorrieann,F,100,27,0,27
Nicolena,F,100,93,0,93
Monolito,M,100,0,37,37
Larizza,F,100,5,0,5
Arturo,M,100,203,45954,46157
Armanda,F,100,822,0,822
Betzayra,F,100,32,0,32
Timone,M,100,0,5,5
Ellanora,F,100,95,0,95
Anan,M,92,5,57,62
Lanya,F,100,753,0,753
Raneem,F,100,489,0,489
Giorgios,M,100,0,7,7
Renauldo,M,100,0,5,5
Liyanah,F,100,5,0,5
Currin,M,100,0,5,5
Carrick,M,100,0,425,425
Eliani,F,100,138,0,138
Joclynn,F,100,128,0,128
Maeta,F,100,5,0,5
Cathrina,F,100,50,0,50
Shamell,M,66,65,128,193
Ysabella,F,100,1376,0,1376
Leandrae,M,100,0,5,5
Isai,M,99,27,5282,5309
Shevy,F,94,170,10,180
Tonasia,F,100,29,0,29
Lashel,F,100,22,0,22
Rahma,F,100,676,0,676
Paislyn,F,100,24,0,24
Jet,M,97,48,1710,1758
Olliver,M,100,0,123,123
Hillip,M,100,0,10,10
Rynlee,F,100,14,0,14
Ravyn,F,99,1880,14,1894
Atahan,M,100,0,10,10
Takeyia,F,100,35,0,35
Shaienne,F,100,5,0,5
Rai,M,68,72,153,225
Keriyah,F,100,7,0,7
Master,M,100,0,294,294
Lanicia,F,100,26,0,26
Xiyah,F,100,5,0,5
Kiersa,F,100,5,0,5
Vaidehi,F,100,146,0,146
Shakayla,F,100,1668,0,1668
Jamisyn,F,96,137,5,142
Rosheen,M,100,0,6,6
Alula,M,100,0,11,11
Florecita,F,100,14,0,14
Reymundo,M,100,0,3094,3094
Cordez,M,100,0,15,15
Armenda,F,100,22,0,22
Kamylle,F,100,67,0,67
Shiloah,F,100,10,0,10
Kennyatta,F,67,10,5,15
Quynton,M,100,0,5,5
Ryneisha,F,100,20,0,20
Almarie,F,100,67,0,67
Quanasia,F,100,184,0,184
Ailia,F,100,45,0,45
Ifeanyi,M,100,0,94,94
Shenetra,F,100,30,0,30
Adriam,M,100,0,5,5
Prosperity,F,100,64,0,64
Aabriella,F,100,10,0,10
Glennisha,F,100,41,0,41
Taba,F,100,5,0,5
Ameera,F,100,1720,0,1720
Barnabas,M,100,0,391,391
Leonice,F,100,5,0,5
Artemis,F,85,609,108,717
Adhara,F,100,14,0,14
Demajae,M,100,0,6,6
Marfil,F,100,17,0,17
Nasr,M,100,0,24,24
Brydon,M,100,0,421,421
Novalee,F,100,1019,0,1019
Wolf,M,100,0,721,721
Annesophie,F,100,40,0,40
Lamarc,M,100,0,13,13
Jerud,M,100,0,16,16
Montrece,F,100,6,0,6
Kashief,M,100,0,29,29
Nayelli,F,100,1058,0,1058
Bow,M,96,5,111,116
Leeshawn,M,100,0,44,44
Nury,F,100,115,0,115
Tambre,F,100,23,0,23
Shantonia,F,100,7,0,7
Eldra,M,100,0,47,47
Akashdeep,M,100,0,65,65
Danayja,F,100,34,0,34
Rosemond,F,72,21,8,29
Leanie,F,100,17,0,17
Caridee,F,100,22,0,22
Pashyn,F,100,5,0,5
Mekhiya,F,100,37,0,37
Samaj,M,93,18,227,245
Shenese,F,100,48,0,48
Shavona,F,100,271,0,271
Jomira,F,100,9,0,9
Shaniqa,F,100,25,0,25
Lynsea,F,100,6,0,6
Jaymisha,F,100,6,0,6
Shuji,M,100,0,6,6
Tedarius,M,100,0,34,34
Rommie,M,100,0,283,283
Maddalena,F,100,549,0,549
Mauricia,F,100,459,0,459
Bourne,M,100,0,6,6
Terryn,F,73,478,179,657
Marcilla,F,100,30,0,30
Coralie,F,100,937,0,937
Yuto,M,100,0,258,258
Meya,F,100,667,0,667
Ahriana,F,100,163,0,163
Samonie,F,100,5,0,5
Emmrie,F,100,21,0,21
Edilson,M,100,0,114,114
Clearence,M,100,0,251,251
Kearstyn,F,100,253,0,253
Jeslynn,F,100,163,0,163
Kamyar,M,100,0,17,17
Naami,F,100,5,0,5
Mida,F,100,22,0,22
Cloudia,F,100,6,0,6
Bryia,F,100,5,0,5
Kaled,M,100,0,192,192
Jadon,M,98,168,8929,9097
Gracielle,F,100,10,0,10
Shanta,F,97,5111,142,5253
Thearsa,F,100,21,0,21
Massey,F,68,32,15,47
Arasely,F,100,244,0,244
Jezebell,F,100,5,0,5
Timmons,M,100,0,7,7
Aurelia,F,100,5538,0,5538
Shereeta,F,100,16,0,16
Roble,M,100,0,10,10
Diana,F,100,285474,1113,286587
Lemisha,F,100,5,0,5
Sharekia,F,100,47,0,47
Micharl,M,100,0,97,97
Raquel,F,99,45171,266,45437
Melvene,F,100,12,0,12
Jaaziah,M,95,6,125,131
Graecie,F,100,6,0,6
Dcarlo,M,100,0,5,5
Johnpeter,M,100,0,30,30
Teashia,F,100,43,0,43
Alyis,M,100,0,25,25
Joselyn,F,100,15360,5,15365
Abdiaziz,M,100,0,107,107
Kyerstin,F,100,5,0,5
Garnet,F,64,966,542,1508
Temi,F,100,10,0,10
Demarque,M,100,0,5,5
Arantxa,F,100,310,0,310
Adaryl,M,100,0,10,10
Adaleyza,F,100,8,0,8
Gloriajean,F,100,25,0,25
Timberland,M,100,0,36,36
Zarrion,M,100,0,10,10
Demeri,F,100,6,0,6
Chantaye,F,100,6,0,6
Eiven,M,100,0,5,5
Rachita,F,100,5,0,5
Camyri,F,100,5,0,5
Emeril,M,80,16,63,79
Ludell,F,100,11,0,11
Tyrielle,F,100,60,0,60
Jonquin,M,100,0,7,7
Harvell,M,100,0,14,14
Lothar,M,100,0,23,23
Karinna,F,100,558,0,558
Hebe,F,100,53,0,53
Jefren,M,100,0,13,13
Vishesh,M,100,0,12,12
Phelix,M,100,0,86,86
Daltan,M,100,0,10,10
Bolanle,F,100,5,0,5
Eloise,F,100,11761,0,11761
Sanya,F,100,1642,0,1642
Tayton,M,98,21,860,881
Noahalexander,M,100,0,6,6
Xzaevion,M,100,0,5,5
Hilary,F,97,23261,759,24020
Dacy,F,100,71,0,71
Shydia,F,100,5,0,5
Marico,M,100,0,388,388
Ehren,M,98,17,1107,1124
Genovia,F,100,11,0,11
Lanaijah,F,100,8,0,8
Premal,M,100,0,10,10
Naiem,M,100,0,37,37
Michellemarie,F,100,6,0,6
Ashane,F,100,5,0,5
Raschad,M,100,0,5,5
Johnaton,M,100,0,243,243
Meike,F,100,20,0,20
Ainsley,F,97,12330,331,12661
Micca,F,100,74,0,74
Jyzelle,F,100,49,0,49
Raynard,M,100,0,2692,2692
Bettyjean,F,100,102,0,102
Torra,F,100,65,0,65
Toufic,M,100,0,7,7
Marelle,F,100,5,0,5
Georgean,F,100,86,0,86
Eleora,F,100,235,0,235
Kaylum,M,100,0,74,74
Nalanie,F,100,178,0,178
Quamari,M,100,0,43,43
Nashyia,F,100,17,0,17
Chaneyra,F,100,9,0,9
Catrice,F,100,1005,0,1005
Niyathi,F,100,29,0,29
Auriyah,F,100,7,0,7
Mariliz,F,100,17,0,17
Tayvone,M,100,0,5,5
Jese,M,100,0,332,332
Breshae,F,100,67,0,67
Herschel,M,100,0,2854,2854
Encarnacion,M,100,0,300,300
Delesia,F,100,83,0,83
Vernitta,F,100,40,0,40
Annamari,F,100,6,0,6
Tequira,F,100,5,0,5
Jaterrian,M,100,0,10,10
Neicha,F,100,5,0,5
Kaio,M,100,0,225,225
Denilah,F,100,6,0,6
Krystyn,F,100,711,0,711
Shelayne,F,100,5,0,5
Tameco,F,100,16,0,16
Vickye,F,100,164,0,164
Mayah,F,100,1841,0,1841
Kalaia,F,100,10,0,10
Nakiea,F,100,66,0,66
Kirrah,F,100,77,0,77
Deedgra,F,100,12,0,12
Mardy,M,78,60,211,271
Azai,M,100,0,82,82
Sorangel,F,100,34,0,34
Crisanta,F,100,39,0,39
Kennedey,F,100,70,0,70
Jamanda,F,100,46,0,46
Zaide,M,57,90,117,207
Batrice,F,100,6,0,6
Traigh,M,100,0,14,14
Shmar,M,100,0,26,26
Rekia,F,100,62,0,62
Shallan,F,100,54,0,54
Uladimir,M,100,0,6,6
Kambreigh,F,100,12,0,12
Tamauri,M,74,10,29,39
Tashaunti,F,100,5,0,5
Johnni,F,94,184,11,195
Shenika,F,100,1839,0,1839
Shakonda,F,100,32,0,32
Araya,F,100,1832,0,1832
Shekitha,F,100,5,0,5
Rodney,M,100,1017,202972,203989
Timonthy,M,100,0,850,850
Waynesha,F,100,62,0,62
Etheleen,F,100,51,0,51
Marlyn,F,86,3396,559,3955
Bayan,F,85,533,92,625
Octavian,M,100,0,895,895
Devarian,M,100,0,10,10
Lonni,F,95,343,19,362
Jayloni,M,100,0,5,5
Christana,F,100,198,0,198
Burnetta,F,100,233,0,233
Zasha,F,100,172,0,172
Bear,M,100,0,619,619
Roen,M,97,11,336,347
Audriana,F,100,3646,0,3646
Gevalia,F,100,5,0,5
Kaysa,F,100,65,0,65
Gennine,F,100,17,0,17
Zora,F,100,2149,5,2154
Monserath,F,100,130,0,130
Uzay,M,100,0,5,5
Tyronica,F,100,145,0,145
Bailey,F,83,88793,18688,107481
Kipling,M,100,0,288,288
Alicyn,F,100,651,0,651
Oluwayemisi,F,100,5,0,5
Jacionna,F,100,7,0,7
Sherief,M,100,0,11,11
Arpad,M,100,0,17,17
Maquel,F,100,24,0,24
Mariani,F,100,37,0,37
Bennard,M,100,0,5,5
Johnaya,F,100,18,0,18
Godson,M,100,0,38,38
Rivky,F,100,1168,0,1168
Bahaa,M,100,0,15,15
Alica,F,100,1251,0,1251
Alshon,M,100,0,5,5
Trance,M,100,0,36,36
Rayvon,M,97,61,1687,1748
Hamlin,M,100,0,5,5
Arcel,M,100,0,12,12
Arcus,M,100,0,6,6
Markon,M,100,0,21,21
Ezmie,F,100,6,0,6
Thea,F,100,7515,0,7515
Pate,M,100,0,135,135
Justion,M,100,0,10,10
Saee,F,100,7,0,7
Marrius,M,100,0,6,6
Obeth,M,100,0,36,36
Jessicamae,F,100,16,0,16
Dakori,M,100,0,7,7
Ricko,M,100,0,50,50
Brynnen,F,59,10,7,17
Sawda,F,100,11,0,11
Kiawana,F,100,18,0,18
Marietha,F,100,14,0,14
Hershall,M,100,0,17,17
Latroy,M,100,0,810,810
Dequarius,M,100,0,329,329
Kaline,F,100,22,0,22
Arhaam,M,100,0,6,6
Khushbu,F,100,133,0,133
Alanna,F,100,19436,7,19443
Anee,F,100,10,0,10
Bradnon,M,100,0,11,11
Lilia,F,100,9620,5,9625
Ozioma,F,100,32,0,32
Tarajee,F,100,18,0,18
Tuula,F,100,15,0,15
Latris,F,100,6,0,6
Chanique,F,100,74,0,74
Allasia,F,100,5,0,5
Leayla,F,100,6,0,6
Yeiri,F,100,18,0,18
Jetli,M,100,0,47,47
Lindi,F,100,1037,0,1037
Catlynn,F,100,143,0,143
Tobias,M,100,0,14519,14519
Arlenne,F,100,131,0,131
Kassidee,F,100,541,0,541
Karstyn,F,100,66,0,66
Korah,F,100,399,0,399
Havala,F,100,14,0,14
Damontez,M,100,0,55,55
Abhinav,M,100,0,1563,1563
Winford,M,100,0,1318,1318
Kathrine,F,100,11100,0,11100
Toluwalope,F,100,5,0,5
Lyllyan,F,100,5,0,5
Langley,F,82,413,89,502
Amiliya,F,100,38,0,38
Yanaiza,F,100,10,0,10
Jhan,M,97,5,154,159
Lilybelle,F,100,64,0,64
Jaquane,M,100,0,120,120
Dahana,F,100,16,0,16
Haiven,F,85,164,28,192
Tandis,F,100,5,0,5
Ingry,F,100,25,0,25
Rickya,F,100,33,0,33
Tanayjah,F,100,10,0,10
Brandais,F,100,5,0,5
Magda,F,100,2514,0,2514
Prestin,M,100,0,616,616
Maide,F,100,5,0,5
Katherine,F,100,452220,1254,453474
Mariatheresa,F,100,40,0,40
Shamada,F,100,5,0,5
Jasreet,F,100,19,0,19
Elizabel,F,100,15,0,15
Dorether,F,100,5,0,5
Nedal,M,100,0,51,51
Yosif,M,100,0,24,24
Jalah,F,99,533,5,538
Eyoel,M,100,0,113,113
Shadell,F,93,66,5,71
Kenedi,F,100,749,0,749
Sheran,F,100,268,0,268
Arundhati,F,100,5,0,5
Lasanda,F,100,6,0,6
Paislei,F,100,44,0,44
Thelia,F,100,63,0,63
Kashi,F,67,10,5,15
Amarion,M,99,44,2977,3021
Tequilia,F,100,6,0,6
Marquees,M,100,0,10,10
Ryu,M,100,0,874,874
Vasili,M,100,0,125,125
Vonita,F,100,291,0,291
Amond,M,100,0,63,63
Kerven,M,100,0,22,22
Cecillia,F,100,438,0,438
Dauna,F,100,139,0,139
Geriel,M,100,0,5,5
Sammara,F,100,27,0,27
Lorana,F,100,25,0,25
Addlie,F,100,6,0,6
Shelsy,F,100,355,0,355
Brownell,M,100,0,6,6
Xsavior,M,100,0,43,43
Keena,F,94,2109,141,2250
Pattiann,F,100,169,0,169
Aleiah,F,100,390,0,390
Jebediah,M,100,0,517,517
Arslan,M,100,0,171,171
Mort,M,100,0,10,10
Armonta,M,100,0,5,5
Crash,M,100,0,28,28
Srilaasya,F,100,5,0,5
Keiralee,F,100,5,0,5
Tawfik,M,100,0,7,7
Montisha,F,100,16,0,16
Tannette,F,100,23,0,23
Henos,M,100,0,24,24
Kanesia,F,100,27,0,27
Monterius,M,100,0,91,91
Lilleah,F,100,6,0,6
Kashyap,M,100,0,44,44
Manika,F,100,195,0,195
Madisyn,F,100,13098,5,13103
Rijad,M,100,0,10,10
Zavier,M,100,5,4369,4374
Jorgina,F,100,64,0,64
Chala,F,100,139,0,139
Rebecca,F,100,651827,1849,653676
Karlie,F,100,9221,0,9221
Kizze,F,100,5,0,5
Snehal,M,89,6,49,55
Lunabella,F,100,47,0,47
Naithan,M,100,0,190,190
Regenald,M,100,0,45,45
Waverley,F,100,40,0,40
Alviery,M,100,0,13,13
Alinson,F,100,17,0,17
Louis,M,99,885,148631,149516
Alessandro,M,100,0,6805,6805
Shinia,F,100,18,0,18
Ameara,F,100,16,0,16
Jurem,M,100,0,27,27
Ouida,F,100,803,0,803
Lanee,F,100,805,0,805
Ivionna,F,100,41,0,41
Ameeria,F,100,6,0,6
Zvi,M,100,0,551,551
Aidah,F,100,75,0,75
Isaiha,M,100,0,606,606
Hadasah,F,100,82,0,82
Dreama,F,100,2403,0,2403
Jaishawn,M,100,0,167,167
Jaydun,M,100,0,23,23
Raeshawn,M,71,124,300,424
Shamaar,M,100,0,34,34
Shanika,F,100,5585,11,5596
Sakeya,F,100,5,0,5
Leonce,M,100,0,77,77
Decory,M,100,0,44,44
Miriama,F,100,5,0,5
Nureen,F,100,5,0,5
Barkley,M,98,5,225,230
Ortencia,F,100,156,0,156
Sayaka,F,100,206,0,206
Tobyn,M,94,14,227,241
Areyona,F,100,21,0,21
Isha,F,100,3451,0,3451
Amelee,F,100,5,0,5
Jvonn,M,100,0,5,5
Charissa,F,100,4960,0,4960
Baila,F,100,1919,0,1919
Giada,F,100,2917,0,2917
Chi,F,56,576,460,1036
Cieara,F,100,528,0,528
Darreion,M,100,0,11,11
Zyshaun,M,100,0,34,34
Eban,M,100,0,219,219
Siobhan,F,100,6620,0,6620
Pammy,F,100,379,0,379
Lanney,M,100,0,18,18
Malerie,F,100,1120,0,1120
Kava,F,100,10,0,10
Hilarion,M,100,0,5,5
Sagen,F,55,23,19,42
Gerson,M,100,0,2865,2865
Bransyn,M,100,0,163,163
Corrissa,F,100,91,0,91
Lenecia,F,100,5,0,5
Amilleon,F,100,10,0,10
Kingjames,M,100,0,59,59
Taquan,M,100,0,1164,1164
Koden,M,100,0,92,92
Ayaka,F,100,383,0,383
Navi,F,80,263,65,328
Jakhyia,F,100,5,0,5
Debara,F,100,306,0,306
Britini,F,100,276,0,276
Jennaleigh,F,100,11,0,11
Roselene,F,100,20,0,20
Deylin,F,73,35,13,48
Lah,F,100,5,0,5
Triumph,M,100,0,26,26
Rodnisha,F,100,69,0,69
Khyran,M,100,0,47,47
Macailah,F,100,5,0,5
Naydine,F,100,55,0,55
Djene,F,100,5,0,5
Daryana,F,100,105,0,105
Haralabos,M,100,0,5,5
Jatoya,F,100,141,0,141
Viya,F,100,10,0,10
Greycen,M,100,0,24,24
Frumie,F,100,11,0,11
Dashonna,F,100,61,0,61
Klyn,F,100,113,0,113
Debroha,F,100,37,0,37
Daiton,M,100,0,149,149
Reggan,F,100,5,0,5
Rahsan,M,100,0,56,56
Hossain,M,100,0,13,13
Mayfield,M,100,0,19,19
Akura,F,100,11,0,11
Costella,F,100,124,0,124
Catherne,F,100,5,0,5
Yehudis,F,100,1377,0,1377
Rowen,M,73,789,2081,2870
Kitana,F,100,1035,0,1035
Buffy,F,100,3263,6,3269
Vermelle,F,100,18,0,18
Laurali,F,100,84,0,84
Aki,M,55,199,243,442
Dnaja,F,100,22,0,22
Keshon,M,96,48,1107,1155
Wiliam,M,100,0,857,857
Carsin,M,100,0,67,67
Adalai,F,100,66,0,66
Quantae,M,100,0,204,204
Ernesha,F,100,64,0,64
Nihal,M,83,94,444,538
Divyansh,M,100,0,12,12
Makenli,F,100,53,0,53
Zyaira,F,100,240,0,240
Shotaro,M,100,0,23,23
Lamine,M,100,0,179,179
Ikra,F,100,5,0,5
Annika,F,100,15647,0,15647
Jameen,M,100,0,5,5
Jenacia,F,100,6,0,6
Raed,M,100,0,307,307
Jayda,F,100,16562,24,16586
Ryett,M,100,0,28,28
Jessianna,F,100,5,0,5
Curron,M,100,0,5,5
Kyrene,F,100,97,0,97
Lonnetta,F,100,61,0,61
Woo,M,100,0,10,10
Comesha,F,100,5,0,5
Jimin,F,58,42,31,73
Kaajal,F,100,5,0,5
Yordany,M,100,0,18,18
Vindetta,F,100,5,0,5
Areille,F,100,12,0,12
Mujahid,M,100,0,269,269
Taffy,F,100,813,0,813
Delancy,F,69,11,5,16
Roxan,F,100,424,0,424
Jeanine,F,100,19967,11,19978
Tamicka,F,100,420,0,420
Berdine,F,100,52,0,52
Ahmi,M,88,5,38,43
Saybree,F,100,5,0,5
Jahkayla,F,100,30,0,30
Rohil,M,100,0,86,86
Sumerlyn,F,100,10,0,10
Ayana,F,100,9569,5,9574
Baylynn,F,100,88,0,88
Jazire,F,100,7,0,7
Krishil,M,100,0,5,5
Tigran,M,100,0,273,273
Humaira,F,100,123,0,123
Petrick,M,100,0,5,5
Tiemeyer,M,100,0,15,15
Billie,F,85,37295,6453,43748
Reymi,M,100,0,5,5
Angelena,F,100,2638,0,2638
Dashae,F,98,243,5,248
Tiereney,F,100,5,0,5
Jaric,M,100,0,49,49
Shanielle,F,100,59,0,59
Thalita,F,100,16,0,16
Leaisha,F,100,13,0,13
Kasen,M,98,94,4556,4650
Raymonde,F,100,31,0,31
Kci,M,100,0,24,24
Nilsa,F,100,1733,0,1733
Yareliz,F,100,166,0,166
Maclaren,F,75,33,11,44
Savera,F,100,67,0,67
Leathan,M,100,0,15,15
Genavieve,F,100,650,0,650
Tzirel,F,100,343,0,343
Lechia,F,100,34,0,34
Yudelca,F,100,6,0,6
Daren,M,98,194,10257,10451
Dkhari,M,100,0,12,12
Dony,M,100,0,22,22
Carson,M,93,6059,83868,89927
Maximilan,M,100,0,6,6
Ronin,M,98,53,3078,3131
Nita,F,100,7008,0,7008
Maiden,F,100,16,0,16
Raford,M,100,0,39,39
Enedina,F,100,1641,0,1641
Saniaa,F,100,43,0,43
Jahsier,M,100,0,25,25
Elodie,F,100,1320,0,1320
Danzel,M,100,0,557,557
Keala,F,97,724,22,746
Wyman,M,100,0,1357,1357
Suhani,F,100,701,0,701
Silver,F,82,1033,232,1265
Smit,M,100,0,41,41
Jolisa,F,100,719,0,719
Daevon,M,100,0,857,857
Waylyn,M,100,0,38,38
Treysean,M,100,0,75,75
Lissy,F,100,58,0,58
Avie,F,99,402,6,408
Josealfredo,M,100,0,152,152
Seira,F,100,124,0,124
Aqilah,F,100,5,0,5
Ardriana,F,100,6,0,6
Timiya,F,100,176,0,176
Astria,F,100,63,0,63
Terryanna,F,100,5,0,5
Lenin,M,100,5,1056,1061
Jeshua,M,100,5,2081,2086
Josefa,F,100,1361,0,1361
Irelynne,F,100,27,0,27
Treca,F,100,21,0,21
Tyshema,F,100,32,0,32
Stphen,M,100,0,25,25
Shenan,F,52,27,25,52
Lakeah,F,100,5,0,5
Camerson,M,100,0,5,5
Jorleny,F,100,5,0,5
Jenali,F,100,6,0,6
Orr,M,78,5,18,23
Dannesha,F,100,20,0,20
Teshika,F,100,6,0,6
Shaelan,F,100,13,0,13
Sabiha,F,100,174,0,174
Velerie,F,100,13,0,13
Chalina,F,100,26,0,26
Devern,M,100,0,10,10
Harpyr,F,100,5,0,5
Annalyne,F,100,5,0,5
Rilyn,F,89,688,84,772
Lestina,F,100,16,0,16
Darletta,F,100,96,0,96
Tessalyn,F,100,22,0,22
Miguelantonio,M,100,0,16,16
Brighton,M,66,964,1843,2807
Tikeshia,F,100,10,0,10
Garwin,M,100,0,17,17
Luiz,M,100,0,2825,2825
Khadeijah,F,100,7,0,7
Angeliza,F,100,11,0,11
Alianah,F,100,154,0,154
Dmiya,F,100,71,0,71
Johnvincent,M,100,0,10,10
Reeghan,F,100,29,0,29
Montinique,F,100,43,0,43
Zadok,M,100,0,246,246
Tandrea,F,100,148,0,148
Emery,F,60,11743,7971,19714
Airys,F,100,5,0,5
Jobanny,M,100,0,62,62
Blondie,F,100,171,0,171
Raoul,M,100,0,1416,1416
Shanitha,F,100,63,0,63
Claribel,F,100,1599,0,1599
Karneisha,F,100,27,0,27
Marijuana,F,100,5,0,5
Adona,F,100,35,0,35
Vershonda,F,100,5,0,5
Shailyn,F,100,726,0,726
Yaindhy,F,100,8,0,8
Navdia,F,100,5,0,5
Sayon,M,100,0,34,34
Sabdiel,M,100,0,12,12
Holdin,M,100,0,5,5
Reeder,M,100,0,10,10
Kenzo,M,100,0,671,671
Saviyon,M,100,0,22,22
Devente,M,100,0,12,12
Nayami,F,100,5,0,5
Abass,M,100,0,68,68
Marlyna,F,100,10,0,10
Maanav,M,100,0,108,108
Nkemdilim,F,100,7,0,7
Claresa,F,100,35,0,35
Olu,M,100,0,7,7
Tlyer,M,100,0,6,6
Dellis,M,100,0,5,5
Jastyn,F,100,11,0,11
Pashia,F,100,13,0,13
Carletha,F,100,457,0,457
Anastasija,F,100,109,0,109
Latrina,F,100,2318,0,2318
Yosha,F,100,37,0,37
Dwon,M,100,0,160,160
Fronie,F,100,5,0,5
Lakendric,M,100,0,31,31
Harry,M,100,444,96534,96978
Christabel,F,100,489,0,489
Trysten,M,81,285,1188,1473
Thadd,M,100,0,145,145
Ardyth,F,100,128,0,128
Leira,F,100,219,0,219
Maylin,F,100,1897,0,1897
Zevyn,M,100,0,7,7
Anabel,F,100,8013,35,8048
Arisha,F,100,503,0,503
Lashurn,F,100,5,0,5
Shabreka,F,100,70,0,70
Kasy,F,100,55,0,55
Artesha,F,100,153,0,153
Wajd,F,100,5,0,5
Trishawna,F,100,5,0,5
Kovid,M,100,0,5,5
Taraann,F,100,54,0,54
Lamaar,M,100,0,6,6
Charleeann,F,100,11,0,11
Dein,M,100,0,5,5
Sharunda,F,100,59,0,59
Chava,F,100,2276,0,2276
Shailene,F,100,118,0,118
Averylynn,F,100,17,0,17
Vience,M,100,0,5,5
Rory,M,82,4946,22819,27765
Aryaman,M,100,0,217,217
Can,M,100,0,324,324
Camlyn,F,100,12,0,12
Tahlil,M,100,0,17,17
Elianagrace,F,100,5,0,5
Mardochee,M,100,0,34,34
Tiwan,M,92,10,123,133
Danet,F,100,11,0,11
Marriah,F,100,665,0,665
Isaabella,F,100,5,0,5
Kentrall,M,100,0,12,12
Brianie,F,100,5,0,5
Esiquiel,M,100,0,5,5
Roszella,F,100,5,0,5
Lilliane,F,100,123,0,123
Kijafa,F,100,16,0,16
Lillyaunna,F,100,11,0,11
Tamaran,F,100,6,0,6
Arisela,F,100,15,0,15
Mylani,F,100,90,0,90
Ritch,M,100,0,25,25
Sifat,M,100,0,5,5
Deshannon,F,63,193,114,307
Gaby,F,98,1030,26,1056
Kaydance,F,100,1277,0,1277
Elyanah,F,100,47,0,47
Halston,M,81,108,456,564
Binita,F,100,5,0,5
Steffane,F,100,6,0,6
Reily,M,61,323,496,819
Thereas,F,100,21,0,21
Aiko,F,100,690,0,690
Trinesha,F,100,26,0,26
Taylee,F,100,1337,0,1337
Trameka,F,100,131,0,131
Teneile,F,100,5,0,5
Shyhiem,M,100,0,158,158
Nathel,M,100,0,5,5
Richetta,F,100,172,0,172
Rustie,F,100,44,0,44
Edwad,M,100,0,6,6
Idris,M,100,10,2097,2107
Yuhanna,M,100,0,5,5
Demetree,M,100,0,26,26
Rami,M,92,212,2461,2673
Sharee,F,100,3712,0,3712
Deanthony,M,100,0,2874,2874
Oonagh,F,100,22,0,22
Aanand,M,100,0,5,5
Xolani,F,100,47,0,47
Aneudi,M,100,0,16,16
Timo,M,100,0,155,155
Stylz,M,100,0,7,7
Sahara,F,100,3348,5,3353
Kimarri,F,100,5,0,5
Annetra,F,100,33,0,33
Shatoya,F,100,840,0,840
Shawntika,F,100,5,0,5
Chassy,F,100,18,0,18
Cindylou,F,100,44,0,44
Tinalouise,F,100,12,0,12
Catalin,F,100,5,0,5
Jackalyn,F,100,538,0,538
Latalia,F,100,88,0,88
Pearlie,F,98,3008,76,3084
Nabeel,M,100,0,927,927
Farris,M,88,174,1261,1435
Makensy,F,100,51,0,51
Demont,M,100,0,522,522
Elannah,F,100,11,0,11
Lillyin,F,100,32,0,32
Phyllicia,F,100,135,0,135
Jwana,F,100,22,0,22
Edelmiro,M,100,0,361,361
Endiyah,F,100,31,0,31
Liduvina,F,100,25,0,25
Vansh,M,100,0,411,411
Shenetha,F,100,54,0,54
Garen,M,99,7,931,938
Burnett,M,82,91,421,512
Therese,F,100,22464,0,22464
Jackston,M,100,0,60,60
Yanisha,F,100,43,0,43
Quenten,M,100,0,675,675
Ariba,F,100,82,0,82
Ola,F,99,2770,40,2810
Nimisha,F,100,121,0,121
Eimly,F,100,5,0,5
Sofia,F,100,96921,97,97018
Cereniti,F,100,46,0,46
Treves,M,100,0,5,5
Shanea,F,100,1130,0,1130
Valo,M,100,0,11,11
Livio,M,100,0,27,27
Quamir,M,100,0,423,423
Rickye,M,100,0,42,42
Lilliyn,F,100,5,0,5
Britiney,F,100,92,0,92
Jalien,M,94,5,76,81
Keyiona,F,100,10,0,10
Latefah,F,100,5,0,5
Chubby,M,100,0,14,14
Annalice,F,100,5,0,5
Earskin,M,100,0,5,5
Tomasz,M,100,0,675,675
Tyras,M,100,0,10,10
Jurian,M,100,0,12,12
Marcedes,F,98,286,5,291
Salote,F,100,57,0,57
Diandre,M,97,15,545,560
Krishiv,M,100,0,246,246
Tavoris,M,100,0,526,526
Greggory,M,100,0,4927,4927
Nicolas,M,100,169,76942,77111
Saranya,F,100,151,0,151
Lianni,F,100,72,0,72
Dalice,F,100,22,0,22
Kareny,F,100,7,0,7
Yuneicy,F,100,5,0,5
Marquael,M,100,0,5,5
Lino,M,100,0,2776,2776
Lonika,F,100,5,0,5
Camisha,F,100,988,0,988
Liliyanna,F,100,5,0,5
Ostara,F,100,5,0,5
Lukeshia,F,100,11,0,11
Abdulloh,M,100,0,20,20
Janiha,F,100,21,0,21
Vinayak,M,100,0,121,121
Daiman,M,100,0,7,7
Tajmir,M,100,0,21,21
Daidra,F,100,5,0,5
Ryo,M,100,0,569,569
Naticia,F,100,32,0,32
Reggy,M,100,0,52,52
Rossanna,F,100,60,0,60
Ariyana,F,100,2611,0,2611
Malakhai,M,100,0,133,133
Shaqunna,F,100,26,0,26
Sifan,F,100,10,0,10
Nylaa,F,100,24,0,24
Patia,F,100,50,0,50
Riyah,F,100,255,0,255
Dafney,F,100,84,0,84
Keimaya,F,100,6,0,6
Izaan,M,100,0,137,137
Anlly,F,100,10,0,10
Leldon,M,100,0,36,36
Teel,F,100,18,0,18
Lyal,M,100,0,5,5
Bayze,M,100,0,6,6
Dustina,F,100,169,0,169
Cyler,M,100,0,483,483
Kunaal,M,100,0,65,65
Attica,F,100,6,0,6
Aysen,M,100,0,51,51
Angelmanuel,M,100,0,10,10
Abiona,F,100,19,0,19
Seely,F,74,14,5,19
Chinna,F,100,38,0,38
Jasjeet,M,100,0,6,6
Lianne,F,100,2670,0,2670
Oliwia,F,100,204,0,204
Dix,M,100,0,5,5
Dejone,F,100,8,0,8
Veto,M,100,0,16,16
Vandra,F,100,5,0,5
Mahli,F,100,80,0,80
Ellsworth,M,100,0,821,821
Ailani,F,100,1248,0,1248
Cavin,M,100,0,1221,1221
Miaisha,F,100,12,0,12
Maribeth,F,100,5040,0,5040
Hadji,M,100,0,5,5
Rayquan,M,100,0,1088,1088
Samyria,F,100,87,0,87
Margo,F,100,16496,22,16518
Kenesha,F,100,986,0,986
Wendee,F,100,773,0,773
Laithan,M,100,0,62,62
Jesus,M,99,1913,195330,197243
Maradee,F,100,5,0,5
Adryann,F,100,5,0,5
Lavayah,F,100,51,0,51
Porshe,F,100,270,0,270
Kalissa,F,100,915,0,915
Charnay,F,100,164,0,164
Viliami,M,100,0,404,404
Menelik,M,100,0,248,248
Thomson,M,100,0,176,176
Marthella,F,100,5,0,5
Mahely,F,100,5,0,5
Yalissa,F,100,111,0,111
Dhyan,M,100,0,127,127
Charlotta,F,100,583,0,583
Helyn,F,100,97,0,97
Altonya,F,100,5,0,5
Tamariah,F,100,21,0,21
Shakyia,F,100,108,0,108
Vivette,F,100,6,0,6
Tyhisa,F,100,6,0,6
Gyda,F,100,6,0,6
Maryla,F,100,8,0,8
Kashiya,F,100,48,0,48
Fairley,M,100,0,5,5
Rickson,M,100,0,40,40
Abreia,F,100,6,0,6
Sherrise,F,100,64,0,64
Chianne,F,100,354,0,354
Ronld,M,100,0,17,17
Epifanio,M,100,0,1031,1031
Gizzel,F,100,36,0,36
Travian,M,100,0,303,303
Jassiah,M,90,17,156,173
Nuradin,M,100,0,5,5
Keishi,M,100,0,10,10
Cyrita,F,100,5,0,5
Tarji,F,100,46,0,46
Gudelia,F,100,51,0,51
Arona,F,62,10,6,16
Zavior,M,100,0,176,176
Azante,M,100,0,5,5
Lynnly,F,100,6,0,6
Lashell,F,100,993,0,993
Laiten,M,100,0,8,8
Kerwin,M,100,0,2069,2069
Ronan,M,99,54,7045,7099
Maxden,M,100,0,35,35
Cardel,M,100,0,16,16
Maylia,F,100,55,0,55
Shaynah,F,100,106,0,106
Clevester,M,100,0,44,44
Najiah,F,100,41,0,41
Chelene,F,100,22,0,22
Rayjay,M,100,0,10,10
Nhyla,F,100,52,0,52
Demarien,M,100,0,47,47
Keyaan,M,100,0,117,117
Garri,F,100,5,0,5
Trinh,F,100,435,0,435
Kriss,M,60,362,537,899
Murlean,F,100,12,0,12
Andony,M,100,0,23,23
Caron,F,75,2701,883,3584
Kire,M,94,5,80,85
Asialyn,F,100,31,0,31
Treshon,M,100,0,389,389
Barbarita,F,100,78,0,78
Davyd,M,100,0,108,108
Brookelynne,F,100,243,0,243
Traeton,M,100,0,149,149
Joshelyn,F,100,56,0,56
Jery,M,100,0,89,89
Thaj,M,100,0,5,5
Amais,M,100,0,5,5
Dalaney,F,100,492,0,492
Semaj,M,77,1611,5274,6885
Arcella,F,100,6,0,6
Ashante,F,89,1443,172,1615
Gervaise,F,100,16,0,16
Arsenial,M,100,0,6,6
Patericia,F,100,22,0,22
Yanna,F,100,439,0,439
Minahil,F,100,141,0,141
Eugenie,F,100,1121,0,1121
Demingo,M,100,0,6,6
Xzavior,M,100,0,375,375
Calixtro,M,100,0,5,5
Ketsy,F,100,7,0,7
Dyllen,M,100,0,174,174
Chailee,F,100,16,0,16
Welsey,M,100,0,33,33
Drystan,M,100,0,72,72
Saequan,M,100,0,6,6
Derykah,F,100,27,0,27
Demetrianna,F,100,5,0,5
Nekiyah,F,100,20,0,20
Donnell,M,94,865,12489,13354
Taleisha,F,100,207,0,207
Temetrius,F,100,5,0,5
Korry,M,97,12,360,372
Taitianna,F,100,5,0,5
Cathee,F,100,17,0,17
Madyline,F,100,44,0,44
Voncia,F,100,29,0,29
Zyerre,M,100,0,6,6
Shamirah,F,100,213,0,213
Arif,M,100,0,587,587
Maraih,F,100,11,0,11
Kellia,F,100,5,0,5
Jashley,F,100,62,0,62
Camya,F,100,498,0,498
Brandan,M,98,96,5514,5610
Anddy,M,100,0,64,64
Breandra,F,100,7,0,7
Serjio,M,100,0,978,978
Keben,M,100,0,13,13
Teniah,F,100,34,0,34
Kawanna,F,100,551,0,551
Johneen,F,100,11,0,11
Gianne,F,100,60,0,60
Jovahny,M,100,0,5,5
Cadien,M,100,0,41,41
Starlit,F,100,87,0,87
Jaleana,F,100,18,0,18
Nitika,F,100,144,0,144
Tareq,M,100,0,296,296
Starlina,F,100,57,0,57
Yailen,F,100,69,0,69
Sourish,M,100,0,62,62
Joshaua,M,100,0,208,208
Stevephen,M,100,0,11,11
Swannie,F,100,13,0,13
Harriet,F,100,12648,5,12653
Susane,F,100,121,0,121
Lanayia,F,100,20,0,20
Makarah,F,100,5,0,5
Daviante,M,100,0,18,18
Shalen,F,87,72,11,83
Lateefah,F,100,617,0,617
Thereasa,F,100,320,0,320
Jaguar,M,100,0,51,51
Hesham,M,100,0,341,341
Aritra,M,100,0,5,5
Katelon,F,100,5,0,5
Lakeela,F,100,5,0,5
Sheril,F,100,623,0,623
Lizbhet,F,100,24,0,24
Feda,F,100,5,0,5
Gennevieve,F,100,5,0,5
Ridhima,F,100,119,0,119
Ariagna,F,100,17,0,17
Mariaann,F,100,5,0,5
Eudora,F,100,396,0,396
Lamonique,F,100,6,0,6
Andis,M,100,0,5,5
Shawntelle,F,100,211,0,211
Vyncent,M,100,0,52,52
Meredeth,F,100,103,0,103
Churchill,M,100,0,11,11
Haddasah,F,100,5,0,5
Javonia,F,100,5,0,5
Breunna,F,100,276,0,276
Philipe,M,100,0,147,147
Haileyann,F,100,81,0,81
Jerrin,M,97,16,468,484
Rosolyn,F,100,12,0,12
Izamar,F,99,512,7,519
Jaxonjames,M,100,0,5,5
Jenitza,F,100,24,0,24
Luellen,F,100,239,0,239
Cresencia,F,100,24,0,24
Camaree,M,55,5,6,11
Kemia,F,100,87,0,87
Mandrill,M,100,0,29,29
Tenea,F,100,168,0,168
Angellea,F,100,29,0,29
Gwynette,F,100,13,0,13
Deion,M,98,123,4859,4982
Nurani,M,100,0,5,5
Traysen,M,100,0,44,44
Tamerick,M,100,0,6,6
Kiela,F,100,276,0,276
Lagreta,F,100,17,0,17
Jannalyn,F,100,10,0,10
Bryndle,F,100,53,0,53
Krishani,F,100,5,0,5
Shirlene,F,100,2936,0,2936
Regen,F,62,10,6,16
Lised,F,100,5,0,5
Quintero,M,100,0,7,7
Devon,M,78,19539,67752,87291
Marwin,M,100,0,307,307
Lynice,F,100,18,0,18
Sandhya,F,100,483,0,483
Nived,M,100,0,23,23
Ziya,F,98,542,10,552
Morion,M,100,0,5,5
Aldwin,M,100,0,124,124
Zenia,F,100,1295,0,1295
Grigory,M,100,0,5,5
Shakenia,F,100,32,0,32
Senya,F,100,108,0,108
Hoyt,M,100,0,2590,2590
Srinath,M,100,0,32,32
Torenzo,M,100,0,11,11
Aleighana,F,100,5,0,5
Yesenio,F,100,6,0,6
Elliza,F,100,21,0,21
Monelle,F,100,6,0,6
Urijah,M,97,78,2389,2467
Anju,F,100,181,0,181
Alejando,M,100,0,30,30
Airen,F,57,135,103,238
Carolyna,F,100,149,0,149
Bernitta,F,100,10,0,10
Shreeta,F,100,10,0,10
Saige,F,90,5903,641,6544
Kieayla,F,100,18,0,18
Mykaya,F,100,12,0,12
Dequavius,M,100,0,82,82
Zaya,F,99,700,10,710
Amena,F,100,695,0,695
Tashanika,F,100,5,0,5
Xoe,F,100,284,0,284
Kiam,M,100,0,79,79
Rifat,M,100,0,56,56
Allisan,F,100,34,0,34
Stefanie,F,100,36338,43,36381
Mackenlie,F,100,5,0,5
Jozett,F,100,5,0,5
Janinne,F,100,41,0,41
Donny,M,100,40,10736,10776
Tarla,F,100,56,0,56
Verbon,M,100,0,13,13
Victoriano,M,100,0,830,830
Abraam,M,100,0,42,42
Saban,M,100,0,65,65
Milele,F,100,6,0,6
Keba,F,100,36,0,36
Cris,M,71,1042,2594,3636
Sequoya,F,99,488,5,493
Nara,F,97,490,17,507
Ronalda,F,100,245,0,245
Tawania,F,100,137,0,137
Asanti,F,81,203,48,251
Rakye,M,100,0,10,10
Motty,M,100,0,43,43
Janele,F,100,256,0,256
Jessilynn,F,100,95,0,95
Deneishia,F,100,5,0,5
Ryleighann,F,100,22,0,22
Baltazar,M,100,0,1988,1988
Dimarion,M,100,0,5,5
Anjanetta,F,100,36,0,36
Mertice,F,100,11,0,11
Anyelo,M,100,0,56,56
Caye,F,100,47,0,47
Leslieanne,F,100,93,0,93
Saleena,F,100,656,0,656
Zenaido,M,100,0,35,35
Somaly,F,100,75,0,75
Jaxom,M,100,0,17,17
Bryce,M,97,2776,101088,103864
Jarely,F,100,773,0,773
Baylen,M,88,109,801,910
Niia,F,100,6,0,6
Ronicia,F,100,27,0,27
Venis,F,100,37,0,37
Zenaida,F,100,2134,0,2134
Heyli,F,100,62,0,62
Taylenn,F,100,5,0,5
Zakiyah,F,100,1399,0,1399
Vallorie,F,100,93,0,93
Gretal,F,100,5,0,5
Travaun,M,100,0,5,5
Lilyiana,F,100,6,0,6
Nieko,M,100,0,199,199
Catrena,F,100,365,0,365
Abbas,M,100,0,1040,1040
Adelayda,F,100,14,0,14
Cornelious,M,100,0,1156,1156
Philipp,M,100,0,752,752
Regana,F,100,68,0,68
Dester,M,100,0,7,7
Rogerio,M,100,0,363,363
Jahnee,F,100,56,0,56
Rotasha,F,100,42,0,42
Kullin,M,100,0,6,6
Cesalie,F,100,12,0,12
Miliah,F,100,28,0,28
Natallie,F,100,480,0,480
Yakir,M,100,0,58,58
Addicus,M,100,0,5,5
Quadasha,F,100,28,0,28
Gretchyn,F,100,47,0,47
Hasly,F,100,6,0,6
Drucella,F,100,42,0,42
Lakelan,M,100,0,5,5
Tylie,F,100,323,0,323
Tion,M,96,16,377,393
Emiah,F,100,151,0,151
Khylan,M,97,5,181,186
Deborha,F,100,1071,0,1071
Khiryn,M,100,0,7,7
Virgini,F,100,5,0,5
Nahomie,F,100,15,0,15
Zyreion,M,100,0,5,5
Dontavias,M,100,0,5,5
Drashawn,M,100,0,13,13
Sakari,F,90,366,40,406
Atyia,F,100,15,0,15
Rahni,F,100,16,0,16
Prithika,F,100,23,0,23
Tyneshia,F,100,574,0,574
Jerlyn,F,100,184,0,184
Gilroy,M,100,0,27,27
Ahtyana,F,100,5,0,5
Ivaya,F,100,6,0,6
Lachay,F,100,6,0,6
Jovonda,F,100,58,0,58
Guinivere,F,100,22,0,22
Viggo,M,100,0,365,365
Evay,M,100,0,6,6
Everardo,M,100,0,3927,3927
Jenaiya,F,100,37,0,37
Shamicka,F,100,172,0,172
Lavetra,F,100,6,0,6
Lizette,F,100,11569,5,11574
Brynden,M,100,0,249,249
Kilo,M,100,0,54,54
Kavona,F,100,12,0,12
Cedarius,M,100,0,89,89
Timohty,M,100,0,272,272
Naiden,M,100,0,38,38
Markchristopher,M,100,0,6,6
Natalija,F,100,166,0,166
Cappie,F,100,31,0,31
Milen,M,75,20,59,79
Reyaan,M,100,0,34,34
Gaynelle,F,100,406,0,406
Maybelin,F,100,6,0,6
Jazayah,F,100,50,0,50
Ileia,F,100,11,0,11
Ramesses,M,100,0,46,46
Mashauna,F,100,5,0,5
Jayton,M,100,0,690,690
Noriel,M,100,0,49,49
Tokina,F,100,5,0,5
Niegel,M,100,0,29,29
Whitney,F,96,94269,4247,98516
Bralie,F,100,7,0,7
Arch,M,100,0,407,407
Cymphonique,F,100,12,0,12
Fatumata,F,100,158,0,158
Chantall,F,100,39,0,39
Kym,F,88,1297,173,1470
Kilan,M,100,0,57,57
Karmella,F,100,284,0,284
Deshanon,M,100,0,5,5
Mohit,M,100,0,404,404
Mamady,M,100,0,23,23
Pono,M,100,0,25,25
Nareg,M,100,0,141,141
Midnight,F,100,8,0,8
Najib,M,100,0,280,280
Kabe,M,100,0,62,62
Hriyaan,M,100,0,5,5
Ihsaan,M,100,0,37,37
Caprial,F,100,12,0,12
Tamarah,F,100,1292,0,1292
Earline,F,100,3269,0,3269
Graem,M,100,0,7,7
Patrickjames,M,100,0,23,23
Ruffus,M,100,0,68,68
Brandell,M,93,6,86,92
Adner,M,100,0,12,12
Marquies,M,100,0,438,438
Jayli,F,100,349,0,349
Shirlie,F,100,192,0,192
Maybeline,F,100,30,0,30
Lakenzie,F,100,63,0,63
Dequante,M,100,0,126,126
Aireana,F,100,194,0,194
Jathon,M,100,0,16,16
Nadina,F,100,442,0,442
Jacella,F,100,6,0,6
Saquoia,F,100,70,0,70
Bron,M,100,0,378,378
Ladena,F,100,381,0,381
Tavarres,M,100,0,8,8
Azusa,F,100,32,0,32
Detavious,M,100,0,88,88
Zackory,M,100,0,460,460
Cebastian,M,100,0,133,133
Marvenia,F,100,6,0,6
Alsha,F,100,106,0,106
Lakyn,F,98,1709,37,1746
Digna,F,100,466,0,466
Uniquewa,F,100,5,0,5
Raniqua,F,100,17,0,17
Lakeley,F,100,5,0,5
Zykel,M,100,0,35,35
Makeyla,F,100,239,0,239
Chancler,M,100,0,18,18
Debraca,F,100,7,0,7
Sanyiah,F,100,130,0,130
Marajade,F,100,56,0,56
Kerrah,F,100,21,0,21
Aaleahya,F,100,15,0,15
Vernicia,F,100,36,0,36
Husani,M,100,0,36,36
Estaban,M,100,0,209,209
Jeanluke,M,100,0,12,12
Sheneika,F,100,78,0,78
Janique,F,100,510,0,510
Zareh,M,100,0,17,17
Feliz,M,56,192,240,432
Shadaisha,F,100,23,0,23
Desmund,M,100,0,120,120
Aarielle,F,100,24,0,24
Jamual,M,100,0,34,34
Donnae,F,100,85,0,85
Haru,M,83,18,85,103
Sherial,F,100,88,0,88
Jenesa,F,100,109,0,109
Santo,M,100,0,1959,1959
Kiaunna,F,100,31,0,31
Haleh,F,100,25,0,25
Naevia,F,100,117,0,117
Clairese,F,100,22,0,22
Amanni,F,100,36,0,36
Terasha,F,100,13,0,13
Manina,F,100,38,0,38
Graig,M,100,0,1295,1295
Frezell,M,100,0,5,5
Takeyshia,F,100,6,0,6
Toxi,F,100,5,0,5
Delita,F,100,122,0,122
Shakyria,F,100,16,0,16
Raizel,F,100,1099,0,1099
Sherille,F,100,11,0,11
Nyelli,F,100,75,0,75
Danarius,M,100,0,116,116
Martir,M,100,0,20,20
Lavonn,F,70,38,16,54
Jnia,F,100,22,0,22
Millah,F,100,7,0,7
Kathline,F,100,200,0,200
Mairene,F,100,11,0,11
Alleigha,F,100,5,0,5
Celina,F,100,12554,6,12560
Iffany,F,100,31,0,31
Dessire,F,100,87,0,87
Kinshasa,F,95,116,6,122
Charlecia,F,100,10,0,10
Larrion,M,100,0,51,51
Saamiya,F,100,88,0,88
Helma,F,100,5,0,5
Erieonna,F,100,5,0,5
Dijone,F,100,6,0,6
Adnrea,F,100,5,0,5
Rayniah,F,100,46,0,46
Kaylen,F,87,5917,904,6821
Semra,F,100,53,0,53
Tineshia,F,100,92,0,92
Bentley,M,94,1951,28196,30147
Jordyne,F,100,311,0,311
Ashanda,F,100,23,0,23
Christon,M,82,231,1058,1289
Delcina,F,100,46,0,46
Venecia,F,100,725,0,725
Kyi,M,61,28,44,72
Adoniz,M,100,0,5,5
Bassel,M,100,0,205,205
Cashanda,F,100,6,0,6
Bobi,F,100,580,0,580
Rikki,F,91,6443,605,7048
Kresta,F,100,160,0,160
Memori,F,100,35,0,35
Akeylah,F,100,135,0,135
Javin,M,100,5,2049,2054
Kyauna,F,100,44,0,44
Hoby,M,100,0,84,84
Paytton,F,100,34,0,34
Iiesha,F,100,36,0,36
Zendell,M,100,0,12,12
Mykiyah,F,100,10,0,10
Kapricia,F,100,5,0,5
Darin,M,99,359,32031,32390
Leevi,M,100,0,474,474
Greidis,F,100,34,0,34
Jaggar,M,100,0,206,206
Sammey,M,100,0,15,15
Yarazeth,F,100,6,0,6
Efosa,M,100,0,47,47
Nalisa,F,100,10,0,10
Brehana,F,100,28,0,28
Kaycia,F,100,20,0,20
Dionnah,F,100,5,0,5
Kaylina,F,100,303,0,303
Broderic,M,100,0,180,180
Latorya,F,100,532,0,532
Claud,M,100,0,1101,1101
Sharley,F,100,102,0,102
Elva,F,99,6862,88,6950
Falicia,F,100,651,0,651
Lilyannah,F,100,58,0,58
Chyanne,F,100,2749,5,2754
Deonia,F,100,6,0,6
Chrles,M,100,0,198,198
Chandan,M,100,0,54,54
Hinsley,F,100,6,0,6
Kathyanne,F,100,6,0,6
Zytavion,M,100,0,5,5
Brezae,F,100,7,0,7
Denyelle,F,100,7,0,7
Hays,M,100,0,236,236
Charmian,F,100,230,0,230
Melachi,M,100,0,51,51
Lemoyne,M,100,0,72,72
Yosue,M,100,0,16,16
Chanise,F,100,333,0,333
Jamoni,M,57,95,127,222
Izmael,M,100,0,107,107
Evelett,F,100,33,0,33
Amye,F,100,549,0,549
Jayvius,M,100,0,10,10
Zaiya,F,100,180,0,180
Vadie,F,100,8,0,8
Brandtley,M,100,0,18,18
Leshaunda,F,100,10,0,10
Fina,F,100,205,0,205
Addalin,F,100,8,0,8
Bayley,F,80,1761,435,2196
Cynda,F,100,509,0,509
Derrian,M,87,88,615,703
Jovianne,F,100,11,0,11
Orionna,F,100,23,0,23
Sabrian,F,100,28,0,28
Haasini,F,100,132,0,132
Jaswinder,M,100,0,5,5
Diasia,F,100,178,0,178
Zeltzin,F,100,34,0,34
Jabarion,M,100,0,9,9
Khylei,F,100,86,0,86
Karington,F,100,153,0,153
Kace,M,98,13,733,746
Riely,M,50,175,177,352
Brycelyn,F,100,80,0,80
Monchel,F,100,56,0,56
Gaylon,M,93,140,1997,2137
Guinevere,F,100,1707,0,1707
Jazayvion,M,100,0,5,5
Maricielo,F,100,6,0,6
Jediael,M,100,0,18,18
Jakaiden,M,100,0,108,108
Cammeron,M,100,0,194,194
Keyron,M,100,0,195,195
Aiyden,M,100,0,385,385
Ketron,M,100,0,27,27
Mieasha,F,100,17,0,17
Taim,M,100,0,101,101
Maisley,F,100,23,0,23
Lirio,F,100,109,0,109
Sherrika,F,100,176,0,176
Kaniylah,F,100,5,0,5
Carley,F,99,15249,126,15375
Lenoxx,M,100,0,15,15
Kielyn,F,92,59,5,64
Lorren,F,70,398,170,568
Jackqulyn,F,100,69,0,69
Malisha,F,100,621,0,621
Holdan,M,100,0,57,57
Avella,F,100,25,0,25
Vanassa,F,100,365,0,365
Yadir,M,100,0,103,103
Genel,F,100,24,0,24
Herculano,M,100,0,5,5
Ezmeralda,F,100,286,0,286
Devaun,M,100,0,369,369
Aryal,F,100,38,0,38
Jiuliana,F,100,13,0,13
Lasedrick,M,100,0,5,5
Jocsan,M,100,0,173,173
Jonay,F,100,151,0,151
Rhyin,F,100,5,0,5
Keeton,M,100,0,750,750
Osvaldo,M,100,12,12859,12871
Bonnetta,F,100,68,0,68
Dyneisha,F,100,70,0,70
Lacedric,M,100,0,56,56
Daleshia,F,100,5,0,5
Kwamin,M,100,0,5,5
Santa,F,100,2021,10,2031
Demecio,M,100,0,16,16
Yulia,F,100,368,0,368
Damarae,M,100,0,5,5
Sharra,F,100,457,0,457
Marga,F,100,191,0,191
Tuwana,F,100,176,0,176
Jameesha,F,100,28,0,28
Jordee,F,100,5,0,5
Kriselle,F,100,17,0,17
Rigoberto,M,100,7,10267,10274
Jameera,F,100,16,0,16
Vanessa,F,100,247069,983,248052
Ranjan,M,100,0,6,6
Jazmon,F,86,225,36,261
Koner,M,100,0,28,28
Pandi,F,100,5,0,5
Caera,F,100,66,0,66
Tresten,M,100,0,134,134
Zailyn,F,67,141,68,209
Aniiyah,F,100,28,0,28
Nery,M,83,267,1281,1548
Daizee,F,100,66,0,66
Brigida,F,100,426,0,426
Kathia,F,100,1239,0,1239
Tiasha,F,100,371,0,371
Ripley,F,76,637,203,840
Brayde,M,100,0,37,37
Mega,F,100,108,0,108
Marigold,F,100,165,0,165
Tanyjah,F,100,26,0,26
Linae,F,100,42,0,42
Mariele,F,100,40,0,40
Alexy,F,55,345,284,629
Aquiel,F,100,5,0,5
Tacuma,M,100,0,87,87
Ethridge,M,100,0,11,11
Shango,M,100,0,28,28
Jennifier,F,100,506,0,506
Jayona,F,100,237,0,237
Abdula,M,100,0,39,39
Alfonso,M,100,80,27342,27422
Karch,M,100,0,46,46
Glorianne,F,100,127,0,127
Adeyinka,F,50,5,5,10
Aaban,M,100,0,72,72
Aleacia,F,100,32,0,32
Kinesha,F,100,127,0,127
Tomeka,F,100,3627,6,3633
Ameila,F,100,196,0,196
Jainiya,F,100,10,0,10
Yavette,F,100,40,0,40
Isairis,F,100,5,0,5
Lartarsha,F,100,6,0,6
Rosalei,F,100,10,0,10
Ekaterini,F,100,197,0,197
Ivalee,F,100,9,0,9
Teresita,F,100,2688,0,2688
Creedence,M,75,37,113,150
Zarien,M,100,0,20,20
Aidanjames,M,100,0,6,6
Meshan,F,100,6,0,6
Jessika,F,100,5835,0,5835
Saamir,M,100,0,55,55
Skyelin,F,100,12,0,12
Maribell,F,100,512,0,512
Kalyb,M,100,0,166,166
Jarreth,M,100,0,50,50
Aubrianne,F,100,132,0,132
Dasmine,F,59,51,36,87
Saniyyah,F,100,210,0,210
Dailene,F,100,19,0,19
Doretha,F,100,3602,0,3602
Startasia,F,100,5,0,5
Jeorge,M,100,0,330,330
Elorah,F,100,80,0,80
Laporchea,F,100,5,0,5
Colm,M,100,0,496,496
Raffi,M,100,0,683,683
Staffon,M,100,0,33,33
Usman,M,100,0,993,993
Moishy,M,100,0,44,44
Kaito,M,100,0,568,568
Emaad,M,100,0,89,89
Sulinda,F,100,15,0,15
Priella,F,100,5,0,5
Anayis,F,100,5,0,5
Armisha,F,100,16,0,16
Valdimir,M,100,0,5,5
Jofiel,M,100,0,19,19
Daysi,F,100,1259,0,1259
Shedric,M,100,0,78,78
Garik,M,100,0,90,90
Rykki,F,100,5,0,5
Armen,M,100,0,1440,1440
Taizo,M,100,0,10,10
Candess,F,100,19,0,19
Aneecia,F,100,10,0,10
Illeanna,F,100,22,0,22
Camarri,M,100,0,5,5
Karleigh,F,100,3480,0,3480
Dash,M,99,11,1132,1143
Kelvion,M,100,0,35,35
Tejas,M,100,0,1055,1055
Kaelly,F,100,45,0,45
Byanca,F,100,415,0,415
Giuseppa,F,100,11,0,11
Verneice,F,100,15,0,15
Talara,F,100,16,0,16
Donella,F,100,1208,0,1208
Bronner,M,100,0,17,17
Kalle,F,92,325,27,352
Trong,M,100,0,61,61
Haillee,F,100,95,0,95
Markis,M,100,0,832,832
Percious,F,100,5,0,5
Octabio,M,100,0,7,7
Dohn,M,100,0,54,54
Ziasia,F,100,104,0,104
Chinetta,F,100,20,0,20
Leanna,F,100,19753,5,19758
Ashee,F,100,5,0,5
Kyen,M,100,0,84,84
Anis,M,93,19,241,260
Jondavid,M,100,0,297,297
Marjie,F,100,297,0,297
Francico,M,100,0,15,15
Isaiah,M,100,565,179923,180488
Jarrian,M,100,0,5,5
Kaybree,F,100,208,0,208
Hadassa,F,100,743,0,743
Sirat,F,100,19,0,19
Nashally,F,100,5,0,5
Jessena,F,100,12,0,12
Christer,M,100,0,5,5
Jerrlyn,F,100,5,0,5
Estel,M,94,20,343,363
Jahrod,M,100,0,17,17
Gloris,F,100,43,0,43
Quasim,M,100,0,125,125
Kaliph,M,100,0,10,10
Daronn,M,100,0,6,6
Nelliel,F,100,5,0,5
Elilah,F,100,12,0,12
Glennys,F,100,11,0,11
Kaydynn,F,100,5,0,5
Kaylix,F,100,5,0,5
Rosser,M,100,0,17,17
Talmage,M,100,0,809,809
Kadien,M,100,0,119,119
Koosha,M,100,0,5,5
Oshua,M,100,0,95,95
Lameka,F,100,480,0,480
Margrete,F,100,6,0,6
Nishika,F,100,130,0,130
Yahaira,F,100,4654,0,4654
Marguise,M,100,0,42,42
Sheccid,F,100,358,0,358
Abdulmalik,M,100,0,338,338
Dennes,M,100,0,28,28
Aleister,M,100,0,175,175
Jessye,F,100,164,0,164
Thad,M,100,0,5920,5920
Gayla,F,100,9127,6,9133
Panhia,F,100,97,0,97
Dakyra,F,100,47,0,47
Capresha,F,100,29,0,29
Antoniette,F,100,610,0,610
Ilsa,F,100,709,0,709
Jazmen,F,100,1069,5,1074
Rikiya,F,100,49,0,49
Delson,M,100,0,51,51
Kwenton,M,100,0,7,7
Dekoven,M,100,0,5,5
Pavielle,F,100,131,0,131
Evylin,F,100,5,0,5
Cansas,F,100,25,0,25
Raeanne,F,100,1695,0,1695
Estiven,M,100,0,184,184
Rajeen,F,100,7,0,7
Chizitere,F,100,5,0,5
Shekeitha,F,100,10,0,10
Tayten,M,86,76,452,528
Rhemy,F,80,20,5,25
Theodosia,F,100,309,0,309
Delainy,F,100,130,0,130
Jaan,M,100,0,103,103
Arin,F,61,2285,1486,3771
Alexavior,M,100,0,7,7
Rhyli,F,100,47,0,47
Myung,F,100,6,0,6
Sao,M,100,0,10,10
Madysson,F,100,36,0,36
Nayeem,M,100,0,7,7
Myracle,F,100,805,0,805
Serennity,F,100,5,0,5
Jazamine,F,100,11,0,11
Meygan,F,100,125,0,125
Viyaan,M,100,0,20,20
Rechetta,F,100,5,0,5
Byrd,M,100,0,61,61
Thersea,F,100,125,0,125
Salomae,F,100,5,0,5
Jaden,M,84,13093,67168,80261
Jacquille,M,100,0,11,11
Samalia,F,100,5,0,5
Tita,F,100,155,0,155
Ibtihaj,F,100,5,0,5
Damontrae,M,100,0,7,7
Tiva,F,100,23,0,23
Danelle,F,99,6864,46,6910
Reve,F,74,55,19,74
Lucenda,F,100,11,0,11
Hari,M,100,0,594,594
Tammee,F,100,92,0,92
Kelleigh,F,100,419,0,419
Perfect,F,100,5,0,5
Rynn,F,89,78,10,88
Livee,F,100,5,0,5
Lajuan,M,64,596,1037,1633
Tylane,M,100,0,5,5
Nimit,M,100,0,30,30
Jorgedavid,M,100,0,5,5
Cooley,M,100,0,5,5
Tarence,M,100,0,537,537
Tamoya,F,100,10,0,10
Asianna,F,100,374,0,374
Zahiem,M,100,0,10,10
Zyyon,M,100,0,6,6
Kethry,F,100,6,0,6
Lakaya,F,100,176,0,176
Citori,F,100,5,0,5
Erman,M,100,0,84,84
Jshaun,M,100,0,145,145
Aisah,F,100,10,0,10
Halima,F,100,1304,0,1304
Sheva,F,100,268,0,268
Aileen,F,100,20370,5,20375
Zabryna,F,100,6,0,6
Ameil,M,100,0,5,5
Earstine,F,100,5,0,5
Arnetria,F,100,13,0,13
Izaack,M,100,0,23,23
Yanita,F,100,11,0,11
Robena,F,100,72,0,72
Saasha,F,100,6,0,6
Leosvel,M,100,0,6,6
Niran,M,100,0,13,13
Roshawn,M,67,422,858,1280
Icesys,F,100,5,0,5
Amareon,M,100,0,91,91
Shlomo,M,100,0,3487,3487
Cirrus,M,100,0,6,6
Darwin,M,100,57,14314,14371
Germari,M,100,0,5,5
Ayzlee,F,100,22,0,22
Samanthan,F,100,113,0,113
Arielle,F,100,21307,40,21347
Shameca,F,100,296,0,296
Branko,M,100,0,54,54
Dannylynn,F,100,5,0,5
Satonia,F,100,13,0,13
Ellarie,F,100,89,0,89
Kaleab,M,100,0,147,147
Tawasha,F,100,11,0,11
Levi,M,99,678,104632,105310
Brinkley,F,96,891,33,924
Greysen,M,88,135,1012,1147
Jerey,M,100,0,5,5
Merika,F,100,40,0,40
Chelsy,F,100,3053,0,3053
Jered,M,100,0,3716,3716
Tonia,F,100,21392,53,21445
Chariel,F,100,5,0,5
Amont,M,100,0,5,5
Prisma,F,100,372,0,372
Dagmara,F,100,6,0,6
Cristene,F,100,33,0,33
Adham,M,100,0,636,636
Alynne,F,100,29,0,29
Keydra,F,100,35,0,35
Mamta,F,100,39,0,39
Jaysten,M,100,0,52,52
Hairo,M,100,0,80,80
Arleta,F,100,269,0,269
Imari,F,76,2112,680,2792
Aran,M,96,27,658,685
Marcion,M,100,0,5,5
Braelee,F,100,192,0,192
Latoiya,F,100,174,0,174
Yaretzi,F,100,6754,0,6754
Winny,F,100,41,0,41
Arnet,M,100,0,10,10
Maysan,F,100,6,0,6
Abriya,F,100,29,0,29
Dimarco,M,100,0,83,83
Carsen,M,77,762,2574,3336
Deonda,F,100,5,0,5
Javary,M,100,0,10,10
Saminah,F,100,8,0,8
Melyssa,F,100,1917,0,1917
Jasenya,F,100,19,0,19
Mayle,F,100,33,0,33
Milanni,F,100,70,0,70
Abdulbari,M,100,0,5,5
Laurnea,F,100,6,0,6
Kamorion,M,100,0,20,20
Trionna,F,100,25,0,25
Ayishah,F,100,11,0,11
Chrisshawn,M,100,0,34,34
Liane,F,100,3410,0,3410
Cathe,F,100,198,0,198
Jovaniel,M,100,0,5,5
Swayze,F,79,221,57,278
Elmus,M,100,0,11,11
Rocci,M,100,0,6,6
Jatari,M,100,0,5,5
Clenton,M,100,0,217,217
Kudura,M,100,0,5,5
Tamlyn,F,100,149,0,149
Zaryan,M,100,0,110,110
Oshane,M,100,0,41,41
Dorlene,F,100,165,0,165
Cullen,M,99,101,11468,11569
Keertana,F,100,32,0,32
Brandon,M,99,4117,740363,744480
Marcey,F,100,1074,0,1074
Enzio,M,100,0,42,42
Quatavius,M,100,0,32,32
Ambreanna,F,100,5,0,5
Aabid,M,100,0,5,5
Lidya,F,100,272,0,272
Loveah,F,100,69,0,69
Maisa,F,100,163,0,163
Teveon,M,100,0,10,10
Letriana,F,100,5,0,5
Kirwin,M,100,0,5,5
Jiovanny,M,100,0,346,346
Austan,M,100,0,191,191
Demaurea,M,100,0,5,5
Ronda,F,99,32196,187,32383
Bard,M,100,0,167,167
Kayori,F,100,32,0,32
Konnor,M,98,81,3978,4059
Vivianne,F,100,1323,0,1323
Doshie,F,100,22,0,22
Arrie,F,81,336,80,416
Janellys,F,100,28,0,28
Tyja,F,100,96,0,96
Juliocesar,M,100,0,410,410
Sacoya,F,100,114,0,114
Benitez,M,100,0,10,10
Brietta,F,100,211,0,211
Rodericka,F,100,25,0,25
Ciani,F,100,574,0,574
Jertavious,M,100,0,5,5
Hildred,F,62,75,45,120
Lochlynn,F,100,21,0,21
Marreon,M,100,0,32,32
Andreis,M,100,0,34,34
Adrianah,F,100,225,0,225
Kileigh,F,100,615,0,615
Maddielyn,F,100,5,0,5
Torsten,M,100,0,446,446
Fabrizio,M,100,0,988,988
Chrishell,F,100,38,0,38
Camaren,M,92,5,54,59
Idania,F,100,531,0,531
Brendetta,F,100,11,0,11
Bankston,M,100,0,19,19
Dynver,F,100,29,0,29
Hershal,M,100,0,151,151
Catrease,F,100,5,0,5
Trinere,F,100,5,0,5
Larry,M,99,2452,471909,474361
Sheen,M,60,10,15,25
Phedra,F,100,47,0,47
Joselen,F,100,5,0,5
Blaiden,M,100,0,91,91
Menika,F,100,11,0,11
Anabell,F,100,1261,0,1261
Marializ,F,100,139,0,139
Lillieanne,F,100,24,0,24
Diesha,F,100,178,0,178
Prabhav,M,100,0,74,74
Cristi,F,100,3170,0,3170
Khylon,M,100,0,38,38
Malayiah,F,100,131,0,131
Sarahlynn,F,100,118,0,118
Garryn,F,100,5,0,5
Shirelle,F,100,705,0,705
Sherelyn,F,100,44,0,44
Sapphire,F,100,2630,0,2630
Maretta,F,100,504,0,504
Tuyet,F,100,298,0,298
Ashyria,F,100,5,0,5
Debrra,F,100,5,0,5
Osnas,F,100,5,0,5
Shaguanna,F,100,5,0,5
Riven,M,58,25,34,59
Tedric,M,100,0,242,242
Ryly,F,55,6,5,11
Charese,F,100,435,0,435
Jairee,M,100,0,6,6
Kaedence,F,98,397,8,405
Breazae,F,100,8,0,8
Enslie,F,100,22,0,22
Meela,F,100,238,0,238
Laxmi,F,100,40,0,40
Wendlyn,F,100,5,0,5
Alayziah,F,100,83,0,83
Ramonica,F,100,118,0,118
Limairy,F,100,7,0,7
Alac,M,100,0,10,10
Treshad,M,100,0,6,6
Quantrel,M,100,0,19,19
Chandi,F,100,242,0,242
Lequon,M,100,0,5,5
Obama,M,100,0,30,30
Christhian,M,100,0,38,38
Shakiya,F,100,783,0,783
Hannibal,M,100,0,483,483
Queenisha,F,100,9,0,9
Alesandro,M,100,0,294,294
Sharvi,F,100,57,0,57
Sarahjoy,F,100,10,0,10
Kenneshia,F,100,71,0,71
Dreveon,M,100,0,37,37
Delon,M,97,38,1162,1200
Kaelon,M,100,0,253,253
Dequilla,F,100,5,0,5
Mahib,M,100,0,5,5
Permelia,F,100,49,0,49
Abdulqadir,M,100,0,26,26
Asheton,M,54,78,93,171
Tyson,M,99,308,38282,38590
Shawnay,F,100,64,0,64
Chellsea,F,100,141,0,141
Yelissa,F,100,25,0,25
Alyrica,F,100,42,0,42
Jarryn,M,100,0,59,59
Cal,M,100,10,3697,3707
Shellbie,F,100,57,0,57
Verner,M,98,5,278,283
Khushboo,F,100,48,0,48
Neeka,F,100,199,0,199
Asalia,F,100,31,0,31
Quinnshawn,M,100,0,5,5
Olson,M,100,0,93,93
Jerymiah,M,100,0,6,6
Isahia,M,100,0,122,122
Heavenli,F,100,13,0,13
Shovonne,F,100,10,0,10
Lavender,F,100,686,0,686
Arietta,F,100,41,0,41
Lounell,F,100,8,0,8
Aja,F,99,7533,84,7617
Orval,M,100,0,833,833
Jamesha,F,100,2243,0,2243
Genessi,F,100,5,0,5
Duce,M,100,0,10,10
Korian,M,100,0,17,17
Seamas,M,100,0,10,10
Yuliana,F,100,4979,0,4979
Deisel,M,100,0,11,11
Iyanuoluwa,F,84,32,6,38
Bethlehem,F,100,331,0,331
Michaelia,F,100,141,0,141
Zoelyn,F,100,6,0,6
Jwon,M,100,0,5,5
Nastassia,F,100,867,0,867
Kimblery,F,100,157,0,157
Jaleah,F,100,2343,0,2343
Enrike,M,100,0,37,37
Liav,M,100,0,12,12
Derward,M,100,0,6,6
Neely,F,96,1815,85,1900
Daymein,M,100,0,87,87
Dereke,M,100,0,207,207
Neliah,F,100,41,0,41
Deon,M,91,1276,13258,14534
Chevelle,F,93,2235,164,2399
Tailor,F,85,900,156,1056
Yanais,F,100,5,0,5
Armando,M,99,362,61978,62340
Veronda,F,100,360,0,360
Vironica,F,100,5,0,5
Jaclin,F,100,153,0,153
Bodin,M,100,0,116,116
Jarrel,M,100,0,851,851
Alphonza,M,100,0,265,265
Nelva,F,100,206,0,206
Ambellina,F,100,31,0,31
Claranne,F,100,5,0,5
Pragya,F,100,117,0,117
Marchita,F,100,19,0,19
Selwyn,M,99,5,875,880
Brentt,M,100,0,294,294
Malani,F,100,814,0,814
Shivansh,M,100,0,134,134
Crea,F,100,11,0,11
Ryean,M,100,0,5,5
Quwanda,F,100,11,0,11
Buffi,F,100,194,0,194
Estephany,F,100,780,0,780
Marterrius,M,100,0,6,6
Tnaya,F,100,10,0,10
Shaina,F,100,11217,18,11235
Taariq,M,100,0,256,256
Antona,F,100,5,0,5
Caesar,M,100,0,3391,3391
Diedre,F,100,1655,0,1655
Tannon,M,100,0,191,191
Seger,M,100,0,85,85
Nilufar,F,100,5,0,5
Chrystiana,F,100,11,0,11
Jennabella,F,100,5,0,5
Amysue,F,100,18,0,18
Sherlyn,F,100,6923,8,6931
Destinymarie,F,100,21,0,21
Bridgitte,F,100,613,0,613
Miccah,M,83,6,30,36
Sakile,F,100,23,0,23
Millana,F,100,20,0,20
Audie,M,91,278,2967,3245
Remer,M,100,0,11,11
Mattlock,M,100,0,7,7
Siarra,F,100,697,0,697
Ples,M,100,0,38,38
Avena,F,100,16,0,16
Jhane,F,100,275,0,275
Loagen,M,100,0,5,5
Mendy,F,84,2160,404,2564
Sylwia,F,100,119,0,119
Tc,M,100,0,64,64
Ashmeet,F,100,6,0,6
Cerenity,F,100,797,0,797
Lurline,F,100,159,0,159
Renard,M,100,0,2400,2400
Kj,M,100,0,79,79
Yenni,F,100,72,0,72
Jysaiah,M,100,0,6,6
Ledion,M,100,0,33,33
Wilfred,M,100,5,7672,7677
Valbona,F,100,73,0,73
Rubina,F,100,487,0,487
Kesa,F,100,135,0,135
Baili,F,100,333,0,333
Malayasia,F,100,120,0,120
Jakerra,F,100,84,0,84
Raksha,F,100,88,0,88
Makayliah,F,100,5,0,5
Melantha,F,100,29,0,29
Muneerah,F,100,51,0,51
Helenmarie,F,100,5,0,5
Sebastion,M,100,0,668,668
Ebelyn,F,100,89,0,89
Lott,M,100,0,25,25
Jia,F,83,1011,214,1225
Donneta,F,100,5,0,5
Galan,M,100,0,59,59
Dieter,M,100,0,864,864
Aviyon,M,92,6,74,80
Danilynn,F,100,153,0,153
Jennetta,F,100,287,0,287
Zackhary,M,100,0,15,15
Nimo,F,100,103,0,103
Deshaunda,F,100,48,0,48
Jhonny,M,100,0,1337,1337
Dorey,F,87,48,7,55
Deymian,M,100,0,5,5
Kamylla,F,100,10,0,10
Mahari,M,54,140,166,306
Kyha,F,100,16,0,16
Kimoya,F,100,5,0,5
Rahshad,M,100,0,18,18
Deondrey,M,100,0,18,18
Adma,M,100,0,23,23
Katielee,F,100,11,0,11
Zeya,F,100,40,0,40
Najmah,F,100,63,0,63
Kyndrick,M,100,0,18,18
Idman,F,100,16,0,16
Dekevion,M,100,0,22,22
Nuha,F,100,445,0,445
Yeira,F,100,224,0,224
Herlene,F,100,14,0,14
Ailynn,F,100,277,0,277
Isak,M,100,0,809,809
Wafi,M,100,0,22,22
Hakiem,M,100,0,73,73
Rebcca,F,100,27,0,27
Dekotah,F,100,10,0,10
Johniqua,F,100,60,0,60
Sherrica,F,100,176,0,176
Jhanet,F,100,5,0,5
Kishawna,F,100,38,0,38
Suzetta,F,100,178,0,178
Nekita,F,100,368,0,368
Comaneci,F,100,9,0,9
Merwyn,M,100,0,78,78
Liamm,M,100,0,6,6
Claybourne,M,100,0,11,11
Laster,M,100,0,10,10
Tishona,F,100,18,0,18
Myoshia,F,100,12,0,12
Umaiza,F,100,106,0,106
Hally,F,100,620,0,620
Tamiko,F,99,2939,42,2981
Janeria,F,100,18,0,18
Betrina,F,100,15,0,15
Billiejean,F,100,191,0,191
Johvanna,F,100,5,0,5
Yokasta,F,100,12,0,12
Janeesha,F,100,11,0,11
Brooks,M,94,1049,17299,18348
Maquita,F,100,133,0,133
Megha,F,100,971,0,971
Rosbel,M,100,0,85,85
Tregg,M,100,0,42,42
Lurleen,F,100,57,0,57
Tyrena,F,100,95,0,95
Toniesha,F,100,147,0,147
Aurthur,M,100,0,190,190
Lushana,F,100,6,0,6
Jerimie,M,100,0,229,229
Tanee,F,100,115,0,115
Sucdi,F,100,5,0,5
Ruhan,M,100,0,134,134
Blessing,F,93,1878,141,2019
Herve,M,100,0,149,149
Spriha,F,100,7,0,7
Tanuja,F,100,5,0,5
Thyrone,M,100,0,5,5
Medhansh,M,100,0,34,34
Ondreya,F,100,5,0,5
Dashanique,F,100,96,0,96
Ashlye,F,100,385,0,385
Keitrick,M,100,0,5,5
Annsley,F,100,542,0,542
Erran,M,100,0,6,6
Alaija,F,100,200,0,200
Hadi,M,100,0,1460,1460
Amamda,F,100,247,0,247
Nabi,M,100,0,5,5
Raynetta,F,100,231,0,231
Jamail,M,100,0,336,336
Sherile,F,100,5,0,5
Bani,F,100,107,0,107
Saturnino,M,100,0,332,332
Whitten,M,97,5,166,171
Ingram,M,92,13,157,170
Thara,F,100,147,0,147
Johon,M,100,0,11,11
Dual,M,100,0,7,7
Garvens,M,100,0,11,11
Nastaja,F,100,7,0,7
Urica,F,100,19,0,19
Greylin,M,100,0,11,11
Efrian,M,100,0,5,5
Sahr,M,100,0,32,32
Paysley,F,100,34,0,34
Jozelyn,F,100,309,0,309
Zaria,F,100,7541,0,7541
Naimah,F,100,1379,0,1379
Chelese,F,100,46,0,46
Jessicamarie,F,100,156,0,156
Adiley,F,100,5,0,5
Saylee,F,100,54,0,54
Kamsi,F,100,6,0,6
Demarian,M,100,0,187,187
Hy,M,100,0,52,52
Tylene,F,100,365,0,365
Tyjier,M,100,0,5,5
Abgail,F,100,29,0,29
Duha,F,100,105,0,105
Sharesse,F,100,24,0,24
Chariese,F,100,5,0,5
Jaqueisha,F,100,7,0,7
Shatiqua,F,100,75,0,75
Aliyna,F,100,10,0,10
Kinley,F,98,11198,245,11443
Tyease,F,100,29,0,29
Ruckus,M,100,0,8,8
Court,M,100,0,265,265
Yehia,M,100,0,41,41
Till,M,100,0,13,13
Veronyca,F,100,6,0,6
Quintasia,F,100,206,0,206
Bonitta,F,100,5,0,5
Phallyn,F,100,18,0,18
Mikayel,M,100,0,26,26
Kishara,F,81,21,5,26
Delinda,F,100,1973,0,1973
Bralon,M,100,0,121,121
Dazani,F,100,56,0,56
Tibby,M,100,0,5,5
Sherald,F,100,94,0,94
Arth,M,100,0,61,61
Alfonza,M,100,0,994,994
Samadhi,F,100,85,0,85
Arayana,F,100,6,0,6
Kalman,M,100,0,579,579
Tawanna,F,100,3862,0,3862
Dailynn,F,98,231,5,236
Syeeda,F,100,26,0,26
Korver,M,100,0,112,112
Natoria,F,100,196,0,196
Lexington,F,61,696,442,1138
Dreanna,F,100,290,0,290
Lamika,F,100,372,0,372
Jillien,F,100,66,0,66
Nybria,F,100,14,0,14
Dena,F,100,27452,56,27508
Malkie,F,100,83,0,83
Taeh,F,100,5,0,5
Jasaan,M,100,0,48,48
Storie,F,100,228,0,228
Shmeil,M,100,0,5,5
Jeidyn,M,100,0,5,5
Delyssa,F,100,17,0,17
Nakina,F,100,57,0,57
Yasaira,F,100,32,0,32
Macyn,F,88,628,87,715
Yaniah,F,100,96,0,96
Adie,F,95,91,5,96
Samuella,F,100,83,0,83
Laurann,F,100,154,0,154
Elec,M,100,0,6,6
Adiyah,F,100,35,0,35
Aneas,M,100,0,16,16
Deanna,F,100,113306,227,113533
Ixchell,F,100,12,0,12
Casino,M,100,0,15,15
Mainhia,F,100,17,0,17
Deneco,M,100,0,5,5
Larhea,F,100,6,0,6
Rashea,F,97,145,5,150
Vedaant,M,100,0,30,30
Tywana,F,100,583,0,583
Whtiney,F,100,5,0,5
Kimatha,F,100,5,0,5
Jumaane,M,100,0,134,134
Kiowa,M,75,55,166,221
Jull,F,100,150,0,150
Louvenia,F,100,797,0,797
Leyat,F,100,5,0,5
Jayvonte,M,100,0,49,49
Undrea,F,73,186,70,256
Darran,M,100,0,773,773
Meschelle,F,100,39,0,39
Laurenda,F,100,43,0,43
Dealva,F,100,5,0,5
Tessy,F,100,194,0,194
Juddie,F,100,5,0,5
Deise,F,100,10,0,10
Roneisha,F,100,573,0,573
Ayoob,M,100,0,13,13
Jajaun,M,100,0,22,22
Anne,F,100,172752,460,173212
Makeda,F,100,1466,0,1466
Emanuela,F,100,412,0,412
Taaj,M,93,5,69,74
Shiah,F,66,73,37,110
Brania,F,100,18,0,18
Kadidja,F,100,21,0,21
Tahlea,F,100,10,0,10
Mayzie,F,100,361,0,361
Remmie,F,100,70,0,70
Emireth,F,100,109,0,109
Micaiah,M,63,1095,1864,2959
Fredda,F,100,467,0,467
Kiska,F,100,14,0,14
Carice,F,100,25,0,25
Sharana,F,100,6,0,6
Mahagany,F,100,24,0,24
Ayedin,M,100,0,31,31
Ibrahem,M,100,0,71,71
Niyel,F,100,5,0,5
Lynneann,F,100,5,0,5
Kadidiatou,F,100,23,0,23
Zhoey,F,100,58,0,58
Abagaile,F,100,15,0,15
Tairik,M,100,0,5,5
Dannika,F,100,516,0,516
Cecy,F,100,37,0,37
Latreshia,F,100,61,0,61
Amabella,F,100,33,0,33
Anevaeh,F,100,41,0,41
Shanean,F,100,26,0,26
Joan,F,97,134830,4057,138887
Phillp,M,100,0,64,64
Talonda,F,100,158,0,158
Quillen,M,100,0,17,17
Sharkia,F,100,10,0,10
Kamyia,F,100,309,0,309
Bev,F,100,880,0,880
Tyruss,M,100,0,5,5
Manase,M,100,0,25,25
Chynna,F,100,2198,0,2198
Geo,M,100,0,168,168
Ogechukwu,F,88,46,6,52
Chaseton,M,100,0,256,256
Kaishon,M,100,0,5,5
Akaria,F,100,18,0,18
Annajane,F,100,19,0,19
Leany,F,100,28,0,28
Jaimmie,F,100,7,0,7
Ezekeil,M,100,0,104,104
Kacie,F,100,11588,32,11620
Kervins,M,100,0,10,10
Reshod,M,100,0,5,5
Azaylah,F,100,22,0,22
Vena,F,100,658,0,658
Torrin,M,88,89,623,712
Kaetlyn,F,100,523,0,523
Penella,F,100,5,0,5
Tianda,F,100,13,0,13
Jameia,F,100,210,0,210
Chrisan,F,100,6,0,6
Laquitta,F,100,691,0,691
Wright,M,100,0,439,439
Tasiana,F,100,38,0,38
Janaiah,F,100,121,0,121
Debooah,F,100,17,0,17
Keliana,F,100,23,0,23
Elisabeth,F,100,36014,27,36041
Delmarie,F,100,34,0,34
Careyann,F,100,15,0,15
Vivek,M,100,0,1660,1660
Larencia,F,100,6,0,6
Snayder,M,100,0,11,11
Ammad,M,100,0,12,12
Khilee,F,100,90,0,90
Willye,F,100,32,0,32
Hazelee,F,100,17,0,17
Tracy,F,81,248884,57036,305920
Keyley,F,100,21,0,21
Sheneque,F,100,16,0,16
Romney,M,83,48,231,279
Jacobian,M,100,0,15,15
Rynette,F,100,5,0,5
Emillie,F,100,433,0,433
Kerrisa,F,100,5,0,5
Deshawndre,M,100,0,5,5
Sheresa,F,100,312,0,312
Jamie,F,76,261699,82591,344290
Tiereny,F,100,6,0,6
Rathany,F,100,5,0,5
Oralia,F,100,3279,0,3279
Santangelo,M,100,0,6,6
Jurel,M,100,0,15,15
Glennie,F,77,226,67,293
Gadiel,M,100,0,949,949
Tsosie,M,100,0,6,6
Chriselle,F,100,17,0,17
Millinia,F,100,5,0,5
Keishla,F,100,317,0,317
Antoniah,F,100,10,0,10
Erinisha,F,100,5,0,5
Shila,F,100,1019,0,1019
Kynara,F,100,9,0,9
Chrishanda,F,100,13,0,13
Tachic,F,100,5,0,5
Saaliha,F,100,7,0,7
Liberti,F,100,119,0,119
Brichelle,F,100,21,0,21
Yaslyn,F,100,101,0,101
Jaritzi,F,100,5,0,5
Lorelee,F,100,110,0,110
Herley,M,100,0,8,8
Monifa,F,100,416,0,416
Lauriano,M,100,0,39,39
Efthimia,F,100,35,0,35
Decameron,M,100,0,29,29
Dezmarie,F,100,36,0,36
Wallie,M,95,5,90,95
Marilyne,F,100,60,0,60
Sihara,F,100,5,0,5
Kailey,F,100,23499,10,23509
Korri,F,99,525,6,531
Iyonah,F,100,16,0,16
Chasitiy,F,100,20,0,20
Kamarious,M,100,0,5,5
Capers,M,100,0,13,13
Andreanna,F,100,843,0,843
Kimiko,F,100,1121,0,1121
Vanille,F,100,6,0,6
Makyi,M,100,0,75,75
Isatou,F,100,258,0,258
Mileydi,F,100,115,0,115
Jaylanni,F,100,33,0,33
Hodge,M,100,0,15,15
Nakeem,M,100,0,154,154
Getzemany,F,100,11,0,11
Dequesha,F,100,11,0,11
Tranard,M,100,0,11,11
Catressa,F,100,5,0,5
Keghan,M,100,0,83,83
Tyshay,F,100,207,0,207
Marshay,F,99,727,5,732
Aleyia,F,100,52,0,52
Tyzaiah,M,100,0,5,5
Presli,F,100,378,0,378
Shakemia,F,100,59,0,59
Briggs,M,100,6,1911,1917
Jecori,M,100,0,10,10
Adlei,F,100,7,0,7
Nevaehmarie,F,100,19,0,19
Akiya,F,100,462,0,462
Maryella,F,100,264,0,264
Jeslie,F,100,74,0,74
Corneall,M,100,0,6,6
Nuala,F,100,263,0,263
Jaquice,F,100,6,0,6
Meyers,M,100,0,6,6
Dandy,M,95,5,93,98
Nhung,F,100,215,0,215
Evionna,F,100,5,0,5
Ambrose,M,100,0,2772,2772
Elron,M,100,0,5,5
Zalynn,F,71,12,5,17
Dedra,F,100,4314,0,4314
Randahl,M,100,0,53,53
Quinnisha,F,100,43,0,43
Sathvika,F,100,76,0,76
Anacelia,F,100,31,0,31
Zainub,F,100,40,0,40
Rameses,M,100,0,142,142
Aansh,M,100,0,11,11
Tensie,F,100,5,0,5
Suleman,M,100,0,124,124
Kymaya,F,100,5,0,5
Lokelani,F,100,100,0,100
Mannon,F,100,5,0,5
Dracen,M,100,0,142,142
Lilirose,F,100,5,0,5
Abimael,M,100,0,987,987
Jagr,M,100,0,25,25
Lierin,F,100,33,0,33
Khristy,F,100,332,0,332
Mikinzi,F,100,13,0,13
Rahzel,M,100,0,40,40
Namaya,F,100,5,0,5
Elizander,M,100,0,5,5
Annemargaret,F,100,5,0,5
Finas,M,100,0,9,9
Michae,M,90,52,490,542
Rosina,F,100,1786,0,1786
Donnalyn,F,100,76,0,76
Sauel,M,100,0,14,14
Tauheedah,F,100,160,0,160
Kaw,M,100,0,15,15
Miceala,F,100,16,0,16
Traca,F,100,26,0,26
Jojean,F,100,13,0,13
Koralee,F,100,42,0,42
Loriane,F,100,27,0,27
Kasin,M,100,0,204,204
Elionaid,M,100,0,11,11
Sieanna,F,100,254,0,254
Keiner,M,100,0,5,5
Aarika,F,100,723,0,723
Renea,F,100,4116,0,4116
Daneka,F,100,201,0,201
Christing,F,100,5,0,5
Kerriana,F,100,25,0,25
Quasir,M,100,0,22,22
Windee,F,100,26,0,26
Kaiser,M,100,0,849,849
Mariyonna,F,100,5,0,5
Seantae,F,100,13,0,13
Panzy,F,100,15,0,15
Suhaill,F,100,15,0,15
Telaysia,F,100,5,0,5
Allene,F,100,1337,0,1337
Ines,F,94,3001,200,3201
Sinan,M,100,0,241,241
Georgios,M,100,0,828,828
Brihany,F,100,49,0,49
Stepehen,M,100,0,20,20
Zemarion,M,100,0,11,11
Kristamarie,F,100,6,0,6
Holten,M,100,0,201,201
Emee,F,100,15,0,15
Anyshia,F,100,11,0,11
Camryn,F,87,22776,3313,26089
Leellen,F,100,34,0,34
Mercede,F,100,535,0,535
Shoni,F,100,132,0,132
Dascha,F,100,5,0,5
Cipriano,M,100,0,1296,1296
Alizabeth,F,100,1477,0,1477
Saniye,F,100,5,0,5
Alexes,F,83,700,139,839
Shinobi,M,100,0,5,5
Joquavious,M,100,0,5,5
Tinslie,F,100,5,0,5
Azariya,F,100,211,0,211
Vaughan,M,99,7,976,983
Melesa,F,100,130,0,130
Allysia,F,100,604,0,604
Katyanna,F,100,10,0,10
Kaileemarie,F,100,5,0,5
Rabon,M,100,0,47,47
Malaeka,F,100,10,0,10
Donielle,F,96,1950,91,2041
Syid,M,100,0,5,5
Lefty,M,100,0,22,22
Zaryha,F,100,5,0,5
Jovany,M,100,11,4121,4132
Vannary,F,100,41,0,41
Daishaun,M,100,0,255,255
Aliahna,F,100,66,0,66
Dayami,F,100,772,0,772
Eleesa,F,100,23,0,23
Marrina,F,100,45,0,45
Marabel,F,100,6,0,6
Brhea,F,100,6,0,6
Kayleemarie,F,100,12,0,12
Loveya,F,100,5,0,5
Noura,F,100,559,0,559
Sumner,M,79,190,733,923
Teondra,F,100,115,0,115
Nathainel,M,100,0,43,43
Dreion,M,100,0,5,5
Jazminn,F,100,112,0,112
Kaylle,F,100,5,0,5
Jannetta,F,100,247,0,247
Jaegar,M,100,0,99,99
Dajavette,F,100,5,0,5
Realyn,F,100,5,0,5
Yasmin,F,100,18666,80,18746
Dremond,M,100,0,5,5
Analey,F,100,22,0,22
Sicily,F,100,1011,0,1011
Aliceia,F,100,28,0,28
Emina,F,100,490,0,490
Quaylin,M,100,0,13,13
Qwinton,M,100,0,21,21
Kaiyu,M,100,0,76,76
Carrieann,F,100,669,0,669
Kamrun,M,100,0,16,16
Lashira,F,100,46,0,46
Anselma,F,100,31,0,31
Annelyn,F,100,5,0,5
Beatrica,F,100,5,0,5
Jalyne,F,94,146,10,156
Kathyy,F,100,5,0,5
Zyire,M,100,0,140,140
Mycaela,F,100,10,0,10
Nelta,F,100,55,0,55
Dainel,M,100,0,97,97
Abraham,M,100,196,62604,62800
Lilly,F,100,37063,24,37087
Blakely,F,79,3868,1030,4898
Delandra,F,100,20,0,20
Arrius,M,100,0,5,5
Jersee,F,100,92,0,92
Guadulupe,F,100,5,0,5
Aileah,F,100,51,0,51
Avaclaire,F,100,41,0,41
Ambria,F,100,1911,0,1911
Cortina,F,100,259,0,259
Aly,F,63,883,511,1394
Hibah,F,100,344,0,344
Davarius,M,100,0,303,303
Kadasia,F,100,117,0,117
Tasina,F,100,5,0,5
Mylez,M,100,0,103,103
Huntington,M,100,0,174,174
Crisoforo,M,100,0,17,17
Samrudh,M,100,0,23,23
Sutten,F,100,17,0,17
Hetty,F,100,85,0,85
Makyla,F,100,2055,0,2055
Emanuelle,M,57,146,196,342
Sunde,F,100,5,0,5
Avva,F,100,12,0,12
Nayda,F,100,250,0,250
Caidence,F,91,811,77,888
Irven,M,100,0,173,173
Laksha,F,100,10,0,10
Breighana,F,100,6,0,6
Shephanie,F,100,64,0,64
Karhonda,F,100,11,0,11
Aviel,M,97,19,558,577
Grasen,M,100,0,12,12
Delorean,M,84,46,234,280
Aeries,F,100,10,0,10
Tiree,M,100,0,39,39
Demetrie,M,95,17,296,313
Alorah,F,100,243,0,243
Rafaelita,F,100,6,0,6
Taissa,F,100,10,0,10
Charleen,F,100,4055,0,4055
Lovonne,F,100,6,0,6
Shyane,F,100,316,0,316
Finola,F,100,134,0,134
Anaiis,F,100,16,0,16
Tamatha,F,100,2811,0,2811
Jerie,F,100,173,0,173
Danaka,F,100,134,0,134
Areeya,F,100,11,0,11
Marciella,F,100,7,0,7
Shynesha,F,100,5,0,5
Elizardo,M,100,0,67,67
Kimbra,F,100,1221,0,1221
Zaniaya,F,100,14,0,14
Maize,F,83,24,5,29
Sherleen,F,100,141,0,141
Bengie,M,100,0,155,155
Lywanda,F,100,6,0,6
Zadah,F,100,7,0,7
Jossalin,F,100,66,0,66
Kamelya,F,100,5,0,5
Aransa,F,100,11,0,11
Andrius,M,100,0,114,114
Mikhael,M,99,8,607,615
Sareen,F,100,150,0,150
Selden,M,100,0,35,35
Chermeka,F,100,8,0,8
Casarah,F,100,46,0,46
Videll,M,100,0,13,13
Kimari,F,64,399,220,619
Jeanluca,M,100,0,5,5
Hodges,M,100,0,96,96
Rahsaun,M,100,0,10,10
Jerriyah,F,100,62,0,62
Eibhlin,F,100,37,0,37
Tremone,M,100,0,28,28
Yanci,F,100,186,0,186
Cantina,F,100,39,0,39
Dezmen,M,100,0,317,317
Mital,F,76,16,5,21
Hatsumi,F,100,5,0,5
Asbiel,M,100,0,9,9
Jelessa,F,100,32,0,32
Haylah,F,100,5,0,5
Shella,F,100,951,0,951
Yansiel,M,100,0,5,5
Kemontae,M,100,0,133,133
Vaitiare,F,100,5,0,5
Miasha,F,100,114,0,114
Mariea,F,100,603,0,603
Shayanna,F,100,271,0,271
Rees,M,88,101,724,825
Jaymiah,F,100,10,0,10
Carrell,M,72,28,73,101
Tashala,F,100,77,0,77
Drevion,M,100,0,172,172
Jenri,M,100,0,24,24
Smitty,M,100,0,63,63
Deken,M,100,0,34,34
Deonica,F,100,47,0,47
Glorie,F,100,225,0,225
Luwana,F,100,276,0,276
Laporcha,F,100,246,0,246
Lugene,F,58,385,281,666
Saarang,M,100,0,6,6
Rethia,F,100,18,0,18
Fantasia,F,100,1781,0,1781
Shuraim,M,100,0,5,5
Veva,F,100,160,0,160
Mallisa,F,100,99,0,99
Floyed,M,100,0,5,5
Mose,M,100,0,1917,1917
Dhilan,M,100,0,235,235
Bijon,M,80,20,80,100
Le,F,63,793,471,1264
Elina,F,100,2889,0,2889
Nohlan,M,100,0,49,49
Christinamarie,F,100,163,0,163
Angelyka,F,100,17,0,17
Tasheem,M,100,0,119,119
Shriyansh,M,100,0,14,14
Mondrell,M,100,0,41,41
Izalea,F,100,5,0,5
Oumou,F,100,418,0,418
Gyselle,F,100,182,0,182
Tyvin,M,100,0,52,52
Thalmus,M,100,0,29,29
Lethaniel,M,100,0,34,34
Sheelah,F,100,71,0,71
Mayann,F,100,5,0,5
Rooseve,M,100,0,5,5
Faheemah,F,100,12,0,12
Charlyne,F,100,423,0,423
Jauquan,M,100,0,6,6
Kwabena,M,100,0,566,566
Manisha,F,100,839,0,839
Tyee,M,100,0,287,287
Tobian,M,100,0,12,12
Sherette,F,100,24,0,24
Tatanya,F,100,25,0,25
Laraya,F,100,189,0,189
Anie,F,100,67,0,67
Westyn,M,95,37,761,798
Lindsea,F,100,70,0,70
Deanza,F,100,68,0,68
Naylah,F,100,270,0,270
Rosalinda,F,100,13046,5,13051
Jamaree,M,99,5,660,665
Oussama,M,100,0,6,6
Landrey,F,90,252,27,279
Scotte,M,100,0,22,22
Lavickie,F,100,5,0,5
Derrus,M,100,0,9,9
Gabie,F,100,5,0,5
Chestin,M,100,0,6,6
Stephan,M,99,229,23402,23631
Lowe,F,50,5,5,10
Dejay,M,100,0,96,96
Jlisa,F,100,31,0,31
Majed,M,100,0,258,258
Badhir,M,100,0,7,7
Athenea,F,100,35,0,35
Claudius,M,100,0,394,394
Leveta,F,100,18,0,18
Deannah,F,100,102,0,102
Macara,F,100,5,0,5
Nieka,F,100,26,0,26
Jerimiha,M,100,0,5,5
Mitchell,M,99,996,144220,145216
Joyelle,F,100,320,0,320
Mic,M,100,0,26,26
Jasana,F,100,5,0,5
Samel,M,100,0,19,19
Vashawn,M,93,33,461,494
Sahwn,M,100,0,36,36
Zafina,F,100,17,0,17
Alianna,F,100,2258,0,2258
Kateleen,F,100,157,0,157
Markjoseph,M,100,0,43,43
Rukia,F,100,86,0,86
Inette,F,100,69,0,69
Jessicca,F,100,558,0,558
Maple,F,100,593,0,593
Duanne,M,66,42,82,124
Jacquarius,M,100,0,8,8
Kahreem,M,100,0,5,5
Ajalae,F,100,13,0,13
Kyrin,M,89,112,901,1013
Marcelina,F,100,1861,0,1861
Jahniya,F,100,455,0,455
Gitel,F,100,172,0,172
Ark,M,100,0,61,61
Jaunna,F,100,5,0,5
Jonattan,M,100,0,41,41
Leeanne,F,100,2964,0,2964
Jaded,F,100,19,0,19
Tikisha,F,100,278,0,278
Bhavani,F,100,23,0,23
Latesia,F,100,172,0,172
Cella,F,100,106,0,106
Princilla,F,100,5,0,5
Alexan,M,100,0,18,18
Mahri,F,100,57,0,57
Keiva,F,100,64,0,64
Kerwyn,M,100,0,17,17
Levonna,F,100,5,0,5
Claudell,M,88,43,314,357
Janith,F,100,180,0,180
Nyamal,F,100,28,0,28
Pleasure,F,100,11,0,11
Agatha,F,100,2258,0,2258
Makinlie,F,100,10,0,10
Renne,F,90,552,61,613
Tyrease,M,100,0,207,207
Ayianna,F,100,233,0,233
Hoskie,M,100,0,11,11
Teyonda,F,100,5,0,5
Ishani,F,100,654,0,654
Janesha,F,100,512,0,512
Donnesha,F,100,273,0,273
Mavourneen,F,100,24,0,24
Saraji,F,100,8,0,8
Mima,F,100,76,0,76
Hopelynn,F,100,54,0,54
Dalexia,F,100,5,0,5
Tarasa,F,100,28,0,28
Bilinda,F,100,47,0,47
Kaebri,F,100,6,0,6
Aeri,F,100,5,0,5
Tekita,F,100,5,0,5
Micah,M,88,10992,78457,89449
Shaundale,M,100,0,5,5
Vaishnavi,F,100,643,0,643
Jasiel,M,93,66,841,907
Nikita,F,82,10205,2170,12375
Kieana,F,100,145,0,145
Johnitta,F,100,5,0,5
Nakela,F,100,7,0,7
Monserrate,F,78,122,34,156
Jalia,F,100,1223,0,1223
Durham,M,100,0,138,138
Hemza,M,100,0,5,5
Aubreylynn,F,100,17,0,17
Nesanel,M,100,0,166,166
Ladavion,M,100,0,117,117
Carneshia,F,100,60,0,60
Sohany,F,100,5,0,5
Mainor,M,100,0,104,104
Crystle,F,100,1187,0,1187
Kionna,F,100,1108,0,1108
Quaadir,M,100,0,10,10
Johnatho,M,100,0,12,12
Mikalya,F,100,52,0,52
Deborahann,F,100,135,0,135
Alhaji,M,100,0,170,170
Cambi,F,100,5,0,5
Torrica,F,100,6,0,6
Charlottee,F,100,10,0,10
Cleaveland,M,100,0,5,5
Bronson,M,100,0,7297,7297
Sharmila,F,100,180,0,180
Tocarro,F,100,6,0,6
Zianne,F,100,63,0,63
Toren,M,99,6,677,683
Omarr,M,100,0,476,476
Freedom,F,65,976,516,1492
Leanette,F,100,130,0,130
Keyhla,F,100,12,0,12
Jefforey,M,100,0,5,5
Jamyis,M,100,0,10,10
Cassand,F,100,11,0,11
Amiria,F,100,128,0,128
Assata,F,100,493,0,493
Maddelyn,F,100,443,0,443
Pearly,F,90,271,30,301
Staney,M,100,0,5,5
Burnell,M,93,80,991,1071
Bassy,F,100,36,0,36
Kesaun,M,100,0,35,35
Geralyn,F,100,4601,0,4601
Shance,M,100,0,10,10
Matis,M,100,0,39,39
Farshad,M,100,0,17,17
Zareyah,F,100,52,0,52
Aeja,F,100,48,0,48
Priyah,F,100,41,0,41
Christoffer,M,100,0,717,717
Jerem,M,100,0,13,13
Dustyn,M,98,60,2480,2540
Shanesse,F,100,5,0,5
Livingston,M,99,5,359,364
Shanie,F,100,488,0,488
Shayleen,F,100,476,0,476
Lafrancine,F,100,5,0,5
Corrion,M,100,0,84,84
Kristilee,F,100,6,0,6
Tatiyanah,F,100,11,0,11
Taline,F,100,251,0,251
Shanora,F,100,99,0,99
Ashadieeyah,F,100,5,0,5
Idena,F,100,11,0,11
Infantfemale,F,100,5,0,5
Kerry,F,51,46914,44733,91647
Mylisha,F,100,42,0,42
Tamaz,M,100,0,14,14
Solmary,F,100,5,0,5
Geffrey,M,100,0,216,216
Iban,M,100,0,513,513
Kaho,F,100,95,0,95
Emisha,F,100,6,0,6
Yaricelis,F,100,6,0,6
Naima,F,100,3416,0,3416
Kandida,F,100,14,0,14
Nikitha,F,100,267,0,267
Earlis,M,100,0,10,10
Jaroslaw,M,100,0,17,17
Obryan,M,100,0,274,274
Nieman,M,100,0,6,6
Gergory,M,100,0,440,440
Kwok,M,100,0,5,5
Peggi,F,100,579,0,579
Harjot,M,74,82,229,311
Shandora,F,100,66,0,66
Lira,F,100,112,0,112
Zevaeh,F,100,11,0,11
Tobby,M,100,0,389,389
Alonie,F,100,46,0,46
Jovanna,F,100,2881,0,2881
Aquilah,F,100,32,0,32
Torrell,M,100,0,369,369
Garvin,M,100,0,1160,1160
Patti,F,100,38027,46,38073
Chasmine,F,100,108,0,108
Suly,F,100,68,0,68
Erian,F,56,106,82,188
Deking,M,100,0,5,5
Malayah,F,100,1515,0,1515
Cornelia,F,100,5004,5,5009
Mely,F,100,35,0,35
Gwennette,F,100,46,0,46
Ishan,M,100,0,1759,1759
Grenda,F,100,72,0,72
Aleara,F,100,12,0,12
Brandisha,F,100,5,0,5
Lulabelle,F,100,5,0,5
Shauntai,F,100,31,0,31
Chadric,M,100,0,194,194
Tristaca,F,100,22,0,22
Cotey,M,100,0,141,141
Fynnleigh,F,100,5,0,5
Radene,F,100,22,0,22
Devontaye,M,100,0,64,64
Aunica,F,100,108,0,108
Evamaria,F,100,115,0,115
Sudeys,M,100,0,11,11
Enrique,M,99,255,49555,49810
Tyas,M,100,0,20,20
Ritu,F,100,341,0,341
Rosalie,F,100,20580,5,20585
Aviad,M,100,0,12,12
Moritz,M,100,0,95,95
Rocio,F,97,12528,426,12954
Zoli,F,100,18,0,18
Athos,M,100,0,9,9
Kaulin,M,100,0,83,83
Karrianne,F,100,11,0,11
Annalicia,F,100,627,0,627
Tylen,M,99,10,993,1003
Cem,M,100,0,86,86
Neil,M,100,256,69933,70189
Deondra,F,77,1341,410,1751
Sakoya,F,100,62,0,62
Kolsyn,M,100,0,21,21
Aylie,F,100,6,0,6
Jayjuan,M,100,0,22,22
Brolin,M,100,0,70,70
Keyth,M,100,0,53,53
Desmin,M,97,5,165,170
Fernandez,M,100,0,372,372
Hynlee,F,100,27,0,27
Kentavis,M,100,0,32,32
Faylene,F,100,99,0,99
Brinna,F,100,389,0,389
Cagney,F,64,186,105,291
Jakila,F,100,25,0,25
Travail,M,100,0,15,15
Kartez,M,100,0,5,5
Luisjose,M,100,0,7,7
Tiona,F,100,1292,0,1292
Perlie,F,100,18,0,18
Uldis,M,100,0,7,7
Davena,F,100,396,0,396
Analayah,F,100,35,0,35
Jaimes,M,100,0,148,148
Linnis,M,100,0,5,5
Gavril,M,100,0,21,21
Rosevelt,M,100,0,429,429
Binca,F,100,5,0,5
Gerturde,F,100,7,0,7
Chrishon,M,100,0,200,200
Maurizio,M,100,0,548,548
Bell,F,90,128,15,143
Dustun,M,100,0,15,15
Nyellie,F,100,85,0,85
Serentiy,F,100,26,0,26
Mikell,M,75,429,1297,1726
Evangelita,F,100,5,0,5
Shakiesha,F,100,7,0,7
Jordyn,F,91,45103,4423,49526
Ramez,M,100,0,124,124
Cherlynn,F,100,237,0,237
Arita,F,100,109,0,109
Caleyah,F,100,42,0,42
Albieri,M,100,0,12,12
Jadavian,M,100,0,18,18
Masooma,F,100,5,0,5
Pinchos,M,100,0,218,218
Miniya,F,100,150,0,150
Calynn,F,100,325,0,325
Zohra,F,100,257,0,257
Keondrick,M,100,0,67,67
Klarysa,F,100,15,0,15
Brandenn,M,100,0,5,5
Betim,M,100,0,5,5
Tajiddin,M,100,0,25,25
Carmita,F,100,164,0,164
Coreen,F,100,1952,0,1952
Markesa,F,100,6,0,6
Rafael,M,99,533,67695,68228
Taylia,F,100,81,0,81
Kamarrah,F,100,8,0,8
Phelicity,F,100,10,0,10
Sparkle,F,100,1566,0,1566
Avareigh,F,100,6,0,6
Talhah,M,100,0,22,22
Xinyu,F,100,12,0,12
Doremus,M,100,0,10,10
Earney,M,100,0,5,5
Darroll,M,100,0,247,247
Jemina,F,100,90,0,90
Marchele,F,100,102,0,102
Camilo,M,100,0,4324,4324
Katianne,F,100,104,0,104
Novalynn,F,100,35,0,35
Michealle,F,100,51,0,51
Janiyyah,F,100,5,0,5
Beca,F,100,11,0,11
Natilie,F,100,274,0,274
Jiri,M,100,0,16,16
Philisa,F,100,17,0,17
Kieralyn,F,100,5,0,5
Cheney,F,65,208,114,322
Pippa,F,100,625,0,625
Daphene,F,100,334,0,334
Luzer,M,100,0,12,12
Nnamdi,M,100,0,618,618
Naiylah,F,100,10,0,10
Stokley,M,100,0,7,7
Lorencita,F,100,15,0,15
Yizel,F,100,158,0,158
Quanah,M,82,40,186,226
Anze,M,100,0,5,5
Bryahna,F,100,63,0,63
Avianne,F,100,21,0,21
Octaviano,M,100,0,388,388
Dennice,F,100,263,0,263
Bunyan,M,100,0,5,5
Edweina,F,100,5,0,5
Bharat,M,100,0,183,183
Issabela,F,100,53,0,53
Heiry,F,100,11,0,11
Trashonda,F,100,5,0,5
Antwayne,M,100,0,11,11
Rhodora,F,100,20,0,20
Perry,M,97,1717,48483,50200
Nkiru,F,100,10,0,10
Helal,M,100,0,5,5
Areal,F,100,124,0,124
Leighanna,F,100,970,0,970
Saagar,M,100,0,113,113
Antwana,M,58,5,7,12
Laelyn,F,100,26,0,26
Daliah,F,100,470,0,470
Darshi,F,100,5,0,5
Janela,F,100,5,0,5
Camarii,M,100,0,5,5
Shakaya,F,100,58,0,58
Traiveon,M,100,0,5,5
Sadina,F,100,30,0,30
Joey,M,90,5656,48918,54574
Shamkia,F,100,6,0,6
Siniya,F,100,111,0,111
Cindal,F,100,7,0,7
Dietta,F,100,10,0,10
Zyquavious,M,100,0,20,20
Cherryle,F,100,5,0,5
Roopa,F,100,48,0,48
Blithe,F,100,11,0,11
Tyreice,M,100,0,15,15
Marikate,F,100,45,0,45
Wayman,M,100,0,1228,1228
Jhett,M,100,0,546,546
Tajmere,M,100,0,5,5
Zalon,M,100,0,11,11
Mikaeel,M,100,0,114,114
Mickaela,F,100,452,0,452
Tadzia,F,100,17,0,17
Casha,F,100,117,0,117
Ada,F,100,18868,34,18902
Alusine,M,100,0,20,20
Philina,F,100,19,0,19
Yolisma,F,100,5,0,5
Lavern,F,52,2767,2533,5300
Loritta,F,100,23,0,23
Jonuel,M,100,0,41,41
Wyatte,M,100,0,312,312
Leeon,M,100,0,46,46
Dacoda,M,82,116,525,641
Auni,F,100,5,0,5
Leahanna,F,100,95,0,95
Chloeann,F,100,88,0,88
Timeka,F,100,1000,0,1000
Taletha,F,100,242,0,242
Adreanne,F,100,109,0,109
Vontrel,M,100,0,5,5
Lakeea,F,100,8,0,8
Deniese,F,100,353,0,353
Gemari,M,100,0,50,50
Suli,F,100,28,0,28
Dailynne,F,100,6,0,6
Nasar,M,100,0,5,5
Bertell,M,100,0,10,10
Firyal,F,100,5,0,5
Adamaris,F,100,2737,0,2737
Brynnlea,F,100,5,0,5
Jalil,M,100,5,2396,2401
Kennedy,F,90,54133,5766,59899
Esad,M,100,0,9,9
Alya,F,100,841,0,841
Malaysiah,F,100,12,0,12
Carlanthony,M,100,0,5,5
Mykhala,F,100,5,0,5
Shaquone,M,100,0,5,5
Rakyia,F,100,22,0,22
Martrice,F,92,123,11,134
Laneisha,F,100,616,0,616
Georgia,F,100,49320,106,49426
Raeli,F,100,72,0,72
Lor,M,100,0,38,38
Alba,F,100,4009,10,4019
Jaquandra,F,100,13,0,13
Malkiel,M,100,0,23,23
Fawad,M,100,0,11,11
Dekevious,M,100,0,10,10
Neleah,F,100,39,0,39
Yisell,F,100,69,0,69
Nateshia,F,100,34,0,34
Ossiel,M,100,0,88,88
Kesharia,F,100,5,0,5
Sahid,M,100,0,288,288
Antonea,F,100,71,0,71
Nikara,F,100,5,0,5
Wilbur,M,100,17,9535,9552
Ramon,M,99,419,55947,56366
Dvontae,M,100,0,106,106
Gildardo,M,100,0,979,979
Nyani,F,100,12,0,12
Aydan,M,91,424,4492,4916
Terece,F,100,11,0,11
Dewight,M,100,0,467,467
Tobbie,F,59,17,12,29
Meric,M,100,0,108,108
Leida,F,100,399,0,399
Iremide,M,100,0,13,13
Kirklen,M,100,0,11,11
Pauline,F,100,33449,63,33512
Stancil,M,100,0,17,17
Eleya,F,100,5,0,5
Keani,F,94,383,25,408
Tremarcus,M,100,0,10,10
Deavon,M,93,29,395,424
Phylea,F,100,6,0,6
Crustal,F,100,7,0,7
Durron,M,100,0,40,40
Shanekqua,F,100,125,0,125
Elizandro,M,100,0,214,214
Anujin,F,100,22,0,22
Tinica,F,100,11,0,11
Ninel,F,100,290,0,290
Elfida,F,100,36,0,36
Axis,M,100,0,7,7
Cherice,F,100,1136,0,1136
Tmaya,F,100,5,0,5
Carlett,F,100,33,0,33
Ludger,M,100,0,7,7
Kitt,F,61,166,106,272
Yuvraj,M,100,0,611,611
Jaquelle,M,100,0,29,29
Narvell,M,100,0,6,6
Deletta,F,100,5,0,5
Tysheka,F,100,123,0,123
Ramont,M,100,0,57,57
Tyahna,F,100,34,0,34
Saben,M,100,0,102,102
Niem,M,100,0,6,6
Nicia,F,100,54,0,54
Betina,F,100,962,0,962
Malakhi,M,100,0,1137,1137
Jesse,M,97,10137,311001,321138
Shandricka,F,100,77,0,77
Michelle,F,100,798390,3230,801620
Jonothon,M,100,0,39,39
Abdulkarim,M,100,0,117,117
Avionne,F,100,19,0,19
Scottie,M,91,1022,9779,10801
Jazlyne,F,100,409,0,409
Daerion,M,100,0,6,6
Berton,M,100,0,529,529
Taleya,F,100,232,0,232
Carlina,F,100,1074,0,1074
Tamarian,M,100,0,17,17
Anikka,F,100,236,0,236
Kyriel,F,100,10,0,10
Abdrew,M,100,0,6,6
Janitzy,F,100,15,0,15
Summerlynn,F,100,75,0,75
Christophermich,M,100,0,52,52
Tomislav,M,100,0,197,197
Thijs,M,100,0,89,89
Olatunji,M,100,0,10,10
Jhania,F,100,72,0,72
Reisha,F,100,135,0,135
Maddie,F,100,3053,0,3053
Malyke,M,100,0,17,17
Gurtaj,M,100,0,28,28
Brackston,M,100,0,36,36
Zaedin,M,100,0,21,21
Tenicha,F,100,5,0,5
Christean,F,100,30,0,30
Holman,M,100,0,26,26
Rosane,F,100,10,0,10
Makia,F,98,1292,23,1315
Angelly,F,100,396,0,396
Delainey,F,100,1213,0,1213
Delphine,F,100,3556,0,3556
Kashen,M,100,0,12,12
Silvana,F,100,1855,0,1855
Iya,F,100,214,0,214
Teana,F,100,944,0,944
Antrell,M,100,0,338,338
Kahil,M,100,0,98,98
Danaisha,F,100,202,0,202
Promyce,F,100,23,0,23
Sherrye,F,100,538,0,538
Odessa,F,99,4032,31,4063
Quinterius,M,100,0,96,96
Calasia,F,100,5,0,5
Margareta,F,100,217,0,217
Jenaye,F,100,143,0,143
Maximiliano,M,100,0,10015,10015
Tiyonna,F,100,315,0,315
Makhayla,F,100,97,0,97
Gleice,F,100,8,0,8
Rickel,F,100,37,0,37
Genevie,F,100,802,0,802
Dinorah,F,100,551,0,551
Markangelo,M,100,0,11,11
Melian,F,100,11,0,11
Rosslynn,F,100,25,0,25
Merville,M,100,0,6,6
Porsha,F,100,3945,6,3951
Laretha,F,100,215,0,215
Alexandrina,F,100,218,0,218
Wilbern,M,100,0,39,39
Kentrez,M,100,0,23,23
Meshelle,F,100,309,0,309
Salene,F,100,139,0,139
Cairn,F,100,5,0,5
Laveda,F,100,449,0,449
Talaia,F,100,10,0,10
Xylan,M,100,0,40,40
Yulanda,F,100,1076,0,1076
Marell,M,100,0,29,29
Sundai,F,100,53,0,53
Tilak,M,100,0,41,41
Lamondo,M,100,0,6,6
Lynzie,F,100,929,0,929
Yeilen,F,100,10,0,10
Deema,F,100,353,0,353
Tenoch,M,100,0,168,168
Kalia,F,100,3790,0,3790
Shawney,F,100,35,0,35
Lynnlee,F,100,325,0,325
Shanara,F,100,241,0,241
Kreg,M,100,0,903,903
Kaliopi,F,100,27,0,27
Rakia,F,100,504,0,504
Divij,M,100,0,5,5
Chayson,M,100,0,136,136
Lateesha,F,100,446,0,446
Saraia,F,100,74,0,74
Yanisley,F,100,9,0,9
Jamice,F,100,116,0,116
Franciene,F,100,10,0,10
Bellamay,F,100,5,0,5
Aleese,F,100,222,0,222
Ashaya,F,100,85,0,85
Damina,F,100,5,0,5
Ariebella,F,100,22,0,22
Richy,M,100,0,647,647
Ereka,F,100,203,0,203
Malaya,F,100,4093,0,4093
Charlcie,F,100,38,0,38
Latunya,F,100,219,0,219
Mikhail,M,99,24,2929,2953
Jonnatan,M,100,0,66,66
Timarion,M,100,0,80,80
Zai,M,79,15,55,70
Yorleni,F,100,26,0,26
Clinetta,F,100,5,0,5
Mechaela,F,100,7,0,7
Cymantha,F,100,27,0,27
Jkia,F,100,5,0,5
Ai,F,97,344,11,355
Yanely,F,100,1251,0,1251
Makiya,F,99,2556,14,2570
Shamisha,F,100,7,0,7
Keontai,M,100,0,7,7
Javionne,M,100,0,32,32
Jacleen,F,100,30,0,30
Dandre,M,99,37,6922,6959
Deangelia,F,100,11,0,11
Sumeka,F,100,14,0,14
Coye,M,100,0,212,212
Jayceion,M,100,0,84,84
Taz,M,97,10,366,376
Georgeann,F,100,1287,0,1287
Jasmil,F,100,5,0,5
Kamala,F,100,1154,0,1154
Delmer,M,100,0,1626,1626
Yanessa,F,100,342,0,342
Edlynn,F,100,5,0,5
Timmothy,M,100,0,3971,3971
Vondalee,F,100,11,0,11
Lainey,F,100,6572,0,6572
Rodner,M,100,0,43,43
Kahn,M,100,0,29,29
Bobbiejo,F,100,1009,0,1009
Ristin,F,100,5,0,5
Jeannelle,F,100,70,0,70
Skylinn,F,100,69,0,69
Janaia,F,100,220,0,220
Dakyah,F,100,5,0,5
Elijsha,M,100,0,37,37
Minhanh,F,100,5,0,5
Cristeen,F,100,5,0,5
Kassiah,F,100,56,0,56
Waltina,F,100,16,0,16
Dianela,F,100,10,0,10
Darisha,F,100,52,0,52
Adorion,M,100,0,6,6
Virlinda,F,100,5,0,5
Devinity,F,100,25,0,25
Alyena,F,100,19,0,19
Valaida,F,100,5,0,5
Nazaria,F,100,329,0,329
Leti,F,100,17,0,17
Brytnee,F,100,63,0,63
Cambrea,F,100,148,0,148
Luisfernando,M,100,0,276,276
Kallel,M,100,0,22,22
Aelicia,F,100,6,0,6
Imar,F,59,16,11,27
Kulsoom,F,100,30,0,30
Jobin,M,100,0,93,93
Jj,M,100,0,435,435
Chancy,M,67,204,423,627
Valentino,M,100,0,5348,5348
Shazad,M,100,0,16,16
Willine,F,100,34,0,34
Arleht,F,100,6,0,6
Azim,M,100,0,375,375
Clarence,M,99,552,73065,73617
Lashieka,F,100,18,0,18
Jabe,M,100,0,181,181
Dahlyla,F,100,31,0,31
Raquael,F,100,5,0,5
Woodard,M,100,0,34,34
Uli,F,100,5,0,5
Omon,M,100,0,5,5
Rocquel,F,100,113,0,113
Adon,M,100,0,606,606
Shaurya,M,100,0,623,623
Vivan,F,63,213,123,336
Adorabella,F,100,21,0,21
Melih,M,100,0,24,24
Kylyn,F,82,271,61,332
Amyna,F,100,14,0,14
Tyria,F,98,328,6,334
Deneene,F,100,74,0,74
Yariela,F,100,67,0,67
Sweden,F,100,30,0,30
Shavelle,F,100,122,0,122
Shinaya,F,100,11,0,11
Guess,M,100,0,5,5
Maaliyah,F,100,207,0,207
Caileen,F,100,139,0,139
Chenice,F,100,37,0,37
Jakkia,F,67,16,8,24
Atiyanna,F,100,6,0,6
Laniece,F,100,524,0,524
Amariana,F,100,570,0,570
Justiniano,M,100,0,5,5
Tocara,F,100,68,0,68
Dineisha,F,100,10,0,10
Leondrus,M,100,0,5,5
Azteca,F,100,5,0,5
Rashan,M,93,66,885,951
Crisol,F,100,64,0,64
Christella,F,100,478,0,478
Marily,F,100,703,0,703
Audy,M,100,0,169,169
Brandall,M,100,0,31,31
Izeal,M,100,0,5,5
Hose,M,100,0,7,7
Jaborie,M,100,0,11,11
Tamryn,F,97,296,10,306
Phoenicia,F,100,122,0,122
Rosaley,F,100,15,0,15
Saida,F,100,998,0,998
Gustavus,M,100,0,148,148
Sujei,F,100,23,0,23
Aveleen,F,100,39,0,39
Shateara,F,100,30,0,30
Larriesha,F,100,5,0,5
Damein,M,100,0,1017,1017
Kayen,M,91,5,50,55
Reyon,M,100,0,15,15
Mumin,M,100,0,91,91
Rut,F,100,647,0,647
Marsi,F,100,123,0,123
Shastelin,F,100,5,0,5
Jonibek,M,100,0,12,12
Odis,M,100,0,2197,2197
Dymonique,F,100,25,0,25
Nahara,F,100,55,0,55
Chayil,F,100,77,0,77
Kelvan,M,100,0,6,6
Viance,F,100,16,0,16
Torben,M,100,0,146,146
Aminda,F,100,39,0,39
Osmary,F,100,16,0,16
Jolenna,F,100,6,0,6
Almeter,F,100,6,0,6
Sanquetta,F,100,7,0,7
Sotera,F,100,11,0,11
Nashir,M,100,0,11,11
Aadam,M,100,0,196,196
Jennnifer,F,100,38,0,38
Saim,M,100,0,127,127
Aubriel,F,100,189,0,189
Mianicole,F,100,21,0,21
Aqsa,F,100,304,0,304
Makenzly,F,100,5,0,5
Andrewjacob,M,100,0,12,12
Rahmir,M,100,0,335,335
Talasia,F,100,209,0,209
Takeo,M,100,0,195,195
Providencia,F,100,114,0,114
Shawntel,F,99,1135,17,1152
Deland,M,100,0,252,252
Rafa,F,67,34,17,51
Kishma,F,100,5,0,5
Vittoria,F,100,1074,0,1074
Corinn,F,100,635,0,635
Nyxon,M,100,0,17,17
Everley,F,100,299,0,299
Tahiya,F,100,26,0,26
Quimora,F,100,5,0,5
Tanaeja,F,100,15,0,15
Shamod,M,100,0,7,7
Zakira,F,100,365,0,365
Judite,F,100,5,0,5
Sharissa,F,100,502,0,502
Cire,M,54,142,165,307
Zeilah,F,100,5,0,5
Roshawna,F,100,61,0,61
Densel,M,100,0,16,16
Shatila,F,100,10,0,10
Franciscus,M,100,0,5,5
Philomene,F,100,16,0,16
Shavna,F,100,32,0,32
Tayonna,F,100,380,0,380
Jeremiha,M,100,0,50,50
Chadwyck,M,100,0,37,37
Kahlif,M,100,0,32,32
Ayelene,F,100,38,0,38
Matyson,F,100,17,0,17
Norland,M,100,0,5,5
Rosmarie,F,100,48,0,48
Montanna,F,97,839,28,867
Ute,F,100,25,0,25
Tanijah,F,100,440,0,440
Alylah,F,100,45,0,45
Rikkilynn,F,100,5,0,5
Columbus,M,100,0,1641,1641
Chriss,M,74,137,390,527
Kalip,M,100,0,10,10
Yissochor,M,100,0,23,23
Tadajah,F,100,5,0,5
Ragenia,F,100,5,0,5
Ahnya,F,100,143,0,143
Emmarie,F,100,693,0,693
Dazhanae,F,100,12,0,12
Mouhamad,M,100,0,99,99
Alexadra,F,100,11,0,11
Arantza,F,100,404,0,404
Marthony,M,100,0,6,6
Martie,F,81,833,194,1027
Unseld,M,100,0,5,5
Rosalene,F,100,70,0,70
Din,M,100,0,57,57
Letrisha,F,100,22,0,22
Starlee,F,100,72,0,72
Rekita,F,100,82,0,82
Tedford,M,100,0,29,29
Akaash,M,100,0,123,123
Rakem,M,100,0,21,21
Keymiyah,F,100,5,0,5
Evaughn,F,100,10,0,10
Persaya,F,100,5,0,5
Vontresa,F,100,6,0,6
Mohammed,M,100,0,11209,11209
Oswin,M,83,29,145,174
Maylis,F,100,18,0,18
Schon,M,100,0,117,117
Elenita,F,100,28,0,28
Etherine,F,100,7,0,7
Zaraiyah,F,100,5,0,5
Mei,F,100,1081,0,1081
Srihaas,M,100,0,37,37
Atit,M,100,0,6,6
Tydon,M,100,0,7,7
Sapheria,F,100,5,0,5
Netanya,F,100,431,0,431
Maeci,F,100,103,0,103
Deshonia,F,100,5,0,5
Marlayna,F,100,761,0,761
Anvita,F,100,326,0,326
Wilgus,M,100,0,11,11
Syri,F,100,26,0,26
Dorrene,F,100,39,0,39
Macauley,M,88,30,213,243
Damyen,M,100,0,144,144
Dorothye,F,100,5,0,5
Danzig,M,100,0,52,52
Zariona,F,100,10,0,10
Payton,F,67,45424,21940,67364
Candace,F,100,76983,153,77136
Temari,F,91,50,5,55
Giara,F,100,56,0,56
Jazzlynn,F,100,1134,0,1134
Cayla,F,100,10184,0,10184
Luvenia,F,100,778,0,778
Jakameron,M,100,0,5,5
Raisean,M,100,0,6,6
Elbony,F,100,189,0,189
Kam,M,53,380,421,801
Rameen,F,63,170,100,270
Jahirah,F,100,18,0,18
Phu,M,100,0,270,270
Joseiah,M,100,0,5,5
Astyn,M,51,18,19,37
Wayde,M,100,0,1773,1773
Teshauna,F,100,21,0,21
Kathelyn,F,100,238,0,238
Martee,F,100,5,0,5
Emeal,M,100,0,15,15
Geraldinne,F,100,5,0,5
Jazmany,M,100,0,5,5
Gibb,M,100,0,11,11
Devy,F,100,27,0,27
Joshus,M,100,0,171,171
Adrine,F,92,54,5,59
Dayjah,F,100,251,0,251
Annya,F,100,151,0,151
Yeremi,M,100,0,42,42
Daymar,M,100,0,15,15
Tannis,F,98,292,5,297
Breeauna,F,100,55,0,55
Chelise,F,100,192,0,192
Quintan,M,100,0,294,294
Bismark,M,100,0,45,45
Tamey,F,100,150,0,150
Shashana,F,100,99,0,99
Narayani,F,100,15,0,15
Shaniquia,F,100,139,0,139
Tameiko,F,100,13,0,13
Nanika,F,100,5,0,5
Lucerito,F,100,379,0,379
General,M,100,0,877,877
Zyah,F,100,232,0,232
Maximilliano,M,100,0,357,357
Marlow,M,70,503,1172,1675
Paj,F,100,11,0,11
Mustafa,M,100,0,4569,4569
Israelle,F,100,23,0,23
Bradrick,M,100,0,176,176
Dnielle,F,100,5,0,5
Linday,F,100,133,0,133
Micaela,F,100,11414,6,11420
Georgianne,F,100,701,0,701
Sherae,F,100,273,0,273
Quinci,F,87,254,37,291
Kerris,F,100,39,0,39
Kenyana,F,100,357,0,357
Santhosh,M,100,0,60,60
Karm,M,100,0,11,11
Bayshawn,M,100,0,5,5
Manyah,F,100,42,0,42
Kurstyn,F,100,100,0,100
Derice,M,100,0,18,18
Racelyn,F,100,5,0,5
Brandeis,F,100,39,0,39
Kait,F,100,7,0,7
Torei,F,100,5,0,5
Matha,F,100,54,0,54
Jacetin,M,100,0,6,6
Nonnie,F,100,135,0,135
Fiifi,M,100,0,5,5
Sudais,M,100,0,97,97
Vashni,F,100,5,0,5
Clorisa,F,100,51,0,51
Coumba,F,100,123,0,123
Liona,F,100,67,0,67
Maxamillion,M,100,0,355,355
Jahid,M,100,0,135,135
Charlesanthony,M,100,0,7,7
Jerilee,F,100,135,0,135
Breonna,F,100,4939,0,4939
Credence,M,55,5,6,11
Ynes,F,55,6,5,11
Jaeron,M,100,0,12,12
Fotios,M,100,0,82,82
Kendriana,F,100,22,0,22
Kirollos,M,100,0,20,20
Seanchristopher,M,100,0,10,10
Monserratt,F,100,153,0,153
Nieya,F,100,17,0,17
Maleck,M,100,0,6,6
Martinus,M,100,0,24,24
Jatana,F,100,37,0,37
Sekani,M,100,0,10,10
Jahlon,M,100,0,109,109
Rhyden,M,100,0,34,34
Elwyn,M,98,10,556,566
Jadhiel,M,100,0,5,5
Yatin,M,100,0,12,12
Jacavion,M,100,0,5,5
Dilon,M,100,0,401,401
Claro,M,100,0,10,10
Betania,F,100,213,0,213
Fedel,M,100,0,5,5
Tynasha,F,100,28,0,28
Shovon,F,100,5,0,5
Patrece,F,100,325,0,325
Aweis,M,100,0,10,10
Emilya,F,100,96,0,96
Karagan,F,100,142,0,142
Paxson,M,100,0,217,217
Lequan,M,99,5,383,388
Brantley,M,96,563,13044,13607
Meki,M,100,0,35,35
Lailee,F,100,98,0,98
Travan,M,100,0,21,21
Malashia,F,100,104,0,104
Airielle,F,100,44,0,44
Diliana,F,100,8,0,8
Franka,F,100,17,0,17
Trase,M,100,0,71,71
Iysis,F,100,273,0,273
Ruperto,M,100,0,685,685
Marqus,M,100,0,909,909
Tysheim,M,100,0,6,6
Ater,M,100,0,5,5
Mecia,F,100,21,0,21
Zackaree,M,100,0,29,29
Zyhir,M,100,0,118,118
Devesh,M,100,0,194,194
Audrienne,F,100,5,0,5
Glendell,M,84,40,207,247
Casen,M,99,17,2815,2832
Mayliah,F,100,10,0,10
Yoeli,F,100,33,0,33
Rynda,F,100,18,0,18
Janaeya,F,100,59,0,59
Zavyon,M,100,0,12,12
Tavarez,M,100,0,22,22
Finlee,F,93,275,20,295
Omega,F,74,988,352,1340
Ondrea,F,100,769,0,769
Teandre,M,100,0,265,265
Melasia,F,100,40,0,40
Tikela,F,100,5,0,5
Qasim,M,100,0,715,715
Aisatou,F,100,33,0,33
Adrie,F,100,172,0,172
Fate,M,67,107,216,323
Shoshona,F,100,5,0,5
Kadedra,F,100,286,0,286
Paco,M,100,0,274,274
Stryder,M,100,0,424,424
Chadly,M,100,0,7,7
Laurica,F,100,5,0,5
Ovid,M,100,0,114,114
Beacher,M,100,0,6,6
Danett,F,100,143,0,143
Syd,M,100,0,82,82
Shadina,F,100,6,0,6
Aster,F,91,163,17,180
Anacely,F,100,5,0,5
Jemir,M,100,0,12,12
Megann,F,100,797,0,797
Lawren,F,94,961,59,1020
Yailin,F,100,608,0,608
Yuepheng,M,100,0,59,59
Jonquel,M,100,0,10,10
Julianni,F,84,26,5,31
Letishia,F,100,64,0,64
Danyele,F,100,327,0,327
Blimi,F,100,60,0,60
Emiri,F,100,30,0,30
Javina,F,100,5,0,5
Laythen,M,100,0,45,45
Izzi,F,100,28,0,28
Briannah,F,100,1358,0,1358
Matthe,M,100,0,68,68
Ailyn,F,100,2592,0,2592
Dandridge,M,100,0,11,11
Olia,F,100,15,0,15
Alaythia,F,100,16,0,16
Aletza,F,100,7,0,7
Baile,F,100,13,0,13
Lottie,F,100,3947,0,3947
Chakotay,M,100,0,11,11
Aleksandar,M,100,0,1109,1109
Generosa,F,100,10,0,10
Mathue,M,100,0,28,28
Abigailgrace,F,100,11,0,11
Khamoni,M,68,26,55,81
Sael,M,100,0,113,113
Nielle,F,100,58,0,58
Vikranth,M,100,0,30,30
Janie,F,100,34502,134,34636
Allaire,F,100,21,0,21
Jensie,F,100,10,0,10
Xong,F,76,16,5,21
Jerrisha,F,100,17,0,17
Mordechai,M,100,0,4180,4180
Tomika,F,100,2781,5,2786
Hamdan,M,100,0,116,116
Isaack,M,100,0,107,107
Mardelle,F,100,113,0,113
Dlaney,F,100,6,0,6
Nadiyah,F,100,898,0,898
Blakeli,F,100,10,0,10
Evaleen,F,100,44,0,44
Keila,F,100,6036,0,6036
Shoshannah,F,100,210,0,210
Eterniti,F,100,12,0,12
Meelah,F,100,127,0,127
Damarie,M,66,44,85,129
Dashiah,F,100,5,0,5
Delories,F,100,321,0,321
Rakiesha,F,100,5,0,5
Saraha,F,100,42,0,42
Shaundrea,F,100,145,0,145
Dahlia,F,100,7645,0,7645
Davell,M,100,0,270,270
Yalexia,F,100,8,0,8
Danaysy,F,100,6,0,6
Darreyl,M,100,0,43,43
Raoof,M,100,0,5,5
Venard,M,100,0,5,5
Talena,F,100,887,0,887
Lemuel,M,100,0,4419,4419
Aristotelis,M,100,0,32,32
Latricia,F,100,5369,0,5369
Juandalynn,F,100,13,0,13
Allannah,F,100,203,0,203
Izamary,F,100,31,0,31
Audi,F,59,101,70,171
Bassey,M,100,0,10,10
Bilon,F,100,5,0,5
Indiyah,F,100,130,0,130
Lesslie,F,96,486,18,504
Rodonna,F,100,5,0,5
Darrelle,M,79,64,238,302
Sheenika,F,100,6,0,6
Nikkolaus,M,100,0,6,6
Tamre,F,100,90,0,90
Carden,M,90,26,235,261
Koli,M,62,8,13,21
Zarious,M,100,0,7,7
Kiisha,F,100,13,0,13
Icysis,F,100,10,0,10
Ruhika,F,100,5,0,5
Sunnee,F,100,5,0,5
Chamar,M,100,0,219,219
Dejuane,M,100,0,26,26
Debron,M,100,0,48,48
Trisity,F,100,5,0,5
Avaree,F,100,289,0,289
Audreigh,F,100,15,0,15
Solach,F,100,5,0,5
Valynda,F,100,41,0,41
Eitan,M,100,0,1401,1401
Samee,M,100,0,36,36
Rashieda,F,100,10,0,10
Nasasha,F,100,15,0,15
Amilea,F,100,41,0,41
Yamari,F,96,123,5,128
Lonette,F,100,198,0,198
Xhaiden,M,100,0,87,87
Lavia,F,100,5,0,5
Earma,F,100,105,0,105
Jayk,M,100,0,39,39
Damu,M,100,0,34,34
Anadelia,F,100,96,0,96
Francesca,F,100,25846,33,25879
Stevi,F,100,1366,0,1366
Harvie,M,100,0,232,232
Monik,F,100,142,0,142
Archibald,M,100,0,758,758
Maryelizabeth,F,100,1676,0,1676
Trini,F,71,549,229,778
Walela,F,100,7,0,7
Henry,M,99,1276,253255,254531
Huel,M,100,0,28,28
Osborn,M,100,0,105,105
Treyvan,M,100,0,38,38
Latorra,F,100,37,0,37
Heike,F,100,120,0,120
Sariel,M,100,0,33,33
Kurtisha,F,100,27,0,27
Danuta,F,100,142,0,142
Lakima,F,100,61,0,61
Neriah,F,99,1416,20,1436
Treyvonn,M,100,0,32,32
Tosheba,F,100,34,0,34
Lexa,F,100,920,0,920
Janessah,F,100,36,0,36
Lukkas,M,100,0,11,11
Shandice,F,100,12,0,12
Dondre,M,100,0,1501,1501
Tavonya,F,100,6,0,6
Tremari,M,100,0,14,14
Marland,M,100,0,570,570
Quintina,F,100,1017,0,1017
Zykaria,F,100,10,0,10
Siham,F,100,402,0,402
Aydeliz,F,100,6,0,6
Sriansh,M,100,0,42,42
Trease,F,100,145,0,145
Larain,F,100,10,0,10
Lacorya,F,100,5,0,5
Tadasia,F,100,12,0,12
Affie,F,100,5,0,5
Kindsey,F,100,82,0,82
Kazi,M,78,61,214,275
Shalisha,F,100,353,0,353
Karamo,M,100,0,5,5
Seerit,F,100,11,0,11
Aubreelynn,F,100,28,0,28
Tiranke,F,100,6,0,6
Kena,F,99,1700,11,1711
Raidon,M,100,0,121,121
Christanna,F,100,36,0,36
Lesie,F,100,57,0,57
Twyla,F,100,4636,0,4636
Mateusz,M,100,0,1055,1055
Derick,M,100,39,18127,18166
Sheilda,F,100,35,0,35
Zamiya,F,100,481,0,481
Jamesmatthew,M,100,0,21,21
Ayaa,F,100,23,0,23
Antania,F,100,338,0,338
Jackson,M,100,525,186484,187009
Lo,M,87,5,33,38
Lamya,F,100,1664,0,1664
Chloeanne,F,100,61,0,61
Kwaun,M,100,0,5,5
Lenon,M,100,0,144,144
Kalp,M,100,0,5,5
Brisco,M,100,0,31,31
Marcine,F,100,393,0,393
Tonishia,F,100,87,0,87
Marien,F,100,89,0,89
Willy,M,99,21,2750,2771
Zury,F,100,428,0,428
Javor,M,100,0,5,5
Haigen,M,100,0,13,13
Kevaughn,M,100,0,290,290
Laryn,F,100,374,0,374
Jadee,F,100,298,0,298
Indy,F,58,329,243,572
Kaithlyn,F,100,316,0,316
Delva,F,100,72,0,72
Gearld,M,100,5,1729,1734
Albina,F,100,460,0,460
Mohamadali,M,100,0,20,20
Kimra,F,100,220,0,220
Duriel,M,100,0,253,253
Khamarion,M,100,0,73,73
Ajeya,F,100,15,0,15
Marciano,M,100,0,824,824
Rawad,M,100,0,43,43
Seward,M,100,0,53,53
Obaid,M,100,0,15,15
Arialle,F,100,5,0,5
Zorion,M,100,0,128,128
Verneeda,F,100,5,0,5
Teshara,F,100,56,0,56
Delroy,M,100,0,929,929
Annalise,F,100,8875,0,8875
Kaygan,F,100,14,0,14
Illiana,F,100,1312,0,1312
Addileigh,F,100,22,0,22
Nilan,M,100,0,53,53
Sharath,M,100,0,11,11
Fatyma,F,100,10,0,10
Chima,M,100,0,259,259
Myalyn,F,100,5,0,5
Alverna,F,100,78,0,78
Azya,F,100,163,0,163
Chester,M,100,123,29269,29392
Jayann,F,100,45,0,45
Cariah,F,100,84,0,84
Clay,M,100,94,29790,29884
Leilonnie,F,100,5,0,5
Adaijah,F,100,76,0,76
Rosonda,F,100,5,0,5
Khayman,M,100,0,89,89
Datavia,F,100,12,0,12
Lun,F,100,15,0,15
Tammyann,F,100,6,0,6
Arner,M,100,0,5,5
Chakka,F,100,10,0,10
Praveer,M,100,0,5,5
Ardys,F,100,44,0,44
Jermia,F,100,189,0,189
Mariamne,F,100,14,0,14
Raechel,F,100,2248,0,2248
Shenel,F,100,42,0,42
Regenna,F,100,26,0,26
Aireyana,F,100,14,0,14
Hayoon,F,100,5,0,5
Michone,F,100,10,0,10
Aquanetta,F,100,207,0,207
Dlana,F,100,5,0,5
Veneshia,F,100,10,0,10
Husna,F,100,247,0,247
Jerlin,F,100,12,0,12
Keslyn,F,100,74,0,74
Verl,M,100,0,422,422
Lloyde,M,100,0,11,11
Drayten,M,100,0,6,6
Lark,F,93,1241,100,1341
Isaly,F,100,119,0,119
Xaver,M,100,0,49,49
Asriel,M,62,12,20,32
Glorya,F,100,37,0,37
Aidean,M,100,0,23,23
Samridhi,F,100,21,0,21
Maayan,F,99,418,5,423
Lacandice,F,100,22,0,22
Debraann,F,100,196,0,196
Devana,F,100,24,0,24
Harmeet,F,65,11,6,17
Kensuke,M,100,0,33,33
Aideliz,F,100,114,0,114
Shilonda,F,100,37,0,37
Icess,F,100,108,0,108
Kieren,M,76,118,368,486
Danissa,F,100,91,0,91
Champ,M,100,0,495,495
Neelia,F,100,6,0,6
Zuko,M,100,0,18,18
Wendle,M,100,0,49,49
Ameenah,F,100,673,0,673
Kaleo,M,100,0,850,850
Zyad,M,100,0,97,97
Daylen,M,91,244,2415,2659
Adamae,F,100,12,0,12
Krissie,F,100,422,0,422
Chakita,F,100,134,0,134
Talea,F,100,743,0,743
Shenee,F,100,264,0,264
Kohler,M,100,0,95,95
Oxford,M,100,0,16,16
Aerica,F,100,87,0,87
Angeljesus,M,100,0,41,41
Crystie,F,100,90,0,90
Tayeshawn,M,100,0,5,5
Raydrick,M,100,0,6,6
Drishti,F,100,60,0,60
Keenen,M,100,0,1114,1114
Gwenna,F,100,248,0,248
Loveta,F,100,14,0,14
Abida,F,100,30,0,30
Brevyn,M,94,11,168,179
Vondia,F,100,5,0,5
Hunnie,F,100,6,0,6
Abdurahman,M,100,0,274,274
Cameo,F,88,1472,206,1678
Umamah,F,100,6,0,6
Aleyla,F,100,22,0,22
Shintaro,M,100,0,26,26
Lizamarie,F,100,32,0,32
Shylia,F,100,52,0,52
Samraj,M,100,0,5,5
Jatiya,F,100,10,0,10
Wilmary,F,100,82,0,82
Janiyah,F,100,9039,0,9039
Jahmon,M,100,0,36,36
Geovonie,M,100,0,5,5
Mauro,M,100,0,4480,4480
Kayleann,F,100,77,0,77
Brizia,F,100,35,0,35
Avanna,F,100,156,0,156
Teneia,F,100,5,0,5
Dekota,M,75,239,712,951
Shonnetta,F,100,5,0,5
Daiki,M,100,0,95,95
Shalaya,F,100,516,0,516
Yeilyn,F,100,68,0,68
Nilesh,M,100,0,177,177
Brianah,F,100,408,0,408
Camillie,F,100,5,0,5
Ivanah,F,100,5,0,5
Aleyda,F,100,937,0,937
Quaron,M,100,0,161,161
Poonam,F,100,260,0,260
Brannen,M,100,0,359,359
Anylia,F,100,28,0,28
Amelea,F,100,11,0,11
Deniz,M,54,601,712,1313
Seryniti,F,100,5,0,5
Nikiyah,F,100,187,0,187
Dessa,F,100,860,0,860
Delbreco,M,100,0,5,5
Meghana,F,100,895,0,895
Daciana,F,100,10,0,10
Havanna,F,100,393,0,393
Sachika,F,100,11,0,11
Jalaila,F,100,53,0,53
Veronicia,F,100,10,0,10
Awwab,M,100,0,11,11
Tabb,M,100,0,61,61
Zeppelin,M,94,16,247,263
Saint,M,100,0,444,444
Mikki,F,99,1957,11,1968
Adeen,M,100,0,5,5
Lasheba,F,100,80,0,80
Nhut,M,100,0,16,16
Dorca,F,100,30,0,30
Nann,F,100,5,0,5
Hephzibah,F,100,61,0,61
Rondle,M,100,0,48,48
Shanautica,F,100,86,0,86
Khalifa,M,100,0,137,137
Adeem,M,100,0,5,5
Latreal,M,100,0,16,16
Rabiah,F,100,81,0,81
Taurus,M,96,84,1851,1935
Gerene,F,100,24,0,24
Monicia,F,100,110,0,110
Tatsuki,M,100,0,6,6
Temmy,F,100,7,0,7
Johnee,F,100,50,0,50
Kelten,M,100,0,98,98
Lanette,F,100,4469,0,4469
Zuli,F,100,10,0,10
Gearldean,F,100,42,0,42
Lezley,F,100,280,0,280
Airabella,F,100,183,0,183
Leron,M,100,0,1538,1538
Freeman,M,100,0,3718,3718
Zionn,M,100,0,5,5
Guerin,M,100,0,62,62
Shalanna,F,100,5,0,5
Meldoy,F,100,28,0,28
Shaneece,F,100,98,0,98
Lashea,F,100,890,0,890
Ljiljana,F,100,10,0,10
Jekeria,F,100,5,0,5
Emmajean,F,100,235,0,235
Leydi,F,100,350,0,350
Adellyn,F,100,46,0,46
Rashonda,F,100,1498,0,1498
Jaqulyn,F,100,72,0,72
Nehemias,M,100,0,850,850
Lao,M,100,0,32,32
Elydia,F,100,15,0,15
Analeese,F,100,72,0,72
Taqueria,F,100,18,0,18
Linzee,F,100,290,0,290
Ruxton,M,100,0,5,5
Edrick,M,100,0,1299,1299
Shyesha,F,100,21,0,21
Sebestian,M,100,0,5,5
Ravonte,M,100,0,7,7
Jeronica,F,100,179,0,179
Martwon,M,100,0,5,5
Jacelin,F,100,24,0,24
Plez,M,100,0,7,7
Ameriyah,F,100,45,0,45
Tice,M,100,0,33,33
Rajani,F,100,5,0,5
Shiretta,F,100,5,0,5
Shaindel,F,100,622,0,622
Dianeli,F,100,5,0,5
Jerikka,F,100,7,0,7
Gabryle,M,100,0,44,44
Darshanna,F,100,6,0,6
Devion,M,98,26,1643,1669
Thienlong,M,100,0,6,6
Lynda,F,100,46984,61,47045
Latravia,F,100,200,0,200
Santrese,F,100,6,0,6
Benigno,M,100,0,1175,1175
Axwell,M,100,0,5,5
Tremonte,M,100,0,20,20
Mikiyas,M,100,0,17,17
Peggyanne,F,100,11,0,11
Vyonne,F,100,15,0,15
Dragon,M,100,0,115,115
Kaien,M,100,0,59,59
Shavella,F,100,20,0,20
Edu,M,100,0,67,67
Svanik,M,100,0,27,27
Tyunna,F,100,6,0,6
Kensyn,M,100,0,5,5
Rawlings,M,100,0,16,16
Hicks,M,100,0,5,5
Lamani,F,100,25,0,25
Kristapher,M,100,0,68,68
Zamion,M,100,0,5,5
Cierra,F,100,26939,36,26975
Trenita,F,100,106,0,106
Vern,M,98,83,3336,3419
Jusus,M,100,0,6,6
Raegine,F,100,6,0,6
Merrilyn,F,100,222,0,222
Tranita,F,100,22,0,22
Lastat,M,100,0,12,12
Amelina,F,100,44,0,44
Lilah,F,100,9169,0,9169
Deavan,M,100,0,18,18
Cynnamon,F,100,40,0,40
Luxe,F,100,43,0,43
Taquila,F,100,214,0,214
Bhavna,F,100,36,0,36
Conesha,F,100,27,0,27
Shannia,F,100,105,0,105
Izaias,M,100,0,93,93
Khadedra,F,100,25,0,25
Shellea,F,100,10,0,10
Debria,F,100,290,0,290
Brynner,M,100,0,33,33
Chantasia,F,100,21,0,21
Jermar,M,100,0,315,315
Nikylah,F,100,16,0,16
Divion,M,100,0,8,8
Nikaela,F,100,68,0,68
Rasim,M,100,0,7,7
Derique,M,100,0,5,5
Kimonie,F,100,5,0,5
Carlvin,M,100,0,5,5
Aamori,F,100,87,0,87
Shonna,F,100,3063,0,3063
Afaf,F,100,28,0,28
Markena,F,100,5,0,5
Navraj,M,100,0,87,87
Sherell,F,100,1452,0,1452
Zyeire,M,100,0,5,5
Jarem,M,100,0,15,15
Laruth,F,100,38,0,38
Montel,M,100,0,1434,1434
Meril,F,50,10,10,20
Lexsy,F,100,5,0,5
Jamelia,F,100,792,0,792
Adolph,M,100,0,3382,3382
Jasmonique,F,100,26,0,26
Diba,F,100,11,0,11
Lille,F,100,42,0,42
Klay,M,100,0,678,678
Shirletha,F,100,5,0,5
Alyn,F,68,373,172,545
Deanine,F,100,41,0,41
Jazhiel,M,100,0,15,15
Brayven,M,100,0,10,10
Zaydren,M,100,0,5,5
Bryaunna,F,100,6,0,6
Yocelin,F,100,930,0,930
Neisa,F,100,47,0,47
Shanteal,F,100,8,0,8
Va,M,100,0,56,56
Nivetha,F,100,5,0,5
Ashima,F,100,66,0,66
Kayelin,F,100,47,0,47
Pesha,F,100,16,0,16
Jayren,M,100,0,314,314
Joston,M,100,0,21,21
Marquist,M,100,0,130,130
Daimian,M,100,0,186,186
Kysean,M,100,0,79,79
Laycie,F,100,248,0,248
Avya,F,100,42,0,42
Angelque,F,100,14,0,14
Luane,F,100,156,0,156
Raymundo,M,100,0,7521,7521
Marvel,M,54,584,675,1259
Gilda,F,100,4100,0,4100
Orest,M,100,0,203,203
Kaushal,M,100,0,106,106
Williammichael,M,100,0,12,12
Joncarlo,M,100,0,226,226
Amarie,F,80,1549,384,1933
Loida,F,100,624,0,624
Takeeta,F,100,5,0,5
Magdelana,F,100,6,0,6
Anayiah,F,100,162,0,162
Shadona,F,100,5,0,5
Sorena,F,100,20,0,20
Riane,F,99,524,5,529
Roiann,F,100,10,0,10
Tochi,F,77,55,16,71
Teon,M,98,15,888,903
Deania,F,100,79,0,79
Shatasha,F,100,174,0,174
Oak,M,100,0,124,124
Tehila,F,100,527,0,527
Shalyse,F,100,52,0,52
Zaydi,F,100,27,0,27
Cortazia,F,100,6,0,6
Dayten,M,100,0,216,216
Antwuan,M,100,0,749,749
Marques,M,100,23,7653,7676
Topeka,F,100,118,0,118
Zevulun,M,100,0,7,7
Zanajah,F,100,10,0,10
Kharsyn,F,100,5,0,5
Arthea,F,100,50,0,50
Kylinn,F,100,118,0,118
Panayiotis,M,100,0,230,230
Arlecia,F,100,53,0,53
Reaven,F,100,6,0,6
Paladin,M,100,0,31,31
Aariona,F,100,221,0,221
Maggi,F,100,746,0,746
Laurabeth,F,100,70,0,70
Trammell,M,100,0,91,91
Calhoun,M,100,0,65,65
Chisom,F,69,342,153,495
Amaru,M,100,0,462,462
Cynthina,F,100,53,0,53
Tessica,F,100,229,0,229
Vedanth,M,100,0,178,178
Atakan,M,100,0,7,7
Elizeth,F,100,168,0,168
Guston,M,100,0,5,5
Myjoy,F,100,5,0,5
Sela,F,100,1024,0,1024
Kaislyn,F,100,19,0,19
Llarely,F,100,5,0,5
Amilah,F,100,106,0,106
Clevon,M,100,0,271,271
Andreu,M,100,0,189,189
Shakiria,F,100,43,0,43
Laura,F,100,620186,1954,622140
Tanylah,F,100,70,0,70
Maxtin,M,100,0,13,13
Rodricka,F,100,53,0,53
Irisha,F,100,80,0,80
Decarla,F,100,116,0,116
Rashae,F,100,231,0,231
Cletus,M,100,0,1796,1796
Danely,F,100,281,0,281
Xochil,F,100,602,0,602
Wynisha,F,100,9,0,9
Kippi,F,100,52,0,52
Dovi,M,100,0,10,10
Dawnyell,F,100,39,0,39
Alfredrick,M,100,0,6,6
Andraea,F,100,36,0,36
Mazella,F,100,5,0,5
Egon,M,100,0,33,33
Bryshaun,M,100,0,5,5
Maty,F,100,97,0,97
Eiker,M,100,0,15,15
Jaquelyne,F,100,218,0,218
Shayda,F,100,296,0,296
Vineisha,F,100,5,0,5
Heidi,F,100,138231,361,138592
Arelia,F,100,122,0,122
Alvonte,M,100,0,33,33
Izebella,F,100,45,0,45
Ransford,M,100,0,6,6
Edger,M,100,0,77,77
Eugina,F,100,350,0,350
Audre,F,89,332,40,372
Taelar,F,100,55,0,55
Miiangel,F,100,7,0,7
Baille,F,100,5,0,5
Deckard,M,100,0,30,30
Jesselynn,F,100,40,0,40
Nashla,F,100,245,0,245
Lakitsha,F,100,5,0,5
Chrishana,F,100,113,0,113
Rebeka,F,100,2461,0,2461
Maleeka,F,100,211,0,211
Sabriena,F,100,5,0,5
Rhoni,F,100,17,0,17
Maki,M,70,172,411,583
Malone,M,56,147,190,337
Karmen,F,100,5457,10,5467
Taumi,F,100,5,0,5
Kanani,F,99,730,5,735
Datra,F,100,74,0,74
Elmedin,M,100,0,7,7
Eowyn,F,100,809,0,809
Jenefer,F,100,320,0,320
Mesa,F,100,526,0,526
Brean,F,94,144,10,154
Ared,M,100,0,10,10
Sehrish,F,100,31,0,31
Zayaan,M,100,0,160,160
Dimitric,M,100,0,24,24
Benjain,M,100,0,10,10
Riquelmer,M,100,0,14,14
Lexis,F,99,3164,43,3207
Symphani,F,100,40,0,40
Rosisela,F,100,14,0,14
Renegade,M,100,0,5,5
Kyten,M,100,0,5,5
Minna,F,100,1022,0,1022
Kristyne,F,100,384,0,384
Eidy,F,100,6,0,6
Johndrea,F,100,7,0,7
Sniyah,F,100,58,0,58
Dawnte,F,55,6,5,11
Synai,F,100,187,0,187
Lisaanne,F,100,63,0,63
Beowulf,M,100,0,13,13
Dmarcus,M,100,0,817,817
Daly,F,88,250,33,283
Nadege,F,100,310,0,310
Oziah,M,100,0,79,79
Suzane,F,100,264,0,264
Leidi,F,100,136,0,136
Damontray,M,100,0,14,14
Heberth,M,100,0,5,5
Shivraj,M,100,0,10,10
Tashanda,F,100,209,0,209
Monicka,F,100,66,0,66
Sagrario,F,100,137,0,137
Kyper,M,100,0,10,10
Marq,M,100,0,88,88
Lateia,F,100,106,0,106
Dalten,M,100,0,327,327
Arran,M,100,0,225,225
Nizear,M,100,0,5,5
Percell,M,100,0,509,509
Fontella,F,100,351,0,351
Caven,M,100,0,203,203
Kyeler,M,100,0,11,11
Carig,M,100,0,5,5
Alajia,F,100,67,0,67
Navario,M,100,0,5,5
Dishan,M,100,0,12,12
Jalexis,F,100,224,0,224
Tilynn,F,100,11,0,11
Anes,M,100,0,103,103
Careem,M,100,0,85,85
Merriah,F,100,36,0,36
Marietherese,F,100,27,0,27
Mckennan,M,100,0,10,10
Denaija,F,100,21,0,21
Mikaiyah,F,100,5,0,5
Dailee,F,100,99,0,99
Janellie,F,100,194,0,194
Percel,M,100,0,5,5
Umeka,F,100,109,0,109
Sarabeth,F,100,1151,0,1151
Taleaha,F,100,37,0,37
Youlonda,F,100,41,0,41
Jacir,M,100,0,12,12
Raelei,F,100,19,0,19
Takeyah,F,100,189,0,189
Derius,M,100,0,535,535
Milenna,F,100,24,0,24
Kanna,F,100,149,0,149
Marid,M,100,0,5,5
Ettore,M,100,0,36,36
Nayvia,F,100,5,0,5
Fedora,F,100,58,0,58
Valenda,F,100,27,0,27
Denetia,F,100,5,0,5
Leonah,F,100,12,0,12
Teketa,F,100,10,0,10
Maurianna,F,100,74,0,74
Cne,F,100,11,0,11
Sondrea,F,100,27,0,27
Kostas,M,100,0,325,325
Isabellah,F,100,248,0,248
Eamon,M,100,0,3214,3214
Raquawn,M,100,0,8,8
Cindy,F,100,249484,754,250238
Markel,M,97,121,3874,3995
Deoni,F,100,61,0,61
Jarious,M,100,0,109,109
Joyia,F,100,102,0,102
Iyah,F,100,64,0,64
Cinthya,F,100,1706,0,1706
Hildy,F,100,184,0,184
Antawn,M,100,0,587,587
Rashod,M,100,0,878,878
Hayle,F,100,1456,0,1456
Baillie,F,100,409,0,409
Ozzie,M,95,77,1522,1599
Gaviota,F,100,6,0,6
Lieutenant,M,100,0,37,37
Cyera,F,100,148,0,148
Robinette,F,100,618,0,618
Kelseyann,F,100,30,0,30
Raedawn,F,100,21,0,21
Jahasia,F,100,28,0,28
Mischell,F,100,162,0,162
Cherrill,F,100,29,0,29
Weber,M,100,0,38,38
Nkayla,F,100,5,0,5
Mckade,M,100,0,297,297
Keedah,F,100,5,0,5
Jarmaine,M,100,0,376,376
Glori,F,100,429,0,429
Anessia,F,100,149,0,149
Leticia,F,99,40986,215,41201
Samsam,F,100,36,0,36
Rocky,M,99,198,24020,24218
Yandy,M,52,11,12,23
Simplicio,M,100,0,5,5
Mahathi,F,100,195,0,195
Kier,M,97,11,408,419
Chua,F,100,24,0,24
Arianni,F,100,235,0,235
Storee,F,100,34,0,34
Wendoly,F,100,53,0,53
Kandee,F,100,466,0,466
Maryia,F,100,30,0,30
Jashea,F,100,5,0,5
Tarsha,F,100,2375,0,2375
Brenay,F,100,38,0,38
Paulean,F,100,5,0,5
Pavin,M,100,0,5,5
Esbeidi,F,100,20,0,20
Amaryon,M,100,0,12,12
Marvela,F,100,6,0,6
Isadora,F,100,2093,0,2093
Shealene,F,100,32,0,32
Kimbery,F,100,532,0,532
Aemilia,F,100,73,0,73
Yunis,M,100,0,131,131
Davied,M,100,0,181,181
Zaylee,F,100,1281,0,1281
Nihya,F,100,7,0,7
Knisha,F,100,12,0,12
Jarvon,M,100,0,60,60
Fadra,F,100,21,0,21
Areg,M,100,0,50,50
Ziyon,M,83,91,460,551
Reinhold,M,100,0,136,136
Tyanna,F,100,3415,0,3415
Gioanna,F,100,5,0,5
Veena,F,100,509,0,509
Irving,M,100,0,10267,10267
Paytn,F,100,52,0,52
Jenniferlynn,F,100,111,0,111
Common,M,100,0,5,5
Deleon,M,98,14,720,734
Carragan,F,100,5,0,5
Casonja,F,100,5,0,5
Halley,F,99,3611,38,3649
Juleus,M,100,0,19,19
Haley,F,100,151788,680,152468
Carolin,F,100,807,0,807
Avarie,F,100,967,0,967
Ashauntee,F,100,11,0,11
Norvell,M,100,0,545,545
Mireyna,F,100,16,0,16
Addisson,F,100,91,0,91
Bunni,F,100,30,0,30
Phajja,F,100,7,0,7
Britaney,F,100,261,0,261
Aneitra,F,100,9,0,9
Sarahjean,F,100,39,0,39
Trudi,F,100,2724,0,2724
Dhruvin,M,100,0,13,13
Ayushmaan,M,100,0,7,7
Raevin,F,100,128,0,128
Frantasia,F,100,47,0,47
Shawnita,F,100,258,0,258
Madalina,F,100,49,0,49
Aionna,F,100,12,0,12
Kamari,M,63,2990,5161,8151
Blu,M,68,78,165,243
Suzet,F,100,23,0,23
Mikayia,F,100,12,0,12
Jerimiah,M,100,0,4444,4444
Constantino,M,100,0,857,857
Vernetha,F,100,12,0,12
Glendy,F,100,388,0,388
Vallory,F,100,62,0,62
Teodoro,M,100,0,2038,2038
Destery,M,100,0,11,11
Kasib,M,100,0,12,12
Pamalee,F,100,42,0,42
Damaree,M,100,0,109,109
Shivon,F,100,131,0,131
Roe,M,73,53,143,196
Charmisa,F,100,5,0,5
Destinique,F,100,5,0,5
Evonnie,F,100,12,0,12
Kayia,F,100,128,0,128
Lynlie,F,100,22,0,22
Paradyce,F,100,5,0,5
Nikkii,F,100,21,0,21
Cain,M,100,0,4635,4635
Delano,M,100,10,3372,3382
Lenasia,F,100,15,0,15
Shalice,F,100,167,0,167
Json,M,100,0,281,281
Neoshia,F,100,6,0,6
Dee,F,82,11450,2494,13944
Devarius,M,100,0,197,197
Marcoantonio,M,100,0,1434,1434
Jaycey,F,100,60,0,60
Skyley,F,100,69,0,69
Marry,F,100,740,0,740
Jette,F,92,68,6,74
Tora,F,97,829,26,855
Patrichia,F,100,5,0,5
Carlosantonio,M,100,0,12,12
Oliverio,M,100,0,182,182
Kacin,M,100,0,44,44
Asja,F,100,331,0,331
Caleah,F,100,397,0,397
Tykeya,F,100,43,0,43
Bentleigh,F,89,293,38,331
Chanielle,F,100,16,0,16
Johniel,M,100,0,40,40
Katrese,F,100,129,0,129
Smantha,F,100,325,0,325
Andreus,M,100,0,399,399
Hammie,M,100,0,6,6
Jiovany,M,100,0,150,150
Taycie,F,100,11,0,11
Dawon,M,100,0,541,541
Rafaella,F,100,390,0,390
Tonecia,F,100,19,0,19
Anteria,F,100,54,0,54
Jaqui,M,58,17,23,40
Fleur,F,100,130,0,130
Simonetta,F,100,18,0,18
Adashia,F,100,20,0,20
Willison,M,100,0,5,5
Joelouis,M,100,0,5,5
Sahniyah,F,100,10,0,10
Ahtziri,F,100,1011,0,1011
Wylee,M,86,37,229,266
Naiyma,F,100,10,0,10
Rylon,M,100,0,203,203
Raevynn,F,100,15,0,15
Kellijo,F,100,45,0,45
Lataisha,F,100,273,0,273
Bronwynn,F,100,27,0,27
Sanantonio,M,100,0,6,6
Learon,M,100,0,5,5
Tulsi,F,100,331,0,331
Couper,M,100,0,142,142
Ivelisse,F,100,1516,0,1516
Horacio,M,100,0,3642,3642
Rickyy,M,100,0,5,5
Orlee,F,100,10,0,10
Nathaniel,M,100,939,220735,221674
Landus,M,100,0,10,10
Bryant,M,99,232,44597,44829
Rayshell,F,100,188,0,188
Modena,F,100,29,0,29
Tiffanyann,F,100,91,0,91
Harlan,M,99,110,8735,8845
Niyati,F,100,262,0,262
Naudia,F,100,1250,0,1250
Chelle,F,100,342,0,342
Andrue,M,100,0,578,578
Yvetta,F,100,436,0,436
Zayquan,M,100,0,158,158
Shatanya,F,100,44,0,44
Markas,M,100,0,135,135
Kemaurion,M,100,0,26,26
Steicy,F,100,5,0,5
Chiquitia,F,100,8,0,8
Carron,F,78,342,98,440
Fiyinfoluwa,F,71,32,13,45
Arinn,F,100,30,0,30
Sumiah,F,100,10,0,10
Maddalyn,F,100,387,0,387
Madsen,M,93,5,71,76
Yuuta,M,100,0,7,7
Clayborne,M,100,0,113,113
Lajace,M,100,0,5,5
Granger,M,100,0,441,441
Ashlan,F,97,978,34,1012
Abygale,F,100,307,0,307
Lorell,F,93,139,10,149
Noam,M,89,201,1676,1877
Reniece,F,100,5,0,5
Tysan,M,100,0,16,16
Seina,F,100,40,0,40
Margarito,M,100,0,2647,2647
Leontay,M,100,0,10,10
Jenevi,F,100,11,0,11
Indasha,F,100,5,0,5
Jiyanna,F,100,5,0,5
Nashika,F,100,60,0,60
Jakorey,M,100,0,152,152
Henreitta,F,100,12,0,12
Cristia,F,100,5,0,5
Keneka,F,100,6,0,6
Justien,F,100,8,0,8
Liandra,F,100,173,0,173
Ziana,F,100,290,0,290
Lovetta,F,100,445,0,445
Royce,M,94,1075,15741,16816
Aireka,F,100,5,0,5
Casadi,F,100,11,0,11
Karibe,M,100,0,5,5
Taloria,F,100,16,0,16
Naziah,F,68,231,109,340
Georjean,F,100,70,0,70
Flory,F,100,17,0,17
Jeantte,F,100,28,0,28
Tatjana,F,100,418,0,418
Sulamita,F,100,167,0,167
Alesiram,F,100,13,0,13
Myrick,M,100,0,213,213
Nazair,M,100,0,62,62
Ieishia,F,100,9,0,9
Kency,F,81,22,5,27
Tyquan,M,100,10,3332,3342
Florena,F,100,5,0,5
Mano,M,100,0,18,18
Asmir,M,100,0,31,31
Veyah,F,100,5,0,5
Kimiyah,F,100,105,0,105
Nyiema,F,100,22,0,22
Shereef,M,100,0,6,6
Vien,M,100,0,16,16
Corderrius,M,100,0,11,11
Tayhlor,F,100,5,0,5
Brandton,M,100,0,6,6
Telsa,F,100,74,0,74
Kalaysia,F,100,147,0,147
Maxtyn,M,100,0,21,21
Driston,M,100,0,24,24
Alla,F,97,354,10,364
Schwanda,F,100,99,0,99
Quinshawn,M,100,0,44,44
Marilouise,F,100,35,0,35
Landin,M,99,16,2233,2249
Mattyson,F,100,10,0,10
Sabu,M,100,0,5,5
Aashir,M,100,0,84,84
Lanndon,M,100,0,6,6
Ceferino,M,100,0,115,115
Ahkeel,M,100,0,6,6
Carmel,F,90,3377,385,3762
Ezabelle,F,100,10,0,10
Tyrea,F,87,88,13,101
Hudsynn,F,100,5,0,5
Shierra,F,100,5,0,5
Jakaria,F,100,184,0,184
Harriette,F,100,1160,0,1160
Chevez,M,100,0,69,69
Tsubasa,M,100,0,39,39
Samantah,F,100,45,0,45
Bibian,F,100,23,0,23
Dekobe,M,100,0,6,6
Shani,F,100,4345,17,4362
Chayzen,M,100,0,5,5
Timothee,M,100,0,201,201
Stallone,M,100,0,6,6
Tomiwa,M,100,0,5,5
Delyla,F,100,412,0,412
Tasha,F,100,35322,106,35428
Gulianna,F,100,135,0,135
Vicotria,F,100,22,0,22
Elliana,F,100,7943,0,7943
Kora,F,100,3142,0,3142
Honestee,F,100,89,0,89
Jonhenry,M,100,0,7,7
Maraki,F,100,64,0,64
Nivek,M,100,0,106,106
Janaki,F,100,142,0,142
Samin,M,100,0,105,105
Sankeerth,M,100,0,5,5
Erynne,F,100,179,0,179
Xerxes,M,100,0,136,136
Marua,F,100,51,0,51
Tesla,F,98,1835,42,1877
Artemio,M,100,0,2020,2020
Darienne,F,100,358,0,358
Rehan,M,99,6,933,939
Lieba,F,100,16,0,16
Riyan,M,51,304,316,620
Khadin,M,100,0,17,17
Jillissa,F,100,5,0,5
Trenae,F,100,228,0,228
Achraf,M,100,0,10,10
Shavannah,F,100,43,0,43
Austinn,M,100,0,28,28
Rhonisha,F,100,17,0,17
Kye,M,92,229,2707,2936
Terrika,F,100,570,0,570
Sofiyah,F,100,16,0,16
Honoka,F,100,21,0,21
Saturnina,F,100,16,0,16
Keeta,F,100,51,0,51
Ryann,F,93,7995,645,8640
Takya,F,100,200,0,200
Dusan,M,100,0,99,99
Audreyonna,F,100,5,0,5
Chirag,M,100,0,655,655
Raileigh,F,100,128,0,128
Regetta,F,100,6,0,6
Elyahna,F,100,5,0,5
Thuan,M,98,5,207,212
Shonell,F,100,50,0,50
Alique,F,50,5,5,10
Coleridge,M,100,0,12,12
Azizi,F,83,71,15,86
Kamario,M,100,0,14,14
Johnnathon,M,100,0,10,10
Anmarie,F,100,365,0,365
Nandi,F,100,682,0,682
Shantela,F,100,5,0,5
Steffi,F,100,507,0,507
Leviah,F,100,13,0,13
Ezrael,M,100,0,57,57
Sedarius,M,100,0,35,35
Rahmeek,M,100,0,28,28
Stormy,F,89,6373,769,7142
Aiddan,M,100,0,17,17
Kevaeh,F,100,6,0,6
Sianna,F,100,1241,0,1241
Melven,M,100,0,62,62
Nayona,F,100,5,0,5
Dyshon,M,100,0,102,102
Yitzchak,M,100,0,931,931
Rasaan,M,100,0,213,213
Denean,F,100,484,0,484
Legaci,F,100,101,0,101
Jeri,F,99,19478,257,19735
Brayelle,F,100,6,0,6
Nikcole,F,100,109,0,109
Neilyn,F,100,10,0,10
Retha,F,100,2917,0,2917
Braesen,M,100,0,5,5
Gwen,F,99,19654,109,19763
Marriam,F,100,11,0,11
Cyre,F,100,39,0,39
Anjuli,F,100,529,0,529
Nyari,F,100,74,0,74
Averly,F,100,114,0,114
Sadeeq,M,100,0,5,5
Adeeba,F,100,11,0,11
Tren,M,100,0,10,10
Lorrain,F,100,277,0,277
Khyren,M,100,0,128,128
Nai,F,74,202,71,273
Meah,F,100,1266,0,1266
Minton,M,100,0,10,10
Avanni,F,100,61,0,61
Lasonda,F,100,47,0,47
Moneika,F,100,6,0,6
Zinedine,M,100,0,82,82
Yousaf,M,100,0,105,105
Xylee,F,100,5,0,5
Zilin,F,100,6,0,6
Marquan,M,100,0,1629,1629
Nelson,M,99,249,46818,47067
Krisi,F,100,146,0,146
Kizzi,F,100,70,0,70
Yaribeth,F,100,28,0,28
Faraaz,M,100,0,66,66
Jehan,F,77,315,92,407
Saani,F,100,20,0,20
Shadae,F,100,873,0,873
Tangala,F,100,97,0,97
Taneah,F,100,68,0,68
Stefphon,M,100,0,5,5
Su,F,95,526,26,552
Siyanna,F,100,44,0,44
Baruti,M,100,0,6,6
Anthonyjames,M,100,0,137,137
Chesten,M,100,0,6,6
Pushti,F,100,6,0,6
Analeia,F,100,6,0,6
Yngwie,M,100,0,5,5
Alexe,F,100,15,0,15
Mickey,M,86,3060,19301,22361
Jashonda,F,100,7,0,7
Sajad,M,100,0,75,75
Dnaielle,F,100,10,0,10
Mashawnda,F,100,10,0,10
Bellanie,F,100,28,0,28
Katlyne,F,100,269,0,269
Keymani,F,61,124,78,202
Lationa,F,100,12,0,12
Fabriana,F,100,5,0,5
Shunn,M,100,0,16,16
Termayne,M,100,0,10,10
Ezayah,M,100,0,5,5
Breckin,M,88,128,918,1046
Jadaija,F,100,5,0,5
Abdirashid,M,100,0,22,22
Bayle,F,89,221,28,249
Rooney,M,81,97,403,500
Majda,F,100,11,0,11
Zynasia,F,100,74,0,74
Akheem,M,100,0,44,44
Tyke,M,100,0,165,165
Camyrn,F,100,31,0,31
Arjan,M,100,0,369,369
Eryne,F,100,16,0,16
Railynn,F,100,318,0,318
Orlin,M,100,0,420,420
Hadli,F,100,80,0,80
Kerina,F,100,214,0,214
Asyria,F,100,70,0,70
Trennon,M,100,0,59,59
Trisca,F,100,5,0,5
Mazal,F,100,137,0,137
Rreon,F,100,6,0,6
Canaan,M,92,251,3008,3259
Camiron,M,100,0,8,8
Maurin,F,100,5,0,5
Genessy,F,100,45,0,45
Dontrea,M,100,0,5,5
Sharmilla,F,100,5,0,5
Azayla,F,100,153,0,153
Aprille,F,100,519,0,519
Fineas,M,100,0,38,38
Rachelanne,F,100,85,0,85
Brisa,F,100,7215,0,7215
Tighe,M,100,0,436,436
Mihail,M,100,0,105,105
Marquite,F,100,52,0,52
Arzie,M,100,0,5,5
Courtnie,F,100,2109,0,2109
Nevaehia,F,100,5,0,5
Annalesia,F,100,15,0,15
Gumaro,M,100,0,371,371
Airalyn,F,100,30,0,30
Giulianna,F,100,951,0,951
Elsha,F,100,35,0,35
Willie,M,91,15320,163740,179060
Darlane,F,100,13,0,13
Laterrence,M,100,0,25,25
Emersen,F,94,620,43,663
Taqueena,F,100,6,0,6
Emeris,M,100,0,5,5
Rodaisha,F,100,5,0,5
Genavie,F,100,115,0,115
Juliaanne,F,100,12,0,12
Airrion,M,100,0,72,72
Natayja,F,100,5,0,5
Onel,M,100,0,32,32
Valanda,F,100,21,0,21
Jelsy,F,100,10,0,10
Aketzaly,F,100,8,0,8
Arelys,F,100,336,0,336
Caledonia,F,100,47,0,47
Jaimelee,F,100,20,0,20
Jagger,M,99,59,4452,4511
Olakunle,M,100,0,10,10
Dipali,F,100,16,0,16
Samirra,F,100,31,0,31
Yakelyn,F,100,30,0,30
Chamel,F,50,5,5,10
Gary,M,100,2348,634829,637177
Divija,F,100,12,0,12
Aryo,M,100,0,5,5
Darleen,F,100,4223,0,4223
Shonita,F,100,122,0,122
Crystell,F,100,5,0,5
Priscill,F,100,7,0,7
Dylanie,F,100,65,0,65
Cyaira,F,100,25,0,25
Adlee,F,100,320,0,320
Vida,F,99,3419,38,3457
Zandria,F,100,521,0,521
Foy,M,99,5,436,441
Yeison,M,100,0,250,250
Ulla,F,100,36,0,36
Elyvia,F,100,11,0,11
Dariona,F,100,141,0,141
Nateisha,F,100,69,0,69
Jayliyah,F,100,10,0,10
Shanaisha,F,100,5,0,5
Tavie,F,100,31,0,31
Demarrius,M,100,0,64,64
Marcale,M,100,0,18,18
Kya,F,100,4309,13,4322
Juritza,F,100,5,0,5
Alfreada,F,100,5,0,5
Vegas,M,61,115,182,297
Faaizah,F,100,6,0,6
Tekeya,F,100,117,0,117
Jakyree,M,100,0,26,26
Qubilah,F,100,5,0,5
Anova,F,100,5,0,5
Suhaylah,F,100,155,0,155
Manuella,F,100,251,0,251
Malwina,F,100,5,0,5
Hilliard,M,100,0,422,422
Olukemi,F,100,76,0,76
Jniya,F,100,229,0,229
Melisande,F,100,16,0,16
Jarek,M,100,0,1438,1438
Anjoli,F,100,141,0,141
Brallan,M,100,0,325,325
Zriah,F,100,7,0,7
Aeriel,F,100,733,0,733
Nashelle,F,100,26,0,26
Vonciel,F,100,16,0,16
Aroosa,F,100,6,0,6
Lewana,F,100,21,0,21
Jacueline,F,100,27,0,27
Argeniz,M,100,0,10,10
Whittnie,F,100,5,0,5
Theora,F,100,63,0,63
Finneus,M,100,0,70,70
Denney,M,100,0,127,127
Ishanvi,F,100,137,0,137
Litzi,F,100,489,0,489
Golnaz,F,100,10,0,10
Alaijha,F,100,39,0,39
Nyquasha,F,100,6,0,6
Treve,M,100,0,5,5
Jamez,M,100,0,523,523
Tomii,F,100,6,0,6
Kyndl,F,100,7,0,7
Darlisha,F,100,82,0,82
Ruey,F,100,5,0,5
Letesha,F,100,197,0,197
Terin,F,65,343,181,524
Melda,F,100,309,0,309
Mozetta,F,100,25,0,25
Jarett,M,100,0,3389,3389
Garbielle,F,100,6,0,6
Mackenize,F,100,291,0,291
Shavonte,F,83,233,48,281
Shonda,F,100,7444,0,7444
Zebrina,F,100,5,0,5
Janaesha,F,100,5,0,5
Amaka,F,100,97,0,97
Jacely,F,100,5,0,5
Shabab,M,100,0,17,17
Kurry,M,100,0,12,12
Thimothy,M,100,0,751,751
Denim,M,76,333,1042,1375
Janeya,F,100,275,0,275
Domnick,M,100,0,282,282
Bailen,M,100,0,71,71
Renauld,M,100,0,39,39
Lucrezia,F,100,168,0,168
Tyree,M,95,728,12596,13324
Glynne,F,100,7,0,7
Shekelia,F,100,55,0,55
Ajeenah,F,100,79,0,79
Tomicka,F,100,108,0,108
Laighton,F,100,5,0,5
Eila,F,100,430,0,430
Azarria,F,100,101,0,101
Shilo,F,68,1622,767,2389
Stevie,M,58,8259,11513,19772
Khanya,F,100,29,0,29
Lynnete,F,100,5,0,5
Kaytlyne,F,100,5,0,5
Mada,F,100,87,0,87
Andre,M,98,1978,114134,116112
Maliq,M,100,0,606,606
Garric,M,100,0,10,10
Kendrie,F,100,10,0,10
Nathalia,F,100,4420,0,4420
Timur,M,100,0,449,449
Kaisley,F,100,247,0,247
Aubreeann,F,100,14,0,14
Taiwon,M,100,0,5,5
Chrisean,M,100,0,146,146
Dakayla,F,100,418,0,418
Copelin,M,100,0,12,12
Emmaline,F,100,3432,0,3432
Adyn,M,91,114,1097,1211
Indie,F,88,476,65,541
Ansha,F,100,10,0,10
Pazong,F,100,10,0,10
Corin,F,67,1629,801,2430
Darcel,F,90,1240,131,1371
Taska,F,100,24,0,24
Cleone,F,100,56,0,56
Orville,M,100,0,4770,4770
Ambrasia,F,100,6,0,6
Whittany,F,100,129,0,129
Rechelle,F,100,628,0,628
Kayln,F,100,512,0,512
Dezja,F,100,11,0,11
Reonna,F,100,277,0,277
Yasemin,F,100,387,0,387
Nelissa,F,100,169,0,169
Kindu,M,100,0,11,11
Airiel,F,100,145,0,145
Yatzil,F,100,196,0,196
Donavan,M,100,5,7326,7331
Kurston,F,100,23,0,23
Theopolis,M,100,0,146,146
Lyndin,F,100,14,0,14
Winry,F,100,119,0,119
Jhariel,M,100,0,11,11
Amariee,F,100,22,0,22
Trevia,F,100,252,0,252
Tequilla,F,100,839,0,839
Maxximus,M,100,0,252,252
Ayen,F,100,38,0,38
Kaalyn,F,100,12,0,12
Ferin,F,100,10,0,10
Kinshasha,F,100,5,0,5
Amelie,F,100,5343,0,5343
Alnisha,F,100,29,0,29
Linsday,F,100,6,0,6
Chree,F,100,10,0,10
Ahsen,M,100,0,6,6
Ritchy,M,100,0,5,5
Karina,F,100,56069,253,56322
Sahasra,F,100,875,0,875
Dishawn,M,100,0,196,196
Torrance,M,88,452,3317,3769
Ammarah,F,100,29,0,29
Raenell,F,100,217,0,217
Glendolyn,F,100,16,0,16
Tionna,F,100,2427,0,2427
Pavle,M,100,0,59,59
Jerrious,M,100,0,5,5
Rasheed,M,99,34,4419,4453
Orma,F,100,8,0,8
Patrickjohn,M,100,0,7,7
Sharane,F,100,54,0,54
Jamen,M,100,0,587,587
Palyn,F,100,87,0,87
Domico,M,100,0,6,6
Rolen,M,100,0,89,89
Musashi,M,100,0,10,10
Elaya,F,100,87,0,87
Teig,M,100,0,12,12
Yailenys,F,100,9,0,9
Allyna,F,100,166,0,166
Avah,F,100,2886,0,2886
Shellise,F,100,12,0,12
Shaana,F,100,58,0,58
Annea,F,100,5,0,5
Markian,M,100,0,51,51
Kamla,F,100,68,0,68
Adlene,F,100,5,0,5
Frank,M,100,1503,323389,324892
Rheyna,F,100,12,0,12
Yakeisha,F,100,17,0,17
Naissa,F,100,5,0,5
Berneice,F,100,157,0,157
Charlynne,F,100,16,0,16
Skyann,F,100,144,0,144
Cyprian,M,100,0,205,205
Kimlyn,F,100,10,0,10
Jarah,F,97,403,11,414
Teria,F,100,582,0,582
Cimara,F,100,5,0,5
Demeteria,F,100,12,0,12
Soraida,F,100,542,0,542
Reace,M,69,37,84,121
Jayvien,M,100,0,479,479
Liandro,M,100,0,71,71
Pasty,F,100,103,0,103
Keinan,M,100,0,136,136
Teilor,F,100,17,0,17
Mycha,F,100,18,0,18
Stalyn,M,100,0,10,10
Zandon,M,100,0,89,89
Hazzel,F,100,19,0,19
Vonice,F,100,5,0,5
Shawnalee,F,100,29,0,29
Gabel,M,100,0,17,17
Kaleela,F,100,5,0,5
Altair,F,55,86,69,155
Rubia,F,100,36,0,36
Taniyia,F,100,8,0,8
Amaja,F,100,44,0,44
Hajirah,F,100,5,0,5
Raphaela,F,100,323,0,323
Jessenia,F,100,5046,0,5046
Chukwudubem,M,100,0,5,5
So,F,100,47,0,47
Tyreonna,F,100,75,0,75
Tennell,F,72,13,5,18
Kamiryn,F,100,58,0,58
Ellakate,F,100,66,0,66
Aselin,F,100,5,0,5
Iviona,F,100,66,0,66
Aubrey,F,86,85563,13706,99269
Iverson,M,99,6,865,871
Jziah,M,100,0,6,6
Eulices,M,100,0,36,36
Kyro,M,100,0,90,90
Nerea,F,100,45,0,45
Edwen,M,100,0,79,79
Khylin,M,74,25,73,98
Irine,F,100,119,0,119
Gradin,M,100,0,44,44
Keason,M,100,0,10,10
Javarus,M,100,0,289,289
Safwaan,M,100,0,6,6
Triya,F,100,6,0,6
Ashanique,F,100,17,0,17
Rosston,M,100,0,10,10
Chorlette,F,100,6,0,6
Tyrike,M,100,0,46,46
Nysha,F,100,167,0,167
Norlan,M,100,0,43,43
Zanilah,F,100,17,0,17
Messai,M,100,0,7,7
Sibilla,F,100,5,0,5
Eliaz,M,100,0,221,221
Hellen,F,100,2209,0,2209
Gentle,M,100,0,35,35
Maame,F,100,114,0,114
Daliana,F,100,150,0,150
Quanza,F,100,5,0,5
Jerian,M,100,0,43,43
Deshan,M,95,12,237,249
Yuleydi,F,100,10,0,10
Kyala,F,100,40,0,40
Karalyn,F,100,1396,0,1396
Vonn,M,97,5,171,176
Raahil,M,100,0,53,53
Karlena,F,100,250,0,250
Makayle,F,100,154,0,154
Lynder,F,100,5,0,5
Cyrano,M,100,0,14,14
Channy,F,69,33,15,48
Tayvian,M,100,0,197,197
Damayanti,F,100,14,0,14
Raaed,M,100,0,5,5
Tanice,F,100,66,0,66
Rebacca,F,100,90,0,90
Aidien,M,100,0,5,5
Zhalen,M,100,0,5,5
Waled,M,100,0,5,5
Tesslynn,F,100,11,0,11
Dalainey,F,100,5,0,5
Diyala,F,100,12,0,12
Ozair,M,100,0,46,46
Arty,M,100,0,125,125
Cassity,F,100,353,0,353
Cittlali,F,100,11,0,11
Leyonna,F,100,45,0,45
Siya,F,100,1036,0,1036
Jaquis,M,96,10,229,239
Anahi,F,100,13544,31,13575
Kaze,M,100,0,8,8
Paizley,F,100,627,0,627
Suhailey,F,100,5,0,5
Rhylen,M,74,26,73,99
Farrukh,M,100,0,5,5
Estefanny,F,100,159,0,159
Rozalynn,F,100,195,0,195
Jamariae,M,100,0,6,6
Shaquera,F,100,119,0,119
Ajee,F,90,301,35,336
Johnesha,F,100,279,0,279
Deniece,F,100,1056,0,1056
Glynes,F,100,11,0,11
Janneli,F,100,5,0,5
Kori,F,90,10627,1241,11868
Radyn,M,100,0,11,11
Khylie,F,100,356,0,356
Janeiah,F,100,6,0,6
Tarlton,M,100,0,5,5
Mang,M,73,16,43,59
Nakayla,F,100,1635,0,1635
Maripat,F,100,101,0,101
Kornell,M,100,0,21,21
Raylene,F,100,3245,0,3245
Kenniel,M,100,0,34,34
Coretha,F,100,202,0,202
Shawnna,F,100,2854,0,2854
Kara,F,100,96495,270,96765
Iolana,F,100,46,0,46
Rodna,F,100,6,0,6
Andrianne,F,100,33,0,33
Maemi,F,100,5,0,5
Eisen,M,100,0,96,96
Aurik,M,100,0,5,5
Nytavious,M,100,0,5,5
Trayona,F,100,7,0,7
Jairen,M,100,0,150,150
Ayrionna,F,100,25,0,25
Nataly,F,100,12226,10,12236
Aurilla,F,100,5,0,5
Trendan,M,100,0,5,5
Joviana,F,100,33,0,33
Tynaja,F,100,11,0,11
Jenai,F,100,703,0,703
Naudiya,F,100,10,0,10
Correy,M,96,46,1070,1116
Lydea,F,100,50,0,50
Ardynn,F,100,6,0,6
Anaum,F,100,29,0,29
Eloy,M,100,0,5865,5865
Sandy,F,90,59104,6372,65476
Jael,F,61,2942,1857,4799
Amaryn,F,100,6,0,6
Cherita,F,100,1037,0,1037
Keyly,F,100,237,0,237
Raquela,F,100,7,0,7
Kausha,F,100,5,0,5
Mandalyn,F,100,290,0,290
Jakylan,M,100,0,76,76
Zarifa,F,100,24,0,24
Rialey,F,100,11,0,11
Montravious,M,100,0,115,115
Javorius,M,100,0,15,15
Carolita,F,100,5,0,5
Ariellah,F,100,26,0,26
Optimus,M,100,0,5,5
Sahana,F,100,1582,0,1582
Engrid,F,100,21,0,21
Citally,F,100,5,0,5
Ruchel,F,100,227,0,227
Natrice,F,100,23,0,23
Nichoas,M,100,0,16,16
Jillann,F,100,126,0,126
Miura,F,100,5,0,5
Ariza,F,100,387,0,387
Ezme,F,100,27,0,27
Takiea,F,100,11,0,11
Reaganne,F,100,10,0,10
Kollyn,M,96,6,141,147
Keiya,F,100,42,0,42
Nika,F,100,1800,5,1805
Jacobb,M,100,0,245,245
Myesheia,F,100,7,0,7
Elionna,F,100,11,0,11
Willoh,F,100,21,0,21
Augustyn,M,100,0,5,5
Traeshaun,M,100,0,5,5
Radamel,M,100,0,5,5
Edmund,M,100,5,18030,18035
Sachiko,F,100,240,0,240
Toscha,F,100,59,0,59
Arifa,F,100,15,0,15
Jamah,M,100,0,37,37
Jahmere,M,100,0,486,486
Asala,F,100,5,0,5
Eliska,F,100,159,0,159
Parks,M,100,0,524,524
Denman,M,100,0,20,20
Jovey,F,100,23,0,23
Hanson,M,100,0,1024,1024
Jairius,M,100,0,55,55
Okima,F,100,27,0,27
Cannen,M,100,0,116,116
Davonta,M,100,0,1154,1154
Dareece,M,100,0,5,5
Velisha,F,100,47,0,47
Sugeiri,F,100,5,0,5
Ady,F,100,117,0,117
Odella,F,100,80,0,80
Myrna,F,100,9858,0,9858
Abbye,F,100,184,0,184
Luqman,M,100,0,566,566
Doneka,F,100,11,0,11
Terrique,M,100,0,5,5
Dalila,F,100,4589,0,4589
Brynlea,F,100,107,0,107
Fabiene,F,100,5,0,5
Marsenio,M,100,0,5,5
Aydrian,M,82,40,182,222
Fani,F,100,64,0,64
Ziaira,F,100,25,0,25
Solita,F,100,112,0,112
Katiria,F,100,525,0,525
Clintin,M,100,0,30,30
Nang,M,100,0,11,11
Khaleb,M,100,0,580,580
Algene,F,100,8,0,8
Ilaria,F,100,332,0,332
Gered,M,100,0,39,39
Shaughnessy,F,95,91,5,96
Daffany,F,100,46,0,46
Juaita,F,100,5,0,5
Tykevious,M,100,0,42,42
Riaan,M,100,0,153,153
Elainea,F,100,32,0,32
Amrik,M,100,0,6,6
Choua,F,82,390,86,476
Herbie,M,100,0,676,676
Anesia,F,100,455,0,455
Heylin,F,100,22,0,22
Andresha,F,100,27,0,27
Marnisha,F,100,128,0,128
Talayna,F,100,33,0,33
Chrisitne,F,100,5,0,5
Symari,F,100,11,0,11
Vincen,M,100,0,103,103
Kianah,F,100,256,0,256
Tevaughn,M,100,0,51,51
Aubryella,F,100,5,0,5
Maider,F,100,5,0,5
Janeel,F,100,5,0,5
Aadit,M,100,0,267,267
Fachon,F,100,6,0,6
Emperor,M,100,0,11,11
Tabiatha,F,100,23,0,23
Magavi,F,100,5,0,5
Mclean,M,96,11,297,308
Angello,M,100,0,451,451
Loree,F,100,2121,0,2121
Sachi,F,100,779,0,779
Eztli,F,100,23,0,23
Shaynia,F,100,22,0,22
Philana,F,100,332,0,332
Nerick,M,100,0,39,39
Letasha,F,100,285,0,285
Trayden,M,100,0,211,211
Pancho,M,100,0,122,122
Sadik,M,100,0,93,93
Karmah,F,100,125,0,125
Thurlow,M,100,0,46,46
Ibtihal,F,100,5,0,5
Hendrick,M,100,0,734,734
Treylan,M,100,0,122,122
Idrissa,M,94,6,89,95
Casey,M,59,75002,106825,181827
Seana,F,100,1826,0,1826
Adoria,F,100,87,0,87
Bennett,M,97,767,25175,25942
Aquileo,M,100,0,5,5
Latifia,F,100,9,0,9
Lareen,F,100,85,0,85
Koran,M,98,10,511,521
Zaylor,M,100,0,19,19
Tersea,F,100,73,0,73
Francenia,F,100,112,0,112
Nechemia,M,100,0,74,74
Dennon,M,100,0,33,33
Shriyaan,M,100,0,5,5
Kvaughn,M,100,0,21,21
Jasper,M,97,607,20896,21503
Myalin,F,100,5,0,5
Tajh,M,100,0,632,632
Rohan,M,100,16,8557,8573
Lynli,F,100,19,0,19
Casimir,M,100,0,1089,1089
Djenne,F,100,18,0,18
Syniah,F,100,439,0,439
Pauletta,F,100,1565,0,1565
Bige,M,100,0,12,12
Earmon,M,100,0,11,11
Taven,M,97,47,1318,1365
Kaymen,M,92,13,151,164
Tarick,M,100,0,147,147
Crisma,F,100,10,0,10
Adonia,F,100,308,0,308
Marcha,F,100,157,0,157
Javion,M,100,11,4876,4887
Blaken,M,100,0,5,5
Janaria,F,100,151,0,151
Poleth,F,100,18,0,18
Latina,F,100,2049,0,2049
Shelba,F,100,487,0,487
Yusef,M,100,0,2384,2384
Khrystina,F,100,94,0,94
Suhaib,M,100,0,282,282
Ahlexus,F,100,13,0,13
Louay,M,100,0,30,30
Niarah,F,100,17,0,17
Shervon,F,100,97,0,97
Erna,F,100,781,0,781
Daielle,F,100,98,0,98
Andrenika,F,100,11,0,11
Zian,M,71,133,332,465
Froy,M,100,0,6,6
Gage,M,100,218,52702,52920
Eszter,F,100,5,0,5
Zarionna,F,100,40,0,40
Bostynn,F,100,20,0,20
Genavee,F,100,21,0,21
Jamillia,F,100,103,0,103
Mashal,F,100,111,0,111
Mili,F,100,308,0,308
Giavana,F,100,282,0,282
Keaon,M,100,0,26,26
Michial,M,100,0,952,952
Oluwasemilore,M,57,26,35,61
Jalyla,F,100,16,0,16
Jaboree,M,100,0,7,7
Yulliana,F,100,5,0,5
Sage,F,63,14457,8349,22806
Nayalis,F,100,5,0,5
Zulie,F,100,15,0,15
Kaizer,M,100,0,145,145
Madeleine,F,100,28715,15,28730
Kabryn,M,100,0,5,5
Phill,M,100,0,281,281
Tapainga,F,100,8,0,8
Mallarie,F,100,204,0,204
Leajah,F,100,15,0,15
Chazlynn,F,100,24,0,24
Kaz,M,100,0,344,344
Dilyn,M,65,162,304,466
Tyton,M,100,0,113,113
Uniyah,F,100,8,0,8
Estivalis,F,100,5,0,5
Keithan,M,100,0,657,657
Landrick,M,100,0,6,6
Santwan,M,100,0,21,21
Haizlee,F,100,26,0,26
Cassanora,F,100,11,0,11
Symone,F,100,3822,0,3822
Taro,M,100,0,290,290
Yutong,F,100,8,0,8
Tamitra,F,100,37,0,37
Ojani,M,100,0,102,102
Rija,F,100,28,0,28
Gorgeous,F,100,135,0,135
Lindalou,F,100,16,0,16
Braxtyn,M,80,206,814,1020
Terrall,M,100,0,130,130
Adolphus,M,100,0,1396,1396
Kahlee,F,71,70,28,98
Karson,M,86,1468,9227,10695
Tnisha,F,100,21,0,21
Maden,M,100,0,37,37
Lequita,F,100,469,0,469
Daykota,M,100,0,6,6
Brantlee,M,86,140,836,976
Etta,F,100,5860,0,5860
Clenard,M,100,0,6,6
Michle,M,100,0,8,8
Gerhardt,M,100,0,83,83
Anetra,F,100,423,0,423
Nicosha,F,100,58,0,58
Jeanessa,F,100,17,0,17
Tangle,F,100,8,0,8
Mattheo,M,100,0,44,44
Kwuan,M,100,0,5,5
Deashia,F,100,279,0,279
Loredana,F,100,263,0,263
Sevrin,M,100,0,83,83
Ritesh,M,100,0,162,162
Kyhir,M,100,0,10,10
Matiana,F,100,40,0,40
Eoghan,M,100,0,277,277
Marsella,F,100,112,0,112
Simyah,F,100,23,0,23
Charrissa,F,100,30,0,30
Ayonna,F,100,1021,0,1021
Zaiyon,M,100,0,7,7
Paxton,M,90,1299,11814,13113
Jailinne,F,100,6,0,6
Kartik,M,100,0,379,379
Shivaun,F,100,60,0,60
Sherkia,F,100,7,0,7
Ashleeann,F,100,5,0,5
Leemon,M,100,0,15,15
Oel,M,100,0,5,5
Adelaide,F,100,9292,0,9292
Sherida,F,100,793,0,793
Szymon,M,100,0,352,352
Myionna,F,100,11,0,11
Kiasia,F,100,385,0,385
Eline,F,100,67,0,67
Keoki,M,100,0,454,454
Kia,F,98,7457,164,7621
Zaliah,F,100,44,0,44
Taje,M,56,99,125,224
Akmal,M,100,0,11,11
Izma,F,100,33,0,33
Ruthan,F,100,11,0,11
Asiaonna,F,100,5,0,5
Delissa,F,100,401,0,401
Astacia,F,100,46,0,46
Torii,F,75,50,17,67
Moneta,F,100,10,0,10
Tolulope,F,80,151,38,189
Kyrianna,F,100,69,0,69
Calton,M,100,0,153,153
Revis,M,100,0,121,121
Naiyla,F,100,13,0,13
Nickolaus,M,100,0,1751,1751
Ronreaco,M,100,0,11,11
Ish,M,100,0,5,5
Aryssa,F,100,574,0,574
Datid,M,100,0,5,5
Kateryna,F,100,62,0,62
Eknoor,F,86,68,11,79
Jontia,F,100,29,0,29
Betrice,F,100,49,0,49
Skyle,F,100,5,0,5
Mazaria,F,100,5,0,5
Felissa,F,100,282,0,282
Allisyn,F,100,877,0,877
Keisher,F,100,11,0,11
Demiah,F,100,193,0,193
Kedran,M,100,0,5,5
Karlos,M,100,0,1671,1671
Hadiatou,F,100,10,0,10
Erilynn,F,100,28,0,28
Dalaysia,F,100,116,0,116
Katelynne,F,100,1310,0,1310
Shirl,F,94,1231,80,1311
Cherrell,F,100,433,0,433
Cordarell,M,100,0,16,16
Lielah,F,100,9,0,9
Endyia,F,100,5,0,5
Taelan,M,100,0,5,5
Therse,F,100,5,0,5
Italy,F,100,908,0,908
Laqueen,F,100,10,0,10
Cassye,F,100,6,0,6
Davieon,M,100,0,295,295
Cally,F,100,1654,0,1654
Anik,M,92,17,206,223
Lazario,M,100,0,6,6
Jenniferr,F,100,7,0,7
Mber,F,100,40,0,40
Chappell,M,86,5,32,37
Hirma,F,100,5,0,5
Jamirra,F,100,81,0,81
Briona,F,100,1649,0,1649
Cori,F,91,10908,1125,12033
Elyja,M,100,0,17,17
Madasyn,F,100,372,0,372
Javonnie,M,89,10,83,93
Thailia,F,100,19,0,19
Germane,M,100,0,12,12
Jobey,M,100,0,33,33
Kaysen,M,85,231,1342,1573
Tre,M,99,58,5218,5276
Tarja,F,100,11,0,11
Krisley,F,100,5,0,5
Deridre,F,100,16,0,16
Ameira,F,100,133,0,133
Mattisen,F,100,91,0,91
Ferrah,F,100,66,0,66
Antonette,F,100,4155,0,4155
Garla,F,100,52,0,52
Tramisha,F,100,5,0,5
Aleezay,F,100,15,0,15
Fantasha,F,100,64,0,64
Nicteha,F,100,5,0,5
Shinna,F,100,6,0,6
Vallen,M,71,34,83,117
Akisha,F,100,373,0,373
Klowie,F,100,25,0,25
Jhoselin,F,100,127,0,127
Sakyra,F,100,26,0,26
Chinelle,F,100,27,0,27
Mercadez,F,100,152,0,152
Jahliah,F,100,5,0,5
Diane,F,100,369460,994,370454
Zhanya,F,100,11,0,11
Chapin,M,82,45,211,256
Xiaver,M,100,0,5,5
Mabelle,F,100,68,0,68
Chavez,M,99,8,786,794
Hermen,M,100,0,19,19
Sue,F,100,66796,280,67076
Mesiyah,F,71,12,5,17
Lennan,F,100,21,0,21
Deleatrice,F,100,5,0,5
Emar,M,100,0,12,12
Markella,F,100,224,0,224
Talae,F,100,5,0,5
Gadeer,F,100,5,0,5
Rocco,M,100,5,15782,15787
Rayansh,M,100,0,58,58
Baheerah,F,100,5,0,5
Odilon,M,100,0,117,117
Soundra,F,100,78,0,78
Caige,M,100,0,313,313
Aashrith,M,100,0,92,92
Ayreanna,F,100,17,0,17
Sakira,F,100,103,0,103
Amiliano,M,100,0,31,31
Argentina,F,100,270,0,270
Konesha,F,100,8,0,8
Alischa,F,100,11,0,11
Davinee,F,100,16,0,16
Draeden,M,100,0,101,101
Kelland,M,100,0,6,6
Berkay,M,100,0,49,49
Agripina,F,100,18,0,18
Ebraheem,M,100,0,27,27
Marquez,M,100,5,4959,4964
Shaunah,F,100,14,0,14
Ralphael,M,100,0,395,395
Tyjanae,F,100,163,0,163
Taqi,M,100,0,15,15
Fellicia,F,100,5,0,5
Kendron,M,100,0,5,5
Sreya,F,100,221,0,221
Cam,M,80,339,1396,1735
Avienda,F,100,14,0,14
Matthijs,M,100,0,8,8
Chellie,F,100,140,0,140
Berley,M,100,0,19,19
Cailey,F,100,3355,0,3355
Artavia,F,100,443,0,443
Rhavyn,F,100,5,0,5
Sameisha,F,100,6,0,6
Jamesdavid,M,100,0,42,42
Tramayne,M,100,0,250,250
Iola,F,100,774,0,774
Narasha,F,100,5,0,5
Ishah,F,100,10,0,10
Analise,F,100,3352,0,3352
Shirlane,F,100,5,0,5
Kavitha,F,100,115,0,115
Mykelti,F,58,52,37,89
Bertil,M,100,0,5,5
Ketric,M,100,0,11,11
Kamijah,F,100,15,0,15
Gelina,F,100,47,0,47
Rosabel,F,100,242,0,242
Jaspar,M,100,0,41,41
Syasia,F,100,42,0,42
Vennesa,F,100,53,0,53
Tamzyn,F,100,6,0,6
Jzon,M,100,0,14,14
Ginno,M,100,0,6,6
Lashema,F,100,34,0,34
Aldora,F,100,76,0,76
Jayde,F,94,5556,339,5895
Ariahana,F,100,6,0,6
Katilynn,F,100,376,0,376
Kinly,F,100,47,0,47
Munir,M,100,0,485,485
Analycia,F,100,124,0,124
Twinkle,F,100,84,0,84
Uniquia,F,100,25,0,25
Kaity,F,100,423,0,423
Kenenna,M,100,0,15,15
Alamea,F,100,44,0,44
Minus,M,100,0,5,5
Alysse,F,100,1356,0,1356
Calob,M,100,0,717,717
Rigden,M,100,0,11,11
Shahbaz,M,100,0,41,41
Daniely,F,100,24,0,24
Suchita,F,100,18,0,18
Carder,M,100,0,266,266
Renalda,F,100,63,0,63
Audreyanna,F,100,364,0,364
Kanajah,F,100,10,0,10
Kyleah,F,100,642,0,642
Hebah,F,100,160,0,160
Chantey,F,100,47,0,47
Hennesy,F,100,83,0,83
Crystiana,F,100,42,0,42
Duey,M,100,0,5,5
Angellia,F,100,14,0,14
Abrial,F,100,116,0,116
Therisa,F,100,306,0,306
Karli,F,100,9801,0,9801
Kumasi,M,100,0,18,18
Kavan,M,100,0,732,732
Londie,F,100,13,0,13
Johnatan,M,100,0,659,659
Lemoine,M,100,0,5,5
Kamakani,M,100,0,10,10
Aseem,M,100,0,76,76
Fawn,F,100,4994,0,4994
Daysy,F,100,271,0,271
Juvenal,M,100,0,1094,1094
Laverda,F,100,52,0,52
Glendia,F,100,149,0,149
Davae,F,90,47,5,52
Else,F,100,142,0,142
Elna,F,100,381,0,381
Kfir,M,100,0,5,5
Daonte,M,100,0,30,30
Jamicheal,M,100,0,314,314
Gennesy,F,100,11,0,11
Kasye,F,100,5,0,5
Female,F,100,1278,5,1283
Kiali,F,100,10,0,10
Chais,M,96,5,131,136
Bobbee,F,100,5,0,5
Quinley,F,100,168,0,168
Vadal,M,100,0,5,5
Kelvonte,M,100,0,11,11
Christiona,F,100,100,0,100
Acea,M,93,5,64,69
Deryl,M,89,144,1207,1351
Shakirah,F,100,797,0,797
Dihanna,F,100,10,0,10
Clydine,F,100,11,0,11
Tybrea,F,100,6,0,6
Leneisha,F,100,16,0,16
Janesia,F,100,92,0,92
Antonion,M,100,0,6,6
Yori,F,86,38,6,44
Shimika,F,100,174,0,174
Sussan,F,100,66,0,66
Athziry,F,100,310,0,310
Geniece,F,100,65,0,65
Adriyanna,F,100,181,0,181
Paetin,F,100,5,0,5
Yogesh,M,100,0,46,46
Ryujin,M,100,0,5,5
Brinlee,F,100,1215,0,1215
Melissia,F,100,1876,0,1876
Tremelle,M,100,0,12,12
Zarak,M,100,0,29,29
Yannel,F,100,13,0,13
Nasya,F,100,680,0,680
Delylah,F,100,730,0,730
Tiffanique,F,100,11,0,11
Adreann,F,100,7,0,7
Krithik,M,100,0,154,154
Shawnn,M,71,44,107,151
Dariela,F,100,494,0,494
Ashim,M,100,0,6,6
Tonija,F,100,5,0,5
Udonna,F,100,5,0,5
Kada,F,100,109,0,109
Anishia,F,100,38,0,38
Julez,M,88,11,78,89
Adams,M,100,0,859,859
Latrey,M,100,0,17,17
Nikolay,M,100,0,319,319
Gazella,F,100,5,0,5
Adarryl,M,100,0,58,58
Omary,M,100,0,5,5
Sofiamarie,F,100,10,0,10
Charnice,F,100,194,0,194
Jalesia,F,100,218,0,218
Alixia,F,100,5,0,5
Tijan,M,100,0,19,19
Delcie,F,100,151,0,151
Tanesia,F,100,285,0,285
Antrea,F,100,5,0,5
Jennille,F,100,11,0,11
Jaquelline,F,100,12,0,12
Destina,F,100,158,0,158
Terisha,F,100,155,0,155
Reyhana,F,100,16,0,16
Slayden,M,100,0,155,155
Avroham,M,100,0,23,23
Ciclaly,F,100,77,0,77
Alasdair,M,100,0,236,236
Ciro,M,100,0,1492,1492
Chidubem,M,100,0,214,214
Kimarah,F,100,13,0,13
Martez,M,100,6,3638,3644
Stanja,F,100,6,0,6
Ric,M,100,0,1156,1156
Leoda,F,100,16,0,16
Genele,F,100,5,0,5
Zayion,M,100,0,29,29
Kerensa,F,100,451,0,451
Arman,M,100,0,3227,3227
Omaryon,M,100,0,5,5
Lizelle,F,100,51,0,51
Venesa,F,100,309,0,309
Lashanta,F,100,509,0,509
Yawanda,F,100,5,0,5
Suha,F,100,435,0,435
Monia,F,100,311,0,311
Xela,F,100,128,0,128
Beckum,M,100,0,28,28
Khadeisha,F,100,6,0,6
Evana,F,100,480,0,480
Sherlynn,F,100,236,0,236
Tiyanna,F,100,732,0,732
Tyrise,M,100,0,8,8
Zayshawn,M,100,0,41,41
Madrona,F,100,6,0,6
Nyzere,M,100,0,12,12
Alexyz,F,100,29,0,29
Catori,F,100,155,0,155
Reba,F,100,9221,0,9221
Deva,F,98,657,11,668
Sauda,F,100,17,0,17
Tkeyha,F,100,20,0,20
Cynequa,F,100,12,0,12
Lasette,F,100,8,0,8
Erby,M,100,0,95,95
Luukas,M,100,0,5,5
Cloe,F,100,3063,0,3063
Orenda,F,100,30,0,30
Akiva,M,93,114,1626,1740
Honesty,F,100,2871,0,2871
Aishia,F,100,403,0,403
Jaslin,F,100,529,0,529
Ikeshia,F,100,49,0,49
Peder,M,100,0,589,589
Natasa,F,100,79,0,79
Desiah,F,100,27,0,27
Vashone,M,100,0,12,12
Thedora,F,100,31,0,31
Bernhard,M,100,0,526,526
Basheer,M,100,0,184,184
Grandville,M,100,0,19,19
Lesbia,F,100,43,0,43
Caeleb,M,100,0,381,381
Denecia,F,100,202,0,202
Luisantonio,M,100,0,215,215
Charlisa,F,100,591,0,591
Paeton,F,82,381,81,462
Baisha,F,100,12,0,12
Nakyra,F,100,264,0,264
Wali,M,100,0,724,724
Shadara,F,100,61,0,61
Kelle,F,98,2302,43,2345
Foley,M,100,0,6,6
Alyshia,F,100,1286,0,1286
Kellynn,F,100,15,0,15
Jas,M,84,13,66,79
Faven,F,100,50,0,50
Laquietta,F,100,5,0,5
Myrian,F,100,161,0,161
Kaylieann,F,100,5,0,5
Norman,M,99,522,78443,78965
Jdon,M,100,0,5,5
Estela,F,100,5773,0,5773
Divyanshi,F,100,7,0,7
Aurelius,M,100,0,490,490
Corbit,M,100,0,11,11
Saindhavi,F,100,7,0,7
Ranvir,M,100,0,137,137
Chon,M,100,0,163,163
Tronda,F,100,60,0,60
Monsserrat,F,100,24,0,24
Tuongvy,F,100,10,0,10
Jereld,M,100,0,67,67
Britani,F,100,1343,0,1343
Corean,F,100,92,0,92
Lang,M,99,6,410,416
Ariaunna,F,100,115,0,115
Janyse,F,100,5,0,5
Advait,M,100,0,303,303
Cynithia,F,100,220,0,220
Alayana,F,100,12,0,12
Jalani,M,61,281,438,719
Melandie,F,100,21,0,21
Austina,F,100,105,0,105
Tylesha,F,100,210,0,210
Foua,F,100,24,0,24
Arvis,M,73,77,210,287
Zadi,F,100,6,0,6
Castyn,M,100,0,5,5
Jaselynn,F,100,70,0,70
Alexaundra,F,100,10,0,10
Chanese,F,100,69,0,69
Timeshia,F,100,58,0,58
Everet,M,100,0,206,206
Wille,M,100,0,108,108
Meklit,F,100,196,0,196
Hakim,M,100,0,1964,1964
Jazman,F,97,329,11,340
Khali,F,52,478,450,928
Kadeem,M,100,0,2363,2363
Kendelle,F,97,179,5,184
Carleah,F,100,57,0,57
Haevyn,F,100,72,0,72
Miroslav,M,100,0,70,70
Natassha,F,100,20,0,20
Malillany,F,100,123,0,123
Lantanya,F,100,5,0,5
Wilibaldo,M,100,0,6,6
Aubrieana,F,100,11,0,11
Shonee,F,100,7,0,7
Mckaylah,F,100,250,0,250
Shanece,F,100,352,0,352
Quintavia,F,100,71,0,71
Francheska,F,100,1777,0,1777
Eneri,F,100,7,0,7
Evynn,F,97,185,5,190
Butler,M,100,0,131,131
Shaliyah,F,100,629,0,629
Kenaz,M,100,0,93,93
Jazzmon,F,100,106,0,106
Marlen,F,91,4848,500,5348
Erikc,M,100,0,10,10
Ciena,F,100,265,0,265
Marcelyn,F,100,254,0,254
Ladamian,M,100,0,47,47
Laurita,F,100,359,0,359
Zoyla,F,100,15,0,15
Mahina,F,100,312,0,312
Sher,M,51,119,122,241
Nikolaos,M,100,0,1548,1548
Vishva,F,69,11,5,16
Devry,M,71,11,27,38
Earlynn,F,100,5,0,5
Panagiota,F,100,504,0,504
Mozelle,F,100,332,0,332
Rydel,M,100,0,5,5
Kymere,M,100,0,59,59
Tyrael,M,100,0,6,6
Aidan,M,98,2559,102121,104680
Desra,F,100,56,0,56
Lytonia,F,100,34,0,34
Grayson,M,94,3096,44951,48047
Yarelie,F,100,131,0,131
Tabu,M,100,0,5,5
Woodson,M,100,0,316,316
Tanusha,F,100,5,0,5
Yerlin,F,100,55,0,55
Dineen,F,100,430,0,430
Nickayla,F,100,181,0,181
Darleene,F,100,43,0,43
Promyss,F,100,5,0,5
Oshiana,F,100,7,0,7
Tieranee,F,100,5,0,5
Yamiyah,F,100,5,0,5
Javyion,M,100,0,7,7
Arrin,M,58,68,95,163
Yoani,M,100,0,12,12
Karesha,F,100,112,0,112
Lavonda,F,100,3087,0,3087
Doniel,M,98,7,366,373
Cordarious,M,100,0,122,122
Yahvi,F,100,31,0,31
Taneisha,F,100,2038,0,2038
Markela,F,100,136,0,136
Jocellyn,F,100,55,0,55
Ranyiah,F,100,35,0,35
Lorrita,F,100,11,0,11
Codero,M,100,0,7,7
Jeanaya,F,100,10,0,10
Thamos,M,100,0,5,5
Sharif,M,100,5,2476,2481
Analleli,F,100,137,0,137
Thurmond,M,100,0,439,439
Hakop,M,100,0,232,232
Tawayna,F,100,15,0,15
Pihu,F,100,12,0,12
Brandilyn,F,100,663,0,663
Aivah,F,100,134,0,134
Kyeleigh,F,100,11,0,11
Shayanne,F,100,326,0,326
Kionne,M,72,15,38,53
Burkley,M,54,27,32,59
Jaret,M,99,22,2809,2831
Shahram,M,100,0,64,64
Latifha,F,100,42,0,42
Zhaniyah,F,100,32,0,32
Mielle,F,100,37,0,37
Albertjames,M,100,0,5,5
Mildreth,F,100,38,0,38
Kobe,M,98,251,14305,14556
Damonee,M,100,0,10,10
Mackynze,F,100,9,0,9
Jamarrius,M,100,0,83,83
Jumanji,M,100,0,8,8
Zionnah,F,100,46,0,46
Jorren,M,100,0,6,6
Callister,M,100,0,5,5
Hanako,F,100,147,0,147
Jene,F,87,1225,189,1414
Cecily,F,100,6389,0,6389
Lanayshia,F,100,5,0,5
Daurice,F,84,27,5,32
Jodan,M,100,0,27,27
Donzella,F,100,249,0,249
Jemi,F,100,10,0,10
Cailley,F,100,54,0,54
Karmesha,F,100,27,0,27
Qwynn,F,100,27,0,27
Perez,M,100,0,514,514
Jiromi,F,100,10,0,10
Dimante,M,100,0,10,10
Tayven,M,93,37,469,506
Alys,F,100,523,0,523
Mohamadou,M,100,0,59,59
Verdale,M,100,0,6,6
Danyela,F,100,186,0,186
Lucias,M,100,0,17,17
Diminic,M,100,0,5,5
Roianne,F,100,5,0,5
Deshell,F,100,15,0,15
Meryle,F,100,79,0,79
Ardina,F,100,5,0,5
Elke,F,100,1027,0,1027
Shrey,M,100,0,475,475
Jontae,M,81,179,779,958
Yiovanni,M,100,0,30,30
Bosede,F,100,5,0,5
Berneta,F,100,101,0,101
Anaisia,F,100,5,0,5
Zanaia,F,100,6,0,6
Joyel,F,100,130,0,130
Lelania,F,100,66,0,66
Bernell,M,84,138,725,863
Aidy,F,100,20,0,20
Amee,F,100,1659,0,1659
Ebon,M,100,0,253,253
Taaliba,F,100,10,0,10
Jennalynn,F,100,175,0,175
Caroljo,F,100,6,0,6
Avril,F,100,2092,5,2097
Zamani,F,87,80,12,92
Tyronzia,F,100,5,0,5
Ryver,M,65,117,219,336
Aason,M,100,0,17,17
Yagaira,F,100,24,0,24
Jackquelyn,F,100,236,0,236
Macsen,M,100,0,140,140
Sye,M,100,0,80,80
Tleah,F,100,5,0,5
Kambell,F,100,35,0,35
Davor,M,100,0,6,6
Gerret,M,100,0,5,5
Gladys,F,100,28489,79,28568
Ericmichael,M,100,0,11,11
Mori,F,71,57,23,80
Nolen,M,100,5,1749,1754
Javaeh,F,100,77,0,77
Audreona,F,100,5,0,5
Aamina,F,100,232,0,232
Shanira,F,100,140,0,140
Sylvain,M,100,0,74,74
Tremell,M,100,0,559,559
Perryn,M,77,6,20,26
Evanthia,F,100,40,0,40
Marcedez,F,100,11,0,11
Aizley,F,100,28,0,28
Tyquese,M,100,0,6,6
Chene,F,85,64,11,75
Nikesha,F,100,464,0,464
Amarpreet,F,100,5,0,5
Insley,F,100,6,0,6
Regulo,M,100,0,10,10
Breniah,F,100,11,0,11
Feliciana,F,100,322,0,322
Carles,M,98,5,291,296
Sahand,M,100,0,60,60
Shamiah,F,100,543,0,543
Sacajawea,F,100,12,0,12
Jaquin,M,97,5,186,191
Lafay,F,100,5,0,5
Johah,M,100,0,29,29
Finnean,M,100,0,67,67
Keito,M,100,0,5,5
Taitiana,F,100,27,0,27
Dhakirah,F,100,5,0,5
Olwyn,F,100,6,0,6
Fazon,M,100,0,11,11
Storey,F,100,175,0,175
Saphia,F,100,61,0,61
Siranthony,M,100,0,31,31
Ontaria,F,100,5,0,5
Tahiyah,F,100,5,0,5
Nerida,F,100,47,0,47
Kathlyn,F,100,2790,0,2790
Jany,F,100,104,0,104
Heshimu,M,100,0,36,36
Jonathan,M,100,3493,800367,803860
Caliyah,F,100,994,0,994
Ohene,M,100,0,11,11
Zaina,F,100,1586,0,1586
Chanh,M,100,0,11,11
Inari,F,100,241,0,241
Jamesjoseph,M,100,0,32,32
Clinesha,F,100,10,0,10
Dzaria,F,100,23,0,23
Moshay,F,100,5,0,5
Jmarcus,M,100,0,46,46
Malorie,F,100,3512,0,3512
Clabe,M,100,0,17,17
Alondria,F,100,118,0,118
Lasheka,F,100,304,0,304
Yejide,F,100,5,0,5
Yafa,F,100,14,0,14
Merton,M,100,0,495,495
Koryn,F,100,657,0,657
Mackenzy,F,89,938,119,1057
Caaden,M,100,0,5,5
Wafa,F,100,381,0,381
Salah,M,91,59,627,686
Ekamjot,M,86,5,30,35
Bisma,F,100,200,0,200
Gurvis,M,100,0,5,5
Clarah,F,100,5,0,5
Danik,M,100,0,17,17
Chianna,F,100,116,0,116
Addiel,M,100,0,51,51
Diland,M,100,0,18,18
Reylee,F,100,6,0,6
Breegan,F,100,5,0,5
Lem,M,100,0,150,150
Zaiyden,M,100,0,34,34
Yadon,M,100,0,22,22
Aahliyah,F,100,24,0,24
Corell,M,100,0,27,27
Kahnye,M,100,0,6,6
Taylormarie,F,100,149,0,149
Majuma,F,100,5,0,5
Tavien,M,100,0,359,359
Arvind,M,100,0,543,543
Maceson,M,100,0,10,10
Syedmuhammad,M,100,0,6,6
Mahrosh,F,100,39,0,39
Sylah,F,100,20,0,20
Keair,M,100,0,30,30
Santonia,M,52,10,11,21
Sarah,F,100,850064,2428,852492
Azrien,M,100,0,5,5
Wava,F,100,170,0,170
Chasadie,F,100,15,0,15
Trenice,F,100,351,0,351
Mattson,M,100,0,59,59
Joye,F,100,1644,0,1644
Stevphen,M,100,0,26,26
Tashya,F,100,85,0,85
Clancey,M,76,23,71,94
Olya,F,100,6,0,6
Latachia,F,100,18,0,18
Trisden,M,100,0,35,35
Nafisah,F,100,121,0,121
Deasha,F,100,316,0,316
Elleni,F,100,41,0,41
Llenifer,F,100,12,0,12
Yaimara,F,100,7,0,7
Kal,M,100,0,601,601
Stevanna,F,100,27,0,27
Abdala,M,100,0,6,6
Estephania,F,100,425,0,425
Candy,F,100,25970,90,26060
Montgomery,M,93,259,3198,3457
Reema,F,100,1124,0,1124
Melicia,F,100,210,0,210
Maili,F,100,329,0,329
Krystallynn,F,100,12,0,12
Jnyah,F,100,84,0,84
Tyquise,M,100,0,33,33
Lashaunti,F,100,12,0,12
Meaghann,F,100,145,0,145
Jedd,M,100,0,739,739
Bryne,M,95,6,109,115
Darrah,F,100,787,0,787
Annajean,F,100,16,0,16
Justen,M,100,5,3909,3914
Sesha,F,100,36,0,36
Diera,F,100,88,0,88
Matilde,F,96,1532,60,1592
Edvin,M,100,0,704,704
Coralai,F,100,5,0,5
Reetal,F,100,6,0,6
Ayushi,F,100,309,0,309
Orlantha,F,100,11,0,11
Ammiel,M,100,0,47,47
West,M,100,0,1444,1444
Mylea,F,100,264,0,264
Liedson,M,100,0,5,5
Ton,M,100,0,27,27
Presley,F,84,15576,2882,18458
Sherrian,F,100,122,0,122
Kennya,F,100,531,0,531
Alexcya,F,100,8,0,8
Kaytelyn,F,100,80,0,80
Dimonte,M,100,0,10,10
Mandee,F,100,887,0,887
Relando,M,100,0,6,6
Taleen,F,100,502,0,502
Soniah,F,100,23,0,23
Jesiyah,M,100,0,12,12
Zafar,M,100,0,71,71
Khase,M,100,0,5,5
Samiuela,M,100,0,27,27
Vannie,F,55,49,40,89
Kanetha,F,100,32,0,32
Ariyelle,F,100,30,0,30
Dameir,M,100,0,36,36
Zeidi,F,100,5,0,5
Ismeal,M,100,0,85,85
Yadirah,F,100,46,0,46
Daughn,F,100,5,0,5
Malacia,F,100,5,0,5
Yisselle,F,100,17,0,17
Ikaika,M,100,0,785,785
Azarae,F,100,5,0,5
Deren,M,100,0,231,231
Lindsie,F,100,969,0,969
Deke,M,100,0,201,201
Charlize,F,100,4087,0,4087
Markiya,F,100,200,0,200
Januel,M,100,0,210,210
Latory,F,100,44,0,44
Mckailey,F,100,33,0,33
Arya,F,76,5414,1721,7135
Ariene,F,100,44,0,44
Azylah,F,100,6,0,6
Huy,M,100,0,1585,1585
Emanuele,M,100,0,236,236
Semaje,M,80,26,107,133
Avisha,F,100,11,0,11
Deasya,F,100,51,0,51
Khambrel,M,100,0,69,69
Tamilore,F,100,12,0,12
Arye,M,100,0,272,272
Moniyah,F,100,22,0,22
Amichai,M,100,0,34,34
Thadeus,M,100,0,743,743
Vibha,F,100,333,0,333
Keden,M,100,0,42,42
Reiss,M,78,42,152,194
Deronn,M,100,0,11,11
Maximillan,M,100,0,52,52
Melene,F,100,28,0,28
Avreigh,F,100,5,0,5
Nathaly,F,100,5581,0,5581
Raqiya,F,100,10,0,10
Gladine,F,100,10,0,10
Dakeem,M,100,0,26,26
Shaliya,F,100,57,0,57
Maurita,F,100,511,0,511
Leandro,M,100,0,5119,5119
Malaysia,F,100,5367,0,5367
Dwij,M,100,0,10,10
Ketti,F,100,34,0,34
Desmine,M,100,0,38,38
Viena,F,100,10,0,10
Lashondria,F,100,34,0,34
Ellyse,F,100,640,0,640
Rahmell,M,100,0,7,7
Azza,F,100,34,0,34
Diangelo,M,100,0,548,548
Dwen,M,100,0,5,5
Genise,F,100,916,0,916
Nuray,F,100,5,0,5
Selyna,F,100,126,0,126
Navidad,F,100,6,0,6
Khamryn,F,52,38,35,73
Kelcey,F,75,2053,692,2745
Azelle,F,100,12,0,12
Vanita,F,100,1296,0,1296
Jermeshia,F,100,7,0,7
Nicoleann,F,100,5,0,5
Adelise,F,100,99,0,99
Rajneesh,M,100,0,6,6
Jarratt,M,100,0,25,25
Raigyn,F,100,15,0,15
Amri,F,100,252,0,252
Nikiah,F,100,169,0,169
Kaie,M,100,0,5,5
Kimlee,F,100,17,0,17
Makya,F,91,956,90,1046
Magdalynn,F,100,101,0,101
Jarnell,M,100,0,51,51
Whitli,F,100,5,0,5
Elinora,F,100,28,0,28
Shahira,F,100,72,0,72
Sims,M,100,0,82,82
Jacquelinne,F,100,68,0,68
Genea,F,100,600,0,600
Edessa,F,100,34,0,34
Shatel,F,100,5,0,5
Quintae,M,100,0,5,5
Raygina,F,100,6,0,6
Anayshia,F,100,16,0,16
Nikolaus,M,100,0,2382,2382
Damirah,F,100,5,0,5
Stephonie,F,100,155,0,155
Patrice,F,98,32603,754,33357
Warrior,M,100,0,14,14
Arii,F,100,11,0,11
Mylek,M,100,0,5,5
Rion,M,84,213,1096,1309
Saphire,F,100,739,0,739
Zareen,F,100,136,0,136
Faiz,M,100,0,420,420
Shylie,F,100,52,0,52
Laderek,M,100,0,20,20
Chatara,F,100,102,0,102
Janes,M,100,0,144,144
Hoscar,M,100,0,5,5
Anelisse,F,100,74,0,74
Athena,F,100,23504,0,23504
Macen,M,99,5,584,589
Keval,M,100,0,106,106
Daryann,F,100,5,0,5
Lesther,M,100,0,42,42
Dahianna,F,100,5,0,5
Midajah,F,100,59,0,59
Millie,F,100,8551,0,8551
Izhane,F,100,7,0,7
Hiley,F,100,37,0,37
Shanet,F,100,31,0,31
Johniya,F,100,91,0,91
Adeja,F,100,123,0,123
Chloemarie,F,100,45,0,45
Mckale,M,97,6,186,192
Melvis,M,58,11,15,26
Traydon,M,100,0,13,13
Joya,F,100,1546,0,1546
Maitlin,F,100,11,0,11
Todrick,M,100,0,90,90
Yelenis,F,100,7,0,7
Eleazar,M,100,7,4023,4030
Alexeya,F,100,7,0,7
Merv,M,100,0,20,20
Dalisha,F,100,329,0,329
Arkee,M,100,0,5,5
Stara,F,100,5,0,5
Clio,F,100,360,0,360
Tawni,F,100,1876,0,1876
Hamza,M,100,0,5445,5445
Chastine,F,100,36,0,36
Lavail,M,100,0,12,12
Markley,M,100,0,19,19
Gamaliel,M,100,0,1516,1516
Ahmiah,F,100,18,0,18
Ranbir,M,100,0,101,101
Ashura,F,100,5,0,5
Johntavia,F,100,5,0,5
Donquarius,M,100,0,39,39
Stepheni,F,100,151,0,151
Saraye,F,100,37,0,37
Maryama,F,100,249,0,249
Hajime,M,100,0,5,5
Ameriya,F,100,21,0,21
Jkai,M,100,0,51,51
Bailiegh,F,100,5,0,5
Nakijah,F,100,6,0,6
Brec,M,100,0,5,5
Crane,M,100,0,5,5
Hobart,M,100,0,649,649
Gwendolen,F,100,600,0,600
Elbridge,M,100,0,55,55
Malasia,F,100,599,0,599
Niyana,F,100,292,0,292
Navayah,F,100,153,0,153
Khodee,M,100,0,8,8
Janyriah,F,100,5,0,5
Gahan,M,100,0,5,5
Trapp,M,100,0,5,5
Wyvonne,F,100,50,0,50
Tyquavion,M,100,0,46,46
Ptosha,F,100,10,0,10
Chalon,F,86,133,22,155
Dezhanae,F,100,7,0,7
Hersey,M,100,0,65,65
Ardelia,F,100,297,0,297
Oluwatimilehin,M,100,0,137,137
Keywan,M,100,0,52,52
Merle,M,79,1696,6538,8234
Natoya,F,100,607,0,607
Lyndzey,F,100,16,0,16
Aydree,F,100,16,0,16
Choya,M,82,16,73,89
Von,M,92,273,3365,3638
Alixx,F,100,7,0,7
Deshanta,F,100,61,0,61
Ayrion,F,50,6,6,12
Tarianna,F,100,50,0,50
Michaee,M,100,0,20,20
Mckailyn,F,100,12,0,12
Sitey,F,100,5,0,5
Kaid,M,100,0,305,305
Traniqua,F,100,20,0,20
Altovise,F,100,144,0,144
Cartrina,F,100,5,0,5
Matthey,M,100,0,15,15
Keairah,F,100,56,0,56
Shantavious,F,100,35,0,35
Rebekkah,F,100,1539,0,1539
Jannuel,M,100,0,7,7
Angelamarie,F,100,148,0,148
Graciano,M,100,0,153,153
Deshea,F,91,157,16,173
Vadin,M,100,0,31,31
Heathcliff,M,100,0,10,10
Aji,F,100,7,0,7
Bayler,M,78,43,153,196
Perkins,M,100,0,10,10
Marsetta,F,100,5,0,5
Abagael,F,100,210,0,210
Mirical,F,100,15,0,15
Kyndel,F,96,385,16,401
Chalsie,F,100,9,0,9
Amnesty,F,100,13,0,13
Jlynn,F,91,622,59,681
Tashan,M,92,10,123,133
Baela,F,100,5,0,5
Brettnie,F,100,5,0,5
Lizzbeth,F,100,10,0,10
Brytne,F,100,10,0,10
Gissele,F,100,552,0,552
Savaya,F,100,66,0,66
Cleda,F,100,109,0,109
Yarieliz,F,100,100,0,100
Tahleek,M,100,0,5,5
Montserrad,F,100,5,0,5
Kit,M,68,951,2018,2969
Tennyson,M,78,171,621,792
Tamillia,F,100,5,0,5
Eirik,M,100,0,236,236
Jaydin,M,72,1069,2694,3763
Dedrea,F,100,53,0,53
Aurianna,F,100,558,0,558
Jacquenette,F,100,47,0,47
Trane,F,100,54,0,54
Janalynn,F,100,56,0,56
Rain,F,79,2018,531,2549
Jatarius,M,100,0,58,58
Dainon,M,100,0,11,11
Aylina,F,100,19,0,19
Meerub,F,100,5,0,5
Jobana,F,100,30,0,30
Daisee,F,100,77,0,77
Majesty,F,79,572,151,723
Regory,M,100,0,16,16
Sherlonda,F,100,156,0,156
Janalise,F,100,5,0,5
Kiamber,F,100,39,0,39
Montray,M,100,0,199,199
Milagros,F,100,8668,5,8673
Dreylan,M,100,0,10,10
Romaisa,F,100,27,0,27
Clovis,M,92,71,804,875
Miriya,F,100,140,0,140
Syeda,F,100,1226,0,1226
Nahuel,M,100,0,147,147
Valentina,F,100,23515,7,23522
Alainnah,F,100,26,0,26
Tresvon,M,100,0,5,5
Aleyana,F,100,43,0,43
Andretti,M,100,0,33,33
Kother,F,100,5,0,5
Norlene,F,100,48,0,48
Conrado,M,100,0,1408,1408
Courntey,F,100,49,0,49
Rahmaan,M,100,0,38,38
Anayanci,F,100,20,0,20
Yander,M,100,0,19,19
Elesha,F,100,612,0,612
Destany,F,100,3324,0,3324
Foday,M,100,0,69,69
Dushon,M,85,6,34,40
Bita,F,100,107,0,107
Olanrewaju,M,100,0,58,58
Shuwanna,F,100,5,0,5
Inesa,F,100,5,0,5
Abigeal,F,100,22,0,22
Hagop,M,100,0,304,304
Latissha,F,100,28,0,28
Gianpiero,M,100,0,28,28
Ryland,M,95,396,7100,7496
Delonte,M,100,0,1390,1390
Edris,M,63,116,201,317
Charlean,F,100,614,0,614
Nolah,F,100,67,0,67
Arisbeth,F,100,489,0,489
Evra,F,100,5,0,5
Noehly,F,100,8,0,8
Zulekha,F,100,14,0,14
Jonethan,M,100,0,22,22
Tramika,F,100,36,0,36
Jahria,F,100,5,0,5
Jacqualynn,F,100,71,0,71
Zeenia,F,100,6,0,6
Valoree,F,100,129,0,129
Irena,F,100,1122,0,1122
Saunders,M,100,0,73,73
Ghais,M,100,0,5,5
Tosha,F,100,6712,0,6712
Harneet,F,100,108,0,108
Jonessa,F,100,93,0,93
Yosef,M,100,0,6181,6181
Charleah,F,100,5,0,5
Shoran,F,100,16,0,16
Mechelle,F,100,4334,0,4334
Seleina,F,100,10,0,10
Alizaye,F,100,15,0,15
Carmena,F,100,6,0,6
Jven,M,100,0,5,5
Tyquanna,F,100,5,0,5
Jhordyn,F,86,95,15,110
Chenise,F,100,289,0,289
Haileyjade,F,100,7,0,7
Genisus,F,100,6,0,6
Armarion,M,100,0,98,98
Dayona,F,100,246,0,246
Latamara,F,100,68,0,68
Eriksen,M,100,0,6,6
Reshon,M,78,5,18,23
Jadalise,F,100,42,0,42
Nikeya,F,100,507,0,507
Ambresha,F,100,11,0,11
Kristalee,F,100,33,0,33
Ziyun,M,100,0,11,11
Tabithia,F,100,165,0,165
Marcelous,M,100,0,35,35
Samarri,F,100,19,0,19
Chalei,F,100,6,0,6
Mylena,F,100,149,0,149
Valera,F,100,167,0,167
Nesya,F,100,5,0,5
Torin,M,96,153,3368,3521
Rocelyn,F,100,37,0,37
Demetra,F,100,3408,12,3420
Martes,M,100,0,5,5
Zarik,M,100,0,19,19
Ceyana,F,100,5,0,5
Denzil,M,100,0,1396,1396
Faisa,F,100,25,0,25
Areianna,F,100,19,0,19
Maliaka,F,100,62,0,62
Remone,M,100,0,21,21
Joseh,M,100,0,143,143
Elexius,F,100,71,0,71
Erline,F,100,208,0,208
Joise,F,100,6,0,6
Elizet,F,100,77,0,77
Zendaiya,F,100,11,0,11
Pranisha,F,100,6,0,6
Kedric,M,100,0,872,872
Jahzelle,F,100,14,0,14
Keunna,F,100,24,0,24
Shawnesha,F,100,5,0,5
Keundra,F,100,195,0,195
Tarvis,M,100,0,401,401
Coti,F,82,49,11,60
Mohogany,F,100,64,0,64
Juliannie,F,100,29,0,29
Makario,M,100,0,6,6
Dewarren,M,100,0,97,97
Kiotti,M,100,0,6,6
Nevan,M,99,5,948,953
Makinley,F,100,1171,0,1171
Benno,M,100,0,76,76
Matalin,F,100,50,0,50
Demetrion,M,100,0,92,92
Lacara,F,100,62,0,62
Ciel,F,74,161,56,217
Malik,M,99,259,40461,40720
Nixson,M,100,0,25,25
Nanami,F,100,184,0,184
Melieck,M,100,0,8,8
Deyani,F,100,80,0,80
Carlosmanuel,M,100,0,50,50
Koralynn,F,100,58,0,58
Kevinmichael,M,100,0,33,33
Josee,F,100,497,0,497
Barika,F,100,9,0,9
Par,F,100,10,0,10
Aindrea,F,100,16,0,16
Damyiah,F,100,61,0,61
Nickoli,M,100,0,221,221
Eri,M,54,275,329,604
Shaylie,F,100,561,0,561
Delaili,F,100,7,0,7
Zyri,F,100,6,0,6
Lavenda,F,100,30,0,30
Aiona,F,100,5,0,5
Cherylann,F,100,953,0,953
Tarvaris,M,100,0,107,107
Dieudonne,F,100,5,0,5
Antowain,M,100,0,5,5
Durand,M,100,0,934,934
Deontray,M,100,0,316,316
Dorae,F,100,5,0,5
Cuyler,M,98,10,575,585
Homas,M,100,0,20,20
Nyko,M,100,0,46,46
Cecilie,F,100,322,0,322
Geralene,F,100,28,0,28
Franciska,F,100,16,0,16
Mariaantonia,F,100,5,0,5
Shekeia,F,100,5,0,5
Amberia,F,100,74,0,74
Fabia,F,100,16,0,16
Olinka,F,100,21,0,21
Chasady,F,100,135,0,135
Lameya,F,100,5,0,5
Konur,M,100,0,6,6
Lafe,M,100,0,323,323
Kealani,F,100,392,0,392
Aderonke,F,100,23,0,23
Ayrabella,F,100,119,0,119
Mariadelosangel,F,100,28,0,28
Catinna,F,100,11,0,11
Nyson,M,100,0,5,5
Penny,F,100,81411,275,81686
Broghan,M,81,21,90,111
Sashi,F,100,15,0,15
Adelya,F,100,5,0,5
Tykwon,M,100,0,79,79
Yamina,F,100,117,0,117
Alen,M,100,0,1747,1747
Heldana,F,100,37,0,37
Azi,M,100,0,23,23
Emre,M,100,0,605,605
Dauphine,F,100,24,0,24
Ellarae,F,100,81,0,81
Cedricka,F,100,83,0,83
Matten,M,100,0,5,5
Mykenna,F,100,275,0,275
Mystic,F,100,328,0,328
Wilhelmenia,F,100,241,0,241
Derral,M,100,0,227,227
Chawn,M,82,40,187,227
Jahniece,F,100,23,0,23
Lahonda,F,100,5,0,5
Earron,M,100,0,11,11
Jacoblee,M,100,0,6,6
Analeise,F,100,154,0,154
Kymorra,F,100,11,0,11
Madalene,F,100,427,0,427
Eugena,F,100,951,0,951
Lemmie,M,96,5,122,127
Dashal,M,100,0,18,18
Hilma,F,100,106,0,106
Trae,M,99,46,3541,3587
Donatello,M,100,0,133,133
Harrietta,F,100,143,0,143
Leslieann,F,100,465,0,465
Elisea,F,100,173,0,173
Johncarl,M,100,0,10,10
Jahmira,F,100,5,0,5
Laurell,F,100,278,0,278
Paquita,F,100,176,0,176
Marshea,F,100,165,0,165
Dennesly,F,100,10,0,10
Abrianna,F,100,3664,0,3664
Charmeka,F,100,104,0,104
Ericc,M,100,0,10,10
Latessa,F,100,282,0,282
Loan,F,100,426,0,426
Enrigue,M,100,0,585,585
Shehab,M,100,0,39,39
Ashliy,F,100,5,0,5
Mckenzy,F,97,901,30,931
Devarus,M,100,0,36,36
Mackennah,F,100,14,0,14
Tyshan,M,100,0,96,96
Layani,F,100,54,0,54
Dejaa,F,100,5,0,5
Annell,F,100,195,0,195
Briden,M,100,0,38,38
Thao,F,84,1030,192,1222
Giannamarie,F,100,77,0,77
Persais,F,100,80,0,80
Acie,M,97,22,735,757
Aalijah,M,59,107,155,262
Ayliah,F,100,46,0,46
Karion,M,93,5,66,71
Shakera,F,100,1374,0,1374
Yaritssa,F,100,5,0,5
Ismaeel,M,100,0,196,196
Syniyah,F,100,72,0,72
Angelmiguel,M,100,0,12,12
Mycol,M,100,0,5,5
Selphie,F,100,5,0,5
Kryston,F,100,18,0,18
Nivaya,F,100,26,0,26
Som,M,100,0,13,13
Tyreanna,F,100,87,0,87
Kunsh,M,100,0,5,5
Flordia,F,100,26,0,26
Gennessy,F,100,5,0,5
Kalyne,F,100,37,0,37
Davany,F,100,12,0,12
Cybil,F,100,509,0,509
Capree,F,85,28,5,33
Breah,F,100,787,0,787
Abriella,F,100,942,0,942
Ayriana,F,100,294,0,294
Elchonon,M,100,0,196,196
Lilianah,F,100,114,0,114
Francis,M,91,8745,87412,96157
Jera,F,100,722,0,722
Nakasha,F,100,43,0,43
Nishelle,F,100,33,0,33
Dalonzo,M,100,0,5,5
Alaeyah,F,100,20,0,20
Wilkes,M,100,0,75,75
Triona,F,100,22,0,22
Richael,F,100,24,0,24
Armie,F,100,6,0,6
Xavion,M,100,0,1698,1698
Jonryan,M,100,0,6,6
Almaz,F,100,5,0,5
Janesa,F,100,304,0,304
Mabelin,F,100,5,0,5
Chandra,F,100,17179,66,17245
Addylynn,F,100,30,0,30
Shelden,M,98,5,269,274
Elite,M,100,0,12,12
Bric,M,100,0,28,28
Yekaterina,F,100,79,0,79
Keiyara,F,100,6,0,6
Marybel,F,100,652,0,652
Alka,F,100,65,0,65
Karrine,F,100,51,0,51
Xzavion,M,100,0,866,866
Sanoe,F,100,93,0,93
Tahirih,F,100,89,0,89
Rania,F,100,2160,0,2160
Enas,F,100,119,0,119
Telah,F,100,33,0,33
Lucee,F,100,51,0,51
Treylen,M,100,0,92,92
Brindon,M,100,0,26,26
Betel,F,100,39,0,39
Estefan,M,100,0,270,270
Nikkita,F,100,770,0,770
Khrysta,F,100,28,0,28
Lindiwe,F,100,6,0,6
Lateena,F,100,13,0,13
Paticia,F,100,193,0,193
Rhylei,F,100,50,0,50
Lindan,M,100,0,26,26
Chandani,F,100,96,0,96
Yianni,M,100,0,292,292
Ashlely,F,100,5,0,5
Cesc,M,100,0,16,16
Marquisa,F,100,195,0,195
Aajah,F,100,29,0,29
Nashon,M,100,0,358,358
Markaylah,F,100,30,0,30
Sonda,F,100,631,0,631
Nathen,M,100,0,5440,5440
Santania,F,100,16,0,16
Shielah,F,100,5,0,5
Rahul,M,100,0,3219,3219
Deaira,F,100,466,0,466
Tereca,F,100,16,0,16
Leahna,F,100,156,0,156
Edgard,M,100,0,1283,1283
Kamilly,F,100,27,0,27
Anjuan,M,100,0,33,33
Dacia,F,100,2648,0,2648
Garrel,M,100,0,5,5
Viviane,F,100,600,0,600
Roesha,F,100,6,0,6
Desmonique,F,100,22,0,22
Aydden,M,100,0,91,91
Quanecia,F,100,10,0,10
Shakiyla,F,100,398,0,398
Airik,M,100,0,59,59
Tymari,M,100,0,44,44
Lylia,F,100,221,0,221
Darriel,M,77,154,512,666
Rovon,M,100,0,5,5
Karaann,F,100,16,0,16
Lacosta,F,100,250,0,250
Idara,F,100,72,0,72
Laquitha,F,100,68,0,68
Nova,F,90,5791,618,6409
Shaniequa,F,100,25,0,25
Jamarria,F,100,100,0,100
Sheylin,F,100,85,0,85
Densie,F,100,19,0,19
Amaro,M,100,0,78,78
Carisse,F,100,26,0,26
Lethea,F,100,31,0,31
Anacaren,F,100,126,0,126
Deagen,M,100,0,80,80
Renell,F,76,500,155,655
Landee,F,100,8,0,8
Philander,M,100,0,243,243
Veron,M,100,0,359,359
Arshad,M,100,0,205,205
Tavonn,M,100,0,5,5
Adamari,F,100,1668,0,1668
Diala,F,100,106,0,106
Lorissa,F,100,1211,0,1211
Daveed,M,100,0,43,43
Eaton,M,100,0,65,65
Azarius,M,100,0,69,69
Ovetta,F,100,29,0,29
Barack,M,100,0,207,207
Jomanda,F,100,27,0,27
Aliese,F,100,114,0,114
Eniya,F,100,400,0,400
Tomacita,F,100,5,0,5
Arthenia,F,100,12,0,12
Nas,M,100,0,33,33
Malike,M,100,0,166,166
Marthia,F,100,5,0,5
Dolan,M,100,0,1125,1125
Naaman,M,100,0,566,566
Genika,F,100,18,0,18
Meshach,M,100,0,456,456
Aylisha,F,100,6,0,6
Glynn,M,94,156,2470,2626
Ylonda,F,100,274,0,274
Kaylese,F,100,6,0,6
Nahlani,F,100,13,0,13
Luceli,F,100,16,0,16
Oluwadamilola,F,65,197,104,301
Annalina,F,100,148,0,148
Gayann,F,100,30,0,30
Deshayla,F,100,227,0,227
Lysa,F,100,757,0,757
Jacilynn,F,100,5,0,5
Raymand,M,100,0,5,5
Lehiwa,F,100,5,0,5
Matix,M,100,0,364,364
Anberlin,F,100,169,0,169
Quandra,F,100,211,0,211
Taveah,F,100,12,0,12
Keing,M,100,0,12,12
Zoelynn,F,100,28,0,28
Hawk,M,100,0,427,427
Malayzia,F,100,61,0,61
Gariel,M,75,6,18,24
Aleander,M,100,0,14,14
Inigo,M,100,0,67,67
Haileen,F,100,5,0,5
Elyza,F,100,633,0,633
Shalaunda,F,100,61,0,61
Elizeo,M,100,0,54,54
Semia,F,100,47,0,47
Miryan,F,100,17,0,17
Gayge,M,100,0,6,6
Linneah,F,100,5,0,5
Ranae,F,100,2087,0,2087
Mikaelah,F,100,170,0,170
Bowden,M,100,0,213,213
Zohrab,M,100,0,5,5
Salara,F,100,7,0,7
Ailee,F,100,407,0,407
Janus,F,75,78,26,104
Marquavis,M,100,0,202,202
Maricarmen,F,100,1033,0,1033
Fausto,M,100,0,2254,2254
Baylea,F,100,423,0,423
Sanjitha,F,100,10,0,10
Omarion,M,100,5,3361,3366
Tyresa,F,100,79,0,79
Kathlena,F,100,37,0,37
Talvin,M,100,0,113,113
Oreste,M,100,0,79,79
Halane,F,100,5,0,5
Arec,M,100,0,6,6
Lacrystal,F,100,256,0,256
Kenyell,F,76,22,7,29
Javondre,M,100,0,6,6
Lenayah,F,100,33,0,33
Yulma,F,100,26,0,26
Melenaite,F,100,10,0,10
Jazariya,F,100,19,0,19
Nalany,F,100,50,0,50
Diontae,M,100,0,610,610
Quadere,M,100,0,12,12
Amarius,M,100,0,246,246
Azealia,F,100,14,0,14
Prim,F,100,29,0,29
Ishaun,M,100,0,5,5
Shaynie,F,100,10,0,10
Audiel,M,100,0,55,55
Shawndreka,F,100,19,0,19
Dayri,F,100,5,0,5
Sumana,F,100,36,0,36
Huberto,M,100,0,6,6
Ranijah,F,100,45,0,45
Donoban,M,100,0,5,5
Mersadez,F,100,97,0,97
Dashley,F,100,47,0,47
Syheem,M,100,0,5,5
Camyla,F,100,109,0,109
Vanna,F,95,1218,59,1277
Jassar,M,100,0,10,10
Millian,F,100,11,0,11
Pierina,F,100,10,0,10
Jacauri,M,100,0,5,5
Crmen,F,100,5,0,5
Tiffni,F,100,17,0,17
Lata,F,100,5,0,5
Jeffrie,M,94,55,882,937
Alli,F,100,3341,5,3346
Cambriah,F,100,10,0,10
Judene,F,100,92,0,92
Jauwana,F,100,7,0,7
Mariajose,F,100,1545,0,1545
Travion,M,100,0,2145,2145
Rashidah,F,100,342,0,342
Petina,F,100,119,0,119
Garron,M,100,0,784,784
Kile,M,100,0,1019,1019
Lerin,F,87,195,29,224
Hanifah,F,100,137,0,137
Davelyn,F,100,81,0,81
Kaelan,M,77,380,1263,1643
Emmani,F,100,85,0,85
Kitrick,M,100,0,7,7
Lanica,F,100,12,0,12
Linde,F,100,401,0,401
Addaline,F,100,56,0,56
Derria,F,100,13,0,13
Zytavious,M,100,0,43,43
Sabreen,F,100,476,0,476
Blaid,M,100,0,7,7
Krystallee,F,100,5,0,5
Contessa,F,100,1954,0,1954
Kaidy,F,100,18,0,18
Alaylah,F,100,140,0,140
Imaani,F,100,10,0,10
Aizen,M,100,0,361,361
Hyleigh,F,100,12,0,12
Elenoa,F,100,16,0,16
Aleatra,F,100,5,0,5
Jeremaih,M,100,0,391,391
Ashanty,F,100,515,0,515
Keaun,M,100,0,76,76
Horst,M,100,0,67,67
Shadey,F,100,16,0,16
Havard,M,100,0,5,5
Zeik,M,100,0,16,16
Teren,M,68,57,122,179
Balthazar,M,100,0,91,91
Sharmeta,F,100,6,0,6
Micki,F,99,2375,33,2408
Tigre,F,100,5,0,5
Ralphine,F,100,9,0,9
Jacquel,F,69,363,163,526
Tiandre,M,100,0,66,66
Jaquincy,M,100,0,14,14
Kellymarie,F,100,30,0,30
Kaileia,F,100,43,0,43
Joann,F,100,75126,276,75402
Tyris,M,100,0,581,581
Sakeithia,F,100,6,0,6
Gregrey,M,100,0,224,224
Shermica,F,100,24,0,24
Jiayi,F,84,54,10,64
Amythyst,F,100,5,0,5
Vahn,M,100,0,15,15
Munachi,F,50,11,11,22
Jesee,M,89,5,39,44
Sitlaly,F,100,121,0,121
Kalyse,F,100,153,0,153
Etai,M,100,0,159,159
Syndie,F,100,15,0,15
Serria,F,100,165,0,165
Sharrone,F,100,31,0,31
Swati,F,100,403,0,403
Jaquavis,M,100,0,200,200
Vernie,M,65,321,593,914
Qaadir,M,100,0,93,93
Tovin,M,100,0,5,5
Lyzah,F,100,8,0,8
Karynne,F,100,37,0,37
Sheddrick,M,100,0,176,176
Sahirah,F,100,79,0,79
Boey,F,100,8,0,8
Brach,M,100,0,99,99
Shamaia,F,100,5,0,5
Xu,M,100,0,5,5
Keagin,M,100,0,31,31
Quiona,F,100,44,0,44
Cherri,F,100,3821,0,3821
Hawkin,M,100,0,35,35
Phin,M,100,0,5,5
Hatim,M,100,0,188,188
Seryn,F,100,18,0,18
Namirah,F,100,26,0,26
Donene,F,100,39,0,39
Deardra,F,100,82,0,82
Mashaunda,F,100,5,0,5
Yvanna,F,100,343,0,343
Ayshia,F,100,334,0,334
Micajah,M,100,0,67,67
Alayha,F,100,126,0,126
Shanyka,F,100,6,0,6
Shonterria,F,100,25,0,25
Delma,F,90,2459,279,2738
Caimon,M,100,0,5,5
Helenann,F,100,11,0,11
Keyonah,F,100,53,0,53
Andray,M,100,0,222,222
Abbygail,F,100,3039,0,3039
Kaisan,M,100,0,23,23
Chiraag,M,100,0,13,13
Leretha,F,100,6,0,6
Vilinda,F,100,16,0,16
Dynita,F,100,5,0,5
Kahlan,F,99,1118,15,1133
Ambyr,F,100,283,0,283
Wakinyan,M,100,0,18,18
Barton,M,100,0,5763,5763
Rondo,M,100,0,45,45
Dobie,M,100,0,32,32
Nickos,M,100,0,7,7
Ferdinando,M,100,0,170,170
Setara,F,100,5,0,5
Khrystine,F,100,23,0,23
Chrishaud,M,100,0,5,5
Santosh,M,100,0,146,146
Heiner,M,100,0,6,6
Trequon,M,100,0,46,46
Charlissa,F,100,110,0,110
Alverta,F,100,177,0,177
Simms,M,100,0,5,5
Deenna,F,100,45,0,45
Almedia,F,100,56,0,56
Chenele,F,100,5,0,5
Shayley,F,100,233,0,233
Jonnica,F,100,6,0,6
Besa,F,100,11,0,11
Wilmar,M,100,0,177,177
Moana,F,100,501,0,501
Matelyn,F,100,90,0,90
Syntyche,F,100,6,0,6
Wolfe,M,100,0,101,101
Abduljabbar,M,100,0,16,16
Kayci,F,100,1344,0,1344
Zayvin,M,100,0,15,15
Leobardo,M,100,0,2331,2331
Laureen,F,100,6061,0,6061
Yosaira,F,100,5,0,5
Carenda,F,100,9,0,9
Kielee,F,100,150,0,150
Cemiyah,F,100,12,0,12
Daiona,F,100,40,0,40
Binti,F,100,24,0,24
Asana,F,100,26,0,26
Lucja,F,100,5,0,5
Aralia,F,100,7,0,7
Asalah,F,100,17,0,17
Het,M,100,0,16,16
Justise,F,83,210,44,254
Sabriyyah,F,100,5,0,5
Calvary,F,68,44,21,65
Jokari,M,100,0,5,5
Tumeka,F,100,65,0,65
Samanthajo,F,100,287,0,287
Cincere,M,80,108,419,527
Shaila,F,100,2808,0,2808
Lanetra,F,100,90,0,90
Anneka,F,100,793,0,793
Jacovian,M,100,0,6,6
Lynnisha,F,100,11,0,11
Ashalyn,F,100,10,0,10
Tenna,F,100,501,0,501
Milaysia,F,100,12,0,12
Zhania,F,100,74,0,74
Anilyn,F,100,5,0,5
Tashanti,F,100,115,0,115
Jaleese,F,100,32,0,32
Ladaesha,F,100,12,0,12
Hayne,M,100,0,6,6
Brianamarie,F,100,5,0,5
Jonatham,M,100,0,26,26
Isabellemarie,F,100,5,0,5
Orlo,M,100,0,25,25
Josa,M,100,0,7,7
Luzmaria,F,100,634,0,634
Elizabath,F,100,16,0,16
Evern,F,55,6,5,11
Terrill,M,88,491,3576,4067
Reannah,F,100,158,0,158
Dragan,M,100,0,241,241
Naquan,M,100,0,1262,1262
Lancelot,M,100,0,493,493
Natalia,F,100,53462,41,53503
Petal,F,100,13,0,13
Kadraya,F,100,8,0,8
Nayleah,F,100,40,0,40
Beola,F,100,5,0,5
Maissa,F,100,11,0,11
Mashala,F,100,22,0,22
Tamoni,F,100,10,0,10
Aliyanah,F,100,98,0,98
Latrishia,F,100,16,0,16
Desare,F,100,88,0,88
Cashius,M,100,0,189,189
Carryn,F,100,22,0,22
Avaughn,M,100,0,11,11
Kahri,M,64,20,35,55
Mariacristina,F,100,73,0,73
Shontasia,F,100,13,0,13
Bryan,M,100,1707,365579,367286
Jeannia,F,100,63,0,63
Breaunna,F,100,634,0,634
Terriel,M,86,5,32,37
Keeya,F,100,85,0,85
Furman,M,100,0,802,802
Mysha,F,100,350,0,350
Bowdy,M,100,0,78,78
Aneya,F,100,186,0,186
Sylias,M,100,0,6,6
Cherida,F,100,28,0,28
Laynee,F,100,999,0,999
Mellody,F,100,380,0,380
Mickenzy,F,100,11,0,11
Rhyen,F,73,99,37,136
Avina,F,100,133,0,133
Miyo,F,100,7,0,7
Zacarri,M,100,0,11,11
Nuru,M,100,0,5,5
Threasa,F,100,479,0,479
Tayjon,M,100,0,66,66
Ayva,F,100,1811,0,1811
Yazzmin,F,100,17,0,17
Lilyrose,F,100,218,0,218
Yumi,F,100,606,0,606
Kage,M,100,0,1018,1018
Drinda,F,100,100,0,100
Kamiron,M,100,0,18,18
Aalisha,F,100,30,0,30
Sharay,F,99,739,5,744
Shafi,M,100,0,47,47
Tadyn,M,100,0,6,6
Ance,M,100,0,5,5
Abbott,M,96,18,445,463
Bowie,M,71,157,381,538
Dontonio,M,100,0,11,11
Christofer,M,100,0,3513,3513
Sanda,F,100,436,0,436
Ralisha,F,100,21,0,21
Madisongrace,F,100,5,0,5
Jjesus,M,100,0,192,192
Abdul,M,100,0,5227,5227
Dariush,M,100,0,111,111
Beren,M,87,18,120,138
Maddax,M,97,8,287,295
Jentzen,M,100,0,98,98
Marquell,M,99,19,1369,1388
Ayson,M,100,0,227,227
Keneta,F,100,11,0,11
Shabre,F,100,61,0,61
Adaryll,M,100,0,43,43
Juelz,M,96,81,1901,1982
Joandaly,F,100,6,0,6
Yonas,M,100,0,298,298
Kaylie,F,100,18657,0,18657
Errica,F,100,368,0,368
Jyra,F,100,107,0,107
Dominoe,F,100,5,0,5
Edo,M,100,0,16,16
Devoris,M,100,0,41,41
Aristea,F,100,36,0,36
Cheyne,M,89,115,898,1013
Tamson,F,100,15,0,15
Ahlyana,F,100,5,0,5
Kerel,M,100,0,35,35
Chalres,M,100,0,21,21
Mawada,F,100,15,0,15
Srinija,F,100,5,0,5
Mohannad,M,100,0,91,91
Luisjavier,M,100,0,5,5
Sahnya,F,100,5,0,5
Umaima,F,100,33,0,33
Lukin,M,100,0,10,10
Luevenia,F,100,34,0,34
Akeba,F,100,26,0,26
Recia,F,100,49,0,49
Daphanie,F,100,452,0,452
Yoshigey,F,100,6,0,6
Akilah,F,100,2757,0,2757
Tahesia,F,100,5,0,5
Aswad,M,100,0,128,128
Niharika,F,100,274,0,274
Jaretsi,F,100,5,0,5
Marius,M,100,0,1753,1753
Mishawn,F,64,117,65,182
Jesai,M,100,0,6,6
Yoniel,M,100,0,73,73
Aheli,F,100,5,0,5
Abryl,F,100,14,0,14
Dellen,M,100,0,7,7
Kianu,M,100,0,11,11
Aprecious,F,100,5,0,5
Shantisha,F,100,34,0,34
Jion,M,100,0,17,17
Gawain,M,100,0,74,74
Shanetra,F,100,177,0,177
Dalanie,F,100,235,0,235
Shiven,M,100,0,310,310
Marvis,M,62,447,741,1188
Chantha,F,53,34,30,64
Corran,M,100,0,101,101
Artensia,F,100,5,0,5
Maelene,F,100,36,0,36
Danielis,F,100,6,0,6
Nacirema,F,100,5,0,5
Shequilla,F,100,64,0,64
Kanyla,F,100,150,0,150
Duwayne,M,100,0,2137,2137
Ahbleza,M,100,0,6,6
Modestine,F,100,49,0,49
Taiwanda,F,100,6,0,6
Lavani,F,100,6,0,6
Luberta,F,100,112,0,112
Yuva,M,100,0,11,11
Khamyra,F,100,6,0,6
Khamari,M,78,332,1144,1476
Kashiff,M,100,0,7,7
Empress,F,100,541,0,541
Elba,F,99,2272,24,2296
Caida,F,100,5,0,5
Rupal,F,100,204,0,204
Kinlee,F,100,1419,0,1419
Keian,M,100,0,248,248
Kaiya,F,99,5379,33,5412
Sheritta,F,100,205,0,205
Shanylah,F,100,30,0,30
Charneshia,F,100,5,0,5
Billey,M,100,0,122,122
Anay,F,54,745,622,1367
Donnalynn,F,100,69,0,69
Keegin,M,100,0,32,32
Aneta,F,100,471,0,471
Caralyn,F,100,977,0,977
Verlaine,F,100,10,0,10
Fransica,F,100,10,0,10
Leovigildo,M,100,0,5,5
Yanelly,F,100,640,0,640
Haran,M,100,0,27,27
Alfons,M,100,0,33,33
Modesty,F,100,416,0,416
Kittie,F,100,496,0,496
Jahki,M,100,0,275,275
Aysha,F,100,2447,0,2447
Wynona,F,100,1031,0,1031
Jhamari,M,100,0,168,168
Keerthan,M,100,0,5,5
Sherly,F,100,882,0,882
Nesren,F,100,7,0,7
Kenyatte,M,67,61,123,184
Tamijo,F,100,10,0,10
Refoel,M,100,0,90,90
Sheliya,F,100,5,0,5
Iron,M,100,0,13,13
Olney,M,100,0,5,5
Gwendloyn,F,100,88,0,88
Shire,F,100,16,0,16
Devondra,F,100,35,0,35
Taij,M,100,0,6,6
Telica,F,100,5,0,5
Chasin,M,100,0,62,62
Azurah,F,100,5,0,5
Zareya,F,100,62,0,62
Dmareon,M,100,0,5,5
Rosezella,F,100,35,0,35
Nechemiah,M,100,0,5,5
Ravy,M,100,0,5,5
Joshalyn,F,100,184,0,184
Garl,M,100,0,16,16
Darionna,F,100,208,0,208
Aakarsh,M,100,0,53,53
Ciarra,F,100,3289,0,3289
Jone,F,95,370,19,389
Zaneta,F,100,918,0,918
Emit,M,100,0,59,59
Shymeek,M,100,0,6,6
Sunel,M,100,0,14,14
Rajendra,M,100,0,76,76
Buenaventura,M,100,0,5,5
Elexis,F,100,2710,0,2710
Lonya,F,100,65,0,65
Cele,F,100,5,0,5
Taleigha,F,100,255,0,255
Ayris,F,100,64,0,64
Jaylenn,F,64,148,83,231
Ashleey,F,100,18,0,18
Devontia,M,100,0,12,12
Dashiel,M,100,0,239,239
Kaeda,F,100,30,0,30
Kalana,F,100,149,0,149
Chisato,F,100,15,0,15
Annique,F,100,40,0,40
Felicity,F,100,9771,6,9777
Jakashia,F,100,5,0,5
Jmar,M,100,0,45,45
Ladarien,M,100,0,121,121
Ahnyla,F,100,56,0,56
Dayshaun,M,100,0,365,365
Bonni,F,100,1160,0,1160
Jiyoung,F,100,5,0,5
Amarily,F,100,6,0,6
Aleeya,F,100,951,0,951
Jaskirat,M,71,32,80,112
Kaylo,M,100,0,5,5
Zarchary,M,100,0,6,6
Honore,F,91,49,5,54
Tristun,M,100,0,16,16
Zyian,F,58,49,35,84
Xen,M,80,5,20,25
Shanelle,F,100,4252,0,4252
Alvyn,M,100,0,21,21
Amuel,M,100,0,18,18
Tahmel,M,100,0,6,6
Caleiah,F,100,5,0,5
Marlaine,F,100,228,0,228
Araiah,F,100,28,0,28
Carmelita,F,100,4068,0,4068
Bernardine,F,100,569,0,569
Nykel,M,100,0,39,39
Dejour,M,94,14,225,239
Naji,M,100,0,569,569
Raeah,F,100,26,0,26
Burnham,M,100,0,5,5
Gaudalupe,F,100,12,0,12
Rakeb,F,100,80,0,80
Joakima,F,100,13,0,13
Tokie,F,100,5,0,5
Ragina,F,100,370,0,370
Jenise,F,100,2671,0,2671
Mytia,F,100,18,0,18
Keelon,M,100,0,88,88
Saahithi,F,100,23,0,23
Tameshia,F,100,541,0,541
Meyanna,F,100,5,0,5
Aishling,F,100,33,0,33
Amme,F,100,49,0,49
Jamms,M,100,0,12,12
Oryon,M,100,0,77,77
Rawn,M,100,0,110,110
Otto,M,100,0,7132,7132
Adonis,M,99,71,6814,6885
Deshanay,F,100,6,0,6
Maiken,F,100,6,0,6
Danford,M,100,0,153,153
Lederrick,M,100,0,14,14
Barbarajean,F,100,129,0,129
Makaiah,F,96,110,5,115
Kaytin,F,100,20,0,20
Jamison,M,90,1625,14554,16179
Mackenson,M,100,0,10,10
Arley,M,75,400,1187,1587
Jard,M,100,0,6,6
Taleiya,F,100,6,0,6
Rishin,M,100,0,7,7
Carrson,M,100,0,134,134
Decarion,M,100,0,10,10
Braydn,M,100,0,403,403
Raksmey,F,100,5,0,5
Enrico,M,100,0,3080,3080
Tier,F,100,5,0,5
Sulaiman,M,100,0,839,839
Quantasha,F,100,5,0,5
Dmani,M,72,19,49,68
Chirstian,M,100,0,10,10
Aleene,F,100,36,0,36
Jannely,F,100,280,0,280
Alidia,F,100,24,0,24
Tolliver,M,100,0,5,5
Ryshawn,M,100,0,74,74
Lorrene,F,100,199,0,199
Irish,F,92,1169,102,1271
Selicia,F,100,76,0,76
Jabes,M,100,0,120,120
Tishena,F,100,5,0,5
Olivia,F,100,353430,589,354019
Jinhee,F,100,5,0,5
Isma,F,100,21,0,21
Shemeca,F,100,91,0,91
Kenwood,M,100,0,32,32
Rava,F,100,5,0,5
Morgana,F,100,509,0,509
Maurielle,F,100,15,0,15
Chassi,F,100,5,0,5
Demeta,F,100,27,0,27
Lateafa,F,100,6,0,6
Cinamon,F,100,49,0,49
Jenova,F,100,18,0,18
Doren,M,87,36,243,279
Magalie,F,100,260,0,260
Shaunmichael,M,100,0,10,10
Caisyn,F,56,19,15,34
Rayel,F,89,47,6,53
Ellena,F,100,1365,0,1365
Mccayla,F,100,93,0,93
Nyrell,M,100,0,55,55
Fransheska,F,100,195,0,195
Austeja,F,100,7,0,7
Caelob,M,100,0,5,5
Kiegan,M,96,5,133,138
Jinx,F,100,95,0,95
Darnetta,F,100,423,0,423
Caysee,F,100,17,0,17
Ridlee,F,100,5,0,5
Jerimih,M,100,0,11,11
Aidric,M,100,0,317,317
Tilwanda,F,100,5,0,5
Macallen,M,100,0,7,7
Daigon,M,100,0,5,5
Callee,F,100,611,0,611
Tegh,M,100,0,8,8
Estus,M,100,0,12,12
Deianna,F,100,10,0,10
Vaida,F,100,259,0,259
Kiesha,F,100,2621,0,2621
Dah,M,58,5,7,12
Mikaal,M,100,0,5,5
Gwendolin,F,100,64,0,64
Kenron,M,100,0,5,5
Giovana,F,100,719,0,719
Sharne,F,100,94,0,94
Herber,M,100,0,53,53
Adar,M,65,28,51,79
Cylas,M,100,0,442,442
Lashekia,F,100,37,0,37
Jordann,F,95,1000,54,1054
Modesto,M,100,0,1635,1635
Tuff,M,100,0,378,378
Mistydawn,F,100,39,0,39
Shaneaka,F,100,11,0,11
Corris,M,100,0,15,15
Mckaela,F,100,276,0,276
Joyah,F,100,19,0,19
Inesha,F,100,112,0,112
Mykiah,F,100,244,0,244
Naylee,F,100,76,0,76
Michiah,F,59,88,61,149
Shavez,M,100,0,39,39
Sukhmani,F,100,161,0,161
Elio,M,100,0,1608,1608
Alaine,F,100,1093,0,1093
Brittine,F,100,31,0,31
Krissinda,F,100,7,0,7
Scheherazade,F,100,43,0,43
Jodene,F,100,863,0,863
Laurelle,F,100,316,0,316
Celise,F,100,144,0,144
Kainalu,M,100,0,467,467
Gowtham,M,100,0,27,27
Tyhiem,M,100,0,36,36
Rondald,M,100,0,11,11
Koben,M,100,0,110,110
Brandye,F,100,485,0,485
Mosa,M,100,0,11,11
Gineen,F,100,27,0,27
Jillianna,F,100,96,0,96
Yorlet,F,100,9,0,9
Zowee,F,100,5,0,5
Sunehri,F,100,6,0,6
Heilly,F,100,6,0,6
Avish,M,100,0,49,49
Stephon,M,100,14,7934,7948
Trachelle,F,100,100,0,100
Osborne,M,100,0,459,459
Marida,F,100,17,0,17
Fayetta,F,100,330,0,330
Ceili,F,100,262,0,262
Kashia,F,100,596,0,596
Amandajean,F,100,13,0,13
Shanera,F,100,119,0,119
Shaniyia,F,100,5,0,5
Laniesha,F,100,116,0,116
Amiela,F,100,34,0,34
Teree,F,100,29,0,29
Kassey,F,99,637,5,642
Jameil,M,100,0,215,215
Aaisha,F,100,168,0,168
Chadwin,M,100,0,158,158
Shaneek,F,100,16,0,16
Kanalu,M,100,0,6,6
Sukari,F,100,91,0,91
Karolyna,F,100,110,0,110
Evester,M,100,0,10,10
Darma,F,100,5,0,5
Jissie,M,100,0,5,5
Chanan,M,100,0,60,60
Kathaleen,F,100,2186,0,2186
Tangula,F,100,55,0,55
Schavon,F,100,7,0,7
Tonysha,F,100,18,0,18
Kaige,M,98,5,296,301
Octavia,F,99,11063,132,11195
Zamantha,F,100,269,0,269
Petrice,F,100,173,0,173
Bionka,F,100,55,0,55
Tatia,F,100,628,0,628
Walden,M,100,0,509,509
Hester,F,98,1563,27,1590
Daquarius,M,100,0,250,250
Saroya,F,100,52,0,52
Delanor,M,100,0,5,5
Omari,M,96,271,7128,7399
Donavon,M,100,0,4325,4325
Shann,M,57,214,280,494
Dhruva,M,100,0,248,248
Tristian,M,91,616,6032,6648
Savahanna,F,100,70,0,70
Andreona,F,100,8,0,8
Ihab,M,100,0,23,23
Jinnah,F,100,10,0,10
Joycelyn,F,100,4522,0,4522
Klint,M,100,0,736,736
Kourtne,F,100,5,0,5
Jiovannie,M,100,0,5,5
Joury,F,100,41,0,41
Shabriel,F,100,5,0,5
Deneesha,F,100,5,0,5
Ysabell,F,100,14,0,14
Brooker,M,100,0,5,5
Stonie,M,58,10,14,24
Aljean,F,100,7,0,7
Zakaylah,F,100,6,0,6
Jaelin,M,57,851,1126,1977
Arriella,F,100,25,0,25
Ydania,F,100,6,0,6
Lynn,F,86,146665,24446,171111
Chan,M,80,212,848,1060
Teenamarie,F,100,7,0,7
Yahira,F,100,462,0,462
Demante,M,100,0,24,24
Deadrian,M,100,0,236,236
Galya,F,100,60,0,60
Jonet,F,100,78,0,78
Tondi,F,100,6,0,6
Jacinta,F,100,2910,0,2910
Jaiveer,M,100,0,111,111
Odalys,F,100,3053,0,3053
Chamroeun,M,100,0,5,5
Jakel,M,96,11,263,274
Karroll,M,100,0,5,5
Couri,F,100,5,0,5
Nabria,F,100,93,0,93
Leane,F,100,487,0,487
Nixxon,M,100,0,34,34
Larenda,F,100,347,0,347
Irys,F,100,71,0,71
Shemica,F,100,201,0,201
Phala,F,100,34,0,34
Novia,F,100,173,0,173
Eljin,M,100,0,10,10
Kenston,M,100,0,72,72
Tynette,F,100,28,0,28
Rotonda,F,100,48,0,48
Cherryl,F,100,1210,0,1210
Roshard,M,100,0,127,127
Shajuan,F,72,142,56,198
Kameka,F,100,288,0,288
Dezmend,M,100,0,27,27
Alexandriah,F,100,21,0,21
Shawndi,F,100,5,0,5
Rreanna,F,100,5,0,5
Cleon,M,100,0,1160,1160
Korynn,F,100,373,0,373
Dennys,M,83,83,408,491
Lizabelle,F,100,5,0,5
Tevian,M,100,0,15,15
Mariama,F,100,1501,0,1501
Jaiyda,F,100,37,0,37
Shanette,F,100,826,0,826
Cheyrl,F,100,111,0,111
Cashon,M,100,0,21,21
Landun,M,100,0,23,23
Dejanae,F,100,1013,0,1013
Obbie,M,100,0,88,88
Tziporah,F,100,657,0,657
Isaia,M,100,0,363,363
Zoha,F,100,575,0,575
Arquita,F,100,10,0,10
Jasilynn,F,100,12,0,12
Kaymie,F,100,6,0,6
Rihana,F,100,570,0,570
Nathale,F,100,10,0,10
Dilan,M,98,77,3066,3143
Darnae,F,100,48,0,48
Siaosi,M,100,0,216,216
Sibley,F,100,57,0,57
Altonette,F,100,5,0,5
Tamyia,F,100,314,0,314
Jhordy,M,100,0,23,23
Zaccari,M,100,0,20,20
Ellionna,F,100,65,0,65
Marbely,F,100,19,0,19
Aleera,F,100,70,0,70
Zaylia,F,100,33,0,33
Estle,M,100,0,49,49
Avram,M,100,0,697,697
Mert,M,100,0,299,299
Leilynn,F,100,56,0,56
Seri,F,100,134,0,134
Dorsi,F,100,5,0,5
Shymeka,F,100,16,0,16
Chaisty,F,100,25,0,25
Jerardo,M,100,0,1425,1425
Jackolyn,F,100,86,0,86
Myaisha,F,100,28,0,28
Karsyn,F,86,4208,674,4882
Shashwat,M,100,0,78,78
Dyisha,F,100,5,0,5
Vanshon,M,100,0,5,5
Autiana,F,100,48,0,48
Johnothan,M,100,0,121,121
Sophiaann,F,100,17,0,17
Luanne,F,100,7147,0,7147
Jaidy,F,100,159,0,159
Raynesha,F,100,216,0,216
Ajha,F,100,27,0,27
Makiba,F,100,42,0,42
Kelita,F,100,131,0,131
Ena,F,100,1536,0,1536
Zolee,F,100,10,0,10
Ilenia,F,100,15,0,15
Ari,M,84,2134,11146,13280
Steffen,M,100,0,1398,1398
Tyshon,M,99,11,1257,1268
Jacobia,F,67,10,5,15
Yia,M,100,0,32,32
Abishek,M,100,0,50,50
Mylin,F,78,134,37,171
Jaivon,M,100,0,592,592
Atoya,F,100,153,0,153
Tyrick,M,100,0,345,345
Tayron,M,100,0,190,190
Tahisha,F,100,373,0,373
Arieta,F,100,10,0,10
Poseidon,M,100,0,65,65
Gao,F,100,375,0,375
Anastacia,F,100,3846,0,3846
Emelye,F,100,5,0,5
Roshina,F,100,5,0,5
Syriana,F,100,306,0,306
Sumita,F,100,23,0,23
Arnette,F,96,625,28,653
Pajtim,M,100,0,13,13
Anthonny,M,100,0,85,85
Gwynith,F,100,12,0,12
Jazzminn,F,100,5,0,5
Saniyah,F,100,5027,0,5027
Rodick,M,100,0,5,5
Whitfield,M,100,0,104,104
Anuraag,M,100,0,57,57
Braderick,M,100,0,5,5
Anaid,F,100,388,0,388
Tangila,F,100,22,0,22
Jenice,F,100,1707,0,1707
Saila,F,100,19,0,19
Mattlyn,F,100,10,0,10
Khaleeq,M,100,0,31,31
Akayla,F,100,1209,0,1209
Rolandas,M,100,0,5,5
Vayron,M,100,0,5,5
Slyvia,F,100,285,0,285
Lanny,M,99,45,5250,5295
Jessamine,F,100,400,0,400
Eilidh,F,100,122,0,122
Traeger,M,100,0,49,49
Princeton,M,100,0,3022,3022
Keiauna,F,100,16,0,16
Jaliyah,F,100,6990,0,6990
Dmetri,M,100,0,22,22
Atonya,F,100,83,0,83
Phaidra,F,100,8,0,8
Audria,F,100,829,0,829
Abdulraheem,M,100,0,80,80
Syleste,F,100,12,0,12
Sariyha,F,100,5,0,5
Swasti,F,100,6,0,6
Kaleena,F,100,1778,0,1778
Dnajah,F,100,6,0,6
Luxi,F,100,7,0,7
Zylie,F,100,48,0,48
Malavika,F,100,69,0,69
Shomari,M,94,71,1047,1118
Sjon,M,100,0,37,37
Vyvy,F,100,42,0,42
Navey,F,100,14,0,14
Belal,M,100,0,540,540
Bastien,M,100,0,111,111
Macel,F,100,17,0,17
Jekori,M,100,0,5,5
Renny,M,89,59,501,560
Karaleigh,F,100,32,0,32
Naariah,F,100,17,0,17
Sayler,F,99,336,5,341
Delford,M,100,0,147,147
Annitra,F,100,49,0,49
Simba,M,100,0,25,25
Torran,M,100,0,37,37
Lasasha,F,100,162,0,162
Averi,F,96,4463,187,4650
Daja,F,100,2302,0,2302
Petar,M,100,0,480,480
Armanie,F,69,134,61,195
Janavi,F,100,17,0,17
Nithila,F,100,86,0,86
Nicholos,M,100,0,713,713
Cherry,F,100,7086,33,7119
Sipriano,M,100,0,23,23
Meba,M,100,0,16,16
Raichel,F,100,46,0,46
Nashya,F,100,119,0,119
Madysen,F,100,2495,5,2500
Sidnei,F,100,24,0,24
Seferina,F,100,32,0,32
Glendal,M,100,0,38,38
Pace,M,98,11,493,504
Shaterica,F,100,174,0,174
Arav,M,100,0,633,633
Brande,F,100,1141,0,1141
Jenetta,F,100,379,0,379
Teyona,F,100,300,0,300
Moet,F,100,135,0,135
Vinzent,M,100,0,13,13
Tykiera,F,100,63,0,63
Marhsall,M,100,0,6,6
Jeeva,M,100,0,5,5
Letycia,F,100,11,0,11
Ezmay,F,100,9,0,9
Nadolyn,F,100,8,0,8
Mikena,F,100,65,0,65
Boss,M,100,0,88,88
Skyler,M,64,20165,35954,56119
Tricha,F,100,99,0,99
Dejuana,F,100,286,0,286
Leocadio,M,100,0,81,81
Pachia,F,100,200,0,200
Keazia,F,100,16,0,16
Lorrian,F,100,5,0,5
Jewellee,F,100,5,0,5
Gegory,M,100,0,58,58
Abdoulie,M,100,0,110,110
Kalyah,F,100,51,0,51
Milagro,F,98,1375,26,1401
Marat,M,100,0,27,27
Geneieve,F,100,66,0,66
Asiamarie,F,100,6,0,6
Detrez,M,100,0,5,5
Tambry,F,100,5,0,5
Moncerat,F,100,56,0,56
Tavio,M,100,0,125,125
Rajiv,M,100,0,796,796
Shontrell,F,100,51,0,51
Tyisha,F,100,1829,0,1829
Syon,M,100,0,194,194
Juliano,M,100,0,647,647
Devunte,M,100,0,5,5
Kadeidre,F,100,21,0,21
Zariyana,F,100,19,0,19
Jennylyn,F,100,12,0,12
Medora,F,100,190,0,190
Tashonna,F,100,153,0,153
Deiontay,M,100,0,22,22
Yuleysi,F,100,6,0,6
Karas,M,100,0,250,250
Qunita,F,100,22,0,22
Vedanshi,F,100,55,0,55
Dametria,F,100,252,0,252
Drishya,F,100,13,0,13
Glean,M,100,0,17,17
Yuleisy,F,100,20,0,20
Jagjit,M,100,0,21,21
Theodoro,M,100,0,117,117
Katharyn,F,100,1014,0,1014
Shaniqwa,F,100,64,0,64
Maziar,M,100,0,32,32
Leward,M,100,0,5,5
Aybel,M,100,0,15,15
Marialicia,F,100,5,0,5
Crstal,F,100,5,0,5
Jaquetta,F,100,747,0,747
Shyniqua,F,100,11,0,11
Coy,M,97,224,7854,8078
Tenneil,F,100,12,0,12
Arwyn,F,100,310,0,310
Zennia,F,100,15,0,15
Angelic,F,100,3668,0,3668
Sheli,F,100,647,0,647
Bean,M,100,0,5,5
Gogi,F,100,6,0,6
Tanvee,F,100,25,0,25
Natashua,F,100,11,0,11
Atha,F,100,124,0,124
Bonnee,F,100,37,0,37
Carpenter,M,100,0,15,15
Aryton,M,100,0,5,5
Lanning,M,100,0,5,5
Daquana,F,100,95,0,95
Tersia,F,100,30,0,30
Maris,F,91,1627,162,1789
Emia,F,100,53,0,53
Santosha,F,100,90,0,90
Sidhartha,M,100,0,5,5
Nashlie,F,100,12,0,12
Britteni,F,100,20,0,20
Hobson,M,100,0,60,60
Cyntrell,F,100,5,0,5
Shaeli,F,100,56,0,56
Nautika,F,100,219,0,219
Jarod,M,100,5,11578,11583
Laquail,F,100,5,0,5
Leviticus,M,100,0,833,833
Victorine,F,100,107,0,107
Pomaikai,F,100,10,0,10
Lamayah,F,100,22,0,22
Marino,M,100,0,1396,1396
Yousif,M,100,0,864,864
Tris,F,61,94,59,153
Reuven,M,100,0,641,641
Aurellia,F,100,6,0,6
Rhileigh,F,100,5,0,5
Rockey,M,100,0,834,834
Alessia,F,100,2685,0,2685
Ronnell,M,92,183,2167,2350
Davian,M,98,100,4493,4593
Lowen,M,100,0,192,192
Dawnita,F,100,348,0,348
Adrianjames,M,100,0,11,11
Skylr,F,59,16,11,27
Azora,F,100,18,0,18
Deep,M,100,0,344,344
Anatoliy,M,100,0,50,50
Corabelle,F,100,67,0,67
Jlah,F,100,53,0,53
Dequez,M,100,0,11,11
Dametrius,M,100,0,334,334
Iolani,F,100,70,0,70
Simmone,F,100,173,0,173
Emilyah,F,100,12,0,12
Loralie,F,100,650,0,650
Dinita,F,100,76,0,76
Kalib,M,100,0,1373,1373
Zildjian,M,100,0,31,31
Dow,M,100,0,428,428
Conni,F,100,805,0,805
Mayukh,M,100,0,29,29
Keeba,F,100,17,0,17
Destenee,F,100,105,0,105
Celinna,F,100,5,0,5
Talis,M,87,11,75,86
Aneil,M,100,0,35,35
Cezanne,F,100,38,0,38
Kateria,F,100,242,0,242
Danion,M,100,0,5,5
Karai,F,100,11,0,11
Anaissa,F,100,93,0,93
Kessandra,F,100,18,0,18
Mj,M,100,0,70,70
Martynas,M,100,0,13,13
Khloei,F,100,63,0,63
Kayra,F,99,501,5,506
Aleciram,F,100,10,0,10
Nashara,F,100,33,0,33
Lakeda,F,100,53,0,53
Kayzen,M,100,0,35,35
Vondra,F,100,90,0,90
Verena,F,100,761,0,761
Masika,F,100,15,0,15
Wigberto,M,100,0,14,14
Navarius,M,100,0,5,5
Errik,M,100,0,70,70
Sheldon,M,98,464,22969,23433
Tuba,F,100,32,0,32
Geneive,F,100,15,0,15
Bnai,F,100,6,0,6
Terrilynne,F,100,5,0,5
Albria,F,100,5,0,5
Elige,M,100,0,38,38
Dainian,M,100,0,13,13
Jakevis,M,100,0,5,5
Tamarria,F,100,16,0,16
Tysin,M,100,0,106,106
Roget,M,100,0,5,5
Mirsa,F,100,35,0,35
Jaz,M,67,105,214,319
Selica,F,100,18,0,18
Brittnany,F,100,22,0,22
Dlyan,M,100,0,16,16
Leontyne,F,100,213,0,213
Lagatha,F,100,5,0,5
Kiyanna,F,100,659,0,659
Dustie,F,99,896,11,907
Kleb,M,100,0,5,5
Lawarence,M,100,0,40,40
Samiul,M,100,0,31,31
Mashiya,F,100,29,0,29
Sarinity,F,100,83,0,83
Richia,F,100,5,0,5
Awilda,F,100,1634,0,1634
Jara,F,100,765,0,765
Lachonda,F,100,44,0,44
Greylan,M,100,0,27,27
Channer,M,100,0,17,17
Taggart,M,100,0,528,528
Mindie,F,100,487,0,487
Kanwal,F,100,40,0,40
Kitai,M,100,0,78,78
Karisma,F,100,1682,0,1682
Raquell,F,100,195,0,195
Lonis,M,100,0,5,5
Cahlin,F,100,5,0,5
Kambria,F,100,1257,0,1257
Jaasia,F,100,102,0,102
Kineshia,F,100,10,0,10
Ritchard,M,100,0,76,76
Adelane,F,100,5,0,5
Betzayda,F,100,131,0,131
Mickinzie,F,100,5,0,5
Raequawn,M,100,0,6,6
Adnrew,M,100,0,39,39
Kevyon,M,100,0,14,14
Ahkeem,M,100,0,282,282
Salimatou,F,100,83,0,83
Quinnette,F,100,5,0,5
Leandrew,M,100,0,698,698
Lemario,M,100,0,60,60
Jamarie,M,86,87,526,613
Kazandra,F,100,290,0,290
Gerardine,F,100,107,0,107
Lanea,F,100,492,0,492
Nhi,F,100,945,0,945
Yen,F,93,540,42,582
Nickles,M,100,0,16,16
Jennaka,F,100,11,0,11
Kaylor,F,64,536,297,833
Carmeshia,F,100,33,0,33
Thasha,F,100,22,0,22
Laquinda,F,100,145,0,145
Kierica,F,100,5,0,5
Orene,F,100,32,0,32
Burk,M,100,0,151,151
Stepheon,M,100,0,5,5
Wilberta,F,100,23,0,23
Mekhiah,F,100,11,0,11
Braham,M,100,0,7,7
Zaiyan,M,100,0,5,5
Aspyn,F,100,1183,5,1188
Keiser,M,100,0,11,11
Jakiaya,F,100,6,0,6
Clementina,F,100,569,0,569
Priyam,M,100,0,15,15
Jaquaun,M,100,0,11,11
Jayna,F,100,4693,0,4693
Kendley,F,100,5,0,5
Blimy,F,100,449,0,449
Alysandra,F,100,207,0,207
Kylamarie,F,100,5,0,5
Dragen,M,100,0,5,5
Gwendia,F,100,5,0,5
Mitsuko,F,100,5,0,5
Ammara,F,100,74,0,74
Lanishia,F,100,15,0,15
Maddylynn,F,100,5,0,5
Ramatu,F,100,5,0,5
Jaleon,M,100,0,29,29
Uzoma,M,93,8,112,120
Katiuska,F,100,32,0,32
Letica,F,100,193,0,193
Venisha,F,100,261,0,261
Gregoria,F,100,650,0,650
Allec,M,100,0,13,13
Nikalette,F,100,6,0,6
Roald,M,100,0,19,19
Noaah,M,100,0,14,14
Jaryn,M,60,334,509,843
Aqueelah,F,100,321,0,321
Ryson,M,100,0,170,170
Lloana,F,100,5,0,5
Myleena,F,100,11,0,11
Angelica,F,100,86061,321,86382
Kaarin,F,100,89,0,89
Ledia,F,100,55,0,55
Quamel,M,100,0,118,118
Sharron,F,96,9016,328,9344
Zaeya,F,100,5,0,5
Norlishia,F,100,15,0,15
Camyrah,F,100,5,0,5
Traye,M,100,0,97,97
Abubacarr,M,100,0,15,15
Maidelyn,F,100,10,0,10
Dawnica,F,100,5,0,5
Eliscia,F,100,17,0,17
Miguelangel,M,100,0,3329,3329
Dayvin,M,100,0,111,111
Kailly,F,100,89,0,89
Arquimides,M,100,0,18,18
Litsy,F,100,92,0,92
Jadonna,F,100,10,0,10
Raveena,F,100,263,0,263
Calliemae,F,100,5,0,5
Eily,F,100,216,0,216
Fantazia,F,100,29,0,29
Ryoko,F,100,15,0,15
Chenee,F,100,59,0,59
Delonna,F,100,56,0,56
Lenley,M,100,0,5,5
Shelika,F,100,20,0,20
Avyona,F,100,7,0,7
Chamise,F,100,5,0,5
Rukaiyah,F,100,5,0,5
Yusif,M,100,0,236,236
Mekenzie,F,100,1029,0,1029
Gweneva,F,100,5,0,5
Brittoni,F,100,28,0,28
Tammyjo,F,100,38,0,38
Suszanne,F,100,36,0,36
Shawneeque,F,100,5,0,5
Lucricia,F,100,11,0,11
Navae,F,100,53,0,53
Ashantis,F,100,16,0,16
Alexah,F,100,445,0,445
Shrihaan,M,100,0,20,20
Sesalie,F,100,5,0,5
Ariam,F,95,196,11,207
Mariella,F,100,2695,0,2695
Layza,F,100,78,0,78
Glenis,F,97,149,5,154
Jairus,M,100,0,2122,2122
Bhuvi,F,100,8,0,8
Sunrise,F,100,7,0,7
Jamariah,F,100,249,0,249
Keaunte,M,100,0,18,18
Laurena,F,100,521,0,521
Munirah,F,100,121,0,121
Arnis,M,100,0,17,17
Thaddius,M,100,0,529,529
Anothony,M,100,0,344,344
Ashvi,F,100,5,0,5
Makalea,F,100,5,0,5
Lisseth,F,100,583,0,583
Marshai,F,100,49,0,49
Sinjon,M,100,0,5,5
Luka,M,94,270,4201,4471
Kacia,F,100,274,0,274
Winfried,M,100,0,5,5
Shadena,F,100,6,0,6
Yahzarah,F,100,5,0,5
Darryel,M,100,0,225,225
Savant,M,100,0,10,10
Tyrico,M,100,0,22,22
Meggen,F,100,133,0,133
Naydelyn,F,100,59,0,59
Tauheed,M,100,0,74,74
Sadiah,F,100,43,0,43
Binyomin,M,100,0,795,795
Rickia,F,100,463,0,463
Andres,M,99,433,73109,73542
Arraya,F,100,67,0,67
Annalyce,F,100,118,0,118
Keevin,M,100,0,586,586
Vanellope,F,100,140,0,140
Dut,M,100,0,5,5
Drexel,M,100,0,697,697
Takoda,M,92,100,1203,1303
Reshonda,F,100,299,0,299
Jhadiel,M,100,0,18,18
Miyuki,F,100,190,0,190
Geancarlo,M,100,0,21,21
Kyeesha,F,100,10,0,10
Maddelynn,F,100,135,0,135
Tamaia,F,100,35,0,35
Teadora,F,100,10,0,10
Jenay,F,99,940,5,945
Selmer,M,100,0,5,5
Stefaine,F,100,12,0,12
Kirsi,F,100,83,0,83
Shakeyta,F,100,10,0,10
Jhovanna,F,100,7,0,7
Kamya,F,100,2696,0,2696
Dontarrius,M,100,0,5,5
Jammes,M,100,0,31,31
Given,M,100,0,32,32
Pedrojose,M,100,0,6,6
Abner,M,100,0,4226,4226
Fanny,F,100,2471,0,2471
Denerio,M,100,0,7,7
Taquanna,F,100,63,0,63
Blain,M,99,17,1867,1884
Jalysia,F,100,29,0,29
Lyda,F,100,731,0,731
Shawna,F,100,45127,105,45232
Lilyane,F,100,12,0,12
Ondray,M,100,0,12,12
Sharella,F,100,10,0,10
Onelia,F,100,24,0,24
Annachristina,F,100,6,0,6
Yoni,M,97,20,632,652
Samien,M,100,0,6,6
Suniya,F,100,43,0,43
Aylen,F,92,477,39,516
Nihaal,M,100,0,51,51
Latenya,F,100,5,0,5
Rhoman,M,100,0,5,5
Nasim,M,75,119,363,482
Etty,F,100,416,0,416
Hopeton,M,100,0,16,16
Salahaldin,M,100,0,10,10
Correon,M,100,0,7,7
Wilfredo,M,100,0,9065,9065
Aritha,F,100,67,0,67
Raeyana,F,100,5,0,5
Jadziah,F,100,5,0,5
Julian,M,98,2425,155021,157446
Amai,F,100,35,0,35
Ingeborg,F,100,115,0,115
Tiffani,F,100,14795,0,14795
Eden,F,87,25999,4017,30016
Kimira,F,100,30,0,30
Delanne,F,100,5,0,5
Alitzel,F,100,262,0,262
Medina,F,100,1534,0,1534
Jemario,M,100,0,98,98
Dhanush,M,100,0,85,85
Alencia,F,100,101,0,101
Aayah,F,100,24,0,24
Suvan,M,100,0,100,100
Tameera,F,100,5,0,5
Geralda,F,100,24,0,24
Jasicianna,F,100,6,0,6
Lyden,M,100,0,37,37
Genisse,F,100,7,0,7
Maleah,F,100,6076,0,6076
Uranus,F,100,5,0,5
Shnequa,F,100,6,0,6
Jibriel,M,100,0,58,58
Graylee,F,100,25,0,25
Shakerah,F,100,29,0,29
Valette,F,100,11,0,11
Brenin,M,97,5,150,155
Noire,F,100,8,0,8
Reneisha,F,100,236,0,236
Deveshi,F,100,5,0,5
Salvadore,M,100,0,577,577
Sindhura,F,100,11,0,11
Gullermo,M,100,0,5,5
Nayelie,F,100,426,0,426
Sharmika,F,100,40,0,40
Rosmeri,F,100,45,0,45
Aymee,F,100,401,0,401
Elizama,F,100,6,0,6
Johnalexander,M,100,0,5,5
Luiza,F,100,578,0,578
Kaleana,F,100,6,0,6
Laylanee,F,100,7,0,7
Kavell,M,100,0,26,26
Marceleen,F,100,5,0,5
Aresenio,M,100,0,8,8
Tewanda,F,100,35,0,35
Teneeshia,F,100,29,0,29
Abdulelah,M,100,0,22,22
Daveda,F,100,71,0,71
Maricel,F,100,460,0,460
Adelah,F,100,5,0,5
Margalit,F,100,85,0,85
Shekita,F,100,300,0,300
Johnadam,M,100,0,5,5
Sherrina,F,100,63,0,63
Aydrie,F,100,5,0,5
Jennamarie,F,100,194,0,194
Ruot,M,100,0,5,5
Debaroh,F,100,18,0,18
Aaliyahrose,F,100,12,0,12
Vallarie,F,100,138,0,138
Abony,F,100,43,0,43
Karoleigh,F,100,5,0,5
Priyal,F,100,112,0,112
Nally,F,100,5,0,5
Stephanieann,F,100,95,0,95
Kiriaki,F,100,36,0,36
Leul,M,100,0,94,94
Kevaris,M,100,0,5,5
Kili,F,100,103,0,103
Chiemeka,M,100,0,15,15
Maurie,F,80,250,64,314
Lus,F,100,439,0,439
Evonda,F,100,193,0,193
Liba,F,100,538,0,538
Bidal,M,100,0,5,5
Genaro,M,100,0,5633,5633
Jayzen,M,100,0,156,156
Jalan,M,92,70,852,922
Salaheddine,M,100,0,5,5
Kimberline,F,100,6,0,6
Celvin,M,100,0,94,94
Saddam,M,100,0,30,30
Stetsen,M,100,0,32,32
Alvy,M,100,0,30,30
Tresca,F,100,5,0,5
Shenelle,F,100,430,0,430
Lakari,M,100,0,16,16
Dlinda,F,100,5,0,5
Traymon,M,100,0,25,25
Samirrah,F,100,6,0,6
Dantavious,M,100,0,160,160
Shawntai,F,100,16,0,16
Trenton,M,100,78,52560,52638
Raedene,F,100,28,0,28
Petre,M,100,0,5,5
Jina,F,100,1926,0,1926
Aracelis,F,100,1032,0,1032
Tyshana,F,100,67,0,67
Zackariah,M,100,0,1053,1053
Layn,M,100,0,69,69
Surayah,F,100,11,0,11
Lajoy,F,100,230,0,230
Dawan,M,96,35,779,814
Alee,F,88,338,48,386
Nikyra,F,100,43,0,43
Margi,F,100,235,0,235
Omaida,F,100,19,0,19
Anayha,F,100,16,0,16
Valancia,F,100,7,0,7
Delanda,F,100,78,0,78
Rebecc,F,100,6,0,6
Perianne,F,100,5,0,5
Jeanney,F,100,7,0,7
Sebastia,M,100,0,11,11
Lissianna,F,100,5,0,5
Keltan,M,100,0,5,5
Mariaya,F,100,5,0,5
Batuhan,M,100,0,41,41
Mareesha,F,100,10,0,10
Adelyne,F,100,367,0,367
Nyema,F,100,538,0,538
Khalifah,M,100,0,20,20
Gwenevere,F,100,699,0,699
Sherritta,F,100,18,0,18
Robyn,F,98,59547,1097,60644
Jylene,F,100,23,0,23
Maylie,F,100,314,0,314
Absalon,M,100,0,33,33
Lashane,F,91,106,10,116
Bre,F,100,450,0,450
Shantique,F,100,55,0,55
Jjuan,M,100,0,36,36
Sevyn,F,55,191,159,350
Debi,F,100,3776,0,3776
Denice,F,100,10017,0,10017
Satira,F,100,35,0,35
Bahar,F,100,334,0,334
Mellissia,F,100,57,0,57
Chimeka,F,100,15,0,15
Greenley,F,100,136,0,136
Chett,M,100,0,245,245
Dammon,M,100,0,79,79
Harjaap,M,100,0,5,5
Nna,F,100,8,0,8
Tyshara,F,100,26,0,26
Yezenia,F,100,497,0,497
Paayal,F,100,10,0,10
Hooriya,F,100,24,0,24
Ganae,F,100,5,0,5
Sanavi,F,100,13,0,13
Zaylen,M,98,20,880,900
Analee,F,100,1398,0,1398
Avrora,F,100,10,0,10
Jenkarlo,M,100,0,5,5
Coyote,M,100,0,23,23
Canisha,F,100,270,0,270
Kalleen,F,100,16,0,16
Taleesha,F,100,34,0,34
Yustin,M,100,0,11,11
Sra,F,100,27,0,27
Lytle,M,100,0,13,13
Johm,M,100,0,71,71
Tyania,F,100,18,0,18
Sonseeahray,F,100,12,0,12
Karlette,F,100,43,0,43
Tarquin,M,100,0,66,66
Daythan,M,100,0,11,11
Ayami,F,100,11,0,11
Chikara,F,100,12,0,12
Charmine,F,100,309,0,309
Fields,M,100,0,10,10
Demeterius,M,100,0,23,23
Dashay,F,92,288,24,312
Delphenia,F,100,6,0,6
Nickohlas,M,100,0,5,5
Dayani,F,100,395,0,395
Gandalf,M,100,0,5,5
Lanaysia,F,100,68,0,68
Sajidah,F,100,10,0,10
Rainey,F,87,1416,210,1626
Sherline,F,100,286,0,286
Gerd,M,100,0,16,16
Dangelo,M,100,0,6888,6888
Cristoval,M,100,0,405,405
Benna,F,100,103,0,103
Zaineb,F,100,211,0,211
Latatia,F,100,5,0,5
Tymir,M,100,0,775,775
Ikeer,M,100,0,12,12
Izzabela,F,100,7,0,7
Mohab,M,100,0,40,40
Loistine,F,100,41,0,41
Joleena,F,100,103,0,103
Draylin,M,100,0,7,7
Antoniodejesus,M,100,0,55,55
Raice,M,100,0,7,7
Giancarlos,M,100,0,638,638
Stasi,F,100,46,0,46
Benesha,F,100,6,0,6
Allen,M,99,939,162720,163659
Miryah,F,100,71,0,71
Kawther,F,100,26,0,26
Jeiner,M,100,0,5,5
Brantson,M,100,0,37,37
Shaleia,F,100,13,0,13
Alianny,F,100,44,0,44
Delmon,M,100,0,163,163
Sree,F,100,7,0,7
Jaqua,M,69,28,63,91
Hykeim,M,100,0,5,5
Tacey,F,100,300,0,300
Xitlalith,F,100,7,0,7
Kamaura,F,100,6,0,6
Omayma,F,100,6,0,6
Diavian,F,97,175,5,180
Rayannah,F,100,30,0,30
Bina,F,100,517,0,517
Aamilah,F,100,32,0,32
Versia,F,100,12,0,12
Demaree,M,84,11,56,67
Ashur,M,100,0,382,382
Lasharn,F,100,83,0,83
Damaiah,F,100,5,0,5
Izabelle,F,100,3227,0,3227
Demone,M,100,0,477,477
Marco,M,99,333,64963,65296
Jakelin,F,100,612,0,612
Stephanine,F,100,143,0,143
Ranecia,F,100,5,0,5
Jajuane,M,100,0,5,5
Karalea,F,100,6,0,6
Daymeon,M,100,0,130,130
Hideki,M,100,0,22,22
Sakshi,F,100,185,0,185
Shelcy,F,100,19,0,19
Yerimar,F,100,5,0,5
Clynt,M,100,0,5,5
Naiome,F,100,5,0,5
Znyah,F,100,12,0,12
Avelina,F,100,863,0,863
Erinn,F,96,3340,143,3483
Alauna,F,100,633,0,633
Myabella,F,100,12,0,12
Takeasha,F,100,5,0,5
Terrissa,F,100,5,0,5
Rueger,M,100,0,18,18
Kadon,M,100,0,571,571
Leda,F,100,1272,0,1272
Zanye,F,100,6,0,6
Shilow,F,100,15,0,15
Alyss,F,100,302,0,302
Lyrie,F,100,11,0,11
Torree,F,100,10,0,10
Kristain,F,78,237,66,303
Jaculin,F,100,94,0,94
Koriana,F,100,89,0,89
Fidensio,M,100,0,6,6
Shiya,F,86,160,27,187
Tecla,F,100,12,0,12
Ramari,M,100,0,72,72
Trista,F,100,12290,5,12295
Shadai,F,100,283,0,283
Latechia,F,100,26,0,26
Lamiah,F,100,248,0,248
Kathen,M,100,0,6,6
Blaike,M,63,93,158,251
Aviv,M,82,90,415,505
Dyrell,M,100,0,171,171
Armonie,F,74,472,163,635
Shaneese,F,100,90,0,90
Kathryne,F,100,3103,0,3103
Detarius,M,100,0,19,19
Akxel,M,100,0,25,25
Boby,M,100,0,71,71
Gracieann,F,100,77,0,77
Ryelyn,F,100,18,0,18
Wambui,F,100,6,0,6
Tirth,M,100,0,77,77
Delayza,F,100,46,0,46
Joab,M,100,0,592,592
Patsey,F,100,144,0,144
Daygan,M,100,0,12,12
Chasiti,F,100,380,0,380
Camiren,M,100,0,43,43
Arshia,F,72,293,112,405
Quillon,M,100,0,5,5
Mauria,F,100,64,0,64
Rhesa,F,100,133,0,133
Dianamarie,F,100,5,0,5
Medeline,F,100,17,0,17
Wendel,M,100,0,1119,1119
Jenni,F,100,5263,0,5263
Jasiya,F,96,174,8,182
Kiari,F,91,341,35,376
Brasia,F,100,6,0,6
Tayvia,F,100,112,0,112
Kinsly,F,100,37,0,37
Zahkeem,M,100,0,5,5
Russchell,F,100,5,0,5
Jaleb,M,100,0,19,19
Melvon,M,100,0,17,17
Cashana,F,100,5,0,5
Trennis,M,100,0,22,22
Elior,M,100,0,44,44
Rether,F,100,5,0,5
Sabel,F,100,71,0,71
Tydre,M,100,0,24,24
Qualin,M,100,0,58,58
Tiuana,F,100,5,0,5
Keyvion,M,100,0,24,24
Salim,M,100,0,1414,1414
Antonia,F,89,20384,2398,22782
Shulonda,F,100,25,0,25
Kyleen,F,100,950,0,950
Sametra,F,100,47,0,47
Denylah,F,100,16,0,16
Kiyoshi,M,96,10,269,279
Sorayda,F,100,12,0,12
Onekki,F,100,7,0,7
Edwyn,M,100,0,528,528
Audrinna,F,100,152,0,152
Desteney,F,100,46,0,46
Roshonna,F,100,5,0,5
Joren,M,100,0,283,283
Khaia,F,100,36,0,36
Retaj,F,100,97,0,97
Breindy,F,100,338,0,338
Dearra,F,100,68,0,68
Schannon,F,100,5,0,5
Mart,M,100,0,473,473
Krystianna,F,100,81,0,81
Deionte,M,100,0,274,274
Billye,F,98,599,11,610
Montrez,M,100,0,512,512
Bryttany,F,100,235,0,235
Yanitza,F,100,569,0,569
Deriyon,M,100,0,7,7
Charnae,F,100,418,0,418
Milka,F,100,406,0,406
Tifney,F,100,35,0,35
Tiler,M,83,59,286,345
Raida,F,100,6,0,6
Ninetta,F,100,40,0,40
Hindel,F,100,12,0,12
Harith,M,100,0,66,66
Aydian,M,100,0,94,94
Avrom,M,100,0,17,17
Simmon,M,100,0,19,19
Awanda,F,100,34,0,34
Yenta,F,100,11,0,11
Haseem,M,100,0,5,5
Shareta,F,100,71,0,71
Sara,F,100,332524,979,333503
Lynissa,F,100,5,0,5
Larome,M,100,0,39,39
Ahalya,F,100,6,0,6
Khayla,F,100,772,0,772
Shevaun,F,100,105,0,105
Danela,F,100,12,0,12
Erniest,M,100,0,5,5
Khush,M,100,0,108,108
Britnei,F,100,45,0,45
Jaiona,F,100,104,0,104
Rodneshia,F,100,75,0,75
Jaiven,M,100,0,337,337
Andrian,M,85,96,525,621
Eleazer,M,100,0,39,39
Lyneshia,F,100,10,0,10
Bannon,M,100,0,109,109
Kousuke,M,100,0,5,5
Bowman,M,100,0,356,356
Vencent,M,100,0,206,206
Senaida,F,100,759,0,759
Daekwon,M,100,0,220,220
Keynan,M,100,0,300,300
Traegan,M,100,0,25,25
Rainier,M,100,0,505,505
Hajin,M,100,0,5,5
Julette,F,100,5,0,5
Jarrick,M,100,0,220,220
Rawa,F,100,5,0,5
Dessence,F,100,16,0,16
Lynde,F,100,417,0,417
Islay,F,100,65,0,65
Trevonn,M,100,0,210,210
Audrieana,F,100,5,0,5
Christeen,F,100,902,0,902
Natya,F,100,45,0,45
Krystie,F,100,514,0,514
Nyakume,F,100,6,0,6
Jadarian,M,100,0,243,243
Kordarius,M,100,0,20,20
Jacquelina,F,100,358,0,358
Bervin,M,100,0,7,7
Henrene,F,100,5,0,5
Mahad,M,100,0,491,491
Janit,F,100,64,0,64
Dazzlyn,F,100,23,0,23
Koralyne,F,100,6,0,6
Sohan,M,100,0,672,672
Kamillia,F,100,30,0,30
Teiarra,F,100,5,0,5
Cainan,M,100,0,636,636
Decari,M,100,0,74,74
Iyania,F,100,124,0,124
Diamondique,F,100,10,0,10
Lindyn,F,100,75,0,75
Sylvina,F,100,10,0,10
Celesse,F,100,5,0,5
Tahnya,F,100,48,0,48
Jayliana,F,100,329,0,329
Kashus,M,100,0,88,88
Shalicia,F,100,104,0,104
Zacharias,M,100,0,1440,1440
Jeralene,F,100,16,0,16
Ravensymone,F,100,56,0,56
Zirui,M,100,0,5,5
Latona,F,100,345,0,345
Patterson,M,94,20,299,319
Meritta,F,100,11,0,11
Mccarthy,M,100,0,36,36
Jelisha,F,100,74,0,74
Chazity,F,100,55,0,55
Arvi,F,100,5,0,5
Shea,F,59,10204,7218,17422
Daniyal,M,100,0,488,488
Rionna,F,100,166,0,166
Anel,F,87,1737,249,1986
Mua,M,100,0,6,6
Sanyu,F,100,10,0,10
Brittanyann,F,100,118,0,118
Naturi,F,100,68,0,68
Mry,F,100,68,0,68
Blerina,F,100,5,0,5
Manijeh,F,100,5,0,5
Krishona,F,100,5,0,5
Chrisina,F,100,10,0,10
Deanglo,M,100,0,168,168
Irisa,F,100,138,0,138
Gregoy,M,100,0,15,15
Nishay,F,100,10,0,10
Hoang,M,93,51,730,781
Jennett,F,100,236,0,236
Renzo,M,100,0,1338,1338
Shenekia,F,100,60,0,60
Tommaso,M,100,0,429,429
Francisca,F,99,6864,37,6901
Jawann,M,100,0,167,167
Matrice,F,100,87,0,87
Sumeet,M,96,10,231,241
Marvinia,F,100,6,0,6
Mozart,M,100,0,10,10
Treazure,F,100,231,0,231
Katelyne,F,100,544,0,544
Vina,F,100,1165,0,1165
Terressa,F,100,385,0,385
Chanin,F,96,301,11,312
Jaeyla,F,100,18,0,18
Phinneaus,M,100,0,6,6
Tokyo,M,100,0,5,5
Johnluke,M,100,0,234,234
Jabarius,M,100,0,7,7
Caylyn,F,100,416,0,416
Hollylynn,F,100,5,0,5
Waite,M,100,0,5,5
Conita,F,100,44,0,44
Mishayla,F,100,283,0,283
Maeli,F,100,258,0,258
Marv,M,100,0,117,117
Afsaneh,F,100,17,0,17
Daryla,F,100,34,0,34
Shatory,F,100,5,0,5
Ivany,F,100,5,0,5
Avonte,M,100,0,398,398
Shadeen,F,100,5,0,5
Levonta,M,100,0,19,19
Commodore,M,100,0,18,18
Eveliz,F,100,11,0,11
Alagie,M,100,0,6,6
Tazlyn,F,100,6,0,6
Thalya,F,100,133,0,133
Tierany,F,100,156,0,156
Zyrielle,F,100,22,0,22
Shennon,F,100,10,0,10
Deett,F,100,6,0,6
Michaeljames,M,100,0,166,166
Delynda,F,100,78,0,78
Caityln,F,100,5,0,5
Araxi,F,100,10,0,10
Charmane,F,100,733,0,733
Zemar,M,100,0,10,10
Michaelina,F,100,70,0,70
Lajon,M,100,0,30,30
Demonei,M,100,0,5,5
Rhoderick,M,100,0,51,51
Aliaz,M,100,0,5,5
Lavaun,F,100,23,0,23
Suriel,M,100,0,51,51
Thirza,F,100,16,0,16
Johnnetta,F,100,392,0,392
Shynita,F,100,5,0,5
Kentravion,M,100,0,31,31
Jebb,M,100,0,34,34
Jarelly,F,100,85,0,85
Dashanna,F,100,80,0,80
Fortino,M,100,0,587,587
Makeeba,F,100,15,0,15
Tamari,F,66,454,234,688
Norissa,F,100,52,0,52
Fatuma,F,100,334,0,334
Sherrice,F,100,412,0,412
Ebere,F,100,6,0,6
Lashad,M,100,0,23,23
Yosgar,M,100,0,99,99
Rysen,M,100,0,7,7
Foluke,F,100,5,0,5
Jasa,F,100,218,0,218
Balian,M,100,0,207,207
Derrik,M,100,0,2063,2063
Nataniela,F,100,5,0,5
Ronnisha,F,100,364,0,364
Jaxsten,M,100,0,15,15
Wakita,F,100,23,0,23
Johaun,M,100,0,8,8
Hillaree,F,100,19,0,19
Milosh,M,100,0,5,5
Andrus,M,100,0,81,81
Bethzy,F,100,360,0,360
Jazell,F,100,306,0,306
Cameren,M,85,211,1205,1416
Alroy,M,100,0,60,60
Zamier,M,100,0,87,87
Lynard,M,100,0,96,96
Jyler,M,100,0,12,12
Azalyn,F,100,59,0,59
Colisa,F,100,5,0,5
Petros,M,100,0,575,575
Renada,F,100,710,0,710
Nilaya,F,100,61,0,61
Kwamae,M,100,0,5,5
Cynitha,F,100,391,0,391
Hugo,M,100,30,24120,24150
Caresa,F,100,42,0,42
Seabron,M,100,0,18,18
Trevell,M,100,0,598,598
Maor,M,100,0,101,101
Ayobami,M,100,0,10,10
Jomary,F,100,44,0,44
Leelu,F,100,43,0,43
Ruby,F,99,91129,709,91838
Phillicia,F,100,34,0,34
Soyna,F,100,57,0,57
Olawale,M,100,0,92,92
Lakelee,F,100,11,0,11
Remini,F,100,12,0,12
Jahaida,F,100,28,0,28
Jarrison,M,100,0,5,5
Raysean,M,100,0,473,473
Kailin,F,89,1050,130,1180
Terelle,M,99,5,352,357
Keneth,M,100,0,912,912
Novalea,F,100,12,0,12
Efraim,M,100,0,1249,1249
Blayke,M,61,375,584,959
Nikishia,F,100,21,0,21
Makhel,M,100,0,10,10
Nizar,M,100,0,244,244
Joban,M,100,0,6,6
Catriana,F,100,6,0,6
Yazil,F,100,5,0,5
Zahaira,F,100,47,0,47
Auroara,F,100,6,0,6
Yolet,F,100,38,0,38
Marijose,F,100,131,0,131
Dymir,M,100,0,96,96
Carmello,M,100,0,1250,1250
Gerrod,M,100,0,712,712
Cristy,F,99,7946,56,8002
Cyria,F,100,26,0,26
Alphonsa,M,100,0,147,147
Kendyn,M,100,0,130,130
Olbin,M,100,0,5,5
Fadi,M,100,0,691,691
Katreena,F,100,289,0,289
Marquasia,F,100,121,0,121
Alzenia,F,100,6,0,6
Aneria,F,100,5,0,5
Sharalynn,F,100,5,0,5
Diella,F,100,68,0,68
Judithe,F,100,25,0,25
Lilla,F,100,895,0,895
Lashun,F,69,677,307,984
Ellayna,F,100,139,0,139
Tamesia,F,100,55,0,55
Harilaos,M,100,0,5,5
Nubian,F,100,17,0,17
Aanya,F,100,1936,0,1936
Elkin,M,100,0,182,182
Pauli,F,100,21,0,21
Montoria,F,100,10,0,10
Rejena,F,100,6,0,6
Moria,F,100,528,0,528
Jamirr,M,100,0,14,14
Sharilyn,F,100,1313,0,1313
Kenzley,F,100,521,0,521
Prithvi,M,100,0,247,247
Kinyata,F,100,22,0,22
Abdellah,M,100,0,17,17
Francys,F,100,8,0,8
Merrik,M,97,5,191,196
Muhannad,M,100,0,47,47
Ryer,M,100,0,100,100
Guiseppe,M,100,0,399,399
Demir,M,100,0,392,392
Eithen,M,100,0,137,137
Ramonita,F,100,512,0,512
Malisia,F,100,17,0,17
Jozlyne,F,100,5,0,5
Jarica,F,100,148,0,148
Tynise,F,100,33,0,33
Zayana,F,100,117,0,117
Cerina,F,100,505,0,505
Alvis,M,97,61,1746,1807
Maxiel,F,100,18,0,18
Salea,F,100,6,0,6
June,F,98,44136,821,44957
Lomax,M,100,0,5,5
Gesel,F,100,5,0,5
Sebastian,M,100,262,110624,110886
Damarko,M,100,0,106,106
Gib,M,100,0,45,45
Kahden,M,100,0,12,12
Damonta,M,100,0,297,297
Jhalil,M,100,0,294,294
Yesika,F,100,98,0,98
Moniece,F,100,23,0,23
Latangie,F,100,5,0,5
Velarie,F,100,5,0,5
Darnesha,F,100,527,0,527
Maclynn,F,100,6,0,6
Malka,F,100,4111,5,4116
Talya,F,100,2272,0,2272
Gatlynn,M,62,5,8,13
Pauleen,F,100,60,0,60
Laporscha,F,100,107,0,107
Trinidi,F,100,63,0,63
Dhahran,M,100,0,9,9
Tykayla,F,100,5,0,5
Tonio,M,100,0,326,326
Latasia,F,100,605,0,605
Saquita,F,100,35,0,35
Hasina,F,100,188,0,188
Alisa,F,100,32432,22,32454
Alfy,M,100,0,15,15
Brona,F,100,11,0,11
Altoria,F,100,5,0,5
Rozina,F,100,163,0,163
Legendary,M,100,0,5,5
Kerolos,M,100,0,45,45
Shavonia,F,100,25,0,25
Taviah,F,100,14,0,14
Jenora,F,100,5,0,5
Mamoon,M,100,0,18,18
Aimi,F,100,115,0,115
Wilmont,M,100,0,13,13
Barbi,F,100,585,0,585
Uland,M,100,0,6,6
Elnor,F,100,22,0,22
Yamile,F,100,1266,0,1266
Kamori,F,66,237,120,357
Pasqualina,F,100,102,0,102
Neveyah,F,100,72,0,72
Sheleena,F,100,5,0,5
Kiondra,F,100,136,0,136
Germya,F,100,5,0,5
Rosemaria,F,100,143,0,143
Ninia,F,100,5,0,5
Cornesha,F,100,211,0,211
Wialliam,M,100,0,5,5
Maleek,M,100,0,1552,1552
Thressia,F,100,5,0,5
Irvine,M,100,0,213,213
Seela,F,100,11,0,11
Phallon,F,100,112,0,112
Tahmid,M,100,0,221,221
Zakee,M,100,0,535,535
Gared,M,100,0,222,222
Annalayah,F,100,14,0,14
Cyndia,F,100,288,0,288
Zimbabwe,M,100,0,5,5
Karlan,M,100,0,39,39
Roshundra,F,100,34,0,34
Safiyyah,F,100,493,0,493
Moxie,F,100,217,0,217
Tirzo,M,100,0,12,12
Brynia,F,100,10,0,10
Malina,F,100,3240,0,3240
Anuoluwa,F,100,10,0,10
Shamaine,F,98,197,5,202
Jeromiah,M,100,0,51,51
Dilenny,F,100,6,0,6
Jahvier,M,100,0,79,79
Neomi,F,100,1058,0,1058
Sivana,F,100,21,0,21
Aureana,F,100,10,0,10
Bernardina,F,100,61,0,61
Orlondo,M,100,0,76,76
Theodore,M,100,374,106956,107330
Natajah,F,100,89,0,89
Khia,F,100,732,0,732
Amekia,F,100,6,0,6
Laiken,F,86,1114,177,1291
Daniylah,F,100,22,0,22
Tanjanique,F,100,7,0,7
Jaqwan,M,100,0,258,258
Kiersyn,F,100,24,0,24
Irmak,F,100,6,0,6
Rocsi,F,100,77,0,77
Hansel,M,100,0,1465,1465
Ziley,F,100,6,0,6
Darik,M,100,0,504,504
Katja,F,100,817,0,817
Mishaal,F,100,60,0,60
Laurine,F,100,698,0,698
Akeera,F,100,20,0,20
Caterine,F,100,68,0,68
Emera,F,100,66,0,66
Adreinne,F,100,15,0,15
Tata,F,100,138,0,138
Jameyah,F,100,51,0,51
Emmelyne,F,100,11,0,11
Leonora,F,100,2250,0,2250
Cervantes,M,100,0,12,12
Kashmere,F,71,301,121,422
Geno,M,100,0,2335,2335
Aydyn,M,96,11,279,290
Alysea,F,100,55,0,55
Haunani,F,100,74,0,74
Noora,F,100,430,0,430
Ronice,F,100,41,0,41
Wynesha,F,100,21,0,21
Osanna,F,100,5,0,5
Janoah,M,100,0,148,148
Janihya,F,100,6,0,6
Amarelis,F,100,49,0,49
Alayne,F,100,779,0,779
Rikako,F,100,10,0,10
Brinlie,F,100,11,0,11
Wily,M,100,0,6,6
Kellina,F,100,107,0,107
Gifford,M,100,0,544,544
Dair,M,100,0,40,40
Sabas,M,100,0,473,473
Talesha,F,100,622,0,622
Semisi,M,100,0,155,155
Ashon,M,100,0,281,281
Jonnathan,M,100,0,1133,1133
Alleson,F,100,27,0,27
Jkhari,M,100,0,13,13
Nieco,M,100,0,6,6
Juvencio,M,100,0,180,180
Lylianna,F,100,84,0,84
Derrin,M,100,0,646,646
Fathma,F,100,5,0,5
Damen,M,100,0,2191,2191
Mundi,F,100,7,0,7
Judi,F,100,6061,0,6061
Grisell,F,100,169,0,169
Krisalyn,F,100,176,0,176
Jaylianie,F,100,30,0,30
Brodyn,M,100,0,264,264
Idalyz,F,100,16,0,16
Niyonna,F,100,89,0,89
Zenas,M,98,5,280,285
Zurie,F,100,174,0,174
Markryan,M,100,0,5,5
Paryss,F,100,12,0,12
Angeleia,F,100,7,0,7
Karyssa,F,100,887,0,887
Gretchen,F,100,40526,38,40564
Tesia,F,100,1059,0,1059
Laangela,F,100,5,0,5
Angeletta,F,100,88,0,88
Lorrena,F,100,90,0,90
Naa,F,100,38,0,38
Kimby,F,100,6,0,6
Ramoan,M,100,0,5,5
Cadeidra,F,100,12,0,12
Ellon,F,100,5,0,5
Izzabelle,F,100,277,0,277
Tamico,F,100,85,0,85
Hall,M,100,0,169,169
Shahla,F,100,99,0,99
Kaustav,M,100,0,6,6
Akshath,M,100,0,111,111
Caria,F,100,215,0,215
Benessa,F,100,5,0,5
Lecory,M,100,0,5,5
Tanoa,F,100,11,0,11
Bobbyjo,F,100,160,0,160
Abdulhalim,M,100,0,5,5
Mirlinda,F,100,5,0,5
Shamiracle,F,100,99,0,99
Myshia,F,100,38,0,38
Samsara,F,100,25,0,25
Jahmelia,F,100,5,0,5
Mitra,F,99,492,5,497
Antwaune,M,100,0,6,6
Niyeli,F,100,5,0,5
Ledonna,F,100,68,0,68
Ackley,M,100,0,8,8
Franc,M,100,0,16,16
Katrena,F,100,1403,0,1403
Denine,F,100,955,0,955
Ivoryrose,F,100,7,0,7
Shawnnessy,F,100,11,0,11
Jamelvin,M,100,0,5,5
Jaysean,M,100,0,523,523
Roxi,F,100,350,0,350
Wandy,F,100,100,0,100
Ohlin,M,100,0,5,5
Zelena,F,100,88,0,88
Cadarius,M,100,0,367,367
Miguelito,M,100,0,28,28
Nadin,F,100,36,0,36
Cordy,M,80,8,32,40
Mackinzee,F,100,69,0,69
Omir,M,100,0,57,57
Castulo,M,100,0,29,29
Valice,M,100,0,5,5
Marienne,F,100,10,0,10
Carrera,F,100,183,0,183
Niaylah,F,100,11,0,11
Janan,F,98,554,10,564
Kaleece,F,100,5,0,5
Cederick,M,100,0,303,303
Dijonay,F,100,35,0,35
Yaschica,F,100,6,0,6
Tramane,M,100,0,67,67
Deairah,F,100,24,0,24
Juaria,F,100,5,0,5
Allisandra,F,100,48,0,48
Lalia,F,100,195,0,195
Yitel,F,100,5,0,5
Shariece,F,100,70,0,70
Brinn,F,97,461,15,476
Taqwa,F,100,56,0,56
Jinessa,F,100,5,0,5
Andriea,F,100,95,0,95
Rollins,M,97,5,158,163
Enrick,M,100,0,5,5
Yna,F,100,11,0,11
Grayce,F,100,1450,0,1450
Kavin,M,100,0,2413,2413
Damari,M,82,591,2633,3224
Rich,M,100,0,3458,3458
Yuvraaj,M,100,0,13,13
Maritta,F,100,63,0,63
Kadence,F,92,8661,709,9370
Corinne,F,100,29908,15,29923
Analissa,F,100,314,0,314
Vernel,M,81,16,67,83
Kunga,M,75,13,39,52
Nowa,M,100,0,5,5
Marko,M,100,0,3340,3340
Caesare,M,81,10,42,52
Japeth,M,100,0,37,37
Betzhy,F,100,8,0,8
Ervin,M,100,37,13780,13817
Sherone,F,80,40,10,50
Aimon,M,100,0,41,41
Nakesha,F,100,1050,0,1050
Seyon,M,100,0,17,17
Kyier,M,100,0,14,14
Laverne,F,84,10356,2031,12387
Jakevion,M,100,0,90,90
Kimaka,F,100,14,0,14
Bengt,M,100,0,6,6
Shaunti,F,100,50,0,50
Nezzie,F,100,5,0,5
Shakala,F,100,207,0,207
Jeanique,F,100,11,0,11
Youri,M,100,0,10,10
Durango,M,100,0,5,5
Karisia,F,100,9,0,9
Jasmia,F,100,89,0,89
Rahanna,F,100,10,0,10
Ronte,M,100,0,109,109
Quinna,F,100,15,0,15
Haadiya,F,100,49,0,49
Ravina,F,100,69,0,69
Kaeli,F,100,2027,0,2027
Haneen,F,100,866,0,866
Beryl,F,86,1938,326,2264
Halbert,M,100,0,467,467
Makylee,F,100,102,0,102
Calimarie,F,100,11,0,11
Mikael,M,93,286,3792,4078
Nazira,F,100,56,0,56
Kem,M,64,353,635,988
Judilynn,F,100,5,0,5
Venise,F,100,450,0,450
Tekulve,M,100,0,5,5
Landria,F,100,28,0,28
Dioseline,F,100,5,0,5
Shinda,F,100,5,0,5
Vieri,M,100,0,6,6
Zon,M,100,0,15,15
Kilana,F,100,5,0,5
Eric,M,99,4261,844024,848285
Damiun,M,100,0,5,5
Joesph,M,100,12,11084,11096
Lareisha,F,100,40,0,40
Kristilynn,F,100,10,0,10
Faithe,F,100,572,0,572
Keoni,M,90,234,2229,2463
Venesia,F,100,38,0,38
Sacaria,F,100,7,0,7
Javonte,M,99,39,3402,3441
Patricik,M,100,0,17,17
Aubin,M,73,11,30,41
Hance,M,100,0,49,49
Drevian,M,100,0,5,5
Keyerah,F,100,5,0,5
Rafferty,M,100,0,142,142
Thora,F,100,372,0,372
Arzjon,M,100,0,13,13
Paislee,F,100,2550,0,2550
Clella,F,100,30,0,30
Alontay,M,100,0,11,11
Ineta,F,100,11,0,11
Ronnie,M,96,4821,128679,133500
Luismario,M,100,0,63,63
Allyanah,F,100,11,0,11
Phillina,F,100,46,0,46
Jorda,M,100,0,27,27
Kamarri,M,68,73,154,227
Xachary,M,100,0,99,99
Radames,M,100,0,799,799
Naileen,F,100,6,0,6
Jasmane,F,100,81,0,81
Lyanah,F,100,11,0,11
Rylea,F,100,884,0,884
Jeromie,M,100,0,585,585
Idy,F,100,198,0,198
Shawndel,M,53,46,51,97
Harmoney,F,100,403,0,403
Erianny,F,100,24,0,24
Jenavicia,F,100,9,0,9
Scan,M,100,0,16,16
Clarra,F,100,13,0,13
Twynette,F,100,6,0,6
Niccola,F,100,10,0,10
Jakeshia,F,100,12,0,12
Marialana,F,100,5,0,5
Justinthomas,M,100,0,9,9
Lalit,M,100,0,5,5
Reyes,M,95,205,4110,4315
Mckylee,F,100,19,0,19
Tawsif,M,100,0,10,10
Javani,M,100,0,86,86
Safah,F,100,15,0,15
Novena,F,100,16,0,16
Camishia,F,100,5,0,5
Jamirrah,F,100,23,0,23
Lisajean,F,100,5,0,5
Virginio,M,100,0,28,28
Meredyth,F,100,474,0,474
Chueyee,M,100,0,27,27
Nkrumah,M,100,0,27,27
Quamire,M,100,0,5,5
Andranette,F,100,10,0,10
Daksha,F,100,51,0,51
Usayd,M,100,0,6,6
Yeliz,F,100,5,0,5
Latericka,F,100,6,0,6
Ilcia,F,100,5,0,5
Maevis,F,100,9,0,9
Kynzie,F,100,531,0,531
Margit,F,100,372,0,372
Lamesa,F,100,15,0,15
Jamyle,M,100,0,5,5
Norian,M,100,0,5,5
Dalilah,F,100,2808,0,2808
Gabryell,F,100,5,0,5
Collis,M,100,0,574,574
Mahkiya,F,100,5,0,5
Corbyn,M,87,272,1850,2122
Partha,M,100,0,16,16
Christie,F,99,43508,396,43904
Thristan,M,100,0,30,30
Naydeli,F,100,31,0,31
Crysti,F,100,51,0,51
Raniyha,F,100,7,0,7
Chiriga,F,100,5,0,5
Lolly,F,100,179,0,179
Joilyn,F,100,5,0,5
Susa,F,100,176,0,176
Dedi,F,100,11,0,11
Atherine,F,100,37,0,37
Raissa,F,100,474,0,474
Thais,F,100,1311,0,1311
Bradey,M,99,9,694,703
Khai,M,84,197,1059,1256
Maisah,F,100,17,0,17
Aryk,M,100,0,29,29
Zaier,M,100,0,13,13
Jaquaveon,M,100,0,65,65
Trishana,F,100,53,0,53
Rithu,F,100,5,0,5
Dayanie,F,100,5,0,5
Josuhe,M,100,0,5,5
Hasya,F,100,10,0,10
Rorke,M,100,0,14,14
Charlane,F,100,120,0,120
Mezziah,M,100,0,5,5
Kristene,F,100,969,0,969
Kamrey,F,100,52,0,52
Lavie,F,100,6,0,6
Jakkar,M,100,0,12,12
Jamilett,F,100,118,0,118
Sylvonia,F,100,5,0,5
Farin,F,85,97,17,114
Domoni,M,100,0,5,5
Esli,F,77,339,104,443
Jetta,F,100,1221,0,1221
Batula,F,100,5,0,5
Ethangabriel,M,100,0,13,13
Aniketh,M,100,0,179,179
Rithwik,M,100,0,104,104
Hernesto,M,100,0,29,29
Meko,M,57,97,128,225
Cloyce,M,100,0,147,147
Shelvin,M,100,0,59,59
Manly,M,100,0,70,70
Kiamora,F,100,7,0,7
Lasara,F,100,5,0,5
Adeeb,M,100,0,203,203
Jaythen,M,100,0,115,115
Jerade,M,100,0,11,11
Talaysha,F,100,67,0,67
Jennalee,F,100,633,0,633
Corneil,M,100,0,15,15
Sheri,F,100,58210,114,58324
Tyreick,M,100,0,8,8
Skyleen,F,100,70,0,70
Mellyssa,F,100,6,0,6
Sebaztian,M,100,0,7,7
Yixin,F,100,12,0,12
Urszula,F,100,5,0,5
Zhane,F,88,1817,248,2065
Evelyne,F,100,1045,0,1045
Osteen,M,100,0,5,5
Tmothy,M,100,0,25,25
Zsa,F,100,17,0,17
Pier,F,79,364,99,463
Chakelia,F,100,5,0,5
Vionda,F,100,6,0,6
Rocke,M,100,0,40,40
Aniaya,F,100,306,0,306
Josedejesus,M,100,0,627,627
Shanna,F,100,27842,88,27930
Aija,F,100,352,0,352
Lionela,F,100,17,0,17
Noslen,M,100,0,5,5
Elford,M,100,0,5,5
Niclole,F,100,19,0,19
Rosie,F,100,21756,60,21816
Azyra,F,100,18,0,18
Keyten,M,100,0,11,11
Damarco,M,100,0,667,667
Asmi,F,100,66,0,66
Jaidyn,F,67,5142,2551,7693
Minor,M,100,0,404,404
Kensy,F,100,87,0,87
Onyinye,F,100,26,0,26
Xiara,F,100,228,0,228
Kalep,M,100,0,67,67
Conchetta,F,100,298,0,298
Clarenc,M,100,0,15,15
Brison,M,100,0,868,868
Roody,M,100,0,22,22
Latima,F,100,58,0,58
Ameer,M,100,0,3696,3696
Adarrius,M,100,0,97,97
Amsi,F,100,59,0,59
Tyli,F,100,26,0,26
Brigit,F,100,1202,0,1202
Kayhla,F,100,31,0,31
Jamal,M,99,266,30377,30643
Stellar,F,66,23,12,35
Mich,M,100,0,22,22
Traniece,F,100,95,0,95
Quintashia,F,100,5,0,5
Joliet,F,100,52,0,52
Amayla,F,100,18,0,18
Nakyah,F,100,267,0,267
Majeeda,F,100,5,0,5
Analiha,F,100,5,0,5
Leondrae,M,100,0,16,16
Severus,M,100,0,16,16
Kerney,M,100,0,59,59
Jaekwon,M,100,0,154,154
Daezha,F,100,16,0,16
Kida,F,100,42,0,42
Tyreef,M,100,0,5,5
Matthias,M,100,0,5691,5691
Henriette,F,100,147,0,147
Janiia,F,100,5,0,5
Tekiya,F,100,5,0,5
Jesstine,F,100,5,0,5
Ting,F,83,73,15,88
Trinise,F,100,17,0,17
Mikyra,F,100,43,0,43
Dondria,F,100,35,0,35
Charnece,F,100,5,0,5
Faaz,M,100,0,6,6
Ilya,M,88,77,582,659
Aayu,M,100,0,6,6
Jeraldene,F,100,5,0,5
Krishanna,F,100,10,0,10
Saronda,F,100,11,0,11
Treton,M,100,0,50,50
Laekyn,F,100,69,0,69
Jaxlyn,F,100,5,0,5
Ahnjayla,F,100,7,0,7
Analiah,F,100,403,0,403
Donyai,M,100,0,5,5
Oluwatobi,M,75,138,412,550
Dahlin,M,100,0,5,5
Lenika,F,100,23,0,23
Sianne,F,100,95,0,95
Aram,M,99,27,2016,2043
Kyele,M,100,0,13,13
Ahlayla,F,100,16,0,16
Stein,M,100,0,100,100
Zaidan,M,100,0,207,207
Layci,F,100,95,0,95
Leara,F,100,121,0,121
Shundreka,F,100,17,0,17
Isavella,F,100,6,0,6
Dempsey,M,89,199,1634,1833
Searia,F,100,5,0,5
Quantavis,M,100,0,101,101
Marah,F,100,2057,0,2057
Christohper,M,100,0,424,424
Mailing,F,100,5,0,5
Jocabeth,F,100,5,0,5
Koa,M,89,124,1051,1175
Prisilla,F,100,633,0,633
Renauta,F,100,6,0,6
Lenorris,M,100,0,60,60
Jazmine,F,100,33772,99,33871
Donnelly,M,100,0,15,15
Aeryanna,F,100,18,0,18
Clydia,F,100,111,0,111
Joela,F,100,12,0,12
Raymound,M,100,0,108,108
Aumi,M,100,0,5,5
Muireann,F,100,5,0,5
Ellora,F,100,390,0,390
Jadakis,M,100,0,31,31
Contessia,F,100,28,0,28
Becca,F,100,2745,0,2745
Bettye,F,100,3572,0,3572
Tamakia,F,100,92,0,92
Jaequan,M,100,0,232,232
Mabrey,F,100,101,0,101
Mayleen,F,100,580,0,580
Zierre,M,100,0,53,53
Phawn,F,100,5,0,5
Jacai,M,100,0,61,61
Dremon,M,100,0,5,5
Brittina,F,100,40,0,40
Neferteria,F,100,6,0,6
Avont,M,100,0,19,19
Carollyn,F,100,90,0,90
Carlissia,F,100,5,0,5
Kubrick,M,100,0,5,5
Erryn,F,100,99,0,99
Adeva,F,100,5,0,5
Torry,M,86,236,1411,1647
Polli,F,100,13,0,13
Candiace,F,100,94,0,94
Perrier,M,100,0,5,5
Zoia,F,100,6,0,6
Khristine,F,100,604,0,604
Genysis,F,100,22,0,22
Enchantee,F,100,9,0,9
Luella,F,100,2853,0,2853
Jeny,F,100,351,0,351
Theria,F,100,11,0,11
Limmie,M,100,0,71,71
Brandace,F,100,160,0,160
Maryna,F,100,128,0,128
Ahonesty,F,100,43,0,43
Devanhi,F,100,5,0,5
Mikita,F,100,124,0,124
Echelle,F,100,20,0,20
Twaniqua,F,100,5,0,5
Dicy,F,100,11,0,11
Arisleidy,F,100,5,0,5
Kert,M,100,0,219,219
Cecila,F,100,576,0,576
Ara,F,59,1224,864,2088
Rifka,F,100,599,0,599
Akaila,F,100,71,0,71
Tameesha,F,100,23,0,23
Atalee,F,100,26,0,26
Finnley,M,62,650,1073,1723
Avnoor,F,100,7,0,7
Farzana,F,100,198,0,198
Baleigh,F,100,1553,0,1553
Jonanthan,M,100,0,76,76
Tyran,M,97,56,2031,2087
Mairen,F,100,57,0,57
Saveya,F,100,5,0,5
Caydee,F,100,172,0,172
Lexcee,F,100,5,0,5
Juellz,M,100,0,15,15
Xzavien,M,100,0,145,145
Lluvy,F,100,5,0,5
Kimmy,F,78,1004,276,1280
Anquenette,F,100,22,0,22
Donasia,F,100,189,0,189
Moranda,F,100,270,0,270
Jaco,M,100,0,30,30
Rayshun,M,100,0,330,330
Demika,F,100,239,0,239
Emmery,F,98,499,12,511
Latajah,F,100,84,0,84
Kirsty,F,100,945,0,945
Teagon,M,90,12,110,122
Sahaana,F,100,58,0,58
Kamisha,F,100,1128,0,1128
Benny,M,99,214,24402,24616
Pasquinel,M,100,0,5,5
Neilani,F,100,77,0,77
Rosellie,F,100,8,0,8
Yandi,F,72,13,5,18
Jamesrobert,M,100,0,76,76
Latoya,F,100,45412,185,45597
Milene,F,100,54,0,54
Nadyia,F,100,26,0,26
Jeimmy,F,100,20,0,20
Ramiro,M,100,28,20763,20791
Makayli,F,100,113,0,113
Pratyush,M,100,0,118,118
Jolane,F,100,117,0,117
Ppatricia,F,100,10,0,10
Tavonda,F,100,5,0,5
Tobitha,F,100,10,0,10
Terrionna,F,100,228,0,228
Berkli,F,100,19,0,19
Yuleni,F,100,62,0,62
Rashara,F,100,6,0,6
Jonathanjames,M,100,0,11,11
Serayah,F,100,19,0,19
Roshawnda,F,100,272,0,272
Bowan,M,100,0,35,35
Geleah,F,100,20,0,20
Yakini,F,100,15,0,15
Riketa,F,100,5,0,5
Georgianna,F,100,3240,0,3240
Kingston,M,99,86,14525,14611
Trisco,M,100,0,6,6
Conswala,F,100,13,0,13
Yaritza,F,100,6347,5,6352
Liyla,F,100,56,0,56
Markham,M,100,0,416,416
Arianny,F,100,925,0,925
Wanjiru,F,100,8,0,8
Zujeily,F,100,5,0,5
Sulyn,F,100,11,0,11
Zashawn,M,100,0,39,39
Treyon,M,100,0,375,375
Jahsiah,M,100,0,451,451
Cambrielle,F,100,17,0,17
Jaquette,F,100,33,0,33
Aika,F,100,163,0,163
Lender,F,100,27,0,27
Deonta,M,99,36,2413,2449
Arowyn,F,100,12,0,12
Ike,M,100,0,2904,2904
Aaliyan,F,100,97,0,97
Temara,F,100,61,0,61
Trabian,M,100,0,6,6
Talethia,F,100,18,0,18
Ahniah,F,100,12,0,12
Delmi,F,100,214,0,214
Jeckson,M,100,0,6,6
Ziane,F,100,13,0,13
Mee,F,100,344,0,344
Ellenie,F,100,37,0,37
Calven,M,100,0,62,62
Jcorey,M,100,0,5,5
Yamille,F,100,43,0,43
Hargis,M,100,0,17,17
Treson,M,100,0,74,74
Jeffon,M,100,0,11,11
Yesena,F,100,66,0,66
Wilkins,M,100,0,203,203
Aeryk,M,100,0,53,53
Silverio,M,100,0,1225,1225
Zailan,M,100,0,7,7
Teneil,F,100,73,0,73
Bradly,M,100,11,9047,9058
Cardier,M,100,0,12,12
Adelheid,F,100,55,0,55
Kareena,F,100,1246,0,1246
Aneeq,M,100,0,20,20
Vernesa,F,100,10,0,10
Avarae,F,100,61,0,61
Deria,F,100,25,0,25
Savien,M,100,0,133,133
Catelin,F,100,364,0,364
Kdyn,M,100,0,58,58
Avantay,M,100,0,17,17
Jocelynn,F,100,5161,0,5161
Shrihan,M,100,0,170,170
Leilana,F,100,278,0,278
Ashlea,F,100,3151,0,3151
Skye,F,88,16266,2233,18499
Kippy,M,61,102,161,263
Kirynn,F,100,5,0,5
Atleigh,F,100,125,0,125
Haygen,M,93,12,161,173
Kamie,F,100,1169,0,1169
Cie,F,100,11,0,11
Mileke,M,100,0,5,5
Niamarie,F,100,5,0,5
Venessa,F,100,5649,0,5649
Devantre,M,100,0,10,10
Lakai,M,88,30,222,252
Zaviyar,M,100,0,21,21
Jenohn,F,100,14,0,14
Naika,F,100,87,0,87
Adelaida,F,100,1795,0,1795
Audette,F,100,7,0,7
Sladen,M,100,0,123,123
Ebben,M,100,0,5,5
Rediet,F,100,35,0,35
Samerah,F,100,20,0,20
Jaecion,M,100,0,41,41
Damiracle,F,100,10,0,10
Kaycey,F,100,11,0,11
Seleana,F,100,45,0,45
Jabulani,M,100,0,24,24
Lenoir,F,100,6,0,6
Nonia,F,100,5,0,5
Jovonni,M,100,0,127,127
Jeann,F,100,22,0,22
Channelle,F,100,264,0,264
Ahley,F,100,53,0,53
Maneka,F,100,44,0,44
Callyn,F,98,325,5,330
Essica,F,100,189,0,189
Latice,F,100,209,0,209
Stevion,M,100,0,5,5
Aleria,F,100,160,0,160
Dioselyn,F,100,23,0,23
Bryell,F,100,5,0,5
Joelis,F,100,10,0,10
Emyly,F,100,40,0,40
Reda,F,78,792,218,1010
Mansa,M,100,0,47,47
Akerah,F,100,29,0,29
Marioni,M,100,0,10,10
Callista,F,100,1905,0,1905
Payslie,F,100,64,0,64
Blakelynn,F,100,125,0,125
Kobee,M,90,22,204,226
Trieste,F,100,31,0,31
Rhiannen,F,100,11,0,11
Darlicia,F,100,6,0,6
Calisha,F,100,240,0,240
Livana,F,100,5,0,5
Ojetta,F,100,6,0,6
Tashi,F,87,393,61,454
Nylie,F,100,23,0,23
Hyland,M,86,10,64,74
Merline,F,100,278,0,278
Jron,M,100,0,19,19
Simon,M,100,126,41528,41654
Leylanie,F,100,198,0,198
Danaiya,F,100,61,0,61
Isander,M,100,0,8,8
Allessandra,F,100,230,0,230
Alaysa,F,100,48,0,48
Cambreigh,F,100,23,0,23
Kymar,M,100,0,5,5
Kevelyn,F,100,16,0,16
Chauntrice,F,100,5,0,5
Taffeta,F,100,5,0,5
Marvan,M,100,0,5,5
Tanjie,F,100,5,0,5
Demesha,F,100,337,0,337
Shuwanda,F,100,26,0,26
Dionisios,M,100,0,81,81
Saylor,F,91,2777,280,3057
Anastasio,M,100,0,62,62
Rodman,M,100,0,597,597
Sharrita,F,100,5,0,5
Gramm,M,100,0,7,7
Kaiden,M,95,1219,25638,26857
Linsie,F,100,123,0,123
Jogina,F,100,5,0,5
Leeda,F,100,27,0,27
Kieffer,M,100,0,166,166
Spenser,M,89,350,2905,3255
Greg,M,100,143,72049,72192
Siiri,F,100,22,0,22
Orasio,M,100,0,7,7
Sherah,F,100,193,0,193
Osie,M,77,42,139,181
Odia,F,100,6,0,6
Analeigh,F,100,1059,0,1059
Kyrielle,F,100,77,0,77
Benten,M,100,0,11,11
Kharisma,F,100,301,0,301
Orson,M,100,0,871,871
Jhaniya,F,100,87,0,87
Raimundo,M,100,0,254,254
Jacorrion,M,100,0,5,5
Prachi,F,100,394,0,394
Ahaan,M,100,0,193,193
Tawiana,F,100,5,0,5
Celinez,F,100,5,0,5
Manada,F,100,5,0,5
Anand,M,100,0,1610,1610
Hamish,M,100,0,176,176
Aadish,M,100,0,17,17
Ellise,F,100,601,0,601
Jenasis,F,100,234,0,234
Traun,M,100,0,17,17
Jenafer,F,100,179,0,179
Bison,M,100,0,10,10
Rashyia,F,100,12,0,12
Tijana,F,100,69,0,69
Keydi,F,100,99,0,99
Rozaria,F,100,10,0,10
Saiid,M,100,0,5,5
Zania,F,100,674,0,674
Esau,M,100,0,1902,1902
Winfield,M,100,0,1269,1269
Adarion,M,100,0,38,38
Shuronda,F,100,87,0,87
Adream,F,100,45,0,45
Clavon,M,100,0,5,5
Darra,F,100,498,0,498
Sadiyyah,F,100,42,0,42
Bonanza,M,100,0,7,7
Wakeelah,F,100,95,0,95
Jaire,M,90,35,329,364
Esker,M,100,0,42,42
Ozmar,M,100,0,22,22
Develle,M,100,0,60,60
Manali,F,100,69,0,69
Donnald,M,100,0,289,289
Terrianne,F,100,201,0,201
Jayani,F,100,302,0,302
Sueling,F,100,17,0,17
Abry,F,100,6,0,6
Jaselle,F,100,306,0,306
Lawandra,F,100,16,0,16
Verona,F,100,873,0,873
Shawaiz,M,100,0,7,7
Constandina,F,100,5,0,5
Harsh,M,100,0,593,593
Housten,M,100,0,6,6
Tavern,M,100,0,5,5
Tashiyana,F,100,5,0,5
Zarreah,F,100,5,0,5
Ceriah,F,100,62,0,62
Drita,F,100,41,0,41
Roarke,M,100,0,237,237
Benigna,F,100,17,0,17
Yides,F,100,519,0,519
Neili,F,100,5,0,5
Yaelis,F,100,45,0,45
Nathasia,F,100,10,0,10
Jary,M,100,0,50,50
Jaritza,F,100,700,0,700
Tishae,F,100,5,0,5
Leontae,M,100,0,118,118
Jilla,F,100,6,0,6
Sibbie,F,100,6,0,6
Greagory,M,100,0,5,5
Nancyann,F,100,191,0,191
Calib,M,100,0,475,475
Kebba,M,100,0,42,42
Kyhlee,F,100,5,0,5
Petrus,M,100,0,5,5
Jaeana,F,100,39,0,39
Zacarius,M,100,0,27,27
Ganna,F,100,17,0,17
Dereona,F,100,121,0,121
Jhenna,F,100,43,0,43
Jomel,M,100,0,68,68
Tarea,F,100,79,0,79
Daizsa,F,100,15,0,15
Tykiara,F,100,15,0,15
Dorsie,F,60,29,19,48
Tiena,F,100,75,0,75
Santoi,M,100,0,5,5
Sharlisa,F,100,71,0,71
Codyallen,M,100,0,6,6
Ercia,F,100,80,0,80
Evvy,F,100,12,0,12
Yayra,F,100,5,0,5
Mckenzii,F,100,7,0,7
Lannie,M,64,588,1048,1636
Brigid,F,100,5527,0,5527
Amer,M,99,12,1135,1147
Ire,M,100,0,5,5
Dairon,M,100,0,205,205
Daijana,F,100,12,0,12
Latierra,F,100,27,0,27
Marypaz,F,100,16,0,16
Gregorio,M,100,5,7337,7342
Tathan,M,100,0,6,6
Avri,F,95,287,16,303
Glennette,F,100,86,0,86
Ellen,F,100,130079,280,130359
Tomkia,F,100,5,0,5
Azori,F,100,14,0,14
Layden,M,94,41,624,665
Juliann,F,100,6065,18,6083
Orita,F,100,10,0,10
Sravani,F,100,23,0,23
Gurleen,F,100,451,0,451
Jeffree,M,100,0,105,105
Medinah,F,100,18,0,18
Flonnie,F,100,47,0,47
Tomaz,M,100,0,62,62
Rashel,F,100,1094,0,1094
Gai,F,100,20,0,20
Nakai,M,79,130,497,627
Jood,F,92,94,8,102
Aree,F,76,16,5,21
Shanese,F,100,753,0,753
Abrihet,F,100,5,0,5
Shapria,F,100,5,0,5
Issamar,F,100,48,0,48
Yazmene,F,100,5,0,5
Azhan,M,100,0,5,5
Babetta,F,100,58,0,58
Stormey,F,97,215,7,222
Taniah,F,100,823,0,823
Stephone,M,100,0,701,701
Ajea,F,100,12,0,12
Tiajuana,F,100,374,0,374
Ladeidra,F,100,49,0,49
Welden,M,100,0,15,15
Kamren,M,88,436,3127,3563
Shaeden,M,100,0,11,11
Gonzella,F,100,5,0,5
Stevette,F,100,26,0,26
Ferdinand,M,100,0,2470,2470
Nyona,F,100,16,0,16
Ameirah,F,100,47,0,47
Nairoby,F,100,37,0,37
Analei,F,100,77,0,77
Candita,F,100,111,0,111
Seraj,M,100,0,27,27
Geon,M,100,0,15,15
Zulaika,F,100,10,0,10
Johnia,F,100,44,0,44
Arlesia,F,100,86,0,86
Cala,F,100,418,0,418
Donnamarie,F,100,988,0,988
Shonice,F,100,91,0,91
Nichlaus,M,100,0,40,40
Ariunna,F,100,5,0,5
Evorn,F,100,5,0,5
Breane,F,100,135,0,135
Twylia,F,100,77,0,77
Mickell,M,73,51,136,187
Altovese,F,100,6,0,6
Talaija,F,100,5,0,5
Shyna,F,100,113,0,113
Delica,F,100,16,0,16
Jerrit,M,100,0,150,150
Annanya,F,100,5,0,5
Katelund,F,100,5,0,5
Iziaha,M,100,0,19,19
Romio,M,100,0,40,40
Khadijha,F,100,50,0,50
Sheleen,F,100,78,0,78
Clarrissa,F,100,357,0,357
Perseus,M,91,20,209,229
Ilga,F,100,6,0,6
Linnetta,F,100,10,0,10
Jovianna,F,100,19,0,19
Margia,F,100,20,0,20
Milli,F,100,153,0,153
Jolien,F,100,12,0,12
Darinka,F,100,47,0,47
Jaymen,M,100,0,222,222
Jasminerose,F,100,23,0,23
Kaleek,M,100,0,13,13
Hayven,F,81,619,143,762
Darylann,F,100,19,0,19
Quintavion,M,100,0,39,39
Ranjeet,M,100,0,10,10
Lanika,F,100,467,0,467
Winton,M,100,0,549,549
Shiva,M,59,249,363,612
Zylen,M,100,0,128,128
Trasa,F,100,16,0,16
Bronna,F,100,22,0,22
Denahi,M,100,0,25,25
Jamiroquai,M,100,0,29,29
Alexiya,F,100,108,0,108
Kierra,F,100,14903,18,14921
Maree,F,100,536,0,536
Breannon,F,100,42,0,42
Darias,M,100,0,58,58
Dazsha,F,100,33,0,33
Roosvelt,M,100,0,86,86
Taureon,M,100,0,10,10
Johndavid,M,100,0,978,978
Naryan,M,100,0,23,23
Soran,M,100,0,5,5
Jerimaine,M,100,0,10,10
Alysabeth,F,100,73,0,73
Korinna,F,100,377,0,377
Aelyn,F,100,98,0,98
Kristanne,F,100,6,0,6
Desheena,F,100,5,0,5
Chineka,F,100,11,0,11
Jameela,F,100,709,0,709
Florette,F,100,54,0,54
Fariah,F,100,12,0,12
Jeyline,F,100,17,0,17
Chonita,F,100,111,0,111
Dayzha,F,100,76,0,76
Ronecia,F,100,36,0,36
Mathu,M,100,0,11,11
Perfecto,M,100,0,480,480
Harbor,F,60,147,99,246
Helix,M,100,0,12,12
Beonce,F,100,9,0,9
Tarif,M,100,0,23,23
Graceleigh,F,100,12,0,12
Shoua,F,77,282,83,365
Brylon,M,100,0,378,378
Ysidra,F,100,16,0,16
Ledger,M,100,0,819,819
Desiree,F,100,80603,198,80801
Beckah,F,100,5,0,5
Ibiza,F,100,5,0,5
Ashani,F,100,238,0,238
Fairy,F,100,196,0,196
Kjerstin,F,100,229,0,229
Andreya,F,100,997,0,997
Kereen,F,100,7,0,7
Niveah,F,100,216,0,216
Stephie,F,100,77,0,77
Sameya,F,100,23,0,23
Kamdan,M,100,0,14,14
Demontreal,M,100,0,5,5
Taniya,F,100,4644,0,4644
Nosakhare,M,100,0,5,5
Sonique,F,100,24,0,24
Alekzandra,F,100,5,0,5
Mirasol,F,100,28,0,28
Shanegua,F,100,12,0,12
Malcome,M,100,0,55,55
Danaya,F,100,655,0,655
Logunn,M,100,0,5,5
Hridaan,M,100,0,23,23
Syndney,F,100,24,0,24
Deejay,M,96,5,112,117
Kimesha,F,100,322,0,322
Quendarius,M,100,0,59,59
Minelba,F,100,5,0,5
Keerah,F,100,6,0,6
Terralyn,F,100,112,0,112
Jahcere,M,100,0,30,30
Jeanae,F,100,149,0,149
Joniece,F,100,68,0,68
Wanetta,F,100,349,0,349
Eziya,F,100,5,0,5
Cathlyn,F,100,292,0,292
Rudolpho,M,100,0,312,312
Joleth,F,100,28,0,28
Lidia,F,100,8127,0,8127
Tomarion,M,100,0,34,34
Tirus,M,100,0,16,16
Jama,F,96,1421,66,1487
Marylinda,F,100,12,0,12
Tovah,F,100,505,0,505
Kumar,M,100,0,292,292
Sarrina,F,100,10,0,10
Stehpen,M,100,0,5,5
Terell,M,99,38,2532,2570
Kennan,M,96,48,1056,1104
Marsie,F,100,27,0,27
Jermany,M,53,85,96,181
Kinverlin,F,100,5,0,5
Reachel,F,100,21,0,21
Mckoy,M,100,0,118,118
Brooksie,F,100,69,0,69
Delfin,M,100,0,221,221
Ok,F,100,15,0,15
Findlay,M,92,10,111,121
Zoemarie,F,100,10,0,10
Collyns,F,100,131,0,131
Deveta,F,100,5,0,5
Dearl,M,100,0,347,347
Daeron,M,100,0,90,90
Naarah,F,100,145,0,145
Fabrienne,F,100,42,0,42
Briazia,F,100,5,0,5
Vanda,F,100,888,0,888
Linley,F,99,882,11,893
Bowe,M,100,0,73,73
Litsi,F,100,6,0,6
Floyd,M,99,269,41539,41808
Teshon,M,100,0,50,50
Minas,M,100,0,82,82
Joliyah,F,100,57,0,57
Mande,F,100,92,0,92
Aadil,M,100,0,297,297
Anitra,F,100,4260,0,4260
Mayaar,F,100,6,0,6
Osamah,M,100,0,97,97
Yitty,F,100,934,0,934
Meshonda,F,100,15,0,15
Patina,F,100,282,0,282
Jesenya,F,100,91,0,91
Sufian,M,100,0,71,71
Shina,F,100,426,0,426
Shaterria,F,100,145,0,145
Tkia,F,100,52,0,52
Zorayda,F,100,5,0,5
Merriel,M,100,0,5,5
Sherneice,F,100,5,0,5
Luby,M,100,0,30,30
Lexci,F,100,10,0,10
Khalisa,F,100,11,0,11
Phoebi,F,100,5,0,5
Ong,F,100,52,0,52
Gaberille,F,100,5,0,5
Dariya,F,100,265,0,265
Timolyn,F,100,9,0,9
Oliviana,F,100,125,0,125
Finnick,M,100,0,62,62
Itzcoatl,M,100,0,6,6
Paulita,F,100,524,0,524
Jeannet,F,100,30,0,30
Mahit,M,100,0,11,11
Shanequah,F,100,8,0,8
Ramiz,M,100,0,176,176
Katrenia,F,100,217,0,217
Brenon,M,100,0,266,266
Talan,M,99,46,3405,3451
Williaa,M,100,0,6,6
Anilya,F,100,16,0,16
Kamarea,F,100,27,0,27
Kyrea,F,100,5,0,5
Sonal,F,100,591,0,591
Bergen,F,57,403,310,713
Alija,M,60,44,66,110
Laquila,F,100,31,0,31
Farshid,M,100,0,5,5
Raneisha,F,100,345,0,345
Starla,F,100,7595,0,7595
Nickia,F,100,260,0,260
Neva,F,100,4936,0,4936
Suren,M,100,0,94,94
Jonquez,M,100,0,28,28
Rigoverto,M,100,0,37,37
Lakeshia,F,100,4708,0,4708
Jamiracle,F,100,290,0,290
Dawson,M,98,467,28875,29342
Drey,M,100,0,349,349
Uber,M,100,0,36,36
Amadi,F,57,148,112,260
Adulfo,M,100,0,5,5
Sierrah,F,100,1095,0,1095
Samya,F,100,2393,0,2393
Ayres,M,100,0,5,5
Shawana,F,100,1881,0,1881
Tylisha,F,100,497,0,497
Londen,F,64,335,188,523
Rayneshia,F,100,12,0,12
Geanine,F,100,146,0,146
Kathrin,F,100,1052,0,1052
Elaheh,F,100,5,0,5
Jamylex,F,100,5,0,5
Anvith,M,100,0,66,66
Gerell,M,100,0,136,136
Maeven,F,100,41,0,41
Dlayna,F,100,5,0,5
Zayda,F,100,1293,0,1293
Mikenna,F,100,847,0,847
Jonavan,M,100,0,228,228
Gwendalyn,F,100,905,0,905
Silvestre,M,100,0,1810,1810
Nave,F,100,6,0,6
Lisanna,F,100,6,0,6
Yutaka,M,100,0,5,5
Cristan,F,57,203,155,358
Maryrose,F,100,1343,0,1343
Bena,F,100,211,0,211
Kameelah,F,100,390,0,390
Karmann,F,100,10,0,10
Aubrea,F,100,378,0,378
Michieal,M,100,0,16,16
Blayde,M,100,0,217,217
Ranna,F,100,53,0,53
Santoria,F,100,113,0,113
Sarayah,F,100,270,0,270
Holton,M,100,0,515,515
Ricaria,F,100,5,0,5
Brayshaun,M,100,0,5,5
Cherly,F,100,925,0,925
Arcelia,F,100,1398,0,1398
Tyrhonda,F,100,120,0,120
Deveron,M,100,0,158,158
Trcy,F,100,12,0,12
Aynsleigh,F,100,6,0,6
Thomasin,F,100,10,0,10
Teray,M,100,0,17,17
Erieanna,F,100,10,0,10
Savena,F,100,5,0,5
Brynnlee,F,100,487,0,487
Sidonie,F,100,135,0,135
Murriel,F,77,33,10,43
Zaylie,F,100,418,0,418
Neajah,F,100,5,0,5
Nickoles,M,100,0,194,194
Tinh,M,100,0,15,15
Johnbenedict,M,100,0,14,14
Timyah,F,100,44,0,44
Carmela,F,100,8268,5,8273
Harshil,M,100,0,198,198
Karlon,M,100,0,57,57
Dayson,M,100,0,538,538
Kevontre,M,100,0,5,5
Maxi,F,57,125,93,218
Tarisa,F,100,90,0,90
Jahmaad,M,100,0,15,15
Chelcy,F,100,183,0,183
Ineka,F,100,13,0,13
Gwenell,F,100,5,0,5
Tarren,M,65,230,418,648
Hipolita,F,100,11,0,11
Aaleah,F,100,234,0,234
Belmin,M,100,0,56,56
Laela,F,100,1168,0,1168
Eliodoro,M,100,0,174,174
Brahm,M,100,0,188,188
Dustn,M,100,0,21,21
Frani,F,100,18,0,18
Zebulen,M,100,0,56,56
Karrol,F,100,16,0,16
Shereika,F,100,5,0,5
Katosha,F,100,32,0,32
Caedan,M,100,0,137,137
Constandinos,M,100,0,5,5
Amneris,F,100,35,0,35
Alexiz,F,52,265,249,514
Preana,F,100,5,0,5
Marbel,F,100,15,0,15
Fielding,M,100,0,250,250
Aajaylah,F,100,20,0,20
Jeremia,M,98,10,610,620
Carolle,F,100,40,0,40
Evangelyn,F,100,231,0,231
Torean,M,100,0,41,41
Brendalyn,F,100,225,0,225
Tyraya,F,100,5,0,5
Valirie,F,100,5,0,5
Laena,F,100,41,0,41
Nahiem,M,100,0,70,70
Rufino,M,100,0,1094,1094
Nadeem,M,100,0,591,591
Evania,F,100,131,0,131
Zuhaib,M,100,0,30,30
Jacquely,F,100,50,0,50
Markieta,F,100,33,0,33
Yaremy,F,100,5,0,5
Kyron,M,100,0,3358,3358
Phanuel,M,100,0,11,11
Quon,M,100,0,6,6
Nahzir,M,100,0,93,93
Tesher,M,100,0,12,12
Jayllen,M,100,0,6,6
Aoife,F,100,1062,0,1062
Morris,M,99,145,21187,21332
Jayel,F,50,65,64,129
Zuhair,M,100,0,203,203
Makinnley,F,100,27,0,27
Maxmillian,M,100,0,198,198
Azfar,M,100,0,5,5
Camden,M,93,2448,32091,34539
Ireri,F,100,25,0,25
Delorse,F,100,544,0,544
Shanaih,F,100,5,0,5
Destainy,F,100,5,0,5
Loel,M,100,0,118,118
Taleah,F,100,1984,0,1984
Sammeul,M,100,0,5,5
Jeanlucas,M,100,0,6,6
Lakeila,F,100,24,0,24
Tristy,F,100,64,0,64
Dnasia,F,100,90,0,90
Kaprice,F,100,373,0,373
Andew,M,100,0,13,13
Sanora,F,100,297,0,297
Kalup,M,100,0,74,74
Kianna,F,100,7411,0,7411
Dalma,F,100,31,0,31
Keva,F,100,1119,0,1119
Braxen,M,100,0,56,56
Eshawna,F,100,5,0,5
Henesis,F,100,28,0,28
Shyloh,F,82,364,78,442
Hyung,M,100,0,5,5
Angelicia,F,100,443,0,443
Rici,F,100,7,0,7
Nirja,F,100,15,0,15
Jarvin,M,100,0,169,169
Addis,M,73,54,146,200
Jonaye,F,100,20,0,20
Michea,F,100,30,0,30
Karysa,F,100,130,0,130
Laymond,M,100,0,57,57
Lyndzee,F,100,58,0,58
Tlaloc,M,100,0,173,173
Chidalu,M,100,0,5,5
Sarada,F,100,34,0,34
Kaivan,M,100,0,5,5
Raygine,F,100,5,0,5
Watts,M,100,0,15,15
Karamvir,M,100,0,5,5
Nikolaj,M,100,0,50,50
Malanii,F,100,10,0,10
Timyra,F,100,53,0,53
Maketa,F,100,43,0,43
Gavina,F,100,7,0,7
Neveya,F,100,34,0,34
Miloh,M,100,0,62,62
Makylia,F,100,22,0,22
Shakari,F,96,301,12,313
Rayn,M,56,367,465,832
Tony,M,99,2105,200893,202998
Deakyn,M,100,0,18,18
Shurla,F,100,17,0,17
Cieran,M,100,0,6,6
Brisaida,F,100,5,0,5
Khonner,M,100,0,13,13
Sameh,M,100,0,31,31
Syanna,F,100,197,0,197
Thilo,M,100,0,6,6
Lonard,M,100,0,5,5
Kutina,F,100,52,0,52
Corina,F,100,13924,0,13924
Symanthia,F,100,12,0,12
Laianna,F,100,25,0,25
Marychristina,F,100,5,0,5
Kristylee,F,100,7,0,7
Dierdra,F,100,204,0,204
Larobert,M,100,0,5,5
Maylyn,F,100,251,0,251
Myleen,F,100,116,0,116
Zarelia,F,100,5,0,5
Lapaul,M,100,0,10,10
Vernadette,F,100,65,0,65
Moctar,M,100,0,5,5
Lenord,M,100,0,369,369
Nahir,M,100,0,31,31
Bristol,F,92,4358,390,4748
Tyker,M,100,0,5,5
Naeyli,F,100,5,0,5
Nayshaun,M,100,0,41,41
Kenzee,F,100,352,0,352
Brendan,M,100,325,86192,86517
Marqies,M,100,0,5,5
Adonias,M,100,0,98,98
Francely,F,100,64,0,64
Shanita,F,100,3447,0,3447
Lorenz,M,100,0,789,789
Layton,M,94,384,6106,6490
Marlett,F,100,19,0,19
Legacie,F,100,23,0,23
Taheerah,F,100,157,0,157
Hayah,F,100,11,0,11
Jamond,M,100,0,508,508
Ammber,F,100,12,0,12
Tyleah,F,100,402,0,402
Uzziel,M,100,0,423,423
Marniyah,F,100,5,0,5
Qunicy,M,100,0,58,58
Joscelin,F,100,241,0,241
Rehman,M,100,0,135,135
Tikia,F,100,254,0,254
Monali,F,100,10,0,10
Aidrick,M,100,0,14,14
Fable,F,93,66,5,71
Stephane,F,62,1109,668,1777
Keyonda,F,100,175,0,175
Crue,M,100,0,402,402
Suraiya,F,100,118,0,118
Sabrena,F,100,1965,0,1965
Gabrielle,F,99,127389,705,128094
Letrese,F,100,5,0,5
Sulaf,F,100,17,0,17
Chamaine,F,100,63,0,63
Joeliel,M,100,0,5,5
Henlee,F,100,117,0,117
Taurasi,F,100,5,0,5
Brandol,M,100,0,105,105
Johanny,F,86,256,42,298
Craven,M,100,0,190,190
Dametrious,M,100,0,5,5
Josaline,F,100,54,0,54
Jermanee,F,100,5,0,5
Jahkia,F,100,10,0,10
Lachrisa,F,100,11,0,11
Gedaliah,M,100,0,10,10
Kyzen,M,100,0,49,49
Yenisel,F,100,6,0,6
Letzy,F,100,107,0,107
Zykeem,M,100,0,63,63
Tachina,F,100,65,0,65
Chih,M,100,0,6,6
Shabria,F,100,395,0,395
Opel,F,100,7,0,7
Clydette,F,100,38,0,38
Calena,F,100,126,0,126
Madan,M,100,0,31,31
Almida,F,100,5,0,5
Kasiyah,F,100,86,0,86
Mandie,F,100,2314,0,2314
Jarvius,M,100,0,12,12
Bonner,M,100,0,85,85
Tyieshia,F,100,5,0,5
Kanon,M,84,139,719,858
Dekin,M,100,0,11,11
Naquasha,F,100,13,0,13
Xizavier,M,100,0,5,5
Marshawn,M,96,78,1871,1949
Jemma,F,100,2920,0,2920
Christeanna,F,100,6,0,6
Lorilai,F,100,5,0,5
Damyra,F,100,71,0,71
Dalayah,F,100,65,0,65
Divonte,M,100,0,84,84
Josephallen,M,100,0,5,5
Mariyan,F,100,11,0,11
Jaimee,F,99,4361,43,4404
Zakarias,M,100,0,21,21
Kateri,F,100,2045,0,2045
Jecenia,F,100,119,0,119
Jayleana,F,100,49,0,49
Precius,F,100,5,0,5
Urania,F,100,142,0,142
Oscar,M,99,632,121926,122558
Adeleigh,F,100,91,0,91
Marylan,F,100,18,0,18
Nakeira,F,100,27,0,27
Larosa,F,100,110,0,110
Jovahni,M,100,0,11,11
Mareen,F,100,37,0,37
Clair,F,57,2579,1943,4522
Terriauna,F,100,10,0,10
Franko,M,100,0,210,210
Charlisha,F,100,61,0,61
Rini,F,100,54,0,54
Harmony,F,100,19324,19,19343
Jorita,F,100,63,0,63
Soufiane,M,100,0,5,5
Zanieya,F,100,5,0,5
Conwell,M,100,0,5,5
Indiya,F,100,262,0,262
Mayli,F,100,291,0,291
Alleigh,F,100,518,0,518
Lute,M,100,0,10,10
Belford,M,100,0,14,14
Kionah,F,100,17,0,17
Umaira,F,100,6,0,6
Kiyanah,F,100,50,0,50
Dheera,M,100,0,5,5
Buse,F,100,15,0,15
Meghaan,F,100,36,0,36
Sanniyah,F,100,24,0,24
Crispus,M,100,0,7,7
Teha,F,100,5,0,5
Treniya,F,100,71,0,71
Naseim,M,100,0,5,5
Tulasi,F,100,12,0,12
Oneida,F,100,1018,0,1018
Leathea,F,100,5,0,5
Oneisha,F,100,251,0,251
Landell,M,100,0,6,6
Rosey,F,100,399,0,399
Emmelia,F,100,261,0,261
Yuleidi,F,100,36,0,36
Jakada,F,100,5,0,5
Geeta,F,100,185,0,185
Krystin,F,100,3094,0,3094
Zandel,M,100,0,5,5
Annas,M,100,0,22,22
Shonta,F,96,1604,74,1678
Laurah,F,100,27,0,27
Nimrat,F,100,72,0,72
Alp,M,100,0,163,163
Dalaine,F,100,6,0,6
Aedin,M,100,0,166,166
Deveah,F,100,15,0,15
Ruvi,F,100,68,0,68
Kimura,F,100,5,0,5
Brittanynicole,F,100,6,0,6
Margeret,F,100,230,0,230
Asly,F,100,59,0,59
Beebe,F,100,15,0,15
Vaughn,M,97,461,13223,13684
Lajauna,F,100,5,0,5
Shazeb,M,100,0,6,6
Janeil,F,90,199,23,222
Moretta,F,100,5,0,5
Hawanatu,F,100,5,0,5
Rodion,M,100,0,11,11
Emna,F,100,10,0,10
Lahana,F,100,31,0,31
Duong,M,100,0,164,164
Roey,M,100,0,59,59
Valine,F,100,89,0,89
Shibani,F,100,15,0,15
Jorgeantonio,M,100,0,6,6
Terani,F,100,5,0,5
Lance,M,100,345,96339,96684
Rubab,F,100,22,0,22
Eppie,F,51,24,23,47
Ziere,M,100,0,47,47
Dijonna,F,100,24,0,24
Edye,F,100,173,0,173
Mykalah,F,100,145,0,145
Khimani,M,100,0,11,11
Coel,M,100,0,22,22
Denin,M,100,0,5,5
Meme,F,100,10,0,10
Lajune,F,100,189,0,189
Mariadelosang,F,100,148,0,148
Aariyonna,F,100,5,0,5
Caelum,M,100,0,240,240
Gilmar,M,100,0,117,117
Teage,M,100,0,11,11
Tryton,M,100,0,154,154
Shamaila,F,100,5,0,5
Shyanne,F,100,8648,0,8648
Fareed,M,100,0,537,537
Subria,F,100,5,0,5
Basya,F,100,661,0,661
Cedrice,M,100,0,12,12
Reno,M,99,17,2532,2549
Nyobi,F,100,31,0,31
Keyontay,M,100,0,72,72
Aidet,F,100,5,0,5
Shelan,F,100,5,0,5
Konica,F,100,54,0,54
Shammara,F,100,56,0,56
Kamel,M,100,0,467,467
Keayla,F,100,29,0,29
Everly,F,100,3638,5,3643
Quintara,F,100,103,0,103
Voncille,F,100,150,0,150
Rahila,F,100,8,0,8
Brekkin,M,100,0,6,6
Cambell,F,72,185,73,258
Markiah,F,100,62,0,62
Hailee,F,100,13765,6,13771
Kemuel,M,100,0,352,352
Reshunda,F,100,74,0,74
Ivorie,F,100,248,0,248
Terrylynn,F,100,33,0,33
Lakreshia,F,100,24,0,24
Jeanell,F,100,639,0,639
Renlee,F,100,20,0,20
Tavonna,F,100,111,0,111
Rheanna,F,100,1740,0,1740
Amaylee,F,100,5,0,5
Trayci,F,100,6,0,6
Braxdyn,M,100,0,18,18
Valia,F,100,31,0,31
Ashriya,F,100,5,0,5
Aneela,F,100,24,0,24
Kennadee,F,100,412,0,412
Hernaldo,M,100,0,10,10
Duel,M,100,0,45,45
Allorah,F,100,32,0,32
Lavonde,F,100,6,0,6
Nicha,F,100,75,0,75
Jayjay,M,100,0,124,124
Quashun,M,100,0,38,38
Savanha,F,100,123,0,123
Nicodemus,M,100,0,714,714
Jayziel,M,100,0,5,5
Frankey,M,96,5,129,134
Carlosadrian,M,100,0,5,5
Ornella,F,100,154,0,154
Arnisha,F,100,303,0,303
Yoany,F,100,5,0,5
Aviana,F,100,2900,0,2900
Brecon,M,100,0,5,5
Denna,F,100,2037,0,2037
Jamiles,F,100,10,0,10
Raymona,F,100,330,0,330
Zorita,F,100,10,0,10
Elidio,M,100,0,10,10
Saphina,F,100,8,0,8
Tykim,M,100,0,23,23
Avonne,F,100,29,0,29
Malette,F,100,20,0,20
Yadhiel,M,100,0,5,5
Tonnisha,F,100,27,0,27
Vanessia,F,100,297,0,297
Nyhla,F,100,49,0,49
Kamor,F,100,5,0,5
Keysi,F,100,141,0,141
Israh,F,100,18,0,18
Correll,M,100,0,122,122
Latoyia,F,100,1578,0,1578
Esthefani,F,100,28,0,28
Huxley,M,92,43,503,546
Areona,F,100,184,0,184
Lafoya,F,100,10,0,10
Zalyn,M,91,6,62,68
Adiah,F,100,120,0,120
Johnda,F,100,207,0,207
Anisia,F,100,198,0,198
Kaddy,F,100,10,0,10
Nyajiah,F,100,5,0,5
Verdonna,F,100,5,0,5
Winston,M,100,26,14854,14880
Saiquan,M,100,0,106,106
Osten,M,100,0,144,144
Kelechi,M,66,225,446,671
Leveon,M,100,0,5,5
Makade,M,100,0,31,31
Guynell,F,100,11,0,11
Danyah,F,100,174,0,174
Zuliana,F,100,12,0,12
Nissi,F,100,339,0,339
Levolia,F,100,5,0,5
Aubren,F,65,20,11,31
Leihla,F,100,17,0,17
Lillia,F,100,1295,0,1295
Iyssis,F,100,11,0,11
Venetia,F,100,1070,0,1070
Quinterrius,M,100,0,117,117
Marygrace,F,100,1528,0,1528
Dezaraye,F,100,11,0,11
Markiss,M,100,0,10,10
Doniesha,F,100,160,0,160
Nichele,F,100,667,0,667
Dallen,M,100,0,1016,1016
Zebulun,M,100,0,692,692
Gaius,M,100,0,229,229
Rajkumar,M,100,0,5,5
Ardelle,F,100,92,0,92
Ambere,F,100,13,0,13
Seraphina,F,100,1206,0,1206
Jimmye,F,90,63,7,70
Weltha,F,100,5,0,5
Catenia,F,100,6,0,6
Azaireyah,F,100,5,0,5
Jonrobert,M,100,0,5,5
Jahkim,M,100,0,11,11
Jiancarlo,M,100,0,26,26
Zandaya,F,100,6,0,6
Dequay,M,100,0,5,5
Strother,M,100,0,5,5
Fabius,M,100,0,6,6
Maliah,F,100,2847,0,2847
Makesia,F,100,5,0,5
Aisen,M,100,0,40,40
Josianna,F,100,7,0,7
Zanita,F,100,102,0,102
Shelda,F,100,373,0,373
Bismah,F,100,41,0,41
Estavan,M,100,0,10,10
Naum,M,100,0,11,11
Drelyn,M,100,0,152,152
Arkita,F,100,5,0,5
Jimya,F,100,70,0,70
Omid,M,100,0,634,634
Aamani,F,100,127,0,127
Hadilyn,F,100,5,0,5
Meelad,M,100,0,14,14
Mlak,F,100,6,0,6
Amonii,F,100,5,0,5
Akeyah,F,100,13,0,13
Iqra,F,100,813,0,813
Bharath,M,100,0,82,82
Phi,M,91,45,463,508
Mekenzy,F,100,5,0,5
Jasmany,M,100,0,6,6
Kasmine,F,100,10,0,10
Whitlie,F,100,5,0,5
Melesio,M,100,0,64,64
Perri,F,95,1989,114,2103
Datha,F,100,25,0,25
Lethia,F,100,295,0,295
Shamieka,F,100,227,0,227
Amayra,F,100,33,0,33
Tear,F,100,10,0,10
Masi,M,100,0,13,13
Sanira,F,100,5,0,5
Meiyah,F,100,6,0,6
Latarisha,F,100,16,0,16
Chany,F,100,645,0,645
Mikailyn,F,100,10,0,10
Kaniela,M,100,0,17,17
Ford,M,100,0,2796,2796
Allonte,M,100,0,13,13
Noelis,F,100,16,0,16
Keemora,F,100,5,0,5
Athan,M,100,0,1391,1391
Dhriti,F,100,249,0,249
Macheal,M,67,16,33,49
Xaviana,F,100,40,0,40
Magaret,F,100,151,0,151
Tyghe,M,100,0,6,6
Javaun,M,100,0,285,285
Alyaan,M,100,0,19,19
Lennice,F,100,10,0,10
Xavianna,F,100,26,0,26
Lanasia,F,100,362,0,362
Tabita,F,100,240,0,240
Adris,M,100,0,5,5
Keywaun,M,100,0,5,5
Jalaya,F,100,1113,0,1113
Gidgett,F,100,26,0,26
Latela,F,100,5,0,5
Audri,F,100,951,0,951
Jahdari,M,100,0,5,5
Khayden,M,94,18,269,287
Myrtis,F,100,781,0,781
Latiera,F,100,25,0,25
Neecy,F,100,8,0,8
Sabreea,F,100,5,0,5
Alynah,F,100,160,0,160
Laquise,F,100,5,0,5
Tifffany,F,100,6,0,6
Lavette,F,100,1167,0,1167
Jailani,F,100,70,0,70
Myeasha,F,100,92,0,92
Tarshia,F,100,123,0,123
Naron,M,100,0,55,55
Malin,F,77,522,153,675
Deray,M,100,0,190,190
Kyzer,M,100,0,343,343
Janaan,F,100,6,0,6
Rielynn,F,100,111,0,111
Presslie,F,100,10,0,10
Maleeyah,F,100,133,0,133
Ryniah,F,100,12,0,12
Lytzy,F,100,50,0,50
Christiopher,M,100,0,35,35
Gorje,M,100,0,91,91
Kevionna,F,100,88,0,88
Assane,M,100,0,19,19
Harlequin,F,100,30,0,30
Jermanii,F,100,6,0,6
Vernando,M,100,0,5,5
Tomm,M,100,0,8,8
Keyora,F,100,6,0,6
Elayjah,F,100,77,0,77
Nilufer,F,100,5,0,5
Leeum,M,100,0,57,57
Tildon,M,100,0,44,44
Ziyanah,F,100,10,0,10
Dodie,F,100,1185,0,1185
Redrick,M,100,0,26,26
Lexx,M,100,0,69,69
Talma,F,100,42,0,42
Indiah,F,100,168,0,168
Yiming,M,100,0,27,27
Euricka,F,100,5,0,5
Jimenez,M,100,0,16,16
Velvett,F,100,5,0,5
Jahmaal,M,100,0,16,16
Basit,M,100,0,43,43
Cheryl,F,100,366394,836,367230
Clarissia,F,100,69,0,69
Serguio,M,100,0,5,5
Kasinda,F,100,30,0,30
Ruban,M,100,0,11,11
Tshara,F,100,10,0,10
Clotee,F,100,5,0,5
Jerode,M,100,0,34,34
Milledge,M,100,0,50,50
Rakeen,M,100,0,84,84
Jalinda,F,100,53,0,53
Dekoda,M,82,11,49,60
Aricka,F,100,478,0,478
Rozalin,F,100,16,0,16
Arrionna,F,100,146,0,146
Alyrah,F,100,12,0,12
Monserrad,F,100,16,0,16
Plato,M,100,0,26,26
Drianna,F,100,122,0,122
Stennis,M,100,0,16,16
Isaid,M,100,0,97,97
Margy,F,100,282,0,282
Arnetta,F,100,1761,0,1761
Renaya,F,100,44,0,44
Syrita,F,100,112,0,112
Layah,F,100,607,0,607
Lindamaria,F,100,5,0,5
Keyva,F,100,5,0,5
Geetanjali,F,100,10,0,10
Waqas,M,100,0,72,72
Emmanouel,M,100,0,6,6
Jalayia,F,100,112,0,112
Manasi,F,100,187,0,187
Nyzier,M,100,0,87,87
Dorne,M,100,0,18,18
Aeowyn,F,100,17,0,17
Capria,F,100,172,0,172
Jader,M,100,0,71,71
Laliana,F,100,10,0,10
Odet,F,100,7,0,7
Tywanna,F,100,620,0,620
Chrystine,F,100,234,0,234
Jazzarae,F,100,5,0,5
Teryl,F,73,627,234,861
Jlea,F,100,5,0,5
Paisely,F,100,27,0,27
Granderson,M,100,0,6,6
Seeta,F,100,10,0,10
Florenda,F,100,121,0,121
Eilzabeth,F,100,30,0,30
Danard,M,100,0,20,20
Ato,M,100,0,56,56
Javed,M,100,0,244,244
Ximenna,F,100,115,0,115
Shantale,F,100,125,0,125
Jimari,M,100,0,52,52
Jamaris,M,82,77,358,435
Balie,F,100,55,0,55
Oriona,F,100,8,0,8
Kez,M,100,0,10,10
Aiyan,M,100,0,11,11
Jeanita,F,100,211,0,211
Lyles,M,100,0,5,5
Dachia,F,100,15,0,15
Tonisia,F,100,5,0,5
Shauntay,F,99,439,6,445
Diretha,F,100,9,0,9
Orinda,F,100,6,0,6
Lyonel,M,100,0,164,164
Nettie,F,100,4201,0,4201
Tawayne,M,100,0,15,15
Nashton,M,100,0,64,64
Cheylin,F,100,5,0,5
Wilmarie,F,100,113,0,113
Fawzan,M,100,0,5,5
Amiayah,F,100,42,0,42
Riyanshi,F,100,13,0,13
Aydric,M,100,0,22,22
Edwin,M,99,638,120528,121166
Romonia,F,100,124,0,124
Darise,F,100,18,0,18
Jaclyne,F,100,151,0,151
Reyansh,M,100,0,665,665
Maryory,F,100,6,0,6
Jetmir,M,100,0,5,5
Julein,M,100,0,6,6
Hayllie,F,100,16,0,16
Camarion,M,100,0,469,469
Arneice,F,100,5,0,5
Clelia,F,100,171,0,171
Sigourney,F,100,337,0,337
Wael,M,100,0,329,329
Rawlin,M,100,0,98,98
Caston,M,100,0,318,318
Lashaun,F,62,1269,787,2056
Kourtney,F,94,12871,763,13634
Talulla,F,100,10,0,10
Caidynce,F,100,63,0,63
Adelinn,F,100,12,0,12
Ninasimone,F,100,5,0,5
Edell,F,58,14,10,24
Lizmar,F,100,32,0,32
Taityanna,F,100,5,0,5
Yuxin,F,100,17,0,17
Maykol,M,100,0,5,5
Cyrelle,F,100,5,0,5
Sinclair,M,72,287,723,1010
Reatta,F,100,13,0,13
Donneshia,F,100,34,0,34
Ynez,F,100,87,0,87
Tereance,M,100,0,12,12
Kailea,F,100,683,0,683
Jaki,M,64,100,179,279
Saranne,F,100,25,0,25
Zyheir,M,100,0,66,66
Ardean,F,72,55,21,76
Emie,F,100,127,0,127
Mechele,F,100,716,0,716
Dahl,M,100,0,39,39
Pammie,F,100,101,0,101
Clemens,M,100,0,187,187
Rilynn,F,97,1393,40,1433
Modibo,M,100,0,10,10
Dabrielle,F,100,5,0,5
Alainah,F,100,327,0,327
Symya,F,100,40,0,40
Baqir,M,100,0,6,6
Andreika,F,100,40,0,40
Xendaya,F,100,5,0,5
Davante,M,100,0,1232,1232
Giyana,F,100,5,0,5
Genell,F,100,672,0,672
Kruthi,F,100,32,0,32
Haylea,F,100,792,0,792
Markus,M,100,0,12707,12707
Sameul,M,100,0,582,582
Lennett,F,100,5,0,5
Xabier,M,100,0,36,36
Olvin,M,100,0,227,227
Nylla,F,100,22,0,22
Kataya,F,100,112,0,112
Jacenia,F,100,5,0,5
Melynna,F,100,15,0,15
Glorida,F,100,11,0,11
Makaleigh,F,100,96,0,96
Lannah,F,100,179,0,179
Giner,F,100,10,0,10
Chundra,F,100,58,0,58
Jessen,M,100,0,301,301
Norabelle,F,100,6,0,6
Jabori,M,100,0,165,165
Shaquinn,F,100,5,0,5
Benyamin,M,100,0,393,393
Jazzmarie,F,100,5,0,5
Baylee,F,97,16894,611,17505
Bitia,F,100,16,0,16
Daretta,F,100,13,0,13
Amyria,F,100,165,0,165
Alyzon,F,100,45,0,45
Lamira,F,100,77,0,77
Ajhane,F,100,5,0,5
Yuritza,F,100,266,0,266
Lashena,F,100,74,0,74
Audrey,F,99,152694,954,153648
Imoni,F,100,436,0,436
Kenzlie,F,100,258,0,258
Nykita,F,100,40,0,40
Lyiah,F,100,13,0,13
Sharday,F,100,796,0,796
Satnam,M,100,0,5,5
Namine,F,100,57,0,57
Peighton,F,97,1884,62,1946
Liczy,F,100,5,0,5
Dimani,M,100,0,11,11
Keshawndra,F,100,5,0,5
Keyanta,F,100,13,0,13
Tylaisha,F,100,10,0,10
Alexandrine,F,100,15,0,15
Cannon,M,98,120,5610,5730
Onaya,F,100,5,0,5
Tonii,F,100,12,0,12
Kvin,M,100,0,10,10
Egina,F,100,5,0,5
Jeniya,F,100,352,0,352
Anvay,M,100,0,56,56
Shanoa,F,100,38,0,38
Armari,M,65,39,74,113
Kalice,F,100,44,0,44
Lenesha,F,100,48,0,48
Seraph,M,71,6,15,21
Cenai,F,100,7,0,7
Vairon,M,100,0,16,16
Josyah,M,100,0,218,218
Ralinda,F,100,35,0,35
Dritan,M,100,0,5,5
Dencil,M,100,0,50,50
Navdeep,M,53,125,140,265
Adlemi,F,100,21,0,21
Mardina,F,100,6,0,6
Jahzaria,F,100,91,0,91
Chamber,M,100,0,7,7
Jennasis,F,100,39,0,39
Christyle,F,100,8,0,8
Killeen,F,100,11,0,11
Silvie,F,100,56,0,56
Imrane,M,100,0,13,13
Kalyann,F,100,5,0,5
Khloey,F,100,548,0,548
Wildan,M,100,0,5,5
Detravion,M,100,0,72,72
Chanley,F,100,110,0,110
Ashya,F,100,391,0,391
Charmonique,F,100,18,0,18
Jorie,F,99,1074,14,1088
Sonya,F,100,60418,183,60601
Jim,M,100,177,70847,71024
Kinnidi,F,100,26,0,26
Diesel,M,100,0,1139,1139
Ceionna,F,100,5,0,5
Zareb,M,100,0,5,5
Travus,M,100,0,85,85
Tumika,F,100,11,0,11
Esta,F,100,641,0,641
Katherne,F,100,16,0,16
Kristye,F,100,43,0,43
Bethel,F,89,1402,167,1569
Gwynavere,F,100,5,0,5
Ressie,F,100,145,0,145
Najuma,F,100,12,0,12
Higinio,M,100,0,463,463
Taree,F,76,16,5,21
Tamelia,F,100,165,0,165
Josie,F,99,32070,297,32367
Ameliarose,F,100,28,0,28
Kailei,F,100,492,0,492
Kristophor,M,100,0,11,11
Allenah,F,100,5,0,5
Marquis,M,98,474,22276,22750
Leelah,F,100,212,0,212
Xana,F,100,96,0,96
Kaitee,F,100,6,0,6
Fred,M,100,376,79716,80092
Zari,F,99,666,10,676
Mikalynn,F,100,34,0,34
Jovonne,F,86,177,28,205
Rennard,M,100,0,59,59
Aleja,F,100,152,0,152
Domonik,M,100,0,97,97
Othell,M,100,0,50,50
Satrina,F,100,104,0,104
Uniah,F,100,5,0,5
Joahn,M,100,0,11,11
Genya,F,100,20,0,20
Shaquale,F,100,5,0,5
Alyasia,F,100,29,0,29
Kemo,M,100,0,64,64
Danyon,M,100,0,98,98
Sandra,F,100,559439,1798,561237
Audray,F,100,5,0,5
Daquain,M,100,0,47,47
Skiler,M,52,150,163,313
Serina,F,100,5355,0,5355
Edon,M,100,0,158,158
Demetreus,M,100,0,238,238
Philemon,M,100,0,598,598
Bethzaira,F,100,5,0,5
Eliazbeth,F,100,15,0,15
Derrold,M,100,0,5,5
Shentel,F,100,8,0,8
Shoma,M,100,0,6,6
Lotonya,F,100,15,0,15
Pars,M,100,0,8,8
Ryze,M,100,0,13,13
Essence,F,100,8724,0,8724
Sherlock,M,100,0,26,26
Olea,F,100,12,0,12
Zahyra,F,100,47,0,47
Katherina,F,100,1292,0,1292
Sthefani,F,100,5,0,5
Tianyi,M,100,0,5,5
Taiga,M,100,0,205,205
Nataja,F,100,55,0,55
Dawaun,M,100,0,219,219
Jazmynn,F,100,490,0,490
Annon,M,100,0,5,5
Haniff,M,100,0,6,6
Kayahna,F,100,6,0,6
Jeremiya,M,100,0,6,6
Keontre,M,100,0,106,106
Yavonda,F,100,43,0,43
Milik,M,100,0,117,117
Shamarria,F,100,23,0,23
Helmer,M,100,0,93,93
Aydrien,M,100,0,108,108
Annete,F,100,91,0,91
Antero,M,100,0,61,61
Jeorgina,F,100,5,0,5
Arlenis,F,100,55,0,55
Akshaj,M,100,0,404,404
Rilda,F,100,27,0,27
Jervontae,M,100,0,12,12
Coury,M,100,0,57,57
Samihah,F,100,16,0,16
Auzhane,F,100,22,0,22
Princeston,M,100,0,144,144
Jmere,M,100,0,5,5
Shamila,F,100,128,0,128
Gianmichael,M,100,0,17,17
Stevey,F,84,124,23,147
Jenera,F,100,5,0,5
Tehillah,F,100,69,0,69
Yaron,M,100,0,227,227
Turell,M,100,0,11,11
Abram,M,100,0,11630,11630
Aashiyana,F,100,12,0,12
Tishaun,M,100,0,46,46
Latria,F,100,64,0,64
Jerison,M,100,0,22,22
Ayomiposi,M,100,0,6,6
Kierian,M,100,0,34,34
Daquavius,M,100,0,5,5
Solash,F,100,64,0,64
Celsea,F,100,29,0,29
Lexxis,F,100,41,0,41
Janiene,F,100,121,0,121
Demeatrius,M,100,0,5,5
Sheryal,F,100,17,0,17
Shatae,F,100,7,0,7
Lujuana,F,100,69,0,69
Jemila,F,100,120,0,120
Jaycon,M,100,0,5,5
Jahliyah,F,100,127,0,127
Zak,M,100,0,1273,1273
Chamere,F,100,38,0,38
Sunia,F,100,12,0,12
Anjelyna,F,100,6,0,6
Mando,M,100,0,101,101
Amilie,F,100,5,0,5
Tress,F,100,23,0,23
Abdulaziz,M,100,0,973,973
Macus,M,100,0,16,16
Garry,M,100,116,34443,34559
Makinzee,F,100,170,0,170
Randale,M,100,0,407,407
Tyriek,M,100,0,666,666
Jaison,M,100,0,1494,1494
Thawann,F,100,5,0,5
Rosezetta,F,100,84,0,84
Lorise,F,100,5,0,5
Sajah,F,100,17,0,17
Natay,F,100,11,0,11
Colon,M,100,0,404,404
Thadeous,M,100,0,17,17
Herica,F,100,15,0,15
Shareif,M,100,0,5,5
Karalyne,F,100,80,0,80
Laroi,M,100,0,5,5
Sherra,F,100,745,0,745
Arkady,M,100,0,11,11
Ransom,M,100,5,2021,2026
Monaya,F,100,12,0,12
Zyairra,F,100,6,0,6
Sophey,F,100,36,0,36
Chastyn,M,100,0,5,5
Paislea,F,100,41,0,41
Angelle,F,100,1818,0,1818
Pelma,F,100,10,0,10
Lenneth,M,100,0,5,5
Ammaar,M,100,0,156,156
Bryker,M,100,0,43,43
Boz,M,100,0,5,5
Catrin,F,100,39,0,39
Dontrice,F,100,6,0,6
Jamerah,F,100,15,0,15
Thomaslee,M,100,0,7,7
Kasimir,M,100,0,26,26
Shafee,M,100,0,8,8
Tirzah,F,100,1470,0,1470
Waco,M,100,0,132,132
Danait,F,100,12,0,12
Darah,F,100,881,0,881
Bryani,F,100,6,0,6
Yinon,M,100,0,12,12
Eilah,F,100,32,0,32
Tomicko,F,100,5,0,5
Sollie,M,100,0,10,10
Marielouise,F,100,56,0,56
Tanishea,F,100,6,0,6
Rodnie,M,100,0,41,41
Kanta,M,100,0,38,38
Amali,F,100,117,0,117
Troian,F,100,7,0,7
Lydianna,F,100,33,0,33
Sheneka,F,100,822,0,822
Billison,M,100,0,5,5
Thanasi,M,100,0,5,5
Ayala,F,100,588,0,588
Korden,M,100,0,5,5
Mohmad,M,100,0,23,23
Michol,F,100,45,0,45
Treanthony,M,100,0,20,20
Drex,M,100,0,13,13
Ferman,M,100,0,499,499
Laramee,F,100,10,0,10
Lakeya,F,100,1211,0,1211
Landan,M,100,5,1949,1954
Kemoni,F,54,238,201,439
Trevarius,M,100,0,56,56
Jodiel,M,100,0,5,5
Hutch,M,100,0,220,220
Roze,F,100,13,0,13
Keyaira,F,100,894,0,894
Brittanya,F,100,123,0,123
Danielee,F,100,5,0,5
Zykevious,M,100,0,5,5
Aylianna,F,100,5,0,5
Shehryar,M,100,0,10,10
Fredia,F,100,1057,0,1057
Cellia,F,100,5,0,5
Simara,F,100,114,0,114
Kiyani,F,100,65,0,65
Pecos,M,100,0,16,16
Kiryn,F,77,56,17,73
Taylar,F,99,2345,27,2372
Mignonne,F,100,30,0,30
Genessis,F,100,913,0,913
Rais,M,100,0,5,5
Aleighya,F,100,49,0,49
Ilay,M,100,0,28,28
Huston,M,100,0,921,921
Lecia,F,100,1148,0,1148
Dementrius,M,100,0,16,16
Tyleshia,F,100,18,0,18
Broxton,M,100,0,186,186
Shannda,F,100,13,0,13
Lakeysha,F,100,1225,0,1225
Joyell,F,100,89,0,89
Ralon,M,100,0,5,5
Jovetta,F,100,7,0,7
Macaulay,M,92,15,172,187
Lyzbeth,F,100,63,0,63
Kylematthew,M,100,0,11,11
Rosamund,F,100,23,0,23
Richaad,M,100,0,5,5
Hazell,F,100,91,0,91
Gralin,M,100,0,49,49
Binh,M,93,38,472,510
Monserratte,F,100,6,0,6
Freeda,F,100,364,0,364
Pinchas,M,100,0,756,756
Faris,M,99,10,1767,1777
Citalli,F,100,32,0,32
Aashman,M,100,0,5,5
Kezion,M,100,0,5,5
Taner,M,100,0,542,542
Dzung,M,100,0,10,10
Samanthe,F,100,24,0,24
Carmenlita,F,100,42,0,42
Aiana,F,100,133,0,133
Treyston,M,100,0,5,5
Nehimiah,M,100,0,13,13
Yulunda,F,100,11,0,11
Suchi,F,100,15,0,15
Tamella,F,100,94,0,94
Vonnesha,F,100,6,0,6
Rebeccalynn,F,100,60,0,60
Kieron,M,100,0,621,621
Denysse,F,100,6,0,6
Emalina,F,100,74,0,74
Barabra,F,100,42,0,42
Sanjit,M,100,0,127,127
Lynnesha,F,100,11,0,11
Dayanis,F,100,68,0,68
Jameelah,F,100,1128,0,1128
Tanayzia,F,100,5,0,5
Nicholous,M,100,0,129,129
Kash,M,99,44,4436,4480
Lilamae,F,100,5,0,5
Chandria,F,100,192,0,192
Naquitta,F,100,5,0,5
Talley,F,90,287,33,320
Majour,M,100,0,29,29
Allinah,F,100,5,0,5
Vedha,F,100,105,0,105
Lashonta,F,100,237,0,237
Adna,F,100,291,0,291
Wwlliam,M,100,0,22,22
Patric,M,97,73,2574,2647
Luk,M,100,0,10,10
Shooter,M,100,0,207,207
Aldhair,M,100,0,7,7
Houstin,M,100,0,5,5
Demandre,M,100,0,5,5
Lore,F,100,875,0,875
Miela,F,100,71,0,71
Markwon,M,100,0,15,15
Rubye,F,100,515,0,515
Segen,F,100,35,0,35
Abdulhamid,M,100,0,46,46
Schneider,M,100,0,229,229
Liseli,F,100,5,0,5
Tikvah,F,100,32,0,32
Chaska,M,87,10,67,77
Chelby,F,100,486,0,486
Cherron,F,98,316,5,321
Maciej,M,100,0,293,293
Rinoa,F,100,236,0,236
Anicia,F,100,563,0,563
Gibelly,F,100,6,0,6
Izavier,M,100,0,10,10
Josera,F,100,5,0,5
Shawnea,F,100,52,0,52
Dimitrie,M,100,0,18,18
Ncholas,M,100,0,5,5
Miki,F,96,1639,73,1712
Tinothy,M,100,0,6,6
Key,M,93,10,131,141
Elliannah,F,100,58,0,58
Shaunee,F,100,128,0,128
Maddux,M,94,122,1928,2050
Forman,M,100,0,5,5
Murtis,F,100,6,0,6
Rj,M,100,0,569,569
Dayon,M,98,11,630,641
Tashekia,F,100,22,0,22
Fadil,M,100,0,84,84
Rashine,M,100,0,11,11
Elianne,F,100,99,0,99
Hammed,M,100,0,7,7
Seriniti,F,100,5,0,5
Christlyn,F,100,24,0,24
Prestley,F,100,10,0,10
Jaredd,M,100,0,7,7
Daxin,M,100,0,11,11
Akima,F,100,73,0,73
Shantina,F,100,366,0,366
Iszak,M,100,0,16,16
Quadira,F,100,35,0,35
Maz,M,100,0,5,5
Aqua,F,100,109,0,109
Ferenc,M,100,0,37,37
Naudya,F,100,12,0,12
Pheona,F,100,47,0,47
Sumia,F,100,5,0,5
Verania,F,100,249,0,249
Pranav,M,100,0,3236,3236
Lumumba,M,100,0,49,49
Abraheem,M,100,0,17,17
Quienton,M,100,0,20,20
Tammmy,F,100,5,0,5
Telvis,M,100,0,21,21
Hernan,M,100,0,4369,4369
Kias,M,100,0,5,5
Maryum,F,100,267,0,267
Shalo,F,100,5,0,5
Yasaman,F,100,108,0,108
Brion,M,97,84,2605,2689
Rhemi,F,87,33,5,38
Williamm,M,100,0,11,11
Jeevan,M,100,0,332,332
Hasitha,F,100,5,0,5
Cambrie,F,100,1170,0,1170
Makin,M,100,0,16,16
Prakash,M,100,0,58,58
Ivar,M,100,0,223,223
Marshaun,M,100,0,724,724
Suprena,F,100,114,0,114
Chiquila,F,100,18,0,18
Tavante,M,100,0,30,30
Daviel,M,100,0,203,203
Mailynn,F,100,132,0,132
Jaqualon,M,100,0,40,40
Lihi,F,100,12,0,12
Saraa,F,100,6,0,6
Keshayla,F,100,63,0,63
Kaly,F,100,418,0,418
Devonia,F,100,179,0,179
Gonzales,M,100,0,31,31
Derwyn,M,100,0,22,22
Dareka,F,100,7,0,7
Lachrista,F,100,97,0,97
Felcia,F,100,130,0,130
Zena,F,100,3546,0,3546
Calesha,F,100,30,0,30
Kasonya,F,100,19,0,19
Dinahlee,F,100,20,0,20
Dantoni,M,100,0,11,11
Jayquon,M,100,0,65,65
Yexiel,M,100,0,5,5
Niloufar,F,100,35,0,35
Anayancy,F,100,27,0,27
Madalinn,F,100,10,0,10
Clera,F,100,30,0,30
Chare,F,100,5,0,5
Jacenda,F,100,10,0,10
Tyrique,M,100,0,1704,1704
Treyshun,M,100,0,7,7
Shakeah,F,100,5,0,5
Avien,M,100,0,137,137
Maximiano,M,100,0,125,125
Daid,M,100,0,29,29
Alaynia,F,100,5,0,5
Kyra,F,100,32931,23,32954
Megana,F,100,36,0,36
Dyer,M,100,0,12,12
Jimarion,M,100,0,29,29
Nekesia,F,100,5,0,5
Kinjal,F,100,87,0,87
Ajaycia,F,100,8,0,8
Eriko,F,100,78,0,78
Baylor,M,77,715,2453,3168
Gaileen,F,100,5,0,5
Kinlyn,F,100,30,0,30
Sesilia,F,100,91,0,91
Tamieko,F,100,5,0,5
Taranda,F,100,11,0,11
Esmarie,F,100,13,0,13
Ricquel,F,100,134,0,134
Rozan,F,100,35,0,35
Daresha,F,100,46,0,46
Anastasia,F,100,33859,23,33882
Rmon,M,100,0,6,6
Gaige,M,97,104,3862,3966
Lakeeshia,F,100,28,0,28
Keyairah,F,100,53,0,53
Ailed,F,100,216,0,216
Jarline,F,100,5,0,5
Ktina,F,100,6,0,6
Rosaliz,F,100,5,0,5
Nadar,M,100,0,5,5
Jimmy,M,99,1201,176536,177737
Nazarena,F,100,5,0,5
Maya,F,100,79277,152,79429
Roux,F,77,23,7,30
Silbia,F,100,45,0,45
Anferne,M,100,0,5,5
Travione,M,100,0,15,15
Zayneb,F,100,60,0,60
Breen,F,100,5,0,5
Yury,F,92,190,17,207
Sniya,F,100,18,0,18
Alezandro,M,100,0,11,11
Elleanna,F,100,245,0,245
Neesa,F,100,135,0,135
Vertis,M,87,31,215,246
Denetria,F,100,266,0,266
Doralyn,F,100,50,0,50
Ronalee,F,100,165,0,165
Ediel,M,100,0,236,236
Khaiden,M,100,0,128,128
Ny,F,100,11,0,11
Vionna,F,100,6,0,6
Caitria,F,100,10,0,10
Darmarcus,M,100,0,5,5
Rojean,F,100,66,0,66
Ajon,M,100,0,38,38
Mohamedali,M,100,0,43,43
Marchand,F,58,7,5,12
Noeme,F,100,6,0,6
Danyiel,F,100,89,0,89
Serra,F,100,674,0,674
Lehuanani,F,100,12,0,12
Reyly,M,100,0,42,42
Kiomi,F,100,5,0,5
Calayah,F,100,33,0,33
Jeanina,F,100,51,0,51
Jaeon,M,100,0,52,52
Marinna,F,100,410,0,410
Tahtyana,F,100,10,0,10
Edis,M,96,5,112,117
Allisen,F,100,348,0,348
Sequoia,F,91,3038,317,3355
Lilyanna,F,100,2996,0,2996
Tyyon,M,100,0,24,24
Katerin,F,100,804,0,804
Kendle,F,64,326,182,508
Azaleigha,F,100,5,0,5
Jalasha,F,100,10,0,10
Naomi,F,100,86264,117,86381
Lazariyah,F,100,5,0,5
Seangabriel,M,100,0,5,5
Shakitta,F,100,6,0,6
Purity,F,100,166,0,166
Adysan,F,100,7,0,7
Taysen,M,100,0,129,129
Biranna,F,100,9,0,9
Martavious,M,100,0,1148,1148
Johnallen,M,100,0,20,20
Ekambir,M,100,0,5,5
Aranza,F,100,1120,0,1120
Ramah,F,100,52,0,52
Deontavious,M,100,0,28,28
Shenikia,F,100,5,0,5
Fathia,F,100,30,0,30
Reveille,F,100,8,0,8
Queneshia,F,100,5,0,5
Kambree,F,100,1014,0,1014
Damir,M,100,0,1168,1168
Rosali,F,100,116,0,116
Nuran,F,100,5,0,5
Deriana,F,100,74,0,74
Maryjose,F,100,52,0,52
Shailey,F,100,349,0,349
Zhivago,M,100,0,5,5
Devoni,F,100,5,0,5
Avrill,F,100,5,0,5
Ariyani,F,100,18,0,18
Tan,M,98,11,571,582
Laiah,F,100,147,0,147
Jacyeon,M,100,0,10,10
Coralline,F,100,6,0,6
Sirchristopher,M,100,0,5,5
Lakiea,F,100,30,0,30
Namya,F,100,205,0,205
Ogheneruno,M,100,0,5,5
Jennavi,F,100,5,0,5
Shikeyla,F,100,5,0,5
Kynzi,F,100,138,0,138
Hikma,F,100,22,0,22
Shamya,F,100,2027,0,2027
Feleica,F,100,68,0,68
Tamisa,F,100,10,0,10
Demanuel,M,100,0,5,5
Florencio,M,100,0,1783,1783
Demetirus,M,100,0,6,6
Rosalia,F,100,4533,0,4533
Francena,F,100,211,0,211
Shadeed,M,100,0,181,181
Lillian,F,100,133332,242,133574
Hrehaan,M,100,0,6,6
Pinkie,F,100,508,0,508
Oteria,F,100,10,0,10
Dalayza,F,100,47,0,47
Tynlie,F,100,10,0,10
Zahra,F,100,3989,0,3989
Linesha,F,100,6,0,6
Dusti,F,99,1733,9,1742
Cleidy,F,100,6,0,6
Shanicia,F,100,25,0,25
Max,M,100,334,89430,89764
Francene,F,100,1109,0,1109
Ligaya,F,100,60,0,60
Desirai,F,100,70,0,70
Jahkeem,M,100,0,197,197
Kamayia,F,100,12,0,12
Pacience,F,100,25,0,25
Aviyonna,F,100,5,0,5
Aidana,F,100,11,0,11
Douaa,F,100,5,0,5
Deboran,F,100,33,0,33
Drewey,M,100,0,11,11
Ro,F,100,5,0,5
Kizi,F,100,7,0,7
Tarri,F,100,280,0,280
Jeramaine,M,100,0,12,12
Nekeshia,F,100,125,0,125
Deveni,F,100,5,0,5
Joshau,M,100,0,247,247
Demetrish,F,100,5,0,5
Keiasha,F,100,85,0,85
Tabbatha,F,100,748,0,748
Rasheim,M,100,0,31,31
Brentwood,M,100,0,5,5
Yukta,F,100,30,0,30
Angula,F,100,53,0,53
Jonquil,F,79,209,55,264
Govinda,M,100,0,27,27
Alazah,F,100,7,0,7
Komal,F,100,631,0,631
Jaystin,M,100,0,55,55
Windale,M,100,0,5,5
Navil,F,96,117,5,122
Rhnea,F,100,5,0,5
Sylus,M,100,0,621,621
Kilani,F,100,76,0,76
Yoona,F,100,31,0,31
Margena,F,100,12,0,12
Jaymee,F,99,1938,23,1961
Evelyse,F,100,12,0,12
Jeran,M,98,8,477,485
Adyson,F,99,3556,28,3584
Shemecka,F,100,8,0,8
Caylub,M,100,0,6,6
Latray,M,100,0,31,31
Daiven,M,100,0,35,35
Zahiya,F,100,16,0,16
Bia,F,100,5,0,5
Makylah,F,100,408,0,408
Breyon,M,86,95,586,681
Deone,F,58,152,110,262
Mayven,F,100,11,0,11
Tamira,F,100,2018,0,2018
Yaxeni,F,100,23,0,23
Spirit,F,99,544,5,549
Karanveer,M,100,0,118,118
Theodoros,M,100,0,343,343
Edder,M,100,0,281,281
Damini,F,100,46,0,46
Sharree,F,100,23,0,23
Kyrian,M,97,5,182,187
Juhee,F,100,21,0,21
Leilane,F,100,10,0,10
Khaylah,F,100,25,0,25
Servando,M,100,0,1697,1697
Asar,M,100,0,41,41
Jussica,F,100,6,0,6
Fenton,M,100,0,799,799
Alieza,F,100,22,0,22
Jakari,M,93,175,2199,2374
Tinlee,F,100,136,0,136
Keyunna,F,100,174,0,174
Demaurio,M,100,0,5,5
Bayyinah,F,100,73,0,73
Tanyon,M,100,0,151,151
Uroosa,F,100,16,0,16
Zavin,M,100,0,32,32
Chawana,F,100,19,0,19
Sinaiya,F,100,5,0,5
Twilla,F,100,651,0,651
Niquel,F,100,5,0,5
Jaxson,M,100,49,26109,26158
Dkari,M,100,0,33,33
Tekeema,F,100,23,0,23
Alaiyah,F,100,590,0,590
Raven,F,93,36584,2795,39379
Kayslee,F,100,24,0,24
Sateria,F,100,17,0,17
Ayodele,M,70,98,231,329
Eryck,M,100,0,159,159
Matthaus,M,100,0,10,10
Azryel,M,100,0,5,5
Sanitra,F,100,5,0,5
Brack,M,100,0,190,190
Cataliyah,F,100,10,0,10
Kievan,M,100,0,6,6
Kerin,F,83,1262,252,1514
Emmilyn,F,100,112,0,112
Rehana,F,100,267,0,267
Allia,F,100,311,0,311
Maeleah,F,100,11,0,11
Chuka,M,100,0,10,10
Mackinze,F,100,136,0,136
Cimora,F,100,7,0,7
Lashowna,F,100,5,0,5
Carl,M,99,1445,220456,221901
Mihailo,M,100,0,51,51
Alim,M,100,0,526,526
Alis,F,98,280,5,285
Jauna,F,100,95,0,95
Markavious,M,100,0,74,74
Jolana,F,100,71,0,71
Sapana,F,100,12,0,12
Renuka,F,100,90,0,90
Sabreena,F,100,588,0,588
Quillan,M,100,0,251,251
Jangelo,M,100,0,5,5
Shanniya,F,100,5,0,5
Macie,F,100,13947,0,13947
Zyrin,M,100,0,10,10
Rozzlyn,F,100,5,0,5
Jerris,M,72,47,118,165
Huyen,F,100,276,0,276
Jaicen,M,100,0,5,5
Peteris,M,100,0,5,5
Siomara,F,100,650,0,650
Bralen,M,98,5,276,281
Tahmya,F,100,11,0,11
Lillyah,F,100,5,0,5
Corwin,M,100,0,3245,3245
Sonny,M,96,545,12749,13294
Zoribel,F,100,14,0,14
Yahari,F,100,5,0,5
Nazeer,M,100,0,195,195
Devonne,F,58,893,649,1542
Latresia,F,100,53,0,53
Raegina,F,100,6,0,6
Janaliz,F,100,6,0,6
Maari,F,100,17,0,17
Ivannia,F,100,56,0,56
Naema,F,100,57,0,57
Naython,M,100,0,23,23
Madeeha,F,100,61,0,61
Keirstan,F,100,118,0,118
Raeyah,F,100,6,0,6
Hannie,F,100,6,0,6
Nneka,F,100,1162,0,1162
Decklan,M,100,0,212,212
Mont,M,100,0,249,249
Brandiss,F,100,15,0,15
Anterrion,M,100,0,15,15
Latanza,F,100,80,0,80
Brannick,M,100,0,5,5
Rumer,F,100,31,0,31
Ellymae,F,100,5,0,5
Marjae,F,100,13,0,13
Huntter,M,100,0,53,53
Janiylah,F,100,90,0,90
Kayann,F,100,199,0,199
Shaneva,F,100,18,0,18
Zeporia,F,100,5,0,5
Sulieman,M,100,0,11,11
Avital,F,100,719,0,719
Alma,F,98,39547,733,40280
Wuendy,F,100,20,0,20
Henesy,F,100,7,0,7
Kyari,F,100,28,0,28
Kaiesha,F,100,92,0,92
Montrice,F,70,208,88,296
Icole,F,100,19,0,19
Izella,F,100,87,0,87
Jacab,M,100,0,10,10
Kalley,F,100,648,0,648
Jameica,F,100,74,0,74
Valentyna,F,100,13,0,13
Moriah,F,99,10933,94,11027
Dezha,F,100,41,0,41
Chynah,F,100,137,0,137
Jaxtin,M,100,0,132,132
Chrysanthemum,F,100,16,0,16
Demeatrice,F,69,41,18,59
Cassandria,F,100,72,0,72
Edjuan,M,100,0,20,20
Marcellia,F,100,26,0,26
Shawndre,M,100,0,22,22
Zamiyah,F,100,643,0,643
Adrina,F,100,1323,0,1323
Kasmira,F,100,140,0,140
Saud,M,100,0,290,290
Loyalti,F,100,21,0,21
Daizjah,F,100,10,0,10
Martha,F,100,172741,671,173412
Lealand,M,100,0,129,129
Winter,F,94,6459,448,6907
Magnum,M,100,0,227,227
Kaamil,M,100,0,73,73
Maciah,F,56,129,100,229
Miina,F,100,5,0,5
Brecia,F,100,5,0,5
Ghaida,F,100,16,0,16
Carleisha,F,100,26,0,26
Laqresha,F,100,6,0,6
Taaha,M,100,0,15,15
Maylina,F,100,10,0,10
Anakarina,F,100,34,0,34
Darone,M,100,0,5,5
Joshanae,F,100,5,0,5
Adalis,F,100,165,0,165
Serenitey,F,100,11,0,11
Shinea,F,100,17,0,17
Shikhar,M,100,0,15,15
Oniesha,F,100,31,0,31
Phebie,F,100,5,0,5
Tanda,F,100,439,0,439
Khloee,F,100,886,0,886
Jeden,M,100,0,5,5
Iric,M,100,0,21,21
Artemy,M,100,0,5,5
Mellani,F,100,5,0,5
Jesley,F,100,46,0,46
Shi,F,82,314,69,383
Keyonce,F,100,52,0,52
Erec,M,100,0,6,6
Annam,F,100,21,0,21
Arayeli,F,100,5,0,5
Benino,M,100,0,32,32
Christop,M,100,0,1082,1082
Shondreka,F,100,34,0,34
Cesear,M,100,0,12,12
Shayann,F,100,152,0,152
Kealana,F,100,5,0,5
Sammijo,F,100,40,0,40
Kaselynn,F,100,21,0,21
Mehtaab,M,100,0,16,16
Passionae,F,100,5,0,5
Undra,M,88,75,558,633
Larodney,M,100,0,5,5
Natori,F,98,354,6,360
Jonylah,F,100,22,0,22
Sherril,F,99,1076,15,1091
Tavita,M,77,34,116,150
Ladaja,F,100,126,0,126
Loreli,F,100,484,0,484
Annais,F,100,269,0,269
Corney,M,100,0,59,59
Jazminne,F,100,34,0,34
Lachlyn,F,100,26,0,26
Demorio,M,100,0,71,71
Eldredge,M,100,0,10,10
Djellza,F,100,7,0,7
Eathan,M,100,0,1090,1090
Solae,F,100,103,0,103
Temre,F,100,13,0,13
Datrice,F,100,5,0,5
Khalil,M,99,127,14905,15032
Jerimyah,M,100,0,219,219
Elizar,M,100,0,65,65
Mirakal,F,100,6,0,6
Bracha,F,100,1615,0,1615
Sherli,F,100,10,0,10
Tareia,F,100,5,0,5
Saveyon,M,100,0,5,5
Zohie,F,100,26,0,26
Malyki,M,100,0,45,45
Gerda,F,100,138,0,138
Ryeisha,F,100,26,0,26
Malialani,F,100,5,0,5
Ranzy,M,100,0,5,5
Birch,M,100,0,163,163
Shuana,F,100,42,0,42
Kemyiah,F,100,9,0,9
Lacrecia,F,100,382,0,382
Samarpreet,M,100,0,5,5
Donterrius,M,100,0,114,114
Qwanell,M,100,0,51,51
Merette,F,100,5,0,5
Nithish,M,100,0,7,7
Markeida,F,100,5,0,5
Cyrstal,F,100,962,0,962
Kealoha,F,53,36,32,68
Tenly,F,100,27,0,27
Zariyah,F,100,2816,0,2816
Raleigh,M,72,1502,3894,5396
Dynasia,F,100,190,0,190
Breh,M,100,0,5,5
Andela,F,100,11,0,11
Jacaryous,M,100,0,5,5
Shanteka,F,100,36,0,36
Sheretha,F,100,74,0,74
Konstantine,M,98,6,307,313
Quisha,F,100,58,0,58
Huan,M,100,0,87,87
Bristen,F,59,22,15,37
Joash,M,100,0,222,222
Lorenza,M,57,1472,1933,3405
Vishwak,M,100,0,16,16
Iyesha,F,100,269,0,269
Cosima,F,100,97,0,97
Kemilly,F,100,11,0,11
Chadwic,M,100,0,11,11
Tonisa,F,100,5,0,5
Sanav,M,100,0,15,15
Dawnel,F,100,22,0,22
Shaquoia,F,100,72,0,72
Hollee,F,100,693,0,693
Luar,M,100,0,5,5
Rexie,M,100,0,5,5
Diovanni,M,100,0,54,54
Anneth,F,100,149,0,149
Jeannetta,F,100,731,0,731
Aadvika,F,100,13,0,13
Shandra,F,100,3006,0,3006
Kiera,F,100,18527,19,18546
Kissy,F,100,136,0,136
Kamilah,F,100,3820,0,3820
Caitlan,F,100,1047,0,1047
Canyn,M,100,0,7,7
Adriel,M,92,663,7356,8019
Cristobal,M,100,11,6054,6065
Iyunna,F,100,21,0,21
Dibbie,F,100,43,0,43
Chimene,F,100,223,0,223
Jalaina,F,100,133,0,133
Mahan,M,100,0,23,23
Ericlee,M,100,0,10,10
Kapiolani,F,100,17,0,17
Amgela,F,100,11,0,11
Sahibjot,M,100,0,21,21
Rolonda,F,100,484,0,484
Danayjah,F,100,5,0,5
Emika,F,100,54,0,54
Jonethen,M,100,0,6,6
Cylee,F,100,324,0,324
Suhaas,M,100,0,78,78
Alfredia,F,100,748,0,748
Davuan,M,100,0,5,5
Xitlally,F,100,136,0,136
Daney,F,90,57,6,63
Liara,F,100,211,0,211
Jimia,F,100,92,0,92
Ngun,F,100,20,0,20
Kaylla,F,100,191,0,191
Mariasha,F,100,5,0,5
Madalynne,F,100,502,0,502
Linelle,F,100,39,0,39
Abriela,F,100,41,0,41
Deidree,F,100,23,0,23
Vereniz,F,100,13,0,13
Aviraj,M,100,0,41,41
Jadaria,F,100,6,0,6
Blaney,F,100,7,0,7
Trilby,F,100,223,0,223
Chadsity,F,100,38,0,38
Danera,F,100,5,0,5
Tsunami,F,100,12,0,12
Miya,F,100,5761,0,5761
Terika,F,100,637,0,637
Emilia,F,100,18679,0,18679
Jacayden,M,100,0,38,38
Shariyf,M,100,0,20,20
Guila,F,100,8,0,8
Dvora,F,100,106,0,106
Phila,F,100,5,0,5
Talissia,F,100,5,0,5
Alayah,F,100,3714,0,3714
Avalise,F,100,27,0,27
Marly,F,100,1289,5,1294
Deshown,M,100,0,6,6
Anikait,M,100,0,19,19
Hollan,F,89,77,10,87
Shamanda,F,100,79,0,79
Itzhel,F,100,19,0,19
Adesuwa,F,100,93,0,93
Spence,M,100,0,833,833
Swiyyah,F,100,12,0,12
Jusuf,M,100,0,32,32
Muntasir,M,100,0,25,25
Horus,M,100,0,5,5
Aricely,F,100,6,0,6
Decorian,M,100,0,229,229
Morgun,M,100,0,49,49
Alquan,M,100,0,150,150
Loriana,F,100,328,0,328
Darshelle,F,100,5,0,5
Lasiyah,F,100,6,0,6
Esthefany,F,100,186,0,186
Andaiye,F,100,5,0,5
Nyesha,F,100,1510,0,1510
Soo,F,91,193,18,211
Amaira,F,100,176,0,176
Dynesty,F,100,37,0,37
Malita,F,100,109,0,109
Dreyven,M,100,0,5,5
Barin,M,100,0,11,11
Chrysta,F,100,561,0,561
Margaree,F,100,95,0,95
Qwintin,M,100,0,5,5
Lucillia,F,100,30,0,30
Liesl,F,100,1586,0,1586
Cleola,F,100,122,0,122
Channin,M,57,45,60,105
Maira,F,100,5646,17,5663
Aida,F,100,9344,5,9349
Jemiyah,F,100,33,0,33
Nikoleta,F,100,51,0,51
Amitha,F,100,10,0,10
Georgiane,F,100,5,0,5
Torance,M,52,39,42,81
Cheyanne,F,100,14350,0,14350
Koby,M,99,55,5075,5130
Taeveon,M,100,0,159,159
Kyrstal,F,100,128,0,128
Bush,M,100,0,13,13
Genese,F,100,346,0,346
Zenae,F,100,24,0,24
Shatia,F,100,635,0,635
Emannuel,M,100,0,61,61
Brik,M,100,0,33,33
Pattijo,F,100,88,0,88
Najayah,F,100,21,0,21
Aubrye,F,100,41,0,41
Joshlyn,F,100,1138,5,1143
Mina,F,94,7621,497,8118
Musette,F,100,10,0,10
Shatiana,F,100,11,0,11
Kayan,M,94,7,115,122
Jaquana,F,100,399,0,399
Alazae,F,100,259,0,259
Arnee,F,100,6,0,6
Wendye,F,100,28,0,28
Jairon,M,100,0,346,346
Tylasha,F,100,10,0,10
Larnelle,M,100,0,5,5
Kniko,M,100,0,10,10
Tidus,M,100,0,305,305
Quientin,M,100,0,69,69
Donya,F,89,2175,265,2440
Einar,M,100,0,337,337
Jenneifer,F,100,13,0,13
Avaiya,F,100,34,0,34
Chandon,M,100,0,292,292
Marlyin,F,100,12,0,12
Mkiyah,F,100,10,0,10
Adrialis,F,100,8,0,8
Jewelene,F,100,68,0,68
Ajane,F,100,99,0,99
Dionta,M,100,0,359,359
Janic,F,100,5,0,5
Roudy,M,100,0,21,21
Destin,M,89,613,4763,5376
Saritha,F,100,6,0,6
Ronshay,F,100,5,0,5
Tameron,M,69,53,117,170
Toye,F,95,338,16,354
Shanecia,F,100,92,0,92
Zaniya,F,100,2542,0,2542
Alkeria,F,100,6,0,6
Jevette,F,100,5,0,5
Norena,F,100,31,0,31
Tarran,F,51,39,37,76
Jayliani,F,100,34,0,34
Jhonen,M,100,0,50,50
Janis,F,100,27297,95,27392
Milea,F,100,117,0,117
Kacei,F,100,6,0,6
Amahya,F,100,11,0,11
Koah,M,100,0,123,123
Adammichael,M,100,0,6,6
Enzo,M,100,0,6829,6829
Annalysia,F,100,138,0,138
Juandiego,M,100,0,566,566
Brayten,M,100,0,142,142
Jarion,M,100,0,208,208
Kayleeanna,F,100,14,0,14
Contina,F,100,484,0,484
Anda,F,100,157,0,157
Mahkayla,F,100,169,0,169
Macheala,F,100,10,0,10
Kalub,M,100,0,622,622
Nicie,F,100,5,0,5
Alanson,M,100,0,52,52
Jaziya,F,100,236,0,236
Aseneth,F,100,22,0,22
Kemberly,F,100,1480,0,1480
Levonte,M,100,0,231,231
Aimsley,F,100,18,0,18
Taesha,F,100,198,0,198
Kaylia,F,100,683,0,683
Sheneda,F,100,5,0,5
Barbarette,F,100,16,0,16
Oluwafolahanmi,M,100,0,5,5
Zerin,M,100,0,29,29
Azaleigh,F,100,5,0,5
Brittannie,F,100,63,0,63
Yanis,M,65,92,170,262
Avionna,F,100,448,0,448
Paddy,F,60,57,38,95
Paizlee,F,100,406,0,406
Sujin,F,100,32,0,32
Raemona,F,100,5,0,5
Larayne,F,100,101,0,101
Eduar,M,100,0,119,119
Nellee,F,100,5,0,5
Skyelar,F,77,529,156,685
Rafik,M,100,0,53,53
Rakesha,F,100,123,0,123
Waino,M,100,0,6,6
Delbra,F,100,319,0,319
Brienne,F,100,1253,5,1258
Taishawn,M,100,0,113,113
Classie,F,100,368,0,368
Kazuki,M,100,0,319,319
Forrester,M,100,0,75,75
Nakiya,F,100,1617,5,1622
Darliene,F,100,10,0,10
Bryann,F,77,352,103,455
Guyann,F,100,5,0,5
Khamia,F,100,64,0,64
Nyiesha,F,100,225,0,225
Dyke,M,100,0,206,206
Erisa,F,100,63,0,63
Akihiro,M,100,0,32,32
Michealanthony,M,100,0,5,5
Thi,F,86,397,63,460
Shande,M,63,7,12,19
Marlise,F,100,344,0,344
Carlinda,F,100,77,0,77
Aslan,M,90,50,465,515
Bhoomi,F,100,32,0,32
Hanah,F,100,1874,0,1874
Abbigaile,F,100,91,0,91
Keshyra,F,100,12,0,12
Tammyra,F,100,5,0,5
Dionna,F,100,3601,5,3606
Furqan,M,100,0,88,88
Glenville,M,100,0,5,5
Jasalynn,F,100,57,0,57
Katty,F,100,817,0,817
Karalena,F,100,26,0,26
Eryk,M,100,0,886,886
Hurshel,M,100,0,91,91
Shunita,F,100,28,0,28
Marvic,M,100,0,5,5
Murielle,F,100,129,0,129
Walterine,F,100,63,0,63
Shakea,F,100,138,0,138
Tatsiana,F,100,5,0,5
Daralyn,F,100,317,0,317
Tetra,F,100,10,0,10
Lakesha,F,100,8168,6,8174
Nichalus,M,100,0,10,10
Adrienn,F,79,27,7,34
Zyel,M,100,0,24,24
Zobeida,F,100,26,0,26
Ozkar,M,100,0,5,5
Summayah,F,100,5,0,5
Nolee,F,100,48,0,48
Malcoln,M,100,0,7,7
Rohen,M,100,0,98,98
Kyleigha,F,100,69,0,69
Taurius,M,100,0,5,5
Cinthia,F,100,5826,6,5832
Gene,M,98,1164,46610,47774
Keonnie,F,100,5,0,5
Jamilex,F,100,343,0,343
Jess,M,98,306,12372,12678
Jonthomas,M,100,0,43,43
Deaglan,M,100,0,278,278
Jeyceon,M,100,0,5,5
Shenice,F,100,261,0,261
Cheza,F,100,28,0,28
Taevian,M,100,0,21,21
Jamason,M,100,0,200,200
Josman,M,100,0,15,15
Bene,F,100,5,0,5
Vernica,F,100,145,0,145
Anorea,F,100,10,0,10
Kalika,F,100,245,0,245
Kimika,F,100,104,0,104
Jatara,F,100,185,0,185
Emariya,F,100,6,0,6
Karmyne,M,100,0,44,44
Vickki,F,100,97,0,97
Vang,M,97,11,325,336
Juliaann,F,100,30,0,30
Kimbly,F,100,135,0,135
Sondria,F,100,10,0,10
Laighla,F,100,21,0,21
Marsea,F,100,5,0,5
Shaquida,F,100,34,0,34
Claudetta,F,100,110,0,110
Tameika,F,100,1535,0,1535
Nyelah,F,100,59,0,59
Nealie,F,100,93,0,93
Jaywana,F,100,20,0,20
Riku,M,100,0,282,282
Caycee,F,100,349,0,349
Persephone,F,100,1567,0,1567
Cesarina,F,100,12,0,12
Orvis,M,100,0,67,67
Ladean,F,98,208,5,213
Arlie,M,78,451,1605,2056
Numair,M,100,0,51,51
Drashti,F,100,6,0,6
Shaunika,F,100,54,0,54
Romance,M,100,0,45,45
Adelaine,F,100,244,0,244
Ratonya,F,100,10,0,10
Malaree,F,100,33,0,33
Neylin,F,100,18,0,18
Epiphany,F,100,648,0,648
Frantz,M,100,0,997,997
Jalexie,F,100,5,0,5
Koron,M,100,0,130,130
Trayten,M,100,0,38,38
Aashritha,F,100,113,0,113
Sochil,F,100,18,0,18
Alissandra,F,100,317,0,317
Adan,M,100,84,22542,22626
Trennan,M,100,0,5,5
Litzie,F,100,12,0,12
Okley,M,100,0,6,6
Kibibi,F,100,27,0,27
Quamane,M,100,0,45,45
Abigaile,F,100,542,0,542
Aziah,F,66,534,281,815
Merissa,F,100,3373,0,3373
Shakina,F,100,668,0,668
Sancho,M,100,0,34,34
Coraima,F,100,589,0,589
Muriel,F,99,5519,68,5587
Jelissa,F,100,847,0,847
Yaaseen,M,100,0,13,13
Boomer,M,100,0,15,15
Yeiry,F,100,6,0,6
Keenan,M,98,329,15800,16129
Patrisa,F,100,5,0,5
Pablita,F,100,6,0,6
Tamla,F,100,358,0,358
Hessie,F,100,37,0,37
Seve,M,100,0,185,185
Carlena,F,100,1092,0,1092
Cheresa,F,100,108,0,108
Tazz,M,100,0,41,41
Zaevian,M,100,0,16,16
Vawn,F,100,5,0,5
Quentin,M,99,178,33588,33766
Hassen,M,100,0,155,155
Normando,M,100,0,10,10
Abdoulaye,M,100,0,556,556
Khaleal,M,100,0,19,19
Alijandro,M,100,0,10,10
Tarolyn,F,100,16,0,16
Drew,M,92,6298,69574,75872
Janeyah,F,100,37,0,37
Chastain,F,50,5,5,10
Joushua,M,100,0,90,90
Ghadeer,F,100,91,0,91
Doha,F,100,108,0,108
Quortney,F,100,5,0,5
Pashun,F,100,6,0,6
Lasha,F,100,1033,0,1033
Shinetta,F,100,6,0,6
Cleotilde,F,100,91,0,91
Temitayo,M,60,39,58,97
Harriett,F,100,3593,0,3593
Keunta,M,100,0,5,5
Nafeesa,F,100,192,0,192
Karrina,F,100,217,0,217
Lakaila,F,100,24,0,24
Meliah,F,100,487,0,487
Kylo,M,100,0,25,25
Mireyda,F,100,11,0,11
Aleandra,F,100,5,0,5
Baxton,M,100,0,28,28
Creedance,F,58,7,5,12
Marth,F,100,15,0,15
Lebria,F,100,5,0,5
Karrington,F,82,1105,249,1354
Charlona,F,100,5,0,5
Nykeisha,F,100,54,0,54
Tully,M,94,40,655,695
Tayzia,F,100,23,0,23
Algirdas,M,100,0,22,22
Tiaka,F,100,5,0,5
Tong,M,100,0,299,299
Braeson,M,100,0,61,61
Reche,M,100,0,5,5
Jakaiya,F,100,136,0,136
Davi,M,67,439,885,1324
Padriac,M,100,0,5,5
Naly,F,100,63,0,63
Waylon,M,100,16,13654,13670
Amary,F,89,40,5,45
Agamjot,M,100,0,23,23
Oluwatumininu,F,100,5,0,5
Andrell,M,70,134,306,440
Zaydian,M,100,0,12,12
Ronique,F,97,329,10,339
Audryanna,F,100,113,0,113
Kasra,M,100,0,230,230
Jaquayvion,M,100,0,10,10
Jami,F,96,21294,900,22194
Wilhelminia,F,100,10,0,10
Pamula,F,100,662,0,662
Raegyn,F,100,191,0,191
Raeley,F,100,183,0,183
Merrilynn,F,100,7,0,7
Nashid,M,100,0,64,64
Shequanna,F,100,5,0,5
Kaisen,M,99,6,426,432
Nikolis,M,100,0,122,122
Halea,F,100,235,0,235
Qwanesha,F,100,8,0,8
Karston,M,100,0,460,460
Kinga,F,100,178,0,178
Mendel,M,100,0,1726,1726
Roham,M,100,0,6,6
Bryheem,M,100,0,26,26
Whelan,M,100,0,5,5
Adley,F,81,1149,261,1410
Alyxandria,F,100,530,0,530
Wesleigh,F,97,138,5,143
Jarelyn,F,100,66,0,66
Zaevion,M,100,0,149,149
Jafer,M,100,0,5,5
Jetoi,F,100,5,0,5
Mory,M,100,0,68,68
Xaniya,F,100,39,0,39
Yisenia,F,100,5,0,5
Saedee,F,100,10,0,10
Nevach,F,100,5,0,5
Amaleah,F,100,10,0,10
Neithan,M,100,0,70,70
Dariene,F,100,36,0,36
Dosha,F,100,63,0,63
Shreyasi,F,100,5,0,5
Miyanna,F,100,306,0,306
Vetra,F,100,10,0,10
Srihaan,M,100,0,5,5
Katron,M,100,0,33,33
Mayani,F,100,10,0,10
Payshence,F,100,42,0,42
Eilin,F,100,6,0,6
Aaronette,F,100,11,0,11
Kathrynn,F,100,416,0,416
Janita,F,100,1531,0,1531
Casslyn,F,100,5,0,5
Omarii,M,100,0,35,35
Shele,F,100,5,0,5
Marlenn,F,100,11,0,11
Brodey,M,100,0,1034,1034
Zolan,M,100,0,25,25
Azerion,M,100,0,5,5
Tarrel,M,100,0,49,49
Charlesa,F,100,93,0,93
Dontevion,M,100,0,5,5
Garrett,M,100,451,122299,122750
Leandra,F,99,6265,38,6303
Faraj,M,100,0,18,18
Daunta,M,100,0,5,5
Meghyn,F,100,5,0,5
Racio,F,100,6,0,6
Jamerra,F,100,5,0,5
Somaiya,F,100,20,0,20
Brandalynn,F,100,127,0,127
Kami,F,100,8342,20,8362
Kania,F,100,564,0,564
Jenessia,F,100,5,0,5
Makeesha,F,100,41,0,41
Nancey,F,100,327,0,327
Ilani,F,100,214,0,214
Chadwich,M,100,0,31,31
Franco,M,100,0,5751,5751
Allyx,F,100,42,0,42
Kathyann,F,100,171,0,171
Juanjesus,M,100,0,73,73
Dahlya,F,100,38,0,38
Nayden,M,100,0,87,87
Shanty,F,100,139,0,139
Joe,M,98,3510,180046,183556
Brayden,M,99,927,96518,97445
Liezel,F,100,38,0,38
Kojak,M,100,0,15,15
Evalia,F,100,5,0,5
Tobe,M,93,24,297,321
Azmi,M,100,0,12,12
Randyl,M,83,11,55,66
Kenyetta,F,96,2735,128,2863
Tyrius,M,100,0,11,11
Wailyn,M,100,0,5,5
Jahzarra,F,100,47,0,47
Dana,F,80,182495,44635,227130
Isaha,M,100,0,53,53
Mmichael,M,100,0,5,5
Annel,F,100,499,0,499
Kristee,F,100,500,0,500
Samhitha,F,100,165,0,165
Skyshun,M,100,0,5,5
Axeel,M,100,0,10,10
Zarion,M,100,0,298,298
Carnella,F,100,53,0,53
Thyago,M,100,0,13,13
Ryant,M,100,0,52,52
Champaine,F,100,25,0,25
Chay,M,87,54,366,420
Britzy,F,100,76,0,76
Tydus,M,100,0,178,178
Jelaina,F,100,5,0,5
Destani,F,100,1121,0,1121
Jimell,M,100,0,6,6
Kathalene,F,100,130,0,130
Chistopher,M,100,0,1419,1419
Dalante,M,100,0,85,85
Ameelia,F,100,5,0,5
Tyrica,F,100,64,0,64
Durant,M,100,0,167,167
Nazish,F,100,15,0,15
Chloee,F,100,1448,0,1448
Tristi,F,100,25,0,25
Tito,M,100,0,2601,2601
Jennifer,F,100,1451581,4825,1456406
Huck,M,100,0,338,338
Vlad,M,100,0,349,349
Gabreial,F,100,5,0,5
Meyah,F,100,395,0,395
Zacara,F,100,26,0,26
Alanii,F,100,46,0,46
Cario,M,100,0,5,5
Julyn,F,100,8,0,8
Tyshauna,F,100,74,0,74
Valenica,F,100,22,0,22
Axzel,M,100,0,45,45
Janylah,F,100,368,0,368
Irelyn,F,100,955,0,955
Dashuan,M,100,0,9,9
Moena,F,100,16,0,16
Aowyn,F,100,48,0,48
Nickelous,M,100,0,15,15
Delton,M,100,0,2474,2474
Deondrick,M,100,0,114,114
Evelio,M,100,0,503,503
Laranda,F,100,284,0,284
Eryss,F,100,10,0,10
Vontese,F,100,11,0,11
Koichi,M,100,0,16,16
Fiza,F,100,331,0,331
Darein,M,76,5,16,21
Daian,M,100,0,5,5
Blaydin,M,100,0,12,12
Yunior,M,100,0,232,232
Jordynn,F,98,3318,85,3403
Tydan,M,100,0,14,14
Josgart,M,100,0,8,8
Ze,M,100,0,22,22
Sahej,F,53,46,40,86
Dalijah,F,100,16,0,16
Melenie,F,100,603,0,603
Mikaiya,F,100,65,0,65
Maridee,F,100,96,0,96
Aaryana,F,100,88,0,88
Karol,F,88,6526,898,7424
Eldina,F,100,24,0,24
Nyleah,F,100,125,0,125
Analis,F,100,431,0,431
Marston,M,100,0,107,107
Jacqlynn,F,100,49,0,49
Jakeara,F,100,5,0,5
Tristah,F,100,6,0,6
Degan,M,100,0,439,439
Calantha,F,100,5,0,5
Terrol,M,100,0,42,42
Yehonatan,M,100,0,40,40
Shantera,F,100,84,0,84
Mikyah,F,100,202,0,202
Reyanna,F,100,449,0,449
Ramey,M,58,348,481,829
Lamorris,M,100,0,272,272
Pola,F,100,241,0,241
Alias,M,100,0,494,494
Drevin,M,100,0,103,103
Lovea,F,100,7,0,7
Braun,M,100,0,281,281
Navroop,F,100,10,0,10
Shantrail,F,100,5,0,5
Sheenia,F,100,21,0,21
Takori,M,100,0,5,5
Marline,F,100,878,0,878
Reha,F,100,41,0,41
Kanan,M,96,11,245,256
Kieasha,F,100,5,0,5
Triny,F,100,6,0,6
Dallys,F,100,82,0,82
Mack,M,100,26,13390,13416
Zorina,F,100,126,0,126
Tyice,F,100,5,0,5
Kiyah,F,100,1561,0,1561
Shakyah,F,100,53,0,53
Zamarion,M,100,0,723,723
Keandra,F,99,1363,10,1373
Januell,M,100,0,7,7
Rontavius,M,100,0,51,51
Primavera,F,100,27,0,27
Burch,M,100,0,11,11
Gavon,M,100,0,410,410
Analyn,F,100,308,0,308
Zanea,F,100,24,0,24
Tramarcus,M,100,0,5,5
Cherylanne,F,100,79,0,79
Danyka,F,100,202,0,202
Yaser,M,100,0,330,330
Deboraa,F,100,16,0,16
Noorah,F,100,39,0,39
Aarie,F,100,5,0,5
Zahara,F,100,1678,0,1678
Anjelina,F,100,572,0,572
Darlenis,F,100,5,0,5
Najahwan,M,100,0,7,7
Langston,M,94,215,3297,3512
Seynabou,F,100,125,0,125
Detisha,F,100,5,0,5
Ayisha,F,100,855,0,855
Aiesha,F,100,1237,0,1237
Monisha,F,100,1248,0,1248
Betsabeth,F,100,15,0,15
Jaime,M,57,49400,64380,113780
Calanda,F,100,5,0,5
Maryan,F,100,722,0,722
Dali,F,73,94,34,128
Raylend,M,100,0,5,5
Symphonie,F,100,82,0,82
Chardanae,F,100,10,0,10
Lelanya,F,100,5,0,5
Milez,M,100,0,43,43
Bashawn,M,100,0,44,44
Harika,F,100,87,0,87
Jacarey,M,100,0,6,6
Jaquaris,M,100,0,28,28
Khilen,M,100,0,13,13
Geromy,M,100,0,10,10
Morrisa,F,100,207,0,207
Countess,F,100,91,0,91
Jailin,F,59,293,207,500
Jelina,F,100,158,0,158
Isrrael,M,100,0,504,504
Makasia,F,100,5,0,5
Edurdo,M,100,0,6,6
Omyra,F,100,12,0,12
Kealeigh,F,100,12,0,12
Ferrel,M,100,0,48,48
Loreina,F,100,11,0,11
Deveyon,M,100,0,23,23
Deija,F,100,464,0,464
Sandrina,F,100,69,0,69
Myairah,F,100,5,0,5
Charlicia,F,100,26,0,26
Amista,F,100,5,0,5
Laurietta,F,100,6,0,6
Plinio,M,100,0,5,5
Alivea,F,100,272,0,272
Matina,F,100,329,0,329
Sarica,F,100,5,0,5
Manvir,M,88,23,164,187
Shelby,F,93,130370,10436,140806
Ashaud,M,100,0,5,5
Ayansh,M,100,0,63,63
Yarixa,F,100,159,0,159
Treba,F,100,20,0,20
Barre,M,100,0,37,37
Jewelz,F,76,153,47,200
Xavyer,M,100,0,106,106
Soteria,F,100,53,0,53
Antwin,M,100,0,5,5
Juanesteban,M,100,0,8,8
Amylah,F,100,99,0,99
Valetta,F,100,217,0,217
Rolaine,F,100,5,0,5
Narayan,M,100,0,193,193
Alvie,M,98,24,947,971
Shaan,M,100,0,1630,1630
Dalya,F,100,432,0,432
Zarah,F,100,1323,0,1323
Izelle,F,100,25,0,25
Erza,F,69,36,16,52
Tayvionna,F,100,5,0,5
Jeramee,M,100,0,40,40
Galloway,M,100,0,5,5
Jawaan,M,100,0,199,199
Gershon,M,100,0,587,587
Dayleen,F,100,177,0,177
Viktoria,F,100,1861,0,1861
Rahat,M,90,5,46,51
Edythe,F,100,1214,0,1214
Apiphany,F,100,22,0,22
Quantrez,M,100,0,5,5
Jabaar,M,100,0,15,15
Lodema,F,100,16,0,16
Rio,M,59,1279,1863,3142
Tristianna,F,100,5,0,5
Laylaann,F,100,17,0,17
Lafrance,F,67,45,22,67
Tanecia,F,100,287,0,287
Deloss,M,100,0,5,5
Madlynn,F,100,100,0,100
Elenie,F,100,76,0,76
Cressa,F,100,36,0,36
Mariena,F,100,119,0,119
Maryluz,F,100,20,0,20
Osean,M,100,0,5,5
Onesha,F,100,113,0,113
Jeffre,M,100,0,245,245
Quintay,M,100,0,6,6
Jainah,F,100,5,0,5
Adilena,F,100,21,0,21
Rugenia,F,100,5,0,5
Gabrieal,M,54,18,21,39
Coledon,M,100,0,5,5
Wynema,F,100,129,0,129
Jesmine,F,100,55,0,55
Isatu,F,100,135,0,135
Torivio,M,100,0,20,20
Alexya,F,100,449,0,449
Dedera,F,100,8,0,8
Jaxzen,M,100,0,45,45
Raimee,F,100,48,0,48
Danuel,M,98,5,214,219
Symba,F,100,35,0,35
Kalimba,F,100,13,0,13
Thayer,M,93,51,732,783
Sayge,F,83,298,59,357
Latiana,F,100,181,0,181
Sayani,F,100,16,0,16
Williamjohn,M,100,0,5,5
Charnelle,F,100,471,0,471
Markya,F,100,24,0,24
Aziana,F,100,35,0,35
Jaleiah,F,100,87,0,87
Aiyana,F,100,7038,0,7038
Camecia,F,100,6,0,6
Ysmael,M,100,0,56,56
Devian,M,92,22,251,273
Damia,F,100,894,0,894
Sammatha,F,100,54,0,54
Manasvi,F,100,246,0,246
Shanzay,F,100,119,0,119
Naoko,F,100,61,0,61
Shaquala,F,100,355,0,355
Angeleena,F,100,281,0,281
Shlok,M,100,0,454,454
Deliliah,F,100,137,0,137
Dontey,M,100,0,16,16
Leddy,F,100,14,0,14
Kratos,M,100,0,52,52
Worley,M,100,0,120,120
Mykhia,F,100,82,0,82
Elide,F,100,119,0,119
Bradee,F,71,79,33,112
Kadera,F,100,5,0,5
Keshaunna,F,100,5,0,5
Adelie,F,100,343,0,343
Moshood,M,100,0,16,16
Mashyia,F,100,15,0,15
Dottye,F,100,17,0,17
Laurelin,F,100,64,0,64
Nare,F,100,53,0,53
Lavale,M,100,0,55,55
Bolling,M,100,0,5,5
Landonn,M,100,0,15,15
Shunette,F,100,6,0,6
Carolanne,F,100,909,0,909
Shirin,F,100,659,0,659
Cowanda,F,100,26,0,26
Haleyann,F,100,36,0,36
Zenita,F,100,51,0,51
Camm,M,100,0,5,5
Danield,M,100,0,5,5
Power,M,100,0,6,6
Andrina,F,100,634,0,634
Samuell,M,100,0,163,163
Chimira,F,100,11,0,11
Honorio,M,100,0,208,208
Ethlyn,F,100,24,0,24
Akeria,F,100,283,0,283
Phuonganh,F,100,5,0,5
Sigrid,F,100,1179,0,1179
Andrewmichael,M,100,0,10,10
Righley,F,100,5,0,5
Ketcher,M,100,0,31,31
Breyton,M,100,0,180,180
Diar,M,100,0,32,32
Shakil,M,97,5,167,172
Aaliyana,F,100,93,0,93
Manson,M,100,0,251,251
Tosca,F,100,211,0,211
Devera,F,100,282,0,282
Emylie,F,100,172,0,172
Sharmarke,M,100,0,58,58
Vicky,F,99,47172,353,47525
Chetan,M,100,0,397,397
Rheagan,F,100,466,0,466
Elmedina,F,100,10,0,10
Olanna,F,100,15,0,15
Kele,M,54,75,89,164
Kaily,F,100,1956,0,1956
Jeslee,F,100,5,0,5
Collin,M,99,418,71318,71736
Shantya,F,100,5,0,5
Mykela,F,100,208,0,208
Gwendoline,F,100,105,0,105
Jeaniene,F,100,11,0,11
Elizabeta,F,100,20,0,20
Lilie,F,100,471,0,471
Ladaysha,F,100,161,0,161
Daken,M,100,0,38,38
Sherrill,F,88,3807,533,4340
Martrel,M,100,0,15,15
Ethany,F,100,14,0,14
Natia,F,100,689,0,689
Tadarian,M,100,0,5,5
Uta,F,100,10,0,10
Tomeki,F,100,22,0,22
Serissa,F,100,5,0,5
Breeanna,F,100,3086,0,3086
Liannie,F,100,6,0,6
Marhia,F,100,5,0,5
Kyasha,F,100,40,0,40
Vaneisha,F,100,33,0,33
Marylee,F,100,1341,0,1341
Jazzmene,F,100,5,0,5
Javonn,M,100,0,247,247
Gabin,M,100,0,16,16
Nilla,F,100,11,0,11
Christopher,M,100,9223,1969404,1978627
Govanna,F,100,5,0,5
Kontar,M,100,0,6,6
Juana,F,99,11744,76,11820
Krymson,F,84,27,5,32
Batoul,F,100,269,0,269
Ifeanyichukwu,M,100,0,113,113
Sabira,F,100,20,0,20
Izziah,M,100,0,21,21
Alayjiah,F,100,6,0,6
Keanna,F,100,3373,0,3373
Yakisha,F,100,43,0,43
Hermalinda,F,100,20,0,20
Flamur,M,100,0,24,24
Calbert,M,100,0,147,147
Konar,M,100,0,6,6
Chaveli,F,100,17,0,17
Dalasha,F,100,5,0,5
Kawliga,M,100,0,16,16
Sarisha,F,100,30,0,30
Chelea,F,100,13,0,13
Shamim,F,100,8,0,8
Lyndra,F,100,11,0,11
Nizeria,F,100,5,0,5
Meliton,M,100,0,213,213
Quineshia,F,100,53,0,53
Rylee,F,91,40013,4181,44194
Kazeem,M,100,0,36,36
Yanuel,M,100,0,195,195
Sampson,M,100,0,1985,1985
Zayra,F,100,1242,0,1242
Yvalondra,F,100,5,0,5
Madeira,F,100,27,0,27
Anterrio,M,100,0,111,111
Ruddie,M,100,0,5,5
Kino,M,100,0,185,185
Rocker,M,100,0,5,5
Danijela,F,100,63,0,63
Jakhi,M,100,0,584,584
Kamerin,M,65,210,393,603
Tavist,M,100,0,26,26
Bayard,M,100,0,268,268
Rogerick,M,100,0,147,147
Keithen,M,100,0,516,516
Trillian,F,100,31,0,31
Harley,M,52,18739,20344,39083
Aydain,M,100,0,9,9
Coley,M,84,230,1181,1411
Joshuaaaron,M,100,0,11,11
Monet,F,100,4106,6,4112
Roziya,F,100,5,0,5
Peter,M,100,1272,392003,393275
Intisar,F,100,51,0,51
Atena,F,100,5,0,5
Hatch,M,100,0,8,8
Zahirah,F,100,223,0,223
Jerrome,M,100,0,6,6
Lakesa,F,100,106,0,106
Davis,M,98,518,21199,21717
Srisha,F,100,33,0,33
Cheemeng,M,100,0,46,46
Deyci,F,100,69,0,69
Zakyiah,F,100,42,0,42
Raguel,F,100,313,0,313
Senaca,M,100,0,54,54
Deniqua,F,100,137,0,137
Anayssa,F,100,6,0,6
Tio,M,100,0,12,12
Clemente,M,100,0,2581,2581
Job,M,100,0,2531,2531
Mony,M,100,0,5,5
Tavario,M,100,0,5,5
Kimbal,M,92,5,56,61
Braiya,F,100,5,0,5
Toleen,F,100,86,0,86
Mickyla,F,100,7,0,7
Princess,F,100,11707,7,11714
Olajuwon,M,100,0,566,566
Marta,F,100,14355,46,14401
Toddrick,M,100,0,402,402
Dauri,F,100,5,0,5
Shakeira,F,100,328,0,328
Wyndham,M,100,0,33,33
Derquan,M,100,0,5,5
Kalek,M,100,0,5,5
Kelvin,M,99,304,47989,48293
Eduardoluis,M,100,0,9,9
Teika,F,100,16,0,16
Rielyn,F,97,154,5,159
Margherite,F,100,7,0,7
Lynnox,F,82,45,10,55
Kaamilya,F,100,49,0,49
Addington,F,100,5,0,5
Merribeth,F,100,47,0,47
Rocket,M,95,7,130,137
Cap,M,100,0,5,5
Muniza,F,100,5,0,5
Damyn,M,100,0,86,86
Brinder,F,100,5,0,5
Ayja,F,100,16,0,16
Kalonji,M,100,0,145,145
Trevor,M,100,611,152376,152987
Dariyelle,F,100,5,0,5
Deyvin,M,100,0,5,5
Sydnie,F,100,4903,0,4903
Shital,F,100,135,0,135
Jullissa,F,100,55,0,55
Jb,M,100,0,385,385
Malikhi,M,100,0,186,186
Roanne,F,100,301,0,301
Litany,F,100,6,0,6
Javonie,M,100,0,13,13
Sharnele,F,100,5,0,5
Tyshayla,F,100,11,0,11
Ikee,M,100,0,5,5
Jatavian,M,100,0,101,101
Aariana,F,100,353,0,353
Qwana,F,100,6,0,6
Jaiiden,M,100,0,6,6
Tiffiny,F,100,2387,0,2387
Avenn,M,100,0,5,5
Weslin,M,100,0,5,5
Cobey,M,100,0,610,610
Deigo,M,100,0,210,210
Tayyab,M,100,0,39,39
Nathanjames,M,100,0,8,8
Camare,M,100,0,19,19
Madesyn,F,100,158,0,158
Shaydon,M,100,0,127,127
Norleen,F,100,43,0,43
Hamidah,F,100,5,0,5
Kendraya,F,100,12,0,12
Azuredee,F,100,22,0,22
Kaiky,M,100,0,5,5
Sharnaye,F,100,7,0,7
Breezie,F,100,76,0,76
Kiz,F,100,39,0,39
Duval,M,100,0,383,383
Merrin,F,100,138,0,138
Mareya,F,100,35,0,35
Tailore,F,100,7,0,7
Hannaley,F,100,21,0,21
Deloria,F,100,218,0,218
Niranjana,F,100,15,0,15
Artavis,M,100,0,72,72
Ronesha,F,100,773,0,773
Maritess,F,100,58,0,58
Sarai,F,100,15082,6,15088
Armine,F,100,114,0,114
Niaisha,F,100,10,0,10
Davynn,F,100,6,0,6
Ahria,F,100,58,0,58
Kambri,F,100,559,0,559
Anfal,F,100,24,0,24
Proctor,M,100,0,27,27
Arnavi,F,100,8,0,8
Akeim,M,100,0,50,50
Maryemma,F,100,22,0,22
Jilliane,F,100,149,0,149
Khrysten,F,100,29,0,29
Emron,M,100,0,26,26
Jakaree,M,100,0,84,84
Josslynn,F,100,320,0,320
Zenola,F,100,38,0,38
Marnette,F,100,108,0,108
Nishat,F,100,160,0,160
Karden,M,100,0,29,29
Prem,M,100,0,409,409
Charlise,F,100,714,0,714
Nerrissa,F,100,10,0,10
Kamir,M,100,0,48,48
Sun,F,60,429,285,714
Kendasia,F,100,5,0,5
Marcellina,F,100,228,0,228
Kentae,M,100,0,26,26
Damarkis,M,100,0,15,15
Parick,M,100,0,5,5
Renelle,F,100,389,0,389
Carmella,F,100,6763,0,6763
Keia,F,100,597,0,597
Marieliz,F,100,93,0,93
Robertjames,M,100,0,37,37
Javahn,M,100,0,21,21
Harkirat,M,67,12,24,36
Amante,M,100,0,158,158
Aneeqa,F,100,6,0,6
Amileo,M,100,0,11,11
Brealle,F,100,10,0,10
Tischa,F,100,57,0,57
Davontae,M,100,0,1297,1297
Tiese,F,100,24,0,24
Edmar,M,100,0,141,141
Lucile,F,100,1543,0,1543
Doss,M,100,0,61,61
Chave,F,100,5,0,5
Brindle,F,100,33,0,33
Euel,M,100,0,68,68
Riley,F,50,81562,80257,161819
Annaluisa,F,100,5,0,5
Nohely,F,100,786,0,786
Buelah,F,100,54,0,54
Aniceto,M,100,0,269,269
Christepher,M,100,0,286,286
Jaylan,M,84,743,4048,4791
Drexal,M,100,0,6,6
Franchesska,F,100,18,0,18
Ilithia,F,100,5,0,5
Cortlandt,M,100,0,59,59
Calianne,F,100,45,0,45
Alian,M,100,0,43,43
Samanthalynn,F,100,5,0,5
Meesha,F,100,280,0,280
Allese,F,100,5,0,5
Panth,M,100,0,5,5
Jaysun,M,100,0,165,165
Constant,M,58,26,36,62
Kyersten,F,100,11,0,11
Rushil,M,100,0,498,498
Betzalel,M,100,0,199,199
Habib,M,100,0,622,622
Alysia,F,100,9074,0,9074
Oluwadabira,F,100,5,0,5
Yoko,F,100,405,0,405
Shravan,M,100,0,235,235
Shami,F,100,17,0,17
Avinash,M,100,0,849,849
Trigger,M,100,0,113,113
Adorae,F,100,5,0,5
Dezlynn,F,100,22,0,22
Bibek,M,100,0,5,5
Lizett,F,100,1156,0,1156
Everth,M,100,0,33,33
Desray,F,100,10,0,10
Aungelique,F,100,24,0,24
Taleiyah,F,100,41,0,41
Jamonte,M,100,0,670,670
Kaydi,F,100,265,0,265
Tippy,F,55,6,5,11
Macrae,M,100,0,116,116
Niquan,M,100,0,79,79
Jamykal,M,100,0,5,5
Harrisen,M,100,0,12,12
Mckyla,F,100,125,0,125
Reggina,F,100,19,0,19
Shirlette,F,100,68,0,68
Tshawn,M,100,0,24,24
Lorinne,F,100,5,0,5
Tawon,M,100,0,42,42
Takeira,F,100,107,0,107
Jkwon,M,100,0,173,173
Joseeduardo,M,100,0,70,70
Naticha,F,100,5,0,5
Braelon,M,100,0,346,346
Laver,M,100,0,6,6
Torres,M,100,0,255,255
Sundae,F,100,339,0,339
Rachid,M,100,0,50,50
Raveen,F,100,407,0,407
Harison,M,100,0,46,46
Tralaina,F,100,5,0,5
Treniyah,F,100,54,0,54
Ethanjay,M,100,0,5,5
Briton,M,99,5,502,507
Tunisia,F,100,588,0,588
Azaleah,F,100,262,0,262
Daniale,F,100,10,0,10
Jayceona,F,100,25,0,25
Jakeryan,M,100,0,30,30
Yovany,M,100,0,594,594
Patton,M,94,55,875,930
Dollie,F,100,2581,0,2581
Janeia,F,100,39,0,39
Brylei,F,100,169,0,169
Nedia,F,100,40,0,40
Kary,F,60,1835,1224,3059
Jarryd,M,100,0,692,692
Laliyah,F,100,6,0,6
Marcellous,M,100,0,833,833
Jamieson,M,94,78,1295,1373
Remona,F,100,874,0,874
Cherakee,F,100,11,0,11
Tiessa,F,100,5,0,5
Hawken,M,100,0,146,146
Danton,M,100,0,525,525
Marneshia,F,100,5,0,5
Maxin,M,100,0,35,35
Janitra,F,100,6,0,6
Leithan,M,100,0,5,5
Fonda,F,100,3103,0,3103
Savitri,F,100,25,0,25
Geethika,F,100,31,0,31
Sharla,F,100,5918,0,5918
Chrispin,M,100,0,10,10
Vinita,F,100,563,0,563
Khandi,F,100,47,0,47
Seva,F,100,39,0,39
Quinnlee,F,100,5,0,5
Tyrice,M,97,29,898,927
Tyse,M,100,0,71,71
Callie,F,100,36725,127,36852
Marvine,F,92,96,8,104
Cristain,M,100,0,35,35
Ahmod,M,100,0,182,182
Sherryle,F,100,11,0,11
Ashari,F,100,530,0,530
Bernhardt,M,100,0,31,31
Masan,M,100,0,15,15
Jaymon,M,100,0,315,315
Librado,M,100,0,799,799
Attis,M,100,0,16,16
Dimetrius,M,100,0,156,156
Nicklous,M,100,0,244,244
Jakera,F,100,281,0,281
Shion,M,71,38,92,130
Elizamarie,F,100,15,0,15
Adiva,F,100,83,0,83
Raith,M,100,0,39,39
Dreana,F,100,127,0,127
Ezaiah,M,100,0,33,33
Loveaya,F,100,6,0,6
Darrain,M,100,0,13,13
Brany,F,100,15,0,15
Clendon,M,100,0,49,49
Tahirah,F,100,849,0,849
Urbano,M,100,0,517,517
Kadetria,F,100,5,0,5
Kevonne,M,88,6,43,49
Mattheus,M,100,0,139,139
Gwyndolyn,F,100,311,0,311
Norris,M,98,112,6955,7067
Amariyae,F,100,10,0,10
Rodne,M,100,0,5,5
Furkan,M,100,0,103,103
Ryian,M,58,37,51,88
Reilyn,F,100,92,0,92
Curits,M,100,0,42,42
Mims,M,100,0,5,5
Emaliya,F,100,5,0,5
Ezabel,F,100,5,0,5
Alaster,M,100,0,49,49
Kika,F,100,10,0,10
Omorion,M,100,0,5,5
Oneyda,F,100,48,0,48
Jerral,M,100,0,153,153
Darbi,F,100,648,0,648
Kenslei,F,100,41,0,41
Aeryana,F,100,12,0,12
Susel,F,100,6,0,6
Jioni,M,100,0,5,5
Edena,F,100,15,0,15
Terri,F,99,141362,892,142254
Dmichael,M,100,0,49,49
Kariss,F,100,75,0,75
Karana,F,100,11,0,11
Jakory,M,100,0,109,109
Marna,F,100,1459,0,1459
Crishaun,M,100,0,6,6
Felizia,F,100,6,0,6
Maryel,F,100,15,0,15
Lateaka,F,100,5,0,5
Beatrix,F,100,1584,0,1584
Tavi,F,68,105,50,155
Jontasia,F,100,19,0,19
Quentina,F,100,140,0,140
Decorey,M,100,0,123,123
Corette,F,100,6,0,6
Bowyn,M,89,6,49,55
Tyren,M,100,5,1789,1794
Zoel,M,75,11,33,44
Shiann,F,100,1939,0,1939
Raelina,F,100,10,0,10
Melonee,F,100,307,0,307
Aaryav,M,100,0,71,71
Romone,M,100,0,187,187
Harmoni,F,100,2083,0,2083
Jiada,F,100,23,0,23
Peer,M,100,0,23,23
Semiyah,F,100,107,0,107
Amberdawn,F,100,23,0,23
Tanaijah,F,100,41,0,41
Misheeta,F,100,5,0,5
Wakeem,M,100,0,29,29
Makeira,F,100,6,0,6
Minde,F,100,23,0,23
Vint,M,100,0,85,85
Genesy,F,100,40,0,40
Abubakarr,M,100,0,21,21
Kadyn,M,67,1213,2491,3704
Sierra,F,100,93505,269,93774
Ardena,F,100,174,0,174
Lichelle,F,100,124,0,124
Naadia,F,100,10,0,10
Brandiann,F,100,5,0,5
Sarahann,F,100,683,0,683
Roselyn,F,100,6962,0,6962
Saidey,F,100,44,0,44
Jerith,M,100,0,16,16
Kimberlie,F,100,3608,0,3608
Gracious,F,100,106,0,106
Megaan,F,100,6,0,6
Xithlaly,F,100,6,0,6
Alyssanicole,F,100,11,0,11
Klein,M,100,0,204,204
Holly,F,100,193179,796,193975
Hilari,F,100,226,0,226
Claudio,M,99,27,4338,4365
Zenzele,F,100,11,0,11
Chealse,F,100,18,0,18
Ioannis,M,100,0,1079,1079
Lachele,F,100,155,0,155
Adriaan,M,100,0,66,66
Debra,F,100,544134,1140,545274
Ilijah,M,100,0,351,351
Othello,M,100,0,300,300
Nefretiri,F,100,34,0,34
Nyjia,F,100,28,0,28
Eldred,M,100,0,929,929
Gohan,M,100,0,162,162
Tasheika,F,100,151,0,151
Dneisha,F,100,5,0,5
Allanie,F,100,5,0,5
Rainah,F,100,259,0,259
Rossalind,F,100,5,0,5
Tasharra,F,100,78,0,78
Anthonella,F,100,44,0,44
Merrisa,F,100,144,0,144
Nestora,F,100,5,0,5
Persey,M,100,0,5,5
Clayt,M,100,0,20,20
Jaelah,F,100,644,0,644
Jibrael,M,100,0,29,29
Shaquanta,F,100,135,0,135
Saam,M,100,0,40,40
Alvernon,M,100,0,6,6
Kealen,M,100,0,17,17
Ching,M,74,30,84,114
Tharyn,M,100,0,5,5
Steevie,F,100,5,0,5
Deshaila,F,100,5,0,5
Shavone,F,100,473,0,473
Aquavious,M,100,0,16,16
Aerik,M,100,0,75,75
Tiyona,F,100,114,0,114
Sachiel,M,100,0,10,10
Brixton,M,89,69,580,649
Linsee,F,100,11,0,11
Rakya,F,100,31,0,31
Bryndal,F,100,12,0,12
Guymon,M,100,0,5,5
Jla,F,100,190,0,190
Juventina,F,100,5,0,5
Juilo,M,100,0,5,5
Taunja,F,100,90,0,90
Adaobi,F,100,35,0,35
Tateanna,F,100,74,0,74
Shannie,F,100,91,0,91
Nichalas,M,100,0,280,280
Arryana,F,100,140,0,140
Mercedes,F,99,35306,278,35584
Nariya,F,100,288,0,288
Nadalie,F,100,216,0,216
Mendee,F,100,11,0,11
Mayling,F,100,112,0,112
Talyor,F,100,5,0,5
Boston,M,91,542,5641,6183
Levente,M,100,0,37,37
Timmie,M,92,254,2840,3094
Tandy,F,75,1119,382,1501
Lewellyn,M,100,0,42,42
Vanyah,F,100,5,0,5
Brenner,M,99,5,940,945
Rashed,M,100,0,369,369
Acia,F,100,6,0,6
Mariaeduard,F,100,11,0,11
Hermilinda,F,100,5,0,5
Ayush,M,100,0,1549,1549
Sephira,F,100,63,0,63
Stanette,F,100,10,0,10
Ahamad,M,100,0,35,35
Judiah,M,100,0,34,34
Mosses,M,100,0,28,28
Linetta,F,100,108,0,108
Madora,F,100,43,0,43
Varsha,F,100,796,0,796
Elai,M,100,0,105,105
Raimond,M,100,0,27,27
Ladajia,F,100,16,0,16
Kandy,F,100,4993,5,4998
Rashodd,M,100,0,5,5
Isla,F,100,9920,0,9920
Dolores,F,99,35828,256,36084
Almer,M,90,5,46,51
Yolimar,F,100,10,0,10
Nalanee,F,100,5,0,5
Felty,M,100,0,5,5
Lamarkus,M,100,0,153,153
Dariane,F,100,120,0,120
Joshawn,M,100,0,116,116
Krislynn,F,100,435,0,435
Gervase,M,100,0,5,5
Jeth,M,100,0,8,8
Yetzali,F,100,82,0,82
Giavona,F,100,29,0,29
Sheene,F,100,13,0,13
Dhruv,M,100,0,2440,2440
Brentleigh,F,100,11,0,11
Zixi,F,100,5,0,5
Benni,F,100,7,0,7
Nyalee,F,100,28,0,28
Erycka,F,100,13,0,13
Ryott,M,100,0,28,28
Dauda,M,100,0,8,8
Eriqa,F,100,24,0,24
Pharis,M,100,0,6,6
Jahnique,F,100,13,0,13
Hrishik,M,100,0,6,6
Choice,M,100,0,52,52
Carline,F,100,904,0,904
Jasen,M,100,0,4336,4336
Rockwell,M,100,0,678,678
Garet,M,100,0,1439,1439
Chamia,F,100,48,0,48
Teniola,F,95,102,5,107
Verenda,F,100,17,0,17
Uziel,M,100,0,1484,1484
Herrick,M,100,0,49,49
Chenell,F,100,256,0,256
Ingo,M,100,0,45,45
Judd,M,100,0,3883,3883
Laguanda,F,100,29,0,29
Matias,M,100,0,5881,5881
Leia,F,100,6792,0,6792
Kiptyn,M,97,17,506,523
Faizah,F,100,233,0,233
Demiana,F,100,95,0,95
Darriana,F,100,129,0,129
Zaimah,F,100,5,0,5
Jhonathon,M,100,0,27,27
Navleen,F,100,37,0,37
Joshva,M,100,0,59,59
Loukisha,F,100,69,0,69
Ermalene,F,100,5,0,5
Maycen,M,55,47,57,104
Latoyo,F,100,11,0,11
Mahamud,M,100,0,68,68
Ayoola,F,100,5,0,5
Makenzie,F,99,35332,282,35614
Nyell,F,100,10,0,10
Zoriah,F,100,389,0,389
Ahamed,M,100,0,63,63
Teaona,F,100,18,0,18
Rupesh,M,100,0,22,22
Erricka,F,100,154,0,154
Ayleigh,F,100,28,0,28
Kavante,M,100,0,12,12
Katleyn,F,100,25,0,25
Ahsaki,F,100,34,0,34
Myndi,F,100,122,0,122
Charell,F,100,135,0,135
Kytzia,F,100,59,0,59
Jyron,M,100,0,162,162
Spanky,M,100,0,6,6
Celisse,F,100,113,0,113
Fady,M,100,0,213,213
Roarie,F,100,5,0,5
Viliamu,M,100,0,5,5
Nanine,F,100,46,0,46
Christielee,F,100,5,0,5
Morghan,F,100,1168,5,1173
Arn,M,100,0,53,53
Kabri,F,100,9,0,9
Kalisha,F,100,1258,0,1258
Ladeanna,F,100,15,0,15
Carminia,F,100,6,0,6
Lafiamma,M,100,0,6,6
Deaven,M,75,183,556,739
Annaliah,F,100,53,0,53
Clairemarie,F,100,5,0,5
Moroni,M,100,0,342,342
Carnetta,F,100,147,0,147
Ambriella,F,100,63,0,63
Breeya,F,100,53,0,53
Kedwin,M,100,0,22,22
Littzy,F,100,38,0,38
Collena,F,100,10,0,10
Hiiaka,F,100,8,0,8
Caniah,F,100,12,0,12
Tucker,M,99,260,32084,32344
Shada,F,100,589,0,589
Nazli,F,100,122,0,122
Tytionna,F,100,94,0,94
Amias,M,100,0,186,186
Biddie,F,100,5,0,5
Mridula,F,100,41,0,41
Shaquiel,M,91,5,51,56
Traviss,M,100,0,12,12
Meagin,F,100,17,0,17
Keeona,F,100,27,0,27
Davione,M,96,11,245,256
Makiaya,F,100,40,0,40
Galiyah,F,100,25,0,25
Reik,M,100,0,32,32
Kaceyon,M,100,0,5,5
Shlomit,F,100,5,0,5
Solai,F,100,34,0,34
Cristin,F,97,4244,120,4364
Kayleigha,F,100,25,0,25
Deatria,F,100,14,0,14
Vernida,F,100,50,0,50
Lannetta,F,100,5,0,5
Lindsy,F,100,2096,0,2096
Leen,F,100,660,0,660
Keyarah,F,100,231,0,231
Karlynn,F,100,315,0,315
Sherryll,F,100,69,0,69
Kyhia,F,100,11,0,11
Jalyza,F,100,6,0,6
Mileen,F,100,5,0,5
Kashis,M,100,0,56,56
Emmakay,F,100,11,0,11
Yaiden,M,100,0,66,66
Mercadies,F,100,148,0,148
Rayvin,F,98,304,6,310
Randol,M,100,0,454,454
Kennette,F,100,163,0,163
Lamaiya,F,100,23,0,23
Mondell,M,100,0,28,28
Aunesti,F,100,86,0,86
Alodie,F,100,10,0,10
Keshondra,F,100,22,0,22
Deonsha,F,100,6,0,6
Alleah,F,100,343,0,343
Wirt,M,100,0,18,18
Xaivier,M,100,0,133,133
Sharnay,F,100,129,0,129
Marley,F,87,18700,2910,21610
Juliette,F,100,16444,0,16444
Zonia,F,100,369,0,369
Jessicanicole,F,100,5,0,5
Humphrey,M,100,0,435,435
Nayeliz,F,100,104,0,104
Jacquelline,F,100,17,0,17
Wykena,F,100,5,0,5
Donell,M,88,536,4093,4629
Placido,M,100,0,562,562
Cherissa,F,100,161,0,161
Zeriah,F,97,177,5,182
Coryna,F,100,17,0,17
Shellye,F,100,174,0,174
Akiba,F,95,87,5,92
Sidra,F,100,929,0,929
Ameyalli,F,100,35,0,35
Derrek,M,100,0,2913,2913
Khirey,M,100,0,10,10
Axl,M,100,0,1194,1194
Shaely,F,100,140,0,140
Arri,M,57,15,20,35
Xzavius,M,100,0,7,7
Sanjuana,F,100,1686,0,1686
Lateria,F,100,262,0,262
Suhanee,F,100,5,0,5
Mohammadali,M,100,0,23,23
Joven,M,100,0,178,178
Ralna,F,100,24,0,24
Arjav,M,100,0,11,11
Thelma,F,100,22162,65,22227
Elick,M,100,0,5,5
Kanaiya,F,100,39,0,39
Jorma,M,100,0,58,58
Cheryllyn,F,100,6,0,6
Aivy,F,100,135,0,135
Jarrod,M,100,65,24876,24941
Kylon,M,100,0,924,924
Abhilash,M,100,0,22,22
Talarisha,F,100,17,0,17
Johneisha,F,100,164,0,164
Braylinn,F,100,71,0,71
Jheryl,M,100,0,8,8
Ceon,M,100,0,42,42
Dondra,F,96,461,20,481
Akilles,M,100,0,36,36
Nikohl,F,100,11,0,11
Sienna,F,100,19929,10,19939
Foxx,M,100,0,159,159
Shawn,M,90,32637,298614,331251
Jacaiden,M,100,0,16,16
Hayder,M,100,0,10,10
Davilyn,F,100,20,0,20
Analiese,F,100,1369,0,1369
Justic,M,100,0,6,6
Cassy,F,100,1970,0,1970
Braidan,M,100,0,131,131
Sierraleone,F,100,5,0,5
Ginetta,F,100,11,0,11
Ramielle,F,100,17,0,17
Daycia,F,100,17,0,17
Tykesha,F,100,214,0,214
Qasem,M,100,0,22,22
Fateha,F,100,6,0,6
Saprina,F,100,365,0,365
Lupie,F,100,18,0,18
Ahleeyah,F,100,5,0,5
Kaif,M,100,0,31,31
Macii,F,100,26,0,26
Audiana,F,100,31,0,31
Harold,M,100,678,135970,136648
Lady,F,100,784,0,784
Ahsley,F,100,1190,0,1190
Kahley,F,100,126,0,126
Aarav,M,100,0,3271,3271
Maigan,F,100,239,0,239
Sabriyah,F,100,134,0,134
Burdette,M,90,27,238,265
Malonda,F,100,5,0,5
Gardy,M,100,0,74,74
Brink,M,100,0,5,5
Santino,M,100,0,6352,6352
Analin,F,100,16,0,16
Xylia,F,100,271,0,271
Jenaveve,F,100,85,0,85
Illiam,M,100,0,42,42
Abdon,M,100,0,294,294
Xanthus,M,100,0,11,11
Maryline,F,100,16,0,16
Anavel,F,100,35,0,35
Greydis,F,100,181,0,181
Connie,F,99,183188,2164,185352
Natham,M,100,0,13,13
Alhana,F,100,20,0,20
Okemia,F,100,9,0,9
Joiya,F,100,37,0,37
Aidanjohn,M,100,0,5,5
Shwanna,F,100,20,0,20
Marquee,M,86,34,204,238
Lyndsie,F,100,1460,0,1460
Elizabete,F,100,10,0,10
Ovee,F,100,5,0,5
Allionna,F,100,5,0,5
Suley,F,100,32,0,32
Runell,F,100,10,0,10
Coda,M,88,67,484,551
Amenia,F,100,32,0,32
Tamhra,F,100,5,0,5
Barndon,M,100,0,26,26
Salman,M,100,0,1522,1522
Emyrie,F,100,5,0,5
Corneluis,M,100,0,105,105
Kaelum,M,100,0,39,39
Maxie,M,70,677,1558,2235
Tiersa,F,100,99,0,99
Charmica,F,100,6,0,6
Jamyia,F,100,624,0,624
Jahde,F,100,10,0,10
Marwan,M,100,0,839,839
Abukar,M,100,0,28,28
Jhalyn,M,100,0,7,7
Sargent,M,100,0,12,12
Marlis,F,100,314,0,314
Mardean,F,100,5,0,5
Sharil,F,100,41,0,41
Shalette,F,100,16,0,16
Quaterrius,M,100,0,5,5
Saquan,M,99,7,697,704
Desiyah,F,100,29,0,29
Jamikel,M,100,0,6,6
Natassia,F,100,694,0,694
Gabrella,F,100,157,0,157
Shaian,F,100,42,0,42
Jophiel,M,100,0,6,6
Shameen,F,100,13,0,13
Delissia,F,100,5,0,5
Hanane,F,100,5,0,5
Taylorrose,F,100,15,0,15
Cyniya,F,100,18,0,18
Jakyron,M,100,0,60,60
Dayde,M,100,0,6,6
Raymel,M,100,0,68,68
Bridge,M,91,5,48,53
Divyesh,M,100,0,28,28
Niyaz,M,100,0,6,6
Laik,M,100,0,16,16
Anahit,F,100,264,0,264
Jobari,M,100,0,5,5
Tylyn,F,82,246,55,301
Arniya,F,100,12,0,12
Suan,F,77,90,27,117
Dyesha,F,100,104,0,104
Elaria,F,100,86,0,86
Enneth,M,100,0,24,24
Bravin,M,100,0,17,17
Bhavin,M,100,0,167,167
Allyne,F,100,58,0,58
Yakima,F,100,261,0,261
Toran,M,100,0,303,303
Alcee,M,100,0,30,30
Peytynn,F,100,10,0,10
Aristides,M,100,0,529,529
Arlynda,F,100,10,0,10
Merlyn,F,52,617,573,1190
Itia,F,100,5,0,5
Kieston,M,100,0,6,6
Ericka,F,100,22756,46,22802
Cicel,M,100,0,12,12
Teeya,F,100,32,0,32
Jazalin,F,100,5,0,5
Silvino,M,100,0,277,277
Donovin,M,100,0,680,680
Alastar,M,100,0,10,10
Wiley,M,98,116,5971,6087
Dairen,M,100,0,5,5
Shulanda,F,100,21,0,21
Reverie,F,100,35,0,35
Molloy,M,100,0,5,5
Aziria,F,100,5,0,5
Rica,F,100,502,0,502
Lunamarie,F,100,10,0,10
Mehki,M,100,0,1083,1083
Tyecia,F,100,5,0,5
Jimbo,M,100,0,23,23
Keadyn,M,100,0,5,5
Fazal,M,100,0,10,10
Damyon,M,100,0,178,178
Rameek,M,100,0,24,24
Lianette,F,100,84,0,84
Tyleia,F,100,10,0,10
Devinne,F,100,174,0,174
Alexandor,M,100,0,16,16
Sashay,F,100,101,0,101
Aamer,M,100,0,30,30
Shashank,M,100,0,319,319
Rodley,M,100,0,5,5
Verenise,F,100,292,0,292
Willibaldo,M,100,0,6,6
Nahid,F,52,13,12,25
Marisleysi,F,100,5,0,5
Aniah,F,100,2475,0,2475
Juanyae,M,100,0,5,5
Srikari,F,100,6,0,6
Jameele,F,100,10,0,10
Makeen,M,100,0,12,12
Waring,M,100,0,5,5
Degen,M,100,0,5,5
Taeshaun,M,100,0,205,205
Geshia,F,100,5,0,5
Sheenna,F,100,12,0,12
Jimbob,M,100,0,6,6
Amaurion,M,100,0,51,51
Clesha,F,100,10,0,10
Jeevika,F,100,10,0,10
Rosaly,F,100,292,0,292
Quamon,M,100,0,5,5
Sarae,F,100,338,0,338
Dametra,F,100,78,0,78
Daemion,M,100,0,120,120
Christophen,M,100,0,28,28
Noan,M,100,0,26,26
Krishi,M,70,12,28,40
Kenroy,M,100,0,45,45
Ayoub,M,100,0,514,514
Rahmo,F,100,6,0,6
Jance,M,94,5,72,77
Messiyah,M,69,10,22,32
Jozelynn,F,100,96,0,96
Kelson,M,100,0,1064,1064
Sheralee,F,100,102,0,102
Lelandra,F,100,7,0,7
Bach,M,100,0,50,50
Dacotah,M,70,32,76,108
Shouana,F,100,12,0,12
Izaiya,M,100,0,18,18
Atiyya,F,100,9,0,9
Tyashia,F,100,95,0,95
Kashtyn,M,91,5,51,56
Venesha,F,100,96,0,96
Tamecha,F,100,10,0,10
Dondrick,M,100,0,20,20
Elayla,F,100,5,0,5
Kiala,F,100,211,0,211
Tikesha,F,100,109,0,109
Sallyjo,F,100,29,0,29
Dhati,M,100,0,5,5
Kerala,F,100,5,0,5
Shervin,M,100,0,192,192
Efrayim,M,100,0,33,33
Keivn,M,100,0,5,5
Lizete,F,100,48,0,48
Minnette,F,100,148,0,148
Jissel,F,100,436,0,436
Kemarui,M,100,0,5,5
Eliette,F,100,65,0,65
Chandrika,F,100,161,0,161
Miroslava,F,100,621,0,621
Chadwell,M,100,0,6,6
Rithi,F,100,5,0,5
Mytisha,F,100,5,0,5
Okie,M,100,0,5,5
Anisa,F,100,4594,0,4594
Melanee,F,100,1093,0,1093
Desera,F,100,63,0,63
Nailyn,F,100,58,0,58
Breshaun,M,100,0,17,17
Alaiha,F,100,5,0,5
Gift,F,100,66,0,66
Deuntae,M,100,0,116,116
Sovanny,F,100,18,0,18
Bayah,F,100,44,0,44
Savante,M,100,0,17,17
Madasen,F,100,19,0,19
Jeydan,M,100,0,59,59
Heder,M,100,0,8,8
Marve,M,100,0,5,5
Milada,F,100,8,0,8
Cintya,F,100,141,0,141
Adhya,F,100,201,0,201
Zarek,M,100,0,806,806
Gearldene,F,100,11,0,11
Denny,M,97,286,10158,10444
Emmiline,F,100,22,0,22
Kryste,F,100,10,0,10
Bronda,F,100,153,0,153
Zolie,F,100,33,0,33
Shanyse,F,100,5,0,5
Marjan,F,100,181,0,181
Keylani,F,100,56,0,56
Abbygale,F,100,722,0,722
Marryn,F,100,6,0,6
Camaiya,F,100,10,0,10
Heater,F,100,53,0,53
Aliette,F,100,5,0,5
Zeyad,M,100,0,288,288
Nalyssa,F,100,15,0,15
Norwin,M,100,0,5,5
Olajide,M,100,0,32,32
Coreon,M,100,0,79,79
Agustina,F,100,888,0,888
Londi,F,100,5,0,5
Anagrace,F,100,32,0,32
Gilead,M,100,0,25,25
Rylan,M,87,3419,22707,26126
Keb,M,100,0,5,5
Inderpreet,M,100,0,7,7
Guilford,M,100,0,88,88
Cherl,F,100,344,0,344
Estacia,F,100,17,0,17
Leonitus,M,100,0,40,40
Yamilex,F,100,1127,0,1127
Taffie,F,100,118,0,118
Edisa,F,100,11,0,11
Nykhia,F,100,30,0,30
Emly,F,100,5,0,5
Cerria,F,100,102,0,102
Shetara,F,100,112,0,112
Jarvaris,M,100,0,56,56
Wylene,F,100,315,0,315
Maurese,M,100,0,10,10
Davontai,M,100,0,17,17
Kieria,F,100,31,0,31
Shaqille,M,100,0,16,16
Veta,F,100,533,0,533
Celedonio,M,100,0,41,41
Cordell,M,100,18,8411,8429
Amrah,F,100,5,0,5
Janmarcos,M,100,0,6,6
Alenia,F,100,32,0,32
Cherica,F,100,132,0,132
Jacqulene,F,100,88,0,88
Tanieka,F,100,146,0,146
Kareen,F,58,1024,729,1753
Niama,F,100,12,0,12
Katilaya,F,100,18,0,18
Estafania,F,100,12,0,12
Mahleek,M,100,0,10,10
Armiyah,F,100,68,0,68
Fateema,F,100,25,0,25
Matan,M,100,0,577,577
Peregrine,M,80,19,77,96
Zamarius,M,100,0,26,26
Phyllisia,F,100,10,0,10
Machala,F,100,47,0,47
Eliut,M,100,0,46,46
Abbrielle,F,100,83,0,83
Lariya,F,100,143,0,143
Carmelia,F,100,453,0,453
Dhairya,M,100,0,55,55
Cailin,F,99,3428,30,3458
Kelisa,F,100,25,0,25
Laqwanda,F,100,17,0,17
Heba,F,100,1081,0,1081
Michaelallen,M,100,0,5,5
Desjuan,M,100,0,62,62
Aniyja,F,100,11,0,11
Burke,M,99,29,2662,2691
Shakhia,F,100,98,0,98
Kikyo,F,100,13,0,13
Tiphaine,F,100,5,0,5
Spyridon,M,100,0,84,84
Titia,F,100,24,0,24
Zniyah,F,100,142,0,142
Nedenia,F,100,9,0,9
Jaymarion,M,100,0,67,67
Roxana,F,100,10023,26,10049
Koemi,F,100,7,0,7
Tera,F,100,9406,0,9406
Rodgers,M,100,0,182,182
Mushka,F,100,297,0,297
Natha,F,57,36,27,63
Falisha,F,100,905,0,905
Kalashia,F,100,7,0,7
Payman,M,100,0,5,5
Dannyel,M,100,0,11,11
Kayleeana,F,100,14,0,14
Demariea,M,100,0,5,5
Krisie,F,100,52,0,52
Jimette,F,100,11,0,11
Jessee,M,81,297,1228,1525
Hughston,M,100,0,34,34
Jocee,F,100,191,0,191
Jahbari,M,100,0,113,113
Arati,F,100,16,0,16
Camillo,M,100,0,317,317
Latoynia,F,100,6,0,6
Brelle,F,100,13,0,13
Farhaan,M,100,0,64,64
Shawnae,F,100,351,0,351
Blessings,F,100,57,0,57
Urvi,F,100,212,0,212
Hallee,F,100,1058,0,1058
Gopi,F,100,51,0,51
Evyonne,F,100,11,0,11
Demareon,M,100,0,80,80
Dezavion,M,100,0,5,5
Ebby,F,100,17,0,17
Ebbie,M,63,48,82,130
Lale,F,100,22,0,22
Lenette,F,100,882,0,882
Jhavier,M,100,0,5,5
Mickie,F,84,2432,476,2908
Nevaha,F,100,6,0,6
Shondelle,F,100,6,0,6
Sibylla,F,100,34,0,34
Lailonnie,F,100,5,0,5
Karmari,M,100,0,5,5
Rino,M,95,5,104,109
Arvilla,F,100,141,0,141
Mithil,M,100,0,19,19
Denetrice,F,100,22,0,22
Tiyana,F,100,1045,0,1045
Trevhon,M,100,0,5,5
Ulyssis,M,100,0,5,5
Dellene,F,100,47,0,47
Larinda,F,100,517,0,517
Jerria,F,100,10,0,10
Genesee,F,100,198,0,198
Alexsi,M,100,0,7,7
Cerelia,F,100,11,0,11
Teangela,F,100,5,0,5
Leilany,F,100,1691,0,1691
Tyonna,F,100,1173,0,1173
Manija,F,100,6,0,6
Christienne,F,100,40,0,40
Alegacy,F,100,5,0,5
Vatsal,M,100,0,36,36
Payslee,F,100,140,0,140
Rayqwon,M,100,0,10,10
Quaashie,M,100,0,11,11
Shariann,F,100,31,0,31
Caleia,F,100,6,0,6
Garbiel,M,100,0,26,26
Chantia,F,100,301,0,301
Karnecia,F,100,5,0,5
Meliza,F,100,1002,0,1002
Jovonna,F,100,422,0,422
Johannah,F,100,2335,0,2335
Melea,F,100,952,0,952
Adelayne,F,100,6,0,6
Ayliana,F,100,27,0,27
Tyshe,F,100,5,0,5
Tyianna,F,100,100,0,100
Chasen,M,100,0,1611,1611
Claritza,F,100,396,0,396
Dejha,F,100,112,0,112
Titeanna,F,100,13,0,13
Raiford,M,100,0,191,191
Davidalexander,M,100,0,14,14
Asoni,F,100,6,0,6
Vahram,M,100,0,5,5
Akashia,F,100,19,0,19
Keriona,F,100,11,0,11
Zyheim,M,100,0,25,25
Treyvion,M,100,0,537,537
Shahzain,M,100,0,32,32
Sasia,F,100,6,0,6
Kinganthony,M,100,0,5,5
Lasharon,F,100,157,0,157
Zeshawn,M,100,0,36,36
Dayland,M,100,0,5,5
Kaizleigh,F,100,5,0,5
Kelven,M,100,0,113,113
Damiean,M,100,0,76,76
Sushil,M,100,0,25,25
Yadian,M,100,0,5,5
Janae,F,100,15909,6,15915
Jalica,F,100,5,0,5
Mesan,F,100,5,0,5
Tollie,M,96,5,131,136
Yvette,F,100,57804,186,57990
Loleatha,F,100,15,0,15
Kriya,F,100,73,0,73
Akaela,F,100,6,0,6
Chareen,F,100,23,0,23
Keahna,F,100,14,0,14
Daneila,F,100,5,0,5
Elenny,F,100,17,0,17
Monti,M,66,175,336,511
Sherrea,F,100,5,0,5
Zahrah,F,100,248,0,248
Maryetta,F,100,320,0,320
Dalyla,F,100,365,0,365
Delsin,M,100,0,152,152
Kenija,F,100,12,0,12
Makalla,F,100,24,0,24
Nesta,M,80,22,87,109
Ventura,M,91,81,802,883
Kaniah,F,100,403,0,403
Laquania,F,100,7,0,7
Casi,F,100,1075,0,1075
Jerrik,M,100,0,47,47
Arpita,F,100,96,0,96
Renz,M,100,0,18,18
Tauryn,F,100,12,0,12
Zakarri,M,100,0,5,5
Ariell,F,99,767,5,772
Ayiden,M,100,0,59,59
Faruq,M,100,0,63,63
Jennene,F,100,105,0,105
Aszia,F,100,17,0,17
Aubrii,F,100,134,0,134
Charlottie,F,100,5,0,5
Kamoria,F,100,122,0,122
Aided,F,100,7,0,7
Janayah,F,100,521,0,521
Tysir,M,100,0,55,55
Adib,M,100,0,193,193
Colee,F,100,51,0,51
Havana,F,100,683,0,683
Myshon,M,100,0,24,24
Miakoda,F,100,157,0,157
Bogar,M,100,0,34,34
Shaquell,F,55,49,40,89
Kalem,M,100,0,685,685
Emri,F,92,219,20,239
Teriann,F,100,161,0,161
Barbera,F,100,99,0,99
Mondo,M,100,0,33,33
Donnas,F,100,5,0,5
Reynoldo,M,100,0,66,66
Anaiah,F,99,1631,12,1643
Sakhi,M,57,10,13,23
Damiane,M,100,0,31,31
Laderrick,M,100,0,436,436
Nialani,F,100,26,0,26
Joahnna,F,100,10,0,10
Tobenna,M,100,0,129,129
Thomara,F,100,5,0,5
Kambrea,F,100,84,0,84
Earnesteen,F,100,19,0,19
Mckenli,F,100,10,0,10
Laliah,F,100,17,0,17
Alazaya,F,100,10,0,10
Jakenzie,F,100,44,0,44
Rasan,M,100,0,34,34
Edra,F,100,265,0,265
Leaira,F,100,168,0,168
Lui,M,100,0,71,71
Oneita,F,100,79,0,79
Camrin,M,81,215,920,1135
Florin,M,100,0,6,6
Lieza,F,100,5,0,5
Fredric,M,100,0,3861,3861
Ameliyah,F,100,68,0,68
Robben,M,59,45,66,111
Dardan,M,100,0,71,71
Aldahir,M,100,0,217,217
Lanetta,F,100,925,0,925
Tiana,F,100,24669,9,24678
Cjay,M,100,0,37,37
Tywon,M,100,0,799,799
Tahlib,M,100,0,5,5
Aylanie,F,100,18,0,18
Genaya,F,100,40,0,40
Asad,M,100,0,1232,1232
Desmon,M,100,0,1160,1160
Brishae,F,100,22,0,22
Raija,F,100,16,0,16
Dillinger,M,100,0,273,273
Paullina,F,100,5,0,5
Doyt,M,100,0,5,5
Adil,M,100,0,1108,1108
Jubril,M,100,0,33,33
Syed,M,100,11,4486,4497
Lonald,M,100,0,69,69
Japnoor,F,100,5,0,5
Winsome,F,100,15,0,15
Goodness,F,100,10,0,10
Nox,M,100,0,51,51
Raydyn,M,100,0,38,38
Ermalinda,F,100,207,0,207
Yoanna,F,100,561,0,561
Jarvez,M,100,0,10,10
Camario,M,100,0,5,5
Kyalee,F,100,5,0,5
Resheena,F,100,11,0,11
Chinmayi,F,100,53,0,53
Masia,F,100,5,0,5
Sharyon,F,100,23,0,23
Lynika,F,100,6,0,6
Junyi,M,100,0,6,6
Julene,F,100,1270,0,1270
Sheikha,F,100,5,0,5
Matika,F,100,95,0,95
Tanica,F,100,253,0,253
Alala,F,100,15,0,15
Catalino,M,100,0,187,187
Alexzandar,M,100,0,6,6
Amaj,M,100,0,15,15
Bijal,F,100,128,0,128
Demichael,M,100,0,355,355
Mayu,F,100,161,0,161
Appollonia,F,100,55,0,55
Westan,M,100,0,24,24
Debralyn,F,100,5,0,5
Norra,F,100,5,0,5
Todd,M,100,1061,277888,278949
Raffinee,F,100,38,0,38
Shylee,F,100,651,0,651
Deloren,M,100,0,12,12
Ferando,M,100,0,29,29
Ilanie,F,100,10,0,10
Lindell,M,86,205,1261,1466
Tiffony,F,100,137,0,137
Mykala,F,100,1269,0,1269
Zephyrus,M,100,0,13,13
Adelaina,F,100,11,0,11
Tivon,M,100,0,318,318
Tykeisha,F,100,246,0,246
Santerica,F,100,6,0,6
Denika,F,100,523,0,523
Apphia,F,100,79,0,79
Seini,F,100,51,0,51
Triandos,M,100,0,5,5
Jhavon,M,100,0,29,29
Lavante,M,100,0,167,167
Eudell,M,100,0,5,5
Yarelly,F,100,216,0,216
Rosibel,F,100,277,0,277
Buren,M,100,0,69,69
Jayvon,M,100,0,3098,3098
Weylin,M,100,0,527,527
Tanita,F,100,607,0,607
Ethanial,M,100,0,16,16
Jasmene,F,100,101,0,101
Charlotte,F,100,154677,233,154910
Wandalid,F,100,5,0,5
Leondra,F,99,748,5,753
Makarios,M,100,0,65,65
Breesa,F,100,5,0,5
Romeesa,F,100,19,0,19
Genavecia,F,100,5,0,5
Ravensimone,F,100,11,0,11
Guerry,M,100,0,82,82
Terilynn,F,100,120,0,120
Matia,F,99,395,5,400
Kinnedi,F,100,16,0,16
Cengiz,M,100,0,5,5
Jamari,M,94,656,9643,10299
Jathniel,M,100,0,55,55
Janas,F,67,10,5,15
Montrail,M,100,0,221,221
Lourine,F,100,16,0,16
Surah,F,100,51,0,51
Liliam,F,100,16,0,16
Abraar,M,100,0,5,5
Tyshawn,M,97,134,4583,4717
Theophus,M,100,0,5,5
Onterio,M,100,0,38,38
Emmorie,F,100,5,0,5
Whitley,F,96,4745,207,4952
Medger,M,100,0,11,11
Dejanaye,F,100,5,0,5
Lakethia,F,100,126,0,126
Margus,M,100,0,29,29
Tawanda,F,100,4048,0,4048
Nesochi,F,100,7,0,7
Demarionna,F,100,7,0,7
Nilani,F,100,24,0,24
Tymya,F,100,17,0,17
Makston,M,100,0,5,5
Shanreka,F,100,17,0,17
Lari,F,95,784,38,822
Maceo,M,100,0,1705,1705
Tamaj,M,100,0,86,86
Johnjoseph,M,100,0,192,192
Benancio,M,100,0,189,189
Madlyn,F,100,852,0,852
Ladara,F,100,5,0,5
Morelia,F,100,662,0,662
Jomaris,F,100,10,0,10
Marteze,M,100,0,90,90
Ranier,M,100,0,199,199
Jamayah,F,100,190,0,190
Sumehra,F,100,10,0,10
Matei,M,100,0,141,141
Cortana,F,100,86,0,86
Selma,F,99,4015,28,4043
Darria,F,100,152,0,152
Taiasha,F,100,28,0,28
Cherianne,F,100,10,0,10
Monquita,F,100,5,0,5
Niccolo,M,100,0,668,668
Panagiotis,M,100,0,1110,1110
Eulene,F,100,45,0,45
Garvis,M,100,0,44,44
Jacarri,M,100,0,306,306
Christpher,M,100,0,1305,1305
Deaysha,F,100,20,0,20
Beniah,M,100,0,61,61
Hertha,F,100,34,0,34
Arlina,F,100,134,0,134
Taybor,M,100,0,5,5
Dalyce,F,100,86,0,86
Benedetto,M,100,0,478,478
Shin,M,87,12,81,93
Kierstie,F,100,15,0,15
Zita,F,100,945,0,945
Skky,F,100,45,0,45
Deedre,F,100,39,0,39
Quamine,M,100,0,5,5
Kaylonie,F,100,19,0,19
Quentavius,M,100,0,30,30
Wasay,M,100,0,5,5
Kristie,F,100,37844,44,37888
Maitreya,F,58,7,5,12
Raheemah,F,100,6,0,6
Damontre,M,100,0,148,148
Maiysha,F,100,22,0,22
Daddy,M,100,0,21,21
Katalya,F,100,6,0,6
Latreace,F,100,41,0,41
Mkayla,F,100,417,0,417
Itzury,F,100,11,0,11
Maurio,M,100,0,279,279
Almanda,F,100,10,0,10
Faria,F,100,151,0,151
Kristopfer,M,100,0,5,5
Khalief,M,100,0,40,40
Joshuapaul,M,100,0,12,12
Aidenjoseph,M,100,0,5,5
Raevon,M,90,11,101,112
Steele,M,99,21,1542,1563
Chartese,F,100,6,0,6
Amaryia,F,100,17,0,17
Allean,F,100,170,0,170
Demetrius,M,95,1721,32784,34505
Jorgan,M,100,0,11,11
Jaylian,M,100,0,5,5
Suriya,F,94,158,10,168
Doreon,M,100,0,22,22
Caymus,M,100,0,6,6
Maryland,F,81,307,71,378
Averil,F,73,92,34,126
Madra,F,100,21,0,21
Tyseana,F,100,6,0,6
Danaisa,F,100,30,0,30
Ales,M,100,0,7,7
Yasmyn,F,100,135,0,135
Colbe,M,95,6,108,114
Calii,F,100,28,0,28
Danen,M,100,0,58,58
Aldridge,M,100,0,27,27
Juliannamarie,F,100,5,0,5
Larika,F,100,37,0,37
Isaiyah,M,100,0,90,90
Maraya,F,100,742,0,742
Laquon,M,100,0,108,108
Marquiss,M,100,0,11,11
Kawana,F,100,960,0,960
Ryanmichael,M,100,0,36,36
Shanikque,F,100,8,0,8
Promise,F,95,2962,172,3134
Josafat,M,100,0,331,331
Yelitza,F,100,803,0,803
Emrick,M,100,0,135,135
Daimarion,M,100,0,7,7
Khisha,F,100,26,0,26
Karisa,F,100,2700,0,2700
Chawanda,F,100,17,0,17
Zymere,M,100,0,299,299
Jakayden,M,100,0,209,209
Demona,F,100,15,0,15
Prabhdeep,M,100,0,18,18
Gearlean,F,100,12,0,12
Jabarie,M,100,0,224,224
Maziya,F,100,11,0,11
Talin,M,62,299,498,797
Sohil,M,100,0,115,115
Jayon,M,100,0,667,667
Achazia,F,100,6,0,6
Joanmarie,F,100,158,0,158
Hanzo,M,100,0,12,12
Jordian,F,100,27,0,27
Jaja,M,100,0,109,109
Sharnett,F,100,11,0,11
Latrasha,F,100,5,0,5
Marice,M,67,319,647,966
Dorothia,F,100,26,0,26
Gere,M,65,6,11,17
Shengyeng,F,100,5,0,5
Senan,M,100,0,57,57
Latrayvion,M,100,0,5,5
Tyshika,F,100,55,0,55
Kaneka,F,100,54,0,54
Ajanae,F,100,741,0,741
Pranit,M,100,0,67,67
Norton,M,100,0,391,391
Erioluwa,F,55,12,10,22
Petite,F,100,5,0,5
Dzuy,M,100,0,6,6
Samarjit,M,100,0,5,5
Chalyse,F,100,14,0,14
Rafeal,M,100,0,894,894
Taurice,M,100,0,39,39
Nately,F,100,7,0,7
Deason,M,100,0,10,10
Jahzir,M,100,0,106,106
Kearea,F,100,5,0,5
Klover,F,100,93,0,93
Victorialynn,F,100,22,0,22
Offie,F,50,5,5,10
Jermarius,M,100,0,40,40
Anisse,F,100,5,0,5
Terril,M,87,58,377,435
Jamariya,F,100,137,0,137
Jarmain,M,100,0,18,18
Maier,M,100,0,5,5
Svana,F,100,21,0,21
Thaddues,M,100,0,44,44
Rodnesha,F,100,225,0,225
Tranell,M,71,40,98,138
Kinsasha,F,100,5,0,5
Jarian,M,100,0,317,317
Omi,M,100,0,18,18
Quavis,M,100,0,59,59
Salome,F,82,1913,410,2323
Holiday,F,100,228,0,228
Harliegh,F,100,15,0,15
Hesper,F,100,68,0,68
Shiquana,F,100,11,0,11
Tomas,M,100,16,21280,21296
Shelaine,F,100,101,0,101
Coralynn,F,100,296,0,296
Athalie,F,100,43,0,43
Haseeb,M,100,0,405,405
Levora,F,100,26,0,26
Sherraine,F,100,6,0,6
Grantham,M,100,0,180,180
Betsayda,F,100,5,0,5
Dashayla,F,100,202,0,202
Abeera,F,100,28,0,28
Adrion,M,100,0,631,631
Diego,M,100,195,93499,93694
Taylin,F,83,1705,350,2055
Earin,M,100,0,5,5
Oreatha,F,100,12,0,12
Eldric,M,100,0,18,18
Mayely,F,100,38,0,38
Raifah,F,100,6,0,6
Rashied,M,100,0,122,122
Moncheri,F,100,5,0,5
Joriah,M,55,5,6,11
Graesyn,M,72,22,56,78
Veridiana,F,100,17,0,17
Jaizon,M,100,0,80,80
Shanniece,F,100,6,0,6
Shanny,F,100,24,0,24
Carissa,F,100,27460,12,27472
Dezman,M,100,0,154,154
Amelita,F,100,5,0,5
Caymen,M,93,18,248,266
Micheaux,M,100,0,21,21
Tateyana,F,100,59,0,59
Bryian,M,100,0,33,33
Edgardo,M,100,0,5548,5548
Blayson,M,100,0,7,7
Gianno,M,100,0,47,47
Sholanda,F,100,309,0,309
Johnaven,M,100,0,26,26
Reiley,F,64,530,302,832
Jasmaine,F,99,818,6,824
Meda,F,100,252,0,252
Cenedra,F,100,45,0,45
Ronnet,F,100,5,0,5
Makynley,F,100,13,0,13
Mayerlin,F,100,36,0,36
Asialynn,F,100,28,0,28
Rashaunda,F,100,253,0,253
Tadd,M,100,0,1456,1456
Sia,F,99,956,5,961
Tanji,F,100,147,0,147
Eustacio,M,100,0,144,144
Breyonia,F,100,15,0,15
Erving,M,100,0,441,441
Venya,F,100,34,0,34
Joangela,F,100,5,0,5
Majd,M,97,10,330,340
Vallery,F,100,627,0,627
Kjirsten,F,100,94,0,94
Levitt,M,100,0,6,6
Melisse,F,100,268,0,268
Nayelys,F,100,5,0,5
Fallin,F,100,15,0,15
Aulona,F,100,6,0,6
Dilraj,M,100,0,56,56
Abdisalam,M,100,0,5,5
Itzamara,F,100,82,0,82
Hammond,M,100,0,101,101
Tandon,M,100,0,34,34
Cherra,F,100,17,0,17
Emi,F,100,2179,0,2179
Samayah,F,100,332,0,332
Dominick,M,99,262,43745,44007
Jep,M,100,0,34,34
Keisean,M,100,0,175,175
Christiana,F,100,9235,0,9235
Amairany,F,100,923,0,923
Shaza,F,100,46,0,46
Myquan,M,100,0,76,76
Evan,M,98,3720,239941,243661
Khyli,F,100,77,0,77
Tongela,F,100,79,0,79
Mionna,F,100,60,0,60
Neira,F,100,126,0,126
Frosty,M,100,0,6,6
Naizeth,F,100,7,0,7
Armel,M,100,0,135,135
Clairece,F,100,5,0,5
Latwanna,F,100,6,0,6
Anely,F,100,247,0,247
Awa,F,100,553,0,553
Carel,M,79,6,22,28
Niang,F,100,110,0,110
Arden,F,60,3926,2614,6540
Jaelina,F,100,10,0,10
Alishah,F,92,66,6,72
Kenasha,F,100,5,0,5
Monike,F,100,60,0,60
Taino,M,100,0,87,87
Maxfield,M,100,0,794,794
Lianah,F,100,64,0,64
Sina,F,64,755,420,1175
Alexzavier,M,100,0,62,62
Latunia,F,100,17,0,17
Melanney,F,100,10,0,10
Dontel,M,100,0,208,208
Coletin,M,100,0,37,37
Codye,M,100,0,28,28
Chalan,F,100,5,0,5
Mieka,F,100,211,0,211
Sinnamon,F,100,5,0,5
Braya,F,100,263,0,263
Nyomii,F,100,7,0,7
Detrevion,M,100,0,11,11
Garlan,M,100,0,111,111
Yaseen,M,100,0,1494,1494
Tiosha,F,100,22,0,22
Leeanthony,M,100,0,48,48
Lorriane,F,100,444,0,444
Maxymus,M,100,0,5,5
Wakeen,M,100,0,5,5
Jennean,F,100,23,0,23
Mayhem,M,100,0,6,6
Brittinay,F,100,23,0,23
Ransome,M,100,0,45,45
Michiya,F,100,20,0,20
Ronniel,M,100,0,5,5
Izara,F,100,5,0,5
Fredo,M,100,0,5,5
Neeharika,F,100,56,0,56
Dawna,F,100,5342,0,5342
Renota,F,100,44,0,44
Chauncie,F,100,18,0,18
Emelio,M,100,0,222,222
Olivyah,F,100,5,0,5
Merlena,F,100,6,0,6
Andretta,F,100,289,0,289
Adrijana,F,100,51,0,51
Schelly,F,100,107,0,107
Saher,F,97,174,5,179
Tarel,M,100,0,18,18
Buddy,M,100,6,10456,10462
Yejun,M,100,0,6,6
Jovanah,F,100,5,0,5
Cheryllynne,F,100,5,0,5
Itzael,M,100,0,57,57
Aviva,F,100,2387,0,2387
Kamron,M,95,281,5696,5977
Marleyna,F,100,39,0,39
Shantal,F,100,1472,0,1472
Meztly,F,100,5,0,5
Malacki,M,100,0,51,51
Carlosalberto,M,100,0,46,46
Cregg,M,100,0,179,179
Ilene,F,100,7949,0,7949
Cristina,F,99,49192,270,49462
Naven,M,100,0,78,78
Shanti,F,92,1677,140,1817
Dezeray,F,100,397,0,397
Ambriel,F,100,253,0,253
Wendella,F,100,41,0,41
Kaesha,F,100,97,0,97
Tercel,M,100,0,12,12
Shyleigh,F,100,70,0,70
Zeanna,F,100,113,0,113
Bernard,M,99,376,66170,66546
Trenya,F,100,15,0,15
Bruno,M,100,0,7985,7985
Tahjanee,F,100,5,0,5
Seidy,F,100,263,0,263
Dariany,F,100,23,0,23
Hafsah,F,100,359,0,359
Cortavius,M,100,0,105,105
Talion,M,100,0,6,6
Danyll,F,100,5,0,5
Izaiha,M,100,0,266,266
Billyray,M,100,0,46,46
Abinav,M,100,0,24,24
Rease,M,53,62,69,131
Tybria,F,100,39,0,39
Nashalee,F,100,23,0,23
Raney,F,85,309,55,364
Chord,M,100,0,44,44
Rosheena,F,100,36,0,36
Josiephine,F,100,99,0,99
Autry,M,92,39,480,519
Ghina,F,100,24,0,24
Kaiman,M,100,0,5,5
Varshika,F,100,5,0,5
Kalin,M,53,1466,1657,3123
Emmaleah,F,100,95,0,95
Neill,M,100,0,1128,1128
Ellarose,F,100,209,0,209
Sequana,F,100,49,0,49
Jahaven,M,100,0,11,11
Jehiel,M,100,0,113,113
Harman,M,90,58,525,583
Litisha,F,100,256,0,256
Anass,M,100,0,30,30
Dasjia,F,100,5,0,5
Rokas,M,100,0,12,12
Shareef,M,100,0,1046,1046
Kwanita,F,100,43,0,43
Ikponmwosa,M,100,0,5,5
Lwren,F,100,14,0,14
Dwayn,M,100,0,72,72
Jaleigh,F,100,629,0,629
Jarya,F,100,23,0,23
Keyira,F,100,101,0,101
Shiala,F,100,5,0,5
Imana,F,100,14,0,14
Johnny,M,99,2031,210070,212101
Ogden,M,100,0,181,181
Nissim,M,100,0,149,149
Merredith,F,100,50,0,50
Srikrithi,F,100,5,0,5
Jolian,M,100,0,5,5
Benjiam,M,100,0,5,5
Hilberto,M,100,0,122,122
Leiona,F,100,10,0,10
Areebah,F,100,98,0,98
Jeanann,F,100,442,0,442
Maat,F,100,55,0,55
Daimion,M,100,0,76,76
Yitzhak,M,100,0,153,153
Alexeia,F,100,23,0,23
Kendale,M,94,55,870,925
Keyton,M,100,0,652,652
Samatar,M,100,0,35,35
Kemi,F,100,288,0,288
Kameia,F,100,10,0,10
Alecia,F,100,11476,0,11476
Jalessa,F,100,679,0,679
Jasten,M,100,0,97,97
Jenalise,F,100,41,0,41
Yaxiel,M,100,0,75,75
Kadari,M,100,0,15,15
Jynna,F,100,7,0,7
Analiza,F,100,202,0,202
Omika,F,100,5,0,5
Ileyah,F,100,21,0,21
Neketa,F,100,35,0,35
Autavia,F,100,5,0,5
Tynesia,F,100,97,0,97
Dinasia,F,100,24,0,24
Rhona,F,100,1028,0,1028
Allaya,F,100,65,0,65
Terius,M,100,0,87,87
Jhamere,M,100,0,5,5
Lurana,F,100,17,0,17
Nattie,F,100,15,0,15
Gzim,M,100,0,5,5
Jahsi,M,100,0,19,19
Sequoria,F,100,17,0,17
Mayla,F,100,660,0,660
Nyarai,F,100,5,0,5
Pearleen,F,100,6,0,6
Sheriann,F,100,148,0,148
Izza,F,100,43,0,43
Alyse,F,100,6555,0,6555
Dylanmichael,M,100,0,10,10
Doneisha,F,100,365,0,365
Chardonae,F,100,26,0,26
Tyronesha,F,100,5,0,5
Domica,F,100,5,0,5
Laresa,F,100,408,0,408
Casandra,F,100,15332,7,15339
Adrianno,M,100,0,8,8
Eddy,M,98,195,9833,10028
Solarah,F,100,5,0,5
Tennesha,F,100,6,0,6
Ellani,F,100,12,0,12
Radford,M,100,0,513,513
Jayetta,F,100,5,0,5
Andreka,F,100,144,0,144
Blenda,F,100,617,0,617
Charlsey,F,100,194,0,194
Yardley,M,55,81,99,180
Reyshawn,M,100,0,16,16
Aurohom,M,100,0,16,16
Hael,M,100,0,5,5
Emmanuel,M,99,337,64080,64417
Wrenley,F,100,21,0,21
Julieth,F,100,353,0,353
Tyrod,M,100,0,11,11
Kalim,M,100,0,108,108
Khamani,M,66,310,613,923
Larenzo,M,100,0,910,910
Euan,M,100,0,278,278
Nazir,M,100,0,2013,2013
Milinda,F,100,962,0,962
Kaipo,M,100,0,402,402
Caryl,F,98,2533,58,2591
Ygnacio,M,100,0,149,149
Kumani,F,100,5,0,5
Janetra,F,100,5,0,5
Maeghan,F,100,1064,0,1064
Glennon,M,100,0,505,505
Samiera,F,100,5,0,5
Meri,F,100,2074,0,2074
Ilyass,M,100,0,10,10
Dillard,M,100,0,960,960
Laylarose,F,100,32,0,32
Jakyriah,F,100,11,0,11
Alecha,F,100,11,0,11
Hadiyyah,F,100,40,0,40
Rosenna,F,100,5,0,5
Martaveous,M,100,0,5,5
Tenor,M,100,0,20,20
Nicoleta,F,100,31,0,31
Tichina,F,100,379,0,379
Mistie,F,100,2240,0,2240
Greydys,F,100,8,0,8
Dawnn,F,100,297,0,297
Baotran,F,100,16,0,16
Arielly,F,100,23,0,23
Arethia,F,100,23,0,23
Leyan,F,100,48,0,48
Cathreen,F,100,10,0,10
Geniyah,F,100,105,0,105
Dayleon,M,100,0,15,15
Birgitte,F,100,5,0,5
Theia,F,100,136,0,136
Tiaa,F,100,29,0,29
Yoceline,F,100,112,0,112
Brookie,F,100,238,0,238
Coddy,M,100,0,22,22
Tonilyn,F,100,11,0,11
Sudeeksha,F,100,5,0,5
Siniyah,F,100,100,0,100
Henny,F,100,538,0,538
Diamyn,F,100,13,0,13
Daintry,F,100,6,0,6
Jamilka,F,100,5,0,5
Norvella,F,100,57,0,57
Laqueeta,F,100,15,0,15
Briant,M,100,0,923,923
Cinch,M,100,0,97,97
Ellowyn,F,100,85,0,85
Dawsen,M,98,5,323,328
Shakida,F,100,24,0,24
Ahnia,F,100,28,0,28
Jahsun,M,100,0,18,18
Dlisa,F,100,69,0,69
Veldon,M,100,0,54,54
Nikolos,M,100,0,217,217
Alexies,F,100,41,0,41
Harmanpreet,F,54,7,6,13
Zhayden,M,100,0,20,20
Emiliee,F,100,5,0,5
Blessyn,F,100,136,0,136
Amabel,F,100,103,0,103
Thaine,M,100,0,63,63
Abbylynn,F,100,18,0,18
Neera,F,100,62,0,62
Adae,M,100,0,5,5
Amalyn,F,100,5,0,5
Clinten,M,100,0,93,93
Eufemia,F,100,233,0,233
Samier,M,100,0,95,95
Abegayle,F,100,23,0,23
Zenon,M,100,0,782,782
Jliana,F,100,5,0,5
Faeryn,F,100,10,0,10
Kreena,F,100,5,0,5
Odete,F,100,5,0,5
Karma,F,98,4992,100,5092
Sobeida,F,100,14,0,14
Melainie,F,100,107,0,107
Charia,F,100,35,0,35
Zayvian,M,100,0,133,133
Naithyn,M,100,0,5,5
Dyneshia,F,100,75,0,75
Athenia,F,100,110,0,110
Indee,F,100,17,0,17
Blake,M,96,6330,160942,167272
Anaiz,F,100,319,0,319
Kingjosiah,M,100,0,11,11
Ronneisha,F,100,74,0,74
Prezleigh,F,100,11,0,11
Mustafe,M,100,0,7,7
Adriena,F,100,135,0,135
Jaquila,F,100,59,0,59
Chyana,F,100,10,0,10
Shanterria,F,100,251,0,251
Nizaiah,M,100,0,36,36
Tremekia,F,100,6,0,6
Aro,M,100,0,19,19
Burl,M,100,0,1757,1757
Denedra,F,100,37,0,37
Deloni,M,100,0,5,5
Duffie,M,100,0,6,6
Paitin,F,100,28,0,28
Wood,M,100,0,18,18
Taeler,F,99,341,5,346
Delaiah,F,100,20,0,20
Demarious,M,100,0,345,345
Malinah,F,100,11,0,11
Laksmi,F,100,5,0,5
Shashawn,F,100,5,0,5
Makayah,F,100,161,0,161
Derren,M,100,0,392,392
Yashwant,M,100,0,5,5
Bimbo,M,100,0,5,5
Kirisa,F,100,5,0,5
Daniellie,F,100,27,0,27
Marianah,F,100,37,0,37
Audrick,M,100,0,26,26
Khiya,F,100,250,0,250
Tieka,F,100,18,0,18
Keidan,M,100,0,62,62
Elara,F,100,137,0,137
Demie,F,100,46,0,46
Heavon,F,100,15,0,15
Darshan,M,98,11,617,628
Doshia,F,100,86,0,86
Laurenn,F,100,11,0,11
Verdena,F,100,5,0,5
Arnetra,F,100,63,0,63
Jacki,F,100,3242,5,3247
Tabetha,F,100,3905,0,3905
Ellana,F,100,387,0,387
Narcedalia,F,100,26,0,26
Kidus,M,100,0,433,433
Jaynee,F,100,675,0,675
Attache,F,100,6,0,6
Duru,F,100,72,0,72
Tatisha,F,100,61,0,61
Lea,F,99,26230,206,26436
Paton,M,100,0,75,75
Jozetta,F,100,11,0,11
Haslyn,F,100,6,0,6
Malaja,F,100,48,0,48
Zahmir,M,100,0,267,267
Izan,M,100,0,150,150
Javyn,M,100,0,201,201
Rikky,M,100,0,5,5
Adreona,F,100,106,0,106
Nickalis,M,100,0,39,39
Sedricka,F,100,16,0,16
Gleda,F,100,26,0,26
Gissette,F,100,15,0,15
Cheriece,F,100,6,0,6
Quwana,F,100,11,0,11
Esparanza,F,100,72,0,72
Bhargavi,F,100,30,0,30
Karlia,F,100,11,0,11
Sharena,F,100,523,0,523
Ciniyah,F,100,48,0,48
Rocki,M,100,0,5,5
Kaybre,F,100,5,0,5
Nikkiah,F,100,5,0,5
Jlee,F,100,62,0,62
Kamonie,F,100,46,0,46
Tatiyonna,F,100,5,0,5
Mairin,F,100,585,0,585
Johnyla,F,100,6,0,6
Luciella,F,100,22,0,22
Even,M,100,0,407,407
Bethia,F,100,17,0,17
Anuoluwapo,F,100,35,0,35
Anthonyjohn,M,100,0,36,36
Nikaila,F,100,21,0,21
Chasidi,F,100,21,0,21
Armar,M,100,0,6,6
Dinna,F,100,170,0,170
Austintyler,M,100,0,11,11
Fabian,M,99,327,34763,35090
Elisavet,F,100,51,0,51
Dewann,M,100,0,17,17
Kinberli,F,100,25,0,25
Jarrett,M,100,78,21203,21281
Dinos,M,100,0,5,5
Katheren,F,100,104,0,104
Raika,F,100,5,0,5
Delila,F,100,1991,0,1991
Corea,F,100,22,0,22
Azekiel,M,100,0,29,29
Aylon,M,100,0,5,5
Zanah,F,100,31,0,31
Lia,F,100,15066,10,15076
Lacresa,F,100,20,0,20
Ruhi,F,100,435,0,435
Devontee,M,100,0,20,20
Aigne,F,100,9,0,9
Nerys,F,100,5,0,5
Shanique,F,100,1689,0,1689
Kimeka,F,100,61,0,61
Tamye,F,100,42,0,42
Laporshia,F,100,83,0,83
Sammer,M,100,0,39,39
Wilburn,M,100,0,1889,1889
Aalexis,F,100,20,0,20
Nikitia,F,100,88,0,88
Hikaru,M,88,18,132,150
Rhodney,M,100,0,39,39
Daphnie,F,100,717,0,717
Mekalah,F,100,24,0,24
Geordy,M,100,0,27,27
Xeniya,F,100,5,0,5
Beverli,F,100,33,0,33
Ave,F,100,622,0,622
Kylicia,F,100,5,0,5
Keilanie,F,100,11,0,11
Arzo,M,100,0,10,10
Lanaeya,F,100,11,0,11
Dejanai,F,100,50,0,50
Joskar,M,100,0,22,22
Jenrry,M,100,0,35,35
Brandice,F,100,1033,0,1033
Shirley,F,99,169778,1097,170875
Jakeob,M,100,0,182,182
Donminique,M,100,0,5,5
Tanikka,F,100,124,0,124
Karielle,F,100,90,0,90
Daishana,F,100,10,0,10
Janiqua,F,100,361,0,361
Kavonte,M,100,0,205,205
Lahla,F,100,5,0,5
Emmaree,F,100,30,0,30
Jeyleen,F,100,40,0,40
Jaydon,M,98,195,7789,7984
Brayle,F,100,5,0,5
Sabre,F,89,481,59,540
Sharnika,F,100,69,0,69
Tee,M,87,40,262,302
Deresa,F,100,46,0,46
Akerra,F,100,7,0,7
Othon,M,100,0,65,65
Lanyjah,F,100,10,0,10
Martavia,F,100,119,0,119
Ileigh,F,100,69,0,69
Tyresse,M,100,0,268,268
Jhobany,M,100,0,5,5
Alajiah,F,100,81,0,81
Jaymel,M,100,0,18,18
Hamsa,M,100,0,144,144
Mychael,M,84,237,1210,1447
Harvest,F,67,182,91,273
Stephany,F,100,13662,5,13667
Abdalah,M,100,0,6,6
Sharaine,F,100,64,0,64
Isaiaha,M,100,0,13,13
Solomon,M,100,11,19407,19418
Marks,M,100,0,32,32
Yerik,M,100,0,572,572
Aevry,F,100,5,0,5
Raionna,F,100,60,0,60
Dalayshia,F,100,5,0,5
Hektor,M,100,0,51,51
Tayshawna,F,100,10,0,10
Enoch,M,100,0,5455,5455
Kion,M,100,0,601,601
Jamahl,M,100,0,692,692
Marsheila,F,100,106,0,106
Roselynn,F,100,1236,0,1236
Maiah,F,100,721,0,721
Karmel,F,86,121,20,141
Talexis,F,100,6,0,6
Subrina,F,100,871,0,871
Tyka,F,100,5,0,5
Ahniya,F,100,291,0,291
Taimani,F,100,5,0,5
Zaroon,M,100,0,8,8
Siboney,F,100,80,0,80
Daziya,F,100,90,0,90
Liany,F,100,153,0,153
Travond,M,100,0,6,6
Dkayla,F,100,49,0,49
Izacc,M,100,0,104,104
Kryssa,F,100,64,0,64
Leeza,F,100,849,0,849
Traelon,M,100,0,15,15
Shazaria,F,100,10,0,10
Sunda,F,100,22,0,22
Kayton,F,63,142,82,224
Marlenis,F,100,11,0,11
Patte,F,100,45,0,45
Arleni,F,100,29,0,29
Elianys,F,100,40,0,40
Levonda,F,100,40,0,40
Rabi,M,100,0,12,12
Dodd,M,100,0,288,288
Mahesh,M,100,0,203,203
Audine,F,100,5,0,5
Daedra,F,100,34,0,34
Alexian,M,100,0,5,5
Margherita,F,100,552,0,552
Dmar,M,100,0,5,5
Dontavis,M,100,0,354,354
Lailarose,F,100,6,0,6
Nacole,F,100,1018,0,1018
Brosnan,M,100,0,20,20
Shakeel,M,100,0,212,212
Bassem,M,100,0,41,41
Densil,M,100,0,12,12
Aadan,M,100,0,112,112
Jesel,F,100,6,0,6
Fue,M,100,0,272,272
Javi,M,100,0,129,129
Garrit,M,100,0,179,179
Arnesha,F,100,304,0,304
Emitt,M,100,0,168,168
Crosby,M,89,274,2335,2609
Sayward,F,100,117,0,117
Yarisel,F,100,38,0,38
Karrissa,F,100,355,0,355
Yasmeena,F,100,22,0,22
Kenajah,F,100,5,0,5
Nikolle,F,100,40,0,40
Gianelly,F,100,27,0,27
Lenorah,F,100,12,0,12
Jazmane,F,100,31,0,31
Athanasios,M,100,0,1068,1068
Graclyn,F,100,157,0,157
Adenn,M,100,0,12,12
Lenzie,F,61,179,116,295
Yura,F,100,10,0,10
Naren,M,100,0,188,188
Shontay,F,98,567,10,577
Kemp,M,100,0,768,768
Modesti,F,100,6,0,6
Ryleeanne,F,100,5,0,5
Tobye,F,100,5,0,5
Ivori,F,100,316,0,316
Marsell,M,100,0,10,10
Antoan,M,100,0,55,55
Lee,M,76,39022,122302,161324
Jaylien,M,67,14,29,43
Miajah,F,100,11,0,11
Aubryana,F,100,240,0,240
Jelan,M,100,0,73,73
Jalonni,M,100,0,5,5
Edi,M,93,24,307,331
Chukwubuikem,M,100,0,12,12
Joeray,M,100,0,13,13
Keonia,F,100,301,0,301
Tykia,F,100,624,0,624
Devere,M,100,0,177,177
Valorie,F,100,6604,0,6604
Kharson,M,100,0,12,12
Paden,M,90,179,1546,1725
Ebaristo,M,100,0,5,5
Kaicy,F,100,5,0,5
Alexisnicole,F,100,5,0,5
Elanie,F,100,346,0,346
Philant,M,100,0,14,14
Deagan,M,100,0,718,718
Nemecio,M,100,0,20,20
Jodice,M,100,0,7,7
Jakirrah,F,100,5,0,5
Krey,M,100,0,16,16
Persayis,F,100,15,0,15
Rashanna,F,100,183,0,183
Cloey,F,100,1761,0,1761
Mckyle,M,100,0,61,61
Demariae,M,100,0,32,32
Neyo,M,100,0,45,45
Kalliope,F,100,361,0,361
Jaqari,M,100,0,11,11
Camielle,F,100,249,0,249
Kalaeb,M,100,0,10,10
Luvonne,F,100,5,0,5
Mia,F,100,173440,237,173677
Kinard,M,100,0,34,34
Raid,M,100,0,16,16
Jelany,F,100,5,0,5
Jeb,M,100,0,2355,2355
Chaunda,F,100,123,0,123
Zmya,F,100,51,0,51
Gemmalynn,F,100,6,0,6
Kavia,F,100,28,0,28
Wakesha,F,100,11,0,11
Kamy,F,100,111,0,111
Nataylia,F,100,7,0,7
Celissa,F,100,44,0,44
Torriana,F,100,53,0,53
Somarah,F,100,5,0,5
Jereth,M,100,0,31,31
Serkan,M,100,0,13,13
Deonca,F,100,16,0,16
Kydon,M,100,0,33,33
Chie,F,100,32,0,32
Dajiana,F,100,15,0,15
Arneta,F,100,41,0,41
Espen,M,99,5,397,402
Ziniya,F,100,11,0,11
Rayshone,M,100,0,5,5
Dorinda,F,100,3872,0,3872
Teya,F,100,1067,0,1067
Faustina,F,100,752,0,752
Rosalyne,F,100,16,0,16
Achille,M,100,0,58,58
Tanyelle,F,100,10,0,10
Jaydein,M,100,0,10,10
Stuart,M,100,204,47446,47650
Chinyere,F,100,547,0,547
Johnnel,M,100,0,10,10
Eleisa,F,100,6,0,6
Arkesha,F,100,26,0,26
Brandasia,F,100,17,0,17
Denayah,F,100,26,0,26
Khora,F,100,10,0,10
Dantonio,M,100,0,164,164
Missy,F,100,5561,0,5561
Latonya,F,100,21720,67,21787
Kentin,M,100,0,17,17
Brynae,F,100,33,0,33
Issael,M,100,0,36,36
Jaishaun,M,100,0,157,157
Finnian,M,100,0,1643,1643
Handy,M,95,5,97,102
Kysin,M,100,0,32,32
Savana,F,100,4913,0,4913
Kiralee,F,100,14,0,14
Minnetta,F,100,8,0,8
Jamela,F,100,876,0,876
Maxmilian,M,100,0,124,124
Altus,M,100,0,10,10
Latecia,F,100,505,0,505
Daily,F,93,128,10,138
Cline,M,100,0,190,190
Koryne,F,100,6,0,6
Salathiel,M,100,0,64,64
Tnya,F,100,78,0,78
Daiceon,M,100,0,5,5
Kendrea,F,100,626,0,626
Chade,F,88,137,18,155
Nenette,F,100,6,0,6
Jante,M,75,14,41,55
Shanade,F,100,26,0,26
Zaylyn,M,62,34,55,89
Gallagher,M,100,0,5,5
Rogina,F,100,187,0,187
Teraji,F,100,33,0,33
Lema,F,100,25,0,25
Dekari,M,100,0,246,246
Jerek,M,100,0,442,442
Caleb,M,100,560,250921,251481
Rix,M,100,0,5,5
Kimberleigh,F,100,685,0,685
Jerrett,M,100,0,1172,1172
Denetrius,F,100,10,0,10
Niriyah,F,100,5,0,5
Adera,F,100,5,0,5
Satasha,F,100,27,0,27
Aprel,F,100,70,0,70
Gailya,F,100,42,0,42
Urina,F,100,5,0,5
Jinni,F,100,5,0,5
Thoa,F,100,5,0,5
Kibbie,F,100,5,0,5
Breleigh,F,100,272,0,272
Anamarie,F,100,1165,0,1165
Mattalynn,F,100,89,0,89
Mckennon,M,100,0,88,88
Vicenzo,M,100,0,26,26
Aliyiah,F,100,51,0,51
Sacheen,F,100,105,0,105
Daquane,M,100,0,161,161
Michaelray,M,100,0,41,41
Brener,M,100,0,5,5
Adela,F,100,6877,0,6877
Jorianna,F,100,5,0,5
Josejr,M,100,0,12,12
Emani,F,94,4019,276,4295
Mozell,F,66,251,132,383
Kyleemarie,F,100,5,0,5
Rehma,F,100,15,0,15
Sanaa,F,100,4631,0,4631
Noely,F,100,500,0,500
Sharea,F,100,203,0,203
Colleen,F,100,137370,307,137677
Marybelle,F,100,231,0,231
Cati,F,100,44,0,44
Rolla,M,96,5,127,132
Shikina,F,100,18,0,18
Bertie,F,94,630,43,673
Azia,F,100,1248,0,1248
Breonia,F,100,143,0,143
Quanette,F,100,7,0,7
Laleah,F,100,5,0,5
Kuwana,F,100,5,0,5
Deshera,F,100,18,0,18
Adelys,F,100,5,0,5
Corsandra,F,100,5,0,5
Mariade,F,100,39,0,39
Nijeria,F,100,7,0,7
Sneijder,M,100,0,81,81
Sholom,M,100,0,996,996
Numa,F,79,55,15,70
Morgin,F,100,127,0,127
Zyran,M,100,0,20,20
Kaishawn,M,100,0,47,47
Lizvette,F,100,70,0,70
Jataveon,M,100,0,16,16
Maliea,F,100,76,0,76
Shelene,F,100,326,0,326
Kanen,M,100,0,282,282
Ternell,M,100,0,5,5
Damariah,F,100,53,0,53
Lane,M,91,3232,31046,34278
Tishina,F,100,68,0,68
Jakaila,F,100,196,0,196
Shreena,F,100,75,0,75
Kiyuana,F,100,6,0,6
Chayane,M,100,0,5,5
Aaleyah,F,100,764,0,764
Dominicia,F,100,6,0,6
Nakayah,F,100,27,0,27
Creola,F,100,223,0,223
Jaelie,F,100,92,0,92
Gianlucca,M,100,0,72,72
Talayshia,F,100,20,0,20
Bradon,M,100,0,1979,1979
Fritzgerald,M,100,0,43,43
Tyrie,M,94,41,626,667
Kanira,F,100,7,0,7
Victormanuel,M,100,0,228,228
Canada,F,100,54,0,54
Tamicia,F,100,45,0,45
Lauryne,F,100,5,0,5
Elisabet,F,100,1333,0,1333
Roan,M,92,115,1371,1486
Lenice,F,100,254,0,254
Deliylah,F,100,19,0,19
Razaria,F,100,6,0,6
Osbaldo,M,100,0,2891,2891
Vickiana,F,100,38,0,38
Rosanne,F,100,10850,0,10850
Malachia,F,65,20,11,31
Imer,M,100,0,197,197
Simpson,M,100,0,168,168
Letrica,F,100,5,0,5
Nefertari,F,100,292,0,292
Rozann,F,100,148,0,148
Larimar,F,100,22,0,22
Liah,F,100,964,0,964
Rishona,F,100,10,0,10
Jaavon,M,100,0,5,5
Keasya,F,100,5,0,5
Lennetta,F,100,19,0,19
Sheelagh,F,100,7,0,7
Bashiri,M,100,0,5,5
Kinzi,F,100,241,0,241
Tyral,M,100,0,24,24
Kyarah,F,100,182,0,182
Briea,F,100,144,0,144
Thain,M,100,0,5,5
Pawan,M,100,0,37,37
Tynecia,F,100,33,0,33
Chiquana,F,100,6,0,6
Naishawn,M,100,0,11,11
Marciann,F,100,12,0,12
Helsea,F,100,13,0,13
Ramonda,F,100,302,0,302
Angelline,F,100,9,0,9
Luccas,M,100,0,116,116
Lendale,M,100,0,15,15
Etna,F,100,11,0,11
Marikay,F,100,162,0,162
Elainna,F,100,171,0,171
Geofrey,M,100,0,141,141
Sinuhe,M,100,0,10,10
Dafni,F,100,5,0,5
Devany,F,100,809,0,809
Walton,M,100,0,1808,1808
Junette,F,100,103,0,103
Jannita,F,100,5,0,5
Nahyeli,F,100,18,0,18
Chistian,M,100,0,219,219
Joaly,F,100,57,0,57
Marlin,M,89,1245,10282,11527
Yassen,M,100,0,30,30
Keyarra,F,100,322,0,322
Donold,M,100,0,358,358
Kali,F,97,19992,541,20533
Devionna,F,100,7,0,7
Antoinique,F,100,25,0,25
Ziyona,F,100,42,0,42
Zamir,M,100,0,1597,1597
Daela,F,100,24,0,24
Yaretza,F,100,10,0,10
Tailynn,F,100,479,0,479
Breydin,M,100,0,19,19
Curtina,F,100,69,0,69
Gwendoly,F,100,28,0,28
Crytal,F,100,89,0,89
Jaycee,F,89,7611,968,8579
Dejanelle,F,100,21,0,21
Taneca,F,100,12,0,12
Kaycen,M,92,19,212,231
Windham,M,100,0,10,10
Abrianne,F,100,15,0,15
Shynia,F,100,139,0,139
Obasi,M,100,0,5,5
Nyquasia,F,100,8,0,8
Anngie,F,100,6,0,6
Nicolae,M,100,0,108,108
Marqutia,F,100,12,0,12
Petrit,M,100,0,5,5
Bonnette,F,100,16,0,16
Adoniram,M,100,0,21,21
Yaliyah,F,100,10,0,10
Willamena,F,100,10,0,10
Aliah,F,100,3455,0,3455
Tyland,M,100,0,100,100
Kesslyn,F,100,11,0,11
Usher,M,100,0,735,735
Jarrette,M,100,0,142,142
Totiana,F,100,106,0,106
Laralee,F,100,33,0,33
Azhanae,F,100,5,0,5
Corderall,M,100,0,5,5
Delwin,M,100,0,1002,1002
Jameese,F,100,7,0,7
Kamrynne,F,100,5,0,5
Rue,F,82,208,47,255
Arista,F,100,471,0,471
Lanazia,F,100,6,0,6
Ardith,F,99,909,5,914
Hala,F,100,1237,0,1237
Tammie,F,100,35253,134,35387
Ceola,F,100,335,0,335
Maleik,M,100,0,363,363
Neptali,M,100,0,15,15
Norva,F,100,56,0,56
Samere,M,100,0,41,41
Shterna,F,100,199,0,199
Samith,M,100,0,11,11
Cniyah,F,100,56,0,56
Hrach,M,100,0,11,11
Kadden,M,100,0,163,163
Lunden,F,58,324,231,555
Calirose,F,100,27,0,27
Erika,F,100,121814,548,122362
Noreli,F,100,22,0,22
Jackhenry,M,100,0,41,41
Nakia,F,81,8541,1982,10523
Carlynn,F,100,585,0,585
Seandell,M,100,0,15,15
Meilech,M,100,0,130,130
Jennife,F,100,265,0,265
Chineye,F,100,5,0,5
Reshawna,F,100,16,0,16
Quintez,M,100,0,599,599
Ichigo,M,100,0,5,5
Namyia,F,100,6,0,6
Cyndal,F,100,225,0,225
Wyhatt,M,100,0,5,5
Trezdon,M,100,0,19,19
Laylee,F,100,131,0,131
Kellsie,F,100,521,0,521
Letisha,F,100,1889,0,1889
Leizel,F,100,5,0,5
Hilario,M,100,0,3072,3072
Harle,M,100,0,5,5
Chances,F,100,11,0,11
Baraka,M,92,18,198,216
Sailesh,M,100,0,20,20
Romando,M,100,0,39,39
Greko,M,100,0,17,17
Marsheena,F,100,6,0,6
Faythe,F,100,803,0,803
Jahlea,F,100,31,0,31
Briteny,F,100,67,0,67
Jadynce,F,100,5,0,5
Catha,F,100,115,0,115
Kyryn,M,100,0,15,15
Sheyanna,F,100,55,0,55
Cerisa,F,100,5,0,5
Alyssarose,F,100,5,0,5
Ivianna,F,100,115,0,115
Noraa,F,100,85,0,85
Delayla,F,100,160,0,160
Tephen,M,100,0,11,11
Francsico,M,100,0,5,5
Mischa,F,88,1350,180,1530
Keiondra,F,100,128,0,128
Alah,F,100,5,0,5
Muzamil,M,100,0,70,70
Avani,F,99,1969,17,1986
Aryona,F,100,155,0,155
Fareedah,F,100,69,0,69
Shown,M,93,6,75,81
Rosamaria,F,100,1834,0,1834
Mihika,F,100,394,0,394
Cope,M,100,0,43,43
Mahalakshmi,F,100,13,0,13
Byard,M,100,0,12,12
Tayvione,M,100,0,6,6
Alizza,F,100,71,0,71
Kursty,F,100,19,0,19
Cadey,F,100,117,0,117
Mace,M,100,0,1066,1066
Letrecia,F,100,5,0,5
Baudilio,M,100,0,16,16
Marylu,F,100,565,0,565
Alliee,F,100,7,0,7
Kutana,F,100,16,0,16
Geanna,F,100,484,0,484
Jolin,F,91,340,34,374
Quinterra,F,100,46,0,46
Jaiyah,F,100,148,0,148
Trevaughn,M,100,0,804,804
Gregeory,M,100,0,26,26
Savaeh,F,100,12,0,12
Charm,F,100,287,0,287
Dalene,F,100,1196,0,1196
Josiphine,F,100,20,0,20
Febra,F,100,6,0,6
Sareli,F,100,17,0,17
Bassam,M,100,0,346,346
Kaja,F,100,536,0,536
Sareena,F,100,459,0,459
Tahina,F,100,53,0,53
Sammiejo,F,100,6,0,6
Kole,M,100,28,6972,7000
Georgena,F,100,332,0,332
Chiquia,F,100,5,0,5
Jakai,M,90,141,1314,1455
Allandra,F,100,17,0,17
Danaijah,F,100,59,0,59
Remingtyn,F,100,12,0,12
Catiana,F,100,41,0,41
Ario,M,100,0,36,36
Makynlei,F,100,5,0,5
Veleta,F,100,89,0,89
Tawfeeq,M,100,0,5,5
Kholten,M,100,0,5,5
Maquela,F,100,18,0,18
Undray,M,100,0,104,104
Jahquell,M,100,0,10,10
Stefania,F,100,1737,0,1737
Devindra,M,100,0,23,23
Tamir,M,97,45,1434,1479
Chaquita,F,100,525,0,525
Mackinsey,F,100,184,0,184
Raymund,M,100,0,487,487
Jimiya,F,100,11,0,11
Lorrae,F,100,10,0,10
Alfonzie,M,100,0,5,5
Shealan,F,100,5,0,5
Emzie,M,100,0,6,6
Roxsand,F,100,5,0,5
Venette,F,100,27,0,27
Cathalina,F,100,74,0,74
Camareon,M,100,0,23,23
Keyshauna,F,100,18,0,18
Haidy,F,100,175,0,175
Austun,M,100,0,49,49
Jameice,F,100,16,0,16
Jancy,F,98,313,5,318
Alikhan,M,100,0,5,5
Lusila,F,100,27,0,27
Monice,F,100,208,0,208
Amelianna,F,100,23,0,23
Vianeth,F,100,13,0,13
Pantera,F,100,86,0,86
Toniya,F,100,140,0,140
Bridgette,F,100,22780,16,22796
Demonta,M,100,0,689,689
Damany,M,100,0,89,89
Jachin,M,100,0,363,363
Tamasine,F,100,5,0,5
Seriya,F,100,32,0,32
Burnie,M,100,0,239,239
Peris,F,79,22,6,28
Ethyn,M,100,0,1212,1212
Mitcheal,M,100,0,261,261
Sucely,F,100,24,0,24
Tarria,F,100,16,0,16
Greogory,M,100,0,79,79
Jeven,M,100,0,77,77
Eze,M,100,0,6,6
Sovereign,M,56,16,20,36
Keyvin,M,100,0,82,82
Boone,M,100,0,1809,1809
Dhir,M,100,0,16,16
Kirsey,F,100,5,0,5
Tisya,F,100,20,0,20
Josephy,M,100,0,12,12
Jadarion,M,100,0,95,95
Annalize,F,100,32,0,32
Dezire,F,100,647,0,647
Tomari,M,100,0,5,5
Julliana,F,100,293,0,293
Bryor,M,100,0,111,111
Verlinda,F,100,558,0,558
Paishence,F,100,20,0,20
Toinetta,F,100,18,0,18
Sarek,M,100,0,13,13
Lawerance,M,100,0,477,477
Juanpedro,M,100,0,11,11
Rett,M,100,0,91,91
Valisa,F,100,336,0,336
Jelynn,F,100,10,0,10
Dionel,M,100,0,80,80
Artimus,M,100,0,44,44
Chiyo,F,100,11,0,11
Celerina,F,100,6,0,6
Itisha,F,100,6,0,6
Joelys,F,100,63,0,63
Mali,F,96,905,33,938
Astreia,F,100,6,0,6
Nichols,M,100,0,678,678
Knowledge,M,99,10,674,684
Vision,F,100,31,0,31
Arkia,F,100,16,0,16
Saveah,F,100,67,0,67
Anuj,M,100,0,838,838
Kemran,M,100,0,5,5
Scarlettrose,F,100,19,0,19
Chasse,M,100,0,22,22
Pincus,M,100,0,25,25
Kyng,M,100,0,279,279
Kestra,F,100,23,0,23
Moneque,F,100,5,0,5
Amirykal,F,100,13,0,13
Hager,F,87,39,6,45
Alejandra,F,99,47042,525,47567
Nikkol,F,100,132,0,132
Jalysa,F,100,383,0,383
Martrez,M,100,0,26,26
Nyjal,M,100,0,12,12
Emmanuelle,F,78,954,266,1220
Brekyn,F,68,64,30,94
Deem,F,100,28,0,28
Atul,M,100,0,207,207
Ellajane,F,100,34,0,34
Ricka,F,100,84,0,84
Shemika,F,100,1454,0,1454
Lanisha,F,100,1234,0,1234
Nickelle,F,100,49,0,49
Faithanne,F,100,62,0,62
Aanyla,F,100,7,0,7
Jshun,M,100,0,5,5
Ellenora,F,100,18,0,18
Tyonia,F,100,40,0,40
Coralyne,F,100,18,0,18
Amner,M,100,0,33,33
Sandora,F,100,5,0,5
Nikolette,F,100,463,0,463
Annissa,F,100,1141,0,1141
Sriharsha,M,100,0,48,48
Clariece,F,100,5,0,5
Chinenye,F,100,162,0,162
Liridon,M,100,0,39,39
Kasandra,F,100,9144,0,9144
Darri,F,100,29,0,29
Shyera,F,100,21,0,21
Taite,M,54,110,129,239
Chavonna,F,100,28,0,28
Eesha,F,100,642,0,642
Lorian,F,100,233,0,233
Yaniece,F,100,18,0,18
Kaspar,M,100,0,92,92
Romina,F,100,2362,0,2362
Briahna,F,100,1139,0,1139
Chayim,M,100,0,88,88
Rubicelia,F,100,8,0,8
Latai,F,100,5,0,5
Harvetta,F,100,37,0,37
Carmilla,F,100,280,0,280
Avala,F,100,5,0,5
Arrick,M,100,0,205,205
Daquisha,F,100,65,0,65
Malyiah,F,100,95,0,95
Donathan,M,100,0,453,453
Garhett,M,100,0,88,88
Dorna,F,100,62,0,62
Dorann,F,100,117,0,117
Noelia,F,100,5998,0,5998
Yovonda,F,100,33,0,33
Kiwanis,F,100,19,0,19
Denique,F,100,34,0,34
Anisah,F,100,700,0,700
Baxter,M,100,0,1884,1884
Rozenia,F,100,12,0,12
Daikwon,M,100,0,5,5
Barbar,F,100,233,0,233
Iam,M,100,0,94,94
Evelis,F,100,10,0,10
Geissie,F,100,7,0,7
Hamim,M,100,0,6,6
Viona,F,100,64,0,64
Charlaine,F,100,163,0,163
Johniyah,F,100,28,0,28
Joseth,M,100,0,138,138
Jovahn,M,100,0,160,160
Mollye,F,100,130,0,130
Alneisha,F,100,7,0,7
Kamira,F,100,592,0,592
Timothe,M,100,0,15,15
Onnah,F,100,10,0,10
Guztavo,M,100,0,11,11
Cayle,M,65,133,245,378
Jeancarlo,M,100,0,788,788
Kadeidra,F,100,163,0,163
Rhena,F,100,108,0,108
Alem,M,100,0,153,153
Phyllisha,F,100,11,0,11
Shaam,F,100,7,0,7
Bonnita,F,100,419,0,419
Wymon,M,100,0,28,28
Princella,F,100,303,0,303
Mekyle,M,100,0,5,5
Glenisha,F,100,119,0,119
Lyndsi,F,100,1035,0,1035
Kahlis,F,100,5,0,5
Liria,F,100,12,0,12
Denautica,F,100,5,0,5
Aveena,F,100,54,0,54
Remond,M,100,0,33,33
Maggen,F,100,5,0,5
Naimo,F,100,5,0,5
Tashante,F,100,5,0,5
Manning,M,96,32,775,807
Allysah,F,100,23,0,23
Renley,F,68,32,15,47
Jehremy,M,100,0,5,5
Alianys,F,100,39,0,39
Cheretta,F,100,5,0,5
Jewlius,M,100,0,6,6
Mikai,M,98,10,446,456
Aidynn,F,51,64,61,125
Gambit,M,100,0,35,35
Love,F,86,1783,287,2070
Dawnna,F,100,140,0,140
Gregorie,M,100,0,43,43
Jaaron,M,100,0,307,307
Korbon,M,100,0,6,6
Rileigh,F,98,3109,50,3159
Esiquio,M,100,0,53,53
Rayfield,M,100,0,789,789
Rawan,F,100,956,0,956
Jencyn,F,100,5,0,5
Cormac,M,100,0,1966,1966
Tilman,M,100,0,275,275
Damika,F,100,381,0,381
Loryssa,F,100,5,0,5
Marselo,M,100,0,5,5
Javae,F,74,116,41,157
Varick,M,100,0,194,194
Amiin,M,100,0,5,5
Joell,F,53,978,875,1853
Prasad,M,100,0,5,5
Deshanique,F,100,15,0,15
Traveon,M,100,0,983,983
Jahare,M,100,0,5,5
Kaiyonna,F,100,5,0,5
Patrecia,F,100,229,0,229
Minseo,F,100,6,0,6
Leagh,F,100,5,0,5
Brookeann,F,100,5,0,5
Anjolie,F,100,376,0,376
Hiyam,F,100,13,0,13
Wendal,M,100,0,97,97
Aje,F,100,6,0,6
Katriece,F,100,5,0,5
Larence,M,100,0,289,289
Yumara,F,100,5,0,5
Darico,M,100,0,29,29
Merliah,F,100,36,0,36
Aivree,F,100,34,0,34
Utopia,F,100,44,0,44
Shaunita,F,100,135,0,135
Octavis,M,100,0,283,283
Fiorela,F,100,142,0,142
Jesica,F,100,4667,0,4667
Aryian,F,59,26,18,44
Azelyn,F,100,53,0,53
Marysusan,F,100,20,0,20
Destine,F,87,1184,180,1364
Zahiyah,F,100,15,0,15
Radoika,F,100,5,0,5
Zaelin,M,100,0,14,14
Joeen,F,100,5,0,5
Cristyl,F,100,6,0,6
Rexanne,F,100,208,0,208
Amilli,F,100,20,0,20
Zeb,M,100,0,1417,1417
Maximilano,M,100,0,6,6
Apriljoy,F,100,5,0,5
Ketrina,F,100,105,0,105
Laylon,M,100,0,10,10
Layni,F,100,293,0,293
Leamsi,F,100,22,0,22
Chantal,F,100,8163,7,8170
Constancia,F,100,60,0,60
Cheyann,F,100,1575,0,1575
Miriam,F,100,58201,219,58420
Dwuan,M,100,0,22,22
Trishamae,F,100,5,0,5
Tyji,M,100,0,5,5
Saboor,M,100,0,11,11
Pazley,F,100,5,0,5
Javonta,M,100,0,795,795
Dobby,M,100,0,5,5
Makao,M,100,0,5,5
Dederick,M,100,0,45,45
Taina,F,100,2504,0,2504
Danyal,M,71,176,426,602
Stranje,F,100,6,0,6
Glendon,M,100,0,2046,2046
Chenda,F,100,23,0,23
Jovonny,M,100,0,5,5
Myshayla,F,100,13,0,13
Emari,F,55,709,590,1299
Kavien,M,100,0,40,40
Llaneli,F,100,6,0,6
Sevanah,F,100,21,0,21
Cisco,M,100,0,679,679
Annmary,F,100,12,0,12
Saanya,F,100,72,0,72
Angelee,F,100,1171,0,1171
Shandie,F,100,92,0,92
Tiamia,F,100,5,0,5
Jacqueling,F,100,5,0,5
Niguel,M,100,0,148,148
Jaeden,M,84,852,4465,5317
Daron,M,98,160,7174,7334
Qudarius,M,100,0,6,6
Anwon,M,100,0,5,5
Tanina,F,100,130,0,130
Symira,F,100,58,0,58
Roddey,M,100,0,6,6
Wynetta,F,100,276,0,276
Tova,F,100,1980,0,1980
Ludy,F,100,30,0,30
Kdrian,M,100,0,5,5
Halona,F,100,267,0,267
Clariza,F,100,174,0,174
Takisha,F,100,2057,0,2057
Lorelei,F,100,9594,0,9594
Junhao,M,100,0,10,10
Tilisha,F,100,49,0,49
Jaylina,F,100,99,0,99
Bricen,M,100,0,775,775
Kellissa,F,100,5,0,5
Ottilie,F,100,19,0,19
Caithlin,F,100,20,0,20
Alvin,M,99,479,67134,67613
Lamaya,F,100,544,0,544
Magdalene,F,100,3338,0,3338
Julianah,F,100,113,0,113
Neel,M,100,0,2334,2334
Smiley,M,100,0,91,91
Kamiera,F,100,19,0,19
Jacorian,M,100,0,403,403
Shoaib,M,100,0,119,119
Tameem,M,100,0,214,214
Jinette,F,100,5,0,5
Genay,F,100,32,0,32
Latousha,F,100,17,0,17
Drayden,M,100,0,1303,1303
Mance,M,100,0,62,62
Shakeema,F,100,629,0,629
Ralphie,M,100,0,88,88
Leovanni,M,100,0,25,25
Tomikia,F,100,55,0,55
Stellarose,F,100,35,0,35
Nyja,F,100,197,0,197
Sherece,F,100,260,0,260
Tynisha,F,100,1668,0,1668
Meguel,M,100,0,21,21
Mehmet,M,100,0,543,543
Gatlin,M,100,0,1621,1621
Tymia,F,100,254,0,254
Nishi,F,100,220,0,220
Vannesa,F,100,1202,0,1202
Shaniese,F,100,33,0,33
Alilah,F,100,51,0,51
Avan,M,92,48,535,583
Takaiyah,F,100,6,0,6
Zaley,F,100,120,0,120
Erny,M,100,0,6,6
Jasmeen,F,100,562,0,562
Marquest,M,100,0,116,116
Elody,F,100,52,0,52
Aldrina,F,100,5,0,5
Ramello,M,100,0,148,148
Shanquia,F,100,21,0,21
Summer,F,100,71625,211,71836
Aun,M,100,0,11,11
Leudy,M,100,0,11,11
Rassan,M,100,0,29,29
Sirmichael,M,100,0,27,27
Yankee,M,100,0,5,5
Derrionna,F,100,22,0,22
Jayauna,F,100,29,0,29
Lavinda,F,100,17,0,17
Shanessa,F,100,131,0,131
Mallari,F,100,21,0,21
Jamarcus,M,100,0,4987,4987
Rasheema,F,100,113,0,113
Davantay,M,100,0,5,5
Win,M,89,11,92,103
Romaro,M,100,0,37,37
Aramys,M,100,0,5,5
Sidh,M,100,0,28,28
Zacery,M,100,0,17,17
Naana,F,100,8,0,8
Dalary,F,100,215,0,215
Regie,M,100,0,72,72
Jesston,M,100,0,11,11
Broderick,M,100,0,7845,7845
Charie,F,100,312,0,312
Violett,F,100,199,0,199
Elitha,F,100,11,0,11
Jiahna,F,100,5,0,5
Ceyara,F,100,5,0,5
Agasthya,M,100,0,25,25
Keirstyn,F,100,364,0,364
Dyvonne,F,100,5,0,5
Aalaysha,F,100,17,0,17
Deeya,F,100,174,0,174
Ranell,F,82,282,62,344
Kaseem,M,100,0,736,736
Ronaya,F,100,5,0,5
Tokunbo,F,50,5,5,10
Savy,F,100,24,0,24
Levana,F,100,100,0,100
Darlisa,F,100,141,0,141
Raimondo,M,100,0,12,12
Timohy,M,100,0,11,11
Aaratrika,F,100,5,0,5
Mercia,F,100,38,0,38
Alyster,M,100,0,18,18
Laurent,M,100,0,1016,1016
Dyson,M,100,5,1150,1155
Delisia,F,100,115,0,115
Yaqoob,M,100,0,18,18
Violanda,F,100,35,0,35
Abduel,M,100,0,5,5
Reshaun,M,100,0,130,130
Rashema,F,100,62,0,62
Noon,F,100,21,0,21
Breylee,F,100,11,0,11
Masud,M,100,0,121,121
Lynore,F,100,71,0,71
Mersadies,F,100,423,0,423
Dezaray,F,100,890,0,890
Shrhonda,F,100,5,0,5
Sanket,M,100,0,44,44
Vainavi,F,100,16,0,16
Khayree,M,100,0,257,257
Ureka,F,100,15,0,15
Emeline,F,100,1497,0,1497
Yuriel,M,100,0,151,151
Kazimierz,M,100,0,10,10
Faylynn,F,100,47,0,47
Eylin,F,100,110,0,110
Shemeka,F,100,1563,0,1563
Narain,M,100,0,22,22
Naeisha,F,100,5,0,5
Elliott,M,93,2306,29480,31786
Telor,F,100,11,0,11
Davaya,F,100,7,0,7
Magen,F,100,3344,0,3344
Carinna,F,100,168,0,168
Malli,F,100,60,0,60
Dwayne,M,99,452,69171,69623
Nylaya,F,100,28,0,28
Aelan,F,100,6,0,6
Celisa,F,100,324,0,324
Myrianna,F,100,5,0,5
Lunah,F,100,34,0,34
Humberto,M,100,10,14262,14272
Surie,F,100,153,0,153
Deondria,F,100,207,0,207
May,F,98,7200,149,7349
Caletha,F,100,5,0,5
Seon,M,100,0,205,205
Auriona,F,100,5,0,5
Annaelle,F,100,31,0,31
Shynece,F,100,11,0,11
Aryon,M,76,32,100,132
Alara,F,100,589,0,589
Shanquel,F,100,10,0,10
Dilek,F,100,5,0,5
Anbria,F,100,10,0,10
Makhia,F,100,670,0,670
Timarah,F,100,5,0,5
Alitha,F,100,33,0,33
Silus,M,100,0,112,112
Montra,M,65,6,11,17
Shacara,F,100,332,0,332
Delasha,F,100,5,0,5
Jennieke,F,100,5,0,5
Jonnay,F,100,29,0,29
Enrrique,M,100,0,533,533
Marsden,M,100,0,61,61
Mkaylah,F,100,5,0,5
Dolphus,M,100,0,255,255
Zayanah,F,100,5,0,5
Caileigh,F,100,892,0,892
Arrian,M,78,21,76,97
Tomico,F,100,22,0,22
Chet,M,100,0,5205,5205
Sarahkate,F,100,11,0,11
Khalim,M,100,0,7,7
Mykell,M,70,248,585,833
Ylianna,F,100,84,0,84
Nerses,M,100,0,8,8
Saudia,F,100,403,0,403
Laira,F,100,100,0,100
Summit,M,93,16,226,242
Misbah,F,96,113,5,118
Omaid,M,100,0,19,19
Tivis,M,100,0,10,10
Allivia,F,100,53,0,53
Chauntae,F,100,126,0,126
Takeidra,F,100,5,0,5
Tanajia,F,100,23,0,23
Carlee,F,99,10344,74,10418
Dinia,F,100,63,0,63
Biagio,M,100,0,456,456
Mkya,F,100,24,0,24
Toshiba,F,100,408,0,408
Clayson,M,100,0,121,121
Vihaan,M,100,0,1923,1923
Darco,M,100,0,5,5
Corona,F,100,32,0,32
Getzel,M,100,0,7,7
Manoah,M,100,0,116,116
Ayaniah,F,100,5,0,5
Akiyra,F,100,5,0,5
Jadyen,M,100,0,15,15
Kayge,M,100,0,12,12
Italo,M,100,0,278,278
Katharina,F,100,1687,0,1687
Anastajia,F,100,5,0,5
Arnay,M,100,0,7,7
Mathew,M,100,207,66925,67132
Alania,F,100,487,0,487
Abinaya,F,100,48,0,48
Soloman,M,100,0,929,929
Dacio,M,100,0,5,5
Anmar,M,100,0,8,8
Damarrea,M,100,0,5,5
Rily,F,78,58,16,74
Remiah,F,100,24,0,24
Chantry,M,100,0,140,140
Jammie,F,63,3851,2231,6082
Vayah,F,100,5,0,5
Ragin,F,100,6,0,6
Anoosha,F,100,30,0,30
Kenyona,F,100,155,0,155
Maniah,F,100,202,0,202
Junito,M,100,0,5,5
Maryl,F,100,180,0,180
Tomoaki,M,100,0,10,10
Gailanne,F,100,5,0,5
Chantrell,F,100,127,0,127
Alexanda,F,100,22,0,22
Kynzli,F,100,44,0,44
Llecenia,F,100,5,0,5
Eshaun,M,100,0,21,21
Renotta,F,100,22,0,22
Meganmarie,F,100,10,0,10
Travien,M,100,0,41,41
Tamarik,M,100,0,5,5
Filomeno,M,100,0,62,62
Dacorion,M,100,0,22,22
Demetrey,M,100,0,7,7
Latayna,F,100,183,0,183
Arbutus,F,100,36,0,36
Marik,M,100,0,119,119
Garvey,M,100,0,152,152
Tyzion,M,100,0,5,5
Kong,M,100,0,935,935
Tracker,M,100,0,42,42
Leishla,F,100,5,0,5
Cleonte,M,100,0,5,5
Angleo,M,100,0,11,11
Emigdio,M,100,0,296,296
Staphanie,F,100,206,0,206
Hanniah,F,100,5,0,5
Avenley,F,100,20,0,20
Emanuella,F,100,142,0,142
Robertjr,M,100,0,6,6
Shamyiah,F,100,53,0,53
Gaibriel,M,100,0,6,6
Kaysia,F,100,166,0,166
Miatta,F,100,25,0,25
Jaydiel,M,100,0,26,26
Tinamarie,F,100,1159,0,1159
Hirsh,M,100,0,8,8
Lilliam,F,100,586,0,586
Serenity,F,100,42308,59,42367
Whitlee,F,100,411,0,411
Chalia,F,100,18,0,18
Wnedy,F,100,5,0,5
Benard,M,100,0,790,790
Lillyan,F,100,1780,0,1780
Abia,F,100,73,0,73
Shaylla,F,100,5,0,5
Jephte,M,100,0,25,25
Shahzeb,M,100,0,50,50
Sawyer,M,86,4564,27736,32300
Ganon,M,100,0,131,131
Kenneisha,F,100,63,0,63
Charbel,M,100,0,265,265
Colvin,M,100,0,567,567
Gewel,F,100,5,0,5
Irvin,M,100,20,15125,15145
Ohajee,M,100,0,6,6
Kelso,M,100,0,114,114
Trinden,M,100,0,12,12
Anntoinette,F,100,363,0,363
Clyda,F,100,55,0,55
Jesli,F,100,10,0,10
Crol,F,100,12,0,12
Brownie,M,58,25,34,59
Yanzel,M,100,0,37,37
Dynah,F,100,41,0,41
Evella,F,100,40,0,40
Kamesha,F,100,1105,0,1105
Teyonna,F,100,404,0,404
Denaye,F,100,43,0,43
Jarilyn,F,100,53,0,53
Rexann,F,100,116,0,116
Feven,F,100,128,0,128
Hirah,F,100,5,0,5
Lukisha,F,100,79,0,79
Dories,F,100,5,0,5
Tyrae,M,90,35,302,337
Byrant,M,100,0,198,198
Jojo,M,67,100,203,303
Jadeen,F,75,15,5,20
Xylina,F,100,207,0,207
Eura,F,95,88,5,93
Sonali,F,100,1104,0,1104
Ellicia,F,100,91,0,91
Idelfonso,M,100,0,5,5
Doreena,F,100,259,0,259
Ardis,F,70,921,396,1317
Corionna,F,100,45,0,45
Markecia,F,100,54,0,54
Loriann,F,100,3663,0,3663
Tekla,F,100,160,0,160
Shikari,F,100,6,0,6
Katiya,F,100,115,0,115
Everline,F,100,41,0,41
Colgan,M,100,0,10,10
Shinya,M,58,16,22,38
Jaqavious,M,100,0,9,9
Ifunanya,F,100,30,0,30
Iian,M,100,0,6,6
Tarika,F,100,380,0,380
Kiffany,F,100,122,0,122
Iley,F,90,92,10,102
Tirian,M,100,0,6,6
Ryelin,M,68,11,23,34
Rickesha,F,100,115,0,115
Hennah,F,100,8,0,8
Elric,M,100,0,303,303
Allani,F,100,62,0,62
Angele,F,100,1251,0,1251
Peytin,F,91,193,18,211
Deyanira,F,100,1846,0,1846
Rossalyn,F,100,27,0,27
Park,M,100,0,579,579
Braela,F,100,17,0,17
Takiera,F,100,123,0,123
Locklan,M,100,0,43,43
Denari,M,84,5,27,32
Rosel,F,100,6,0,6
Janelyz,F,100,5,0,5
Kendalle,F,100,15,0,15
Katyra,F,100,62,0,62
Ullanda,F,100,24,0,24
Nineth,F,100,12,0,12
Tereasa,F,100,1364,0,1364
Dian,F,97,2740,82,2822
Quanessa,F,100,5,0,5
Yanae,F,100,45,0,45
Kamella,F,100,19,0,19
Jourdin,F,66,146,76,222
Kyilee,F,100,111,0,111
Walid,M,100,0,749,749
Suhana,F,100,309,0,309
Devendra,M,100,0,12,12
Reana,F,100,661,0,661
Chejuana,F,100,5,0,5
Laton,M,100,0,22,22
Temprance,F,100,120,0,120
Shanella,F,100,33,0,33
Denell,F,88,419,58,477
Adalayde,F,100,7,0,7
Taivon,M,100,0,235,235
Joshelin,F,100,14,0,14
Lisa,F,100,960409,2788,963197
Solimar,F,100,337,0,337
Enriqueta,F,100,641,0,641
Treyce,M,100,0,236,236
Bridgett,F,100,12837,0,12837
Khyrie,M,85,18,106,124
Naydelin,F,100,692,0,692
Engie,F,100,31,0,31
Deajanae,F,100,17,0,17
Camery,F,100,56,0,56
Draven,M,96,219,5454,5673
Haggai,M,100,0,5,5
Brinda,F,100,1781,0,1781
Lorelie,F,100,257,0,257
Maariyah,F,100,10,0,10
Casmir,M,52,14,15,29
Jaking,M,100,0,35,35
Melette,F,100,13,0,13
Elleah,F,100,79,0,79
Salvatore,M,100,26,26066,26092
Ahleena,F,100,22,0,22
Zoelle,F,100,184,0,184
Raimi,F,100,50,0,50
Naftoli,M,100,0,328,328
Keron,M,92,71,875,946
Jamar,M,99,73,14484,14557
Sare,F,100,6,0,6
Shaunessy,F,93,69,5,74
Rilya,F,100,55,0,55
Azusena,F,100,426,0,426
Jacqline,F,100,39,0,39
Kegan,M,94,223,3498,3721
Kylana,F,100,11,0,11
Noshin,F,100,34,0,34
Lakotah,F,100,10,0,10
Naoki,M,96,10,249,259
Dcorian,M,100,0,10,10
Robertt,M,100,0,66,66
Charlesten,M,100,0,5,5
Gereld,M,100,0,5,5
Mytrell,M,100,0,7,7
Deajon,M,100,0,5,5
Dam,M,100,0,69,69
Kamaria,F,100,2263,0,2263
Tesse,F,100,15,0,15
Dikran,M,100,0,10,10
Kison,M,100,0,11,11
Derel,M,100,0,65,65
Maddigan,F,100,23,0,23
Martrina,F,100,5,0,5
Carwyn,M,100,0,27,27
Keyvonte,M,100,0,13,13
Petty,F,100,10,0,10
Miller,M,88,507,3863,4370
Janiris,F,100,24,0,24
Sari,F,99,2823,22,2845
Braelie,F,100,32,0,32
Acy,M,87,5,34,39
Damiani,M,100,0,5,5
Alysa,F,100,6792,0,6792
Dannen,M,100,0,5,5
Tykierra,F,100,5,0,5
Kayelani,F,100,55,0,55
Fabiana,F,100,1307,0,1307
Zaimar,M,100,0,5,5
Antionetta,F,100,83,0,83
Hart,M,99,7,543,550
Kalajah,F,100,6,0,6
Janci,F,100,11,0,11
Anastazja,F,100,67,0,67
Derrie,M,70,22,51,73
Tiarah,F,100,438,0,438
Radell,M,55,5,6,11
Jazyah,F,100,60,0,60
Alejos,M,100,0,33,33
Ilsi,F,100,5,0,5
Kordell,M,100,0,1398,1398
Joanna,F,100,85980,306,86286
Zhara,F,100,118,0,118
Emelina,F,100,385,0,385
Zeniya,F,100,144,0,144
Ashvin,M,100,0,159,159
Zala,F,100,65,0,65
Riayn,F,100,27,0,27
Had,M,100,0,5,5
Rabihah,F,100,5,0,5
Taymour,M,100,0,5,5
Jessell,F,100,15,0,15
Mirelys,F,100,22,0,22
Shinita,F,100,160,0,160
Briony,F,100,157,0,157
Jazlina,F,100,6,0,6
Kasyn,M,80,118,481,599
Ananth,M,100,0,160,160
Damonie,M,68,62,133,195
Kaspian,M,100,0,21,21
Javare,M,100,0,6,6
Jerquan,M,100,0,35,35
Junia,F,100,359,0,359
Dareese,F,100,5,0,5
Shamso,F,100,5,0,5
Nolani,F,100,23,0,23
Irlanda,F,100,544,0,544
Adriannah,F,100,266,0,266
Quatasia,F,100,55,0,55
Redginald,M,100,0,6,6
Cyanni,F,100,30,0,30
Johannes,M,100,0,1551,1551
Yolanta,F,100,5,0,5
Vinchenzo,M,100,0,28,28
Yency,F,100,11,0,11
Nascha,F,100,6,0,6
Dinamarie,F,100,56,0,56
Maryuri,F,100,120,0,120
Tarajii,F,100,36,0,36
Arlyce,F,100,43,0,43
Gavy,F,100,5,0,5
Maketta,F,100,5,0,5
Gilberto,M,100,52,23011,23063
Avilynn,F,100,23,0,23
Christa,F,100,31706,27,31733
True,M,57,541,721,1262
Terynn,F,100,6,0,6
Seanette,F,100,11,0,11
Mailie,F,100,17,0,17
Mykhael,M,100,0,28,28
Graciella,F,100,723,0,723
Maricza,F,100,36,0,36
Aryann,F,100,50,0,50
Safeara,F,100,5,0,5
Graycie,F,100,354,0,354
Khadeejah,F,100,159,0,159
Demitrio,M,100,0,5,5
Caelia,F,100,16,0,16
Gurtej,M,100,0,44,44
Adana,F,100,197,0,197
Remon,M,100,0,161,161
Brittiana,F,100,5,0,5
Kloie,F,100,887,0,887
Latanja,F,100,136,0,136
Curlene,F,100,10,0,10
Saifan,M,100,0,82,82
Khenadi,F,100,11,0,11
Shaileigh,F,100,6,0,6
Jameison,M,100,0,38,38
Kaonou,F,100,5,0,5
Latavion,M,100,0,125,125
Sharalyn,F,100,287,0,287
Jamilynn,F,100,179,0,179
Rolondo,M,100,0,84,84
Frida,F,100,5122,0,5122
Cashaun,M,100,0,15,15
Yulinda,F,100,28,0,28
Taquia,F,100,29,0,29
Desree,F,100,217,0,217
Nasri,M,100,0,44,44
Tahi,M,100,0,5,5
Tanaria,F,100,17,0,17
Dantel,M,100,0,5,5
Talaiyah,F,100,12,0,12
Kaneisha,F,100,1014,0,1014
Zyrie,F,100,13,0,13
Sarann,F,100,26,0,26
Azalaya,F,100,5,0,5
Arma,F,100,199,0,199
Ethel,F,100,18814,86,18900
Urja,F,100,37,0,37
Terene,F,100,10,0,10
Kaelen,M,65,314,572,886
Kaileen,F,100,572,0,572
Daylee,F,98,325,6,331
Tiffaney,F,100,2281,0,2281
Rayelyn,F,100,10,0,10
Jimy,M,100,0,146,146
Conzy,F,100,6,0,6
Beonka,F,100,119,0,119
Timbra,F,100,15,0,15
Maxyn,M,100,0,5,5
Toltu,F,100,6,0,6
Tassia,F,100,15,0,15
Shamera,F,100,307,0,307
Shabd,M,100,0,12,12
Pagie,F,100,14,0,14
Dorissa,F,100,64,0,64
Ainka,F,100,6,0,6
Lothario,M,100,0,6,6
Ruoxi,F,100,7,0,7
Hendryx,M,100,0,16,16
Jackquline,F,100,493,0,493
Nelton,M,100,0,10,10
Dmaurion,M,100,0,5,5
Kestutis,M,100,0,22,22
Stevn,M,100,0,16,16
Mackenlee,F,100,16,0,16
Uche,M,100,0,5,5
Tays,F,100,11,0,11
Mikoto,F,100,6,0,6
Nelsie,F,100,11,0,11
Marguetta,F,100,86,0,86
Tatiyana,F,100,2070,0,2070
Sven,M,100,0,1690,1690
Mayrel,F,100,5,0,5
Ahrian,M,100,0,9,9
Hitha,F,100,5,0,5
Emmalina,F,100,343,0,343
Necalli,M,100,0,34,34
Lylarose,F,100,5,0,5
Lachlan,M,95,104,2109,2213
Inchara,F,100,5,0,5
Yurem,M,100,0,720,720
Enaysia,F,100,5,0,5
Sanura,F,100,10,0,10
Sevastian,M,100,0,413,413
Natylee,F,100,32,0,32
Wynee,F,100,83,0,83
Sawsan,F,100,54,0,54
Iris,F,99,44000,282,44282
Nooreen,F,100,10,0,10
Arriya,F,100,20,0,20
Michaila,F,100,292,0,292
Andon,M,100,0,924,924
Sunset,F,100,48,0,48
Zabria,F,100,55,0,55
Renan,M,100,0,288,288
Jaustin,M,100,0,10,10
Braydi,F,100,6,0,6
Tomeca,F,100,159,0,159
Ellyce,F,100,131,0,131
Kyndal,F,97,3690,111,3801
Rodrianna,F,100,10,0,10
Rylieann,F,100,9,0,9
Anureet,F,100,35,0,35
Rafee,M,100,0,5,5
Nyeshia,F,100,256,0,256
Haddon,M,100,0,305,305
Jaquaylon,M,100,0,34,34
Tyronn,M,100,0,236,236
Airicka,F,100,13,0,13
Ahmiracle,F,100,19,0,19
Jhoshua,M,100,0,6,6
Calandra,F,100,1735,0,1735
Keimar,M,100,0,10,10
Arsema,F,100,284,0,284
Brooklon,F,100,5,0,5
Keimy,F,100,5,0,5
Ticarra,F,100,5,0,5
Johari,F,61,245,155,400
Audris,F,100,102,0,102
Quentasia,F,100,50,0,50
Lylybell,F,100,10,0,10
Loreen,F,100,2418,0,2418
Kecha,F,100,48,0,48
Allesha,F,100,119,0,119
Kihara,F,100,38,0,38
Janelise,F,100,18,0,18
Noell,F,91,566,58,624
Caprecia,F,100,26,0,26
Oksanna,F,100,12,0,12
Fronia,F,100,5,0,5
Nyre,F,55,6,5,11
Montavian,M,100,0,6,6
Evanne,F,100,155,0,155
Maleka,F,100,372,0,372
Cynthiaann,F,100,5,0,5
Rosanna,F,100,10443,6,10449
Quannah,F,100,5,0,5
Zeilyn,F,100,5,0,5
Zahri,F,100,5,0,5
Evonia,F,100,6,0,6
Harlynn,F,100,179,0,179
Melisssa,F,100,133,0,133
Nyeisha,F,100,450,0,450
Rushad,M,100,0,5,5
Aamaya,F,100,5,0,5
Alida,F,100,2243,0,2243
Riggen,M,100,0,11,11
Moriel,M,100,0,6,6
Breta,F,100,81,0,81
Ebrahim,M,100,0,335,335
Adrinna,F,100,28,0,28
Desjon,M,100,0,5,5
Antwun,M,100,0,40,40
Keshira,F,100,6,0,6
Bonifacia,F,100,5,0,5
Starlena,F,100,146,0,146
Charels,M,100,0,81,81
Brehanna,F,100,176,0,176
Kemberli,F,100,6,0,6
Braddox,M,100,0,22,22
Samehesha,F,100,5,0,5
Lorraine,F,100,70957,163,71120
Marci,F,100,13600,11,13611
Deundria,F,100,5,0,5
Maham,F,100,239,0,239
Conway,M,100,0,1036,1036
Raighan,F,100,28,0,28
Fareeda,F,100,95,0,95
Yaniya,F,100,53,0,53
Nyeli,F,100,97,0,97
Andri,M,95,5,104,109
Shundra,F,100,376,0,376
Laketha,F,100,303,0,303
Ottavia,F,100,13,0,13
Malayia,F,100,272,0,272
Shu,M,74,18,52,70
Fray,M,100,0,11,11
Najir,M,100,0,96,96
Lamontez,M,100,0,42,42
Carlean,F,100,221,0,221
Travoris,M,100,0,144,144
Shaconna,F,100,18,0,18
Imri,M,77,14,47,61
Lashalle,F,100,5,0,5
Ingrida,F,100,10,0,10
Ferris,M,90,126,1099,1225
Atonio,M,100,0,13,13
Lysha,F,100,72,0,72
Clancy,M,69,453,993,1446
Jasiman,F,100,7,0,7
Daynah,F,100,58,0,58
Charvette,F,100,24,0,24
Cupertino,M,100,0,7,7
Tekoa,F,72,150,58,208
Davantae,M,100,0,28,28
Tienna,F,100,74,0,74
Tinya,F,100,143,0,143
Fardeen,M,100,0,104,104
Willesha,F,100,22,0,22
Ethin,M,100,0,281,281
Deyvid,M,100,0,13,13
Alonia,F,100,82,0,82
Briette,F,100,6,0,6
Hannahrose,F,100,45,0,45
Leighanne,F,100,1255,0,1255
Trawn,M,100,0,6,6
Eleyna,F,100,249,0,249
Laprincess,F,100,27,0,27
Pasleigh,F,100,11,0,11
Cordin,M,100,0,15,15
Anndee,F,100,90,0,90
Amiere,M,91,7,69,76
Jaylianiz,F,100,5,0,5
Bradynn,M,75,5,15,20
Kajana,M,100,0,5,5
Maebry,F,100,110,0,110
Sereen,F,100,286,0,286
Sharney,F,100,5,0,5
Mixtly,F,100,5,0,5
Ariz,M,100,0,62,62
Aerith,F,100,178,0,178
Yahoshua,M,100,0,5,5
Savita,F,100,102,0,102
Coleena,F,100,10,0,10
Ijaz,M,100,0,11,11
Millissa,F,100,329,0,329
Cory,M,95,6390,124337,130727
Alyxus,F,100,5,0,5
Chamaya,F,100,5,0,5
Mathayus,M,100,0,124,124
Denah,F,100,58,0,58
Ceniyah,F,100,110,0,110
Onyinyechi,F,100,92,0,92
Izahia,M,100,0,22,22
Dandrew,M,100,0,51,51
Cimarron,M,88,6,42,48
Zackari,M,100,0,194,194
Theodora,F,100,3867,6,3873
Milfred,M,100,0,42,42
Chontae,F,100,17,0,17
Jazymne,F,100,6,0,6
Azriah,F,100,16,0,16
Deshanda,F,100,111,0,111
Stephannie,F,100,1449,0,1449
Geremiah,M,100,0,370,370
Lessette,F,100,11,0,11
Martiniano,M,100,0,10,10
Zafira,F,100,32,0,32
Keshandra,F,100,11,0,11
Nychelle,F,100,157,0,157
Kolsen,M,100,0,118,118
Kiarri,F,100,5,0,5
Aiya,F,100,268,0,268
Porcher,F,100,11,0,11
Maleri,F,100,10,0,10
Australia,F,100,144,0,144
Rykia,F,100,28,0,28
Makinsey,F,100,304,0,304
Damiana,F,100,543,0,543
Kenshiro,M,100,0,11,11
Edie,F,100,3942,5,3947
Breighden,M,100,0,5,5
Quintonia,F,100,11,0,11
Maret,F,100,45,0,45
Graylon,M,100,0,266,266
Tavaya,F,100,8,0,8
Berdie,F,100,70,0,70
Luisanna,F,100,35,0,35
Cyndle,F,100,30,0,30
Marrie,F,100,102,0,102
Rockelle,F,100,228,0,228
Rosaleigh,F,100,206,0,206
Lety,F,100,70,0,70
Amoure,F,100,6,0,6
Dianaliz,F,100,18,0,18
Larwrence,M,100,0,28,28
Esmerai,F,100,10,0,10
Stedmond,M,100,0,12,12
Lizveth,F,100,37,0,37
Cedrie,M,100,0,58,58
Ela,F,100,1207,0,1207
Karalynne,F,100,17,0,17
Tijon,M,100,0,47,47
Kenyin,M,100,0,17,17
Tamora,F,100,649,0,649
Tiki,F,94,356,23,379
Brox,M,100,0,32,32
Iza,F,100,202,0,202
Salaar,M,100,0,12,12
Jayannah,F,100,17,0,17
Maripaz,F,100,77,0,77
Marek,M,100,5,2295,2300
Leonell,M,100,0,63,63
Alessander,M,100,0,71,71
Adreauna,F,100,5,0,5
Alaunah,F,100,5,0,5
Dayvanee,F,100,5,0,5
Synaia,F,100,5,0,5
Gredmarie,F,100,58,0,58
Emmalena,F,100,73,0,73
Maelina,F,100,5,0,5
Sharoll,F,100,5,0,5
Konley,M,100,0,5,5
Nanna,F,100,11,0,11
Montanah,F,100,5,0,5
Zmarion,M,100,0,11,11
Mikhel,M,100,0,18,18
Panela,F,100,5,0,5
Sheilah,F,100,1765,0,1765
Janil,F,100,41,0,41
Zeplynn,F,100,5,0,5
Tripton,M,100,0,45,45
Samarea,F,100,5,0,5
Leonetta,F,100,46,0,46
Skyasia,F,100,5,0,5
Kahmal,M,100,0,6,6
Anar,M,100,0,31,31
Kathya,F,100,701,0,701
Nitasha,F,100,323,0,323
Tyteonna,F,100,20,0,20
Jeorgia,F,100,122,0,122
Marycaroline,F,100,5,0,5
Fredarius,M,100,0,8,8
Kadeshia,F,100,161,0,161
Cynita,F,100,10,0,10
Alexann,F,100,5,0,5
Yaman,M,100,0,73,73
Khyra,F,100,334,0,334
Laquanza,F,100,17,0,17
Myckala,F,100,6,0,6
Kamyron,M,89,5,41,46
Graer,M,100,0,5,5
Rienna,F,100,10,0,10
Savonne,F,84,26,5,31
Gerre,F,100,26,0,26
Dairus,M,100,0,6,6
Landdon,M,100,0,5,5
Isata,F,100,41,0,41
Awbrey,F,100,5,0,5
Athens,M,88,7,52,59
Wilman,M,100,0,91,91
Jawwad,M,100,0,10,10
Risten,F,100,12,0,12
Alissa,F,100,36668,31,36699
Carrissa,F,100,953,0,953
Alanni,F,100,226,0,226
Jsutin,M,100,0,53,53
Vannia,F,100,112,0,112
Arjen,M,100,0,149,149
Khaza,M,100,0,6,6
Altrice,F,100,5,0,5
Vineeth,M,100,0,83,83
Kaniqua,F,100,20,0,20
Tashyah,F,100,8,0,8
Shantala,F,100,5,0,5
Yaqeen,F,100,5,0,5
Estrada,M,100,0,5,5
Aela,F,100,163,0,163
Arleny,F,100,182,0,182
Makeva,F,100,15,0,15
Maximino,M,100,0,1514,1514
Juanjose,M,100,0,849,849
Danaeja,F,100,28,0,28
Secelia,F,100,6,0,6
Jamyl,M,100,0,15,15
Ambre,F,100,632,0,632
Celeta,F,100,24,0,24
Deral,M,100,0,100,100
Ahri,F,100,51,0,51
Jaylaah,F,100,6,0,6
Martene,F,100,33,0,33
Clemons,M,100,0,6,6
Melanie,F,100,227776,609,228385
Aruba,F,100,6,0,6
Minaya,F,100,28,0,28
Monterrious,M,100,0,18,18
Zee,M,71,15,37,52
Kallissa,F,100,30,0,30
Marisely,F,100,5,0,5
Shawon,M,80,40,165,205
Arshan,M,100,0,150,150
Anthuan,M,100,0,17,17
Zihao,M,100,0,12,12
Angelus,M,97,10,289,299
Jadi,F,100,177,0,177
Ahlani,F,100,83,0,83
Beauty,F,100,229,0,229
Zhaira,F,100,5,0,5
Davarion,M,100,0,150,150
Niklas,M,100,0,1534,1534
Jameis,M,100,0,46,46
Ruther,F,100,62,0,62
Loveless,M,100,0,5,5
Chardanay,F,100,10,0,10
Jessel,F,97,169,5,174
Jacquline,F,100,6633,0,6633
Jiani,F,100,24,0,24
Xavier,M,99,814,115558,116372
Raelene,F,100,2062,0,2062
Abron,M,100,0,107,107
Afifa,F,100,51,0,51
Tylette,F,100,11,0,11
Emmarose,F,100,434,0,434
Leilauni,F,100,5,0,5
Jamile,M,52,204,219,423
Markesia,F,100,83,0,83
Khadija,F,100,3068,0,3068
Liamalexander,M,100,0,5,5
Latori,F,100,157,0,157
Kahmani,M,78,11,39,50
Annacarolina,F,100,15,0,15
Yuepeng,M,100,0,5,5
Quay,M,95,10,200,210
Teather,F,100,30,0,30
Kashmir,F,75,362,119,481
Jennafer,F,100,1080,0,1080
Chao,M,89,36,289,325
Norann,F,100,11,0,11
Cheick,M,100,0,133,133
Valere,F,100,28,0,28
Amyann,F,100,12,0,12
Aldren,M,100,0,16,16
Mieko,F,100,125,0,125
Suhey,F,100,194,0,194
Kiirsten,F,100,5,0,5
Jeliel,M,100,0,14,14
Luciano,M,100,0,8105,8105
Zymier,M,100,0,124,124
Kyaira,F,100,370,0,370
Dashelle,F,100,33,0,33
Mamadi,M,100,0,16,16
Samarth,M,100,0,618,618
Tashionna,F,100,5,0,5
Chaundra,F,100,574,0,574
Caprece,F,100,5,0,5
Tayma,F,100,12,0,12
Syer,M,100,0,10,10
Jordynne,F,100,208,0,208
Sydell,F,100,29,0,29
Krupa,F,100,392,0,392
Analia,F,100,3212,0,3212
Avea,F,100,101,0,101
Quinn,M,61,17946,27909,45855
Kertina,F,100,33,0,33
Kepler,M,100,0,145,145
Danira,F,100,145,0,145
Keitra,F,100,93,0,93
Kassandr,F,100,13,0,13
Jerrah,F,100,22,0,22
Jaycob,M,100,0,3244,3244
Jacynth,F,100,5,0,5
Warren,M,100,341,74770,75111
Innessa,F,100,6,0,6
Shamyra,F,100,753,0,753
Mildred,F,100,31525,69,31594
Carlla,F,100,7,0,7
Jya,F,100,72,0,72
Laporche,F,100,133,0,133
Sheyly,F,100,38,0,38
Soni,F,100,287,0,287
Synae,F,100,28,0,28
Jedrek,M,100,0,147,147
Jerusalen,F,100,60,0,60
Brylin,M,56,123,157,280
Yissachar,M,100,0,25,25
Kazuto,M,100,0,10,10
Melique,M,100,0,30,30
Iyani,F,100,141,0,141
Kaylenn,F,100,100,0,100
Mireia,F,100,5,0,5
Ronil,M,100,0,5,5
Waneta,F,100,346,0,346
Kiere,M,100,0,30,30
Abdirahim,M,100,0,56,56
Mandalin,F,100,5,0,5
Aneudy,M,100,0,99,99
Curby,M,100,0,54,54
Kemareon,M,100,0,17,17
Markette,F,100,5,0,5
Bellamie,F,100,49,0,49
Lillyauna,F,100,73,0,73
Redonda,F,100,33,0,33
Latarus,M,100,0,18,18
Peta,F,100,6,0,6
Nana,F,68,1367,653,2020
Harsha,M,91,19,185,204
Avin,M,93,48,638,686
Arliana,F,100,5,0,5
Tinleigh,F,100,123,0,123
Kaytelynn,F,100,86,0,86
Neilson,M,100,0,194,194
Ciceley,F,100,6,0,6
Abbygael,F,100,70,0,70
Demontray,M,100,0,141,141
Karnesha,F,100,43,0,43
Gaylia,F,100,58,0,58
Zamaria,F,100,582,0,582
Williette,F,100,101,0,101
Terrijo,F,100,11,0,11
Kentleigh,F,100,25,0,25
Veonica,F,100,17,0,17
Lladira,F,100,32,0,32
Shantaria,F,100,22,0,22
Taizley,F,100,5,0,5
Semajae,F,50,5,5,10
Manahel,F,100,6,0,6
Lavare,M,100,0,5,5
Jahmari,M,100,0,779,779
Sha,F,84,624,122,746
Aerie,F,100,73,0,73
Jelisa,F,100,1076,0,1076
Elija,M,100,0,811,811
Shelissa,F,100,7,0,7
Richie,M,97,163,5890,6053
Meila,F,100,203,0,203
Jianah,F,100,16,0,16
Amyha,F,100,10,0,10
Hannahmae,F,100,21,0,21
Issaih,M,100,0,117,117
Jessiel,M,100,0,6,6
Chaislyn,F,100,5,0,5
Jevante,M,100,0,160,160
Sevina,F,100,11,0,11
Nylin,M,58,5,7,12
Malonie,F,100,38,0,38
Azrael,M,81,106,450,556
Amorina,F,100,63,0,63
Janaisha,F,100,163,0,163
Aneva,F,100,5,0,5
Marlisha,F,100,217,0,217
Bethney,F,100,47,0,47
Adriyel,M,100,0,22,22
Javier,M,99,488,89978,90466
Eliza,F,100,28083,32,28115
Walther,M,100,0,62,62
Sesar,M,100,0,468,468
Aeona,F,100,7,0,7
Rakeisha,F,100,185,0,185
Shelsea,F,100,615,0,615
Zyiona,F,100,31,0,31
Shaquielle,M,100,0,38,38
Estefano,M,100,0,147,147
Emaly,F,100,441,0,441
Loreta,F,100,338,0,338
Tonora,F,100,11,0,11
Hawa,F,100,1204,0,1204
Shanyla,F,100,273,0,273
Caternia,F,100,6,0,6
Matracia,F,100,9,0,9
Paitlynn,F,100,6,0,6
Arabela,F,100,87,0,87
Lakwan,M,100,0,6,6
Marcelo,M,100,0,7025,7025
Laker,M,100,0,55,55
Kenja,F,100,50,0,50
Veneta,F,100,149,0,149
Bodee,M,99,5,332,337
Fontana,F,100,10,0,10
Mayada,F,100,7,0,7
Leiyah,F,100,170,0,170
Allena,F,100,1411,0,1411
Kamyah,F,100,636,0,636
Chavis,M,100,0,853,853
Tanush,M,100,0,270,270
Deontia,M,100,0,5,5
Kavari,M,100,0,110,110
Tyecha,F,100,6,0,6
Laiza,F,100,320,0,320
Driton,M,100,0,16,16
Shinece,F,100,7,0,7
Andrianna,F,100,907,0,907
Lilianne,F,100,582,0,582
Jemmerio,M,100,0,8,8
Annaleigha,F,100,70,0,70
Tarra,F,100,2288,0,2288
Kadel,M,100,0,5,5
Cidnee,F,100,56,0,56
Veanne,F,100,5,0,5
Jahson,M,100,0,254,254
Javiona,F,100,18,0,18
Teann,F,100,5,0,5
Hussam,M,100,0,177,177
Peshy,F,100,5,0,5
Julibeth,F,100,5,0,5
Bernnadette,F,100,17,0,17
Alexiona,F,100,10,0,10
Shawntrice,F,100,70,0,70
Ladedra,F,100,21,0,21
Dron,M,100,0,10,10
Shantasia,F,100,278,0,278
Orran,M,100,0,10,10
Bethene,F,100,46,0,46
Camea,F,100,5,0,5
Augusto,M,100,0,1229,1229
Evanna,F,100,538,0,538
Kruse,M,100,0,25,25
Eveleigh,F,100,21,0,21
Ghena,F,100,10,0,10
Adorn,F,100,5,0,5
Jordun,M,100,0,5,5
Sakara,F,100,144,0,144
Domina,F,100,12,0,12
Javanna,F,100,136,0,136
Amancio,M,100,0,39,39
Yatharth,M,100,0,5,5
Iriyana,F,100,5,0,5
Keelia,F,100,162,0,162
Aatif,M,100,0,10,10
Amarely,F,100,21,0,21
Anysha,F,100,97,0,97
Zuleyma,F,100,708,0,708
Prentiss,M,96,60,1580,1640
Yocelyne,F,100,24,0,24
Victoriaann,F,100,44,0,44
Thaddus,M,100,0,58,58
Mikyla,F,100,953,0,953
Amonee,F,100,25,0,25
Ashiley,F,100,11,0,11
Rahima,F,100,95,0,95
Gefen,F,100,10,0,10
Edith,F,100,42362,109,42471
Sinaya,F,100,114,0,114
Gay,F,97,9456,302,9758
Tishauna,F,100,29,0,29
Guhan,M,100,0,63,63
Mackenzey,F,100,168,0,168
Leontine,F,100,130,0,130
Johncarter,M,100,0,5,5
Elyus,M,100,0,5,5
Kristalle,F,100,5,0,5
Tychina,F,100,11,0,11
Tonnie,F,60,572,384,956
Jeramine,M,100,0,95,95
Kalliyan,F,100,39,0,39
Stefaun,M,100,0,7,7
Chloe,F,100,176558,285,176843
Eddyson,M,100,0,5,5
Colita,F,100,41,0,41
Shaonna,F,100,10,0,10
Lavares,M,100,0,19,19
Trene,F,100,32,0,32
Seaneen,F,100,11,0,11
Oceania,F,100,49,0,49
Vielka,F,100,168,0,168
Dann,F,54,1032,882,1914
Krisan,F,100,59,0,59
Zereon,M,100,0,11,11
Dagmawi,M,100,0,123,123
Jakiyra,F,100,6,0,6
Weronika,F,100,274,0,274
Elexi,F,100,5,0,5
Carmecia,F,100,5,0,5
Chenoa,F,100,1600,0,1600
Alston,M,99,16,1631,1647
Valgene,M,100,0,18,18
Micaden,M,100,0,8,8
Roxen,M,100,0,5,5
Khadeja,F,100,181,0,181
Wanita,F,100,981,0,981
Caidon,M,100,0,183,183
Mahita,F,100,32,0,32
Yashley,F,100,6,0,6
Taffani,F,100,10,0,10
Joquetta,F,100,10,0,10
Alonnie,F,100,64,0,64
Tracianne,F,100,5,0,5
Daneyah,F,100,5,0,5
Heran,F,100,57,0,57
Oconnor,M,100,0,6,6
Pattricia,F,100,72,0,72
Emmaley,F,100,35,0,35
Michaele,F,98,1312,21,1333
Neelee,F,100,5,0,5
Laurinda,F,100,1152,0,1152
Antonica,F,100,5,0,5
Balraj,M,100,0,50,50
Rocelin,F,100,6,0,6
Yehya,M,100,0,50,50
Khamare,M,100,0,6,6
Narkita,F,100,12,0,12
Mete,M,100,0,55,55
Maycon,M,100,0,31,31
Blayd,M,100,0,5,5
Seliyah,F,100,5,0,5
Kylin,M,52,857,944,1801
Lynnsay,F,100,11,0,11
Jarques,M,100,0,24,24
Thayna,F,100,5,0,5
Jonavon,M,100,0,126,126
Beanca,F,100,61,0,61
Anabeatriz,F,100,12,0,12
Katlynd,F,100,39,0,39
Laikynn,F,100,42,0,42
Jayvion,M,100,0,2143,2143
Valaire,F,100,6,0,6
Lanora,F,100,1130,0,1130
Blace,M,100,0,25,25
Sanaia,F,100,181,0,181
Melitza,F,100,96,0,96
Urwa,F,100,24,0,24
Vernona,F,100,37,0,37
Dejarvis,M,100,0,10,10
Tayon,M,99,5,394,399
Gwendolyn,F,100,72871,180,73051
Ireona,F,100,10,0,10
Venitta,F,100,19,0,19
Khamaya,F,100,22,0,22
Irmuun,M,100,0,5,5
Jermal,M,100,0,725,725
Avenlea,F,100,15,0,15
Colene,F,100,764,0,764
Francesco,M,100,0,6188,6188
Jessamy,F,100,215,0,215
Zahid,M,100,0,635,635
Estanislado,M,100,0,62,62
Ashney,F,100,5,0,5
Kyriaki,F,100,118,0,118
Julieta,F,100,4403,0,4403
Layahna,F,100,6,0,6
Stephanny,F,100,194,0,194
Duston,M,100,0,1159,1159
Layoya,F,100,12,0,12
Cherrelle,F,100,848,0,848
Amayah,F,100,2058,0,2058
Alexande,M,100,0,314,314
Annahi,F,100,268,0,268
Calley,F,100,890,0,890
Anderw,M,100,0,43,43
Dyran,M,100,0,15,15
Mckenlee,F,100,130,0,130
Jiniyah,F,100,5,0,5
Treymane,M,100,0,5,5
Umama,F,100,5,0,5
Naje,F,78,111,32,143
Lailynn,F,100,75,0,75
Quamae,M,100,0,12,12
Esmerlda,F,100,6,0,6
Abubaker,M,100,0,18,18
Audrieanna,F,100,55,0,55
Abigel,F,100,31,0,31
Tank,M,100,0,91,91
Starlett,F,100,591,0,591
Yexenia,F,100,12,0,12
Zelaya,F,100,18,0,18
Jeannee,F,100,33,0,33
Javious,M,100,0,155,155
Jamae,F,94,74,5,79
Doyne,M,100,0,69,69
Lundin,F,100,33,0,33
Kateara,F,100,5,0,5
Raia,F,100,176,0,176
Arihana,F,100,129,0,129
Ilce,F,100,44,0,44
Demarco,M,100,0,5015,5015
Nebil,M,100,0,5,5
Moneik,F,100,11,0,11
Latrone,M,100,0,17,17
Mica,F,77,2496,742,3238
Bethlyn,F,100,6,0,6
Madisan,F,100,193,0,193
Desiray,F,100,1700,0,1700
Odean,M,75,16,49,65
Iyahna,F,100,146,0,146
Najja,M,52,41,44,85
Kailana,F,100,209,0,209
Josiaha,M,100,0,15,15
Deshion,M,100,0,5,5
Sharel,F,100,239,0,239
Jazlene,F,100,1202,0,1202
Jacynthia,F,100,5,0,5
Jeda,F,100,163,0,163
Thorne,M,100,0,365,365
Tayah,F,100,1081,0,1081
Briell,F,100,186,0,186
Kiayana,F,100,16,0,16
Jermeria,F,100,54,0,54
Natica,F,100,34,0,34
Khy,M,100,0,34,34
Vianni,F,100,30,0,30
Andraya,F,100,897,0,897
Jemaya,F,100,5,0,5
Zuhal,F,100,10,0,10
Vance,M,100,22,17305,17327
Christiene,F,100,6,0,6
Down,F,100,17,0,17
Brittnie,F,100,2301,0,2301
Shonteria,F,100,71,0,71
Morrison,M,95,37,687,724
Lavora,F,100,91,0,91
Coyt,M,100,0,39,39
Amarre,M,100,0,39,39
Enia,F,100,45,0,45
Damoni,M,72,242,637,879
Donnalee,F,100,389,0,389
Mattew,M,100,0,1102,1102
Acey,M,95,10,176,186
Vanity,F,100,1605,0,1605
Leeron,M,100,0,11,11
Krishauna,F,100,83,0,83
Nylani,F,100,34,0,34
Tremya,F,100,58,0,58
Denaysha,F,100,37,0,37
Season,F,100,1149,0,1149
Bukhari,M,100,0,17,17
Yashia,F,100,16,0,16
Tanin,M,100,0,5,5
Edbert,M,100,0,26,26
Hudayfa,M,100,0,5,5
Pharren,F,100,5,0,5
Bronxton,M,100,0,16,16
Bethy,F,100,11,0,11
Hristo,M,100,0,19,19
Cornia,F,100,5,0,5
Lamyra,F,100,109,0,109
Bin,M,100,0,11,11
Alyk,M,100,0,15,15
Khendal,F,100,5,0,5
Ricole,F,100,37,0,37
Lashanique,F,100,35,0,35
Xyanna,F,100,10,0,10
Enita,F,100,15,0,15
Ahmara,F,100,12,0,12
Shirah,F,100,285,0,285
Saliha,F,100,169,0,169
Benika,F,100,19,0,19
Sheneil,F,100,5,0,5
Bielka,F,100,12,0,12
Bonnye,F,100,117,0,117
Banyan,M,100,0,206,206
Fadia,F,100,70,0,70
Martique,M,100,0,5,5
Ninna,F,100,40,0,40
Sruly,M,100,0,32,32
Delysa,F,100,5,0,5
Sanderson,M,100,0,5,5
Kniyah,F,100,77,0,77
Djavan,M,100,0,20,20
Kemely,F,100,21,0,21
Kajon,M,100,0,26,26
Alinna,F,100,249,0,249
Cohyn,M,100,0,12,12
Layliah,F,100,10,0,10
Winner,F,59,16,11,27
Tobi,F,87,2627,392,3019
Veniece,F,100,22,0,22
Makyia,F,100,376,0,376
Abigayil,F,100,21,0,21
Samaiah,F,100,37,0,37
Dakoata,M,100,0,25,25
Kaisy,F,100,83,0,83
Isiss,F,100,39,0,39
Cybill,F,100,136,0,136
Luise,F,96,120,5,125
Erle,M,100,0,229,229
Traden,M,100,0,48,48
Thong,M,100,0,305,305
Camp,M,100,0,52,52
Sahni,F,100,26,0,26
Solitaire,F,100,11,0,11
Alessandra,F,100,14854,0,14854
Olethea,F,100,5,0,5
Jasontyler,M,100,0,5,5
Iviannah,F,100,5,0,5
Shwetha,F,100,29,0,29
Marbella,F,100,1501,0,1501
Evyana,F,100,5,0,5
Khayyam,M,100,0,10,10
Shanerica,F,100,18,0,18
Raian,M,100,0,5,5
Achan,F,100,5,0,5
Solaya,F,100,15,0,15
Everette,M,98,71,4221,4292
Mallia,F,100,5,0,5
Ridhi,F,100,246,0,246
Yoandri,M,100,0,32,32
Maniya,F,100,493,0,493
Adacia,F,100,5,0,5
Karelyn,F,100,120,0,120
Steve,M,100,667,171045,171712
Asiana,F,100,371,0,371
Myrissa,F,100,358,0,358
Tianie,F,100,6,0,6
Laeton,M,100,0,35,35
Laine,F,67,2773,1378,4151
Thresa,F,100,1275,0,1275
Almendra,F,100,126,0,126
Daulton,M,100,0,1421,1421
Zanaiah,F,100,10,0,10
Markaila,F,100,39,0,39
Pranitha,F,100,5,0,5
Jazzlin,F,100,162,0,162
Lasharee,F,100,6,0,6
Lindley,F,79,734,196,930
Marchella,F,91,150,14,164
Reanda,F,100,5,0,5
Tyaira,F,100,143,0,143
Jaretzy,F,100,382,0,382
Moncerrat,F,100,355,0,355
Guerline,F,100,55,0,55
Letricia,F,100,482,0,482
Samory,M,100,0,26,26
Franny,F,100,85,0,85
Isyss,F,100,554,0,554
Brittanye,F,100,41,0,41
Pamelia,F,100,1550,0,1550
Roye,M,100,0,26,26
Denissa,F,100,72,0,72
Shong,M,100,0,5,5
Daely,F,100,10,0,10
Triss,F,100,5,0,5
Shawnee,F,97,3807,120,3927
Nafia,F,100,24,0,24
Tocarra,F,100,226,0,226
Davyon,M,100,0,292,292
Roshaud,M,100,0,16,16
Nalya,F,100,10,0,10
Aydien,M,100,0,95,95
Tihanna,F,100,67,0,67
Medley,F,100,5,0,5
Littie,F,100,27,0,27
Caiden,M,97,404,14067,14471
Akendra,F,100,5,0,5
Donzetta,F,100,28,0,28
Gea,F,100,17,0,17
Vung,F,100,61,0,61
Quadry,M,100,0,67,67
Pristina,F,100,11,0,11
Noella,F,100,1187,0,1187
Mariska,F,100,811,0,811
Charlena,F,100,1317,0,1317
Hallye,F,100,41,0,41
Anuradha,F,100,127,0,127
Ellaina,F,100,401,0,401
Shecid,F,100,21,0,21
Thuraya,F,100,5,0,5
Lovell,M,95,97,1768,1865
Masood,M,100,0,26,26
Ladine,F,100,23,0,23
Jaylind,M,100,0,27,27
Garielle,F,100,80,0,80
Ailish,F,100,443,0,443
Finau,M,100,0,6,6
Allexa,F,100,102,0,102
Nyllah,F,100,19,0,19
Jackilynn,F,100,16,0,16
Kimmarie,F,100,225,0,225
Shena,F,100,2349,0,2349
Lakwanzaa,F,100,5,0,5
Requita,F,100,22,0,22
Odai,M,100,0,71,71
Jaylea,F,100,231,0,231
Linsi,F,100,77,0,77
Dasjah,F,100,13,0,13
Marliee,F,100,5,0,5
Turrell,M,100,0,82,82
Searcy,M,100,0,41,41
Yaslen,F,100,5,0,5
Jaslyn,F,100,3318,0,3318
Ward,M,100,5,5776,5781
Yaidel,M,100,0,15,15
Ruvim,M,100,0,490,490
Quiyana,F,100,23,0,23
Stanely,M,100,0,145,145
Kamberlyn,F,100,35,0,35
Datari,M,100,0,5,5
Gaelle,F,100,334,0,334
Eydie,F,100,478,0,478
Christophr,M,100,0,403,403
Aliera,F,100,27,0,27
Lismary,F,100,55,0,55
Marai,F,100,50,0,50
Beatrize,F,100,32,0,32
Keion,M,100,10,2328,2338
Nisreen,F,100,293,0,293
Jaquarion,M,100,0,30,30
Lamontre,M,100,0,28,28
Meiah,F,100,131,0,131
Devanand,M,100,0,13,13
Maryterese,F,100,5,0,5
Eker,M,100,0,12,12
Tadarious,M,100,0,10,10
Adolpho,M,100,0,134,134
Aundria,F,100,737,0,737
Candrice,F,100,11,0,11
Rhylea,F,100,38,0,38
Akiera,F,100,219,0,219
Micailah,F,100,13,0,13
Lillymae,F,100,52,0,52
Shruti,F,100,996,0,996
Marne,F,99,766,5,771
Ranyla,F,100,27,0,27
Shealy,F,100,34,0,34
Harlee,F,94,4031,236,4267
Shanque,F,100,11,0,11
Juanalberto,M,100,0,45,45
Illya,M,92,31,354,385
Kathyn,F,100,16,0,16
Debborah,F,100,599,0,599
Seonna,F,100,15,0,15
Dawnne,F,100,27,0,27
Nikunj,M,100,0,28,28
Navindra,M,100,0,6,6
Esvin,M,100,0,240,240
Starnisha,F,100,58,0,58
Delenia,F,100,5,0,5
Kimblyn,F,100,6,0,6
Dorene,F,100,4835,0,4835
Desarie,F,100,138,0,138
Roshaunda,F,100,166,0,166
Jammi,F,100,172,0,172
Jarrad,M,100,0,1892,1892
Annley,F,100,6,0,6
Adonna,F,100,485,0,485
Laderion,M,100,0,12,12
Nikel,M,67,5,10,15
Keymari,M,77,33,111,144
Efigenia,F,100,5,0,5
Shanquella,F,100,11,0,11
Caitryn,F,100,5,0,5
Onika,F,100,590,0,590
Chael,M,100,0,334,334
Jaasiel,M,100,0,345,345
Tyleigh,F,100,196,0,196
Kwmane,M,100,0,26,26
Tyffani,F,100,132,0,132
Yuvika,F,100,15,0,15
Jennevie,F,100,5,0,5
Montaysia,F,100,5,0,5
Anaelle,F,100,93,0,93
Enfinity,F,100,6,0,6
Feige,F,100,177,0,177
Kaleina,F,100,5,0,5
Tanique,F,100,125,0,125
Pamale,F,100,35,0,35
Anarah,F,100,20,0,20
Tyme,F,71,49,20,69
Tyjuana,F,100,51,0,51
Alastor,M,100,0,20,20
Rebie,F,100,5,0,5
Willard,M,100,55,16287,16342
Dwayna,F,100,70,0,70
Antonyio,M,100,0,11,11
Sherria,F,100,400,0,400
Tynisia,F,100,6,0,6
Zariaha,F,100,36,0,36
Yazlen,F,100,5,0,5
Marshel,M,88,12,90,102
Yonaton,M,100,0,11,11
Mannuel,M,100,0,11,11
Ashrith,M,100,0,118,118
Aristeo,M,100,0,597,597
Roddell,M,100,0,11,11
Alegandra,F,100,160,0,160
Chalee,F,100,145,0,145
Jameire,M,100,0,55,55
Karon,F,61,4137,2676,6813
Reesa,F,100,641,0,641
Nickeya,F,100,55,0,55
Artina,F,100,291,0,291
Zeza,F,100,5,0,5
Merryl,F,100,182,0,182
Cashmere,F,68,537,253,790
Zelenia,F,100,5,0,5
Benay,F,100,138,0,138
Lenka,F,100,42,0,42
Kadince,F,100,211,0,211
Yanairis,F,100,5,0,5
Bode,M,100,0,1978,1978
Syndel,F,100,7,0,7
Shaude,F,100,6,0,6
Rosaland,F,100,304,0,304
Javian,M,100,6,2104,2110
Rabecca,F,100,860,0,860
Caresse,F,100,331,0,331
Keton,M,100,0,6,6
Erikia,F,100,10,0,10
Charotte,F,100,5,0,5
Kwashawn,M,100,0,5,5
Aravis,F,100,25,0,25
Eira,F,100,173,0,173
Dayvien,M,100,0,11,11
Micaya,F,100,22,0,22
Kanyra,F,100,5,0,5
Shamarr,M,98,5,294,299
Railyn,F,100,424,0,424
Ashritha,F,100,72,0,72
Kinston,M,100,0,106,106
Lyonna,F,100,6,0,6
Kiniesha,F,100,5,0,5
Nasha,F,100,443,0,443
Deshanae,F,100,73,0,73
Tevell,M,100,0,5,5
Lawson,M,97,247,7034,7281
Bleidy,F,100,5,0,5
Griffinn,M,100,0,5,5
Ricia,F,100,11,0,11
Glorietta,F,100,37,0,37
Ronell,M,83,300,1464,1764
Ceira,F,100,354,0,354
Cheikh,M,100,0,300,300
Paylin,F,100,102,0,102
Tabius,M,100,0,49,49
Lavella,F,100,108,0,108
Omarianna,F,100,6,0,6
Helton,M,100,0,20,20
Calianna,F,100,106,0,106
Arham,M,100,0,494,494
Marka,F,98,212,5,217
Jazper,M,100,0,145,145
Gabrail,M,100,0,5,5
Teaerra,F,100,5,0,5
Chibuzor,M,100,0,5,5
Brinsley,F,100,70,0,70
Janniyah,F,100,5,0,5
Adnel,M,100,0,5,5
Hila,F,100,254,0,254
Tashaun,M,95,36,625,661
Alejandro,M,99,841,122036,122877
Nathanal,M,100,0,194,194
Aitlin,F,100,9,0,9
Cleophis,M,100,0,6,6
Jacqueleen,F,100,57,0,57
Ojas,M,100,0,269,269
Beth,F,100,141219,325,141544
Waiz,M,100,0,10,10
Okechukwu,M,100,0,100,100
Nellia,F,100,13,0,13
Sannai,F,100,5,0,5
Haim,M,100,0,70,70
Sylas,M,100,5,3106,3111
Demeree,F,100,5,0,5
Annelies,F,100,156,0,156
Almudena,F,100,10,0,10
Tery,M,79,34,131,165
Charene,F,100,64,0,64
Chassity,F,100,2142,0,2142
Marsh,M,94,11,168,179
Sharlinda,F,100,6,0,6
Avelino,M,100,0,660,660
Adijah,F,100,6,0,6
Agela,F,100,6,0,6
Sabrenna,F,100,7,0,7
Deandrew,M,100,0,273,273
Rasheba,F,100,5,0,5
Murrel,M,100,0,87,87
Finna,F,100,20,0,20
Treyvonne,M,100,0,69,69
Tone,F,55,49,40,89
Yannuel,M,100,0,6,6
Farina,F,100,16,0,16
Jaade,F,100,5,0,5
Marquisha,F,100,1314,0,1314
Semika,F,100,30,0,30
Carwin,M,100,0,20,20
Symora,F,100,25,0,25
Berenisse,F,100,21,0,21
Wendolyne,F,100,5,0,5
Jobany,M,100,0,254,254
Salimata,F,100,113,0,113
Nashiyah,F,100,24,0,24
Ethanandrew,M,100,0,6,6
Jorgia,F,100,290,0,290
Zakariya,M,97,36,1054,1090
Tifphanie,F,100,6,0,6
Ilsy,F,100,15,0,15
Treya,F,100,36,0,36
Xion,M,91,26,272,298
Whitne,F,100,5,0,5
Yalexi,F,100,23,0,23
Ahlias,M,100,0,25,25
Sequia,F,100,25,0,25
Frederico,M,100,0,790,790
Keywon,M,100,0,95,95
Julisha,F,100,56,0,56
Shantaya,F,100,140,0,140
Gregorey,M,100,0,92,92
Valinda,F,100,1224,0,1224
Candra,F,100,1797,0,1797
Shaterrica,F,100,157,0,157
Karlito,M,100,0,20,20
Reannan,F,100,6,0,6
Amelinda,F,100,40,0,40
Maely,F,100,169,0,169
Anica,F,100,967,0,967
Farm,F,100,34,0,34
Riggs,M,100,0,420,420
Selasi,M,100,0,5,5
Romer,M,100,0,5,5
Tymberlyn,F,100,5,0,5
Mckaden,M,100,0,23,23
Taquoia,F,100,10,0,10
Angelinah,F,100,31,0,31
Sharimar,F,100,5,0,5
Felicha,F,100,226,0,226
Kalliyah,F,100,47,0,47
Merrit,F,51,64,62,126
Lakeitra,F,100,7,0,7
Karar,M,100,0,45,45
Uciel,M,100,0,5,5
Bexlee,F,100,13,0,13
Sayden,M,100,0,6,6
Gus,M,100,0,6529,6529
Calissa,F,100,736,0,736
Daryus,M,100,0,290,290
Nakecia,F,100,23,0,23
Dewand,M,100,0,29,29
Allaynah,F,100,5,0,5
Carigan,F,100,86,0,86
Kowanda,F,100,7,0,7
Yali,F,60,26,17,43
Zadia,F,100,79,0,79
Pollie,F,100,145,0,145
Akina,F,100,409,0,409
Brittony,F,100,213,0,213
Derril,M,100,0,76,76
Virgen,F,100,397,0,397
Kilee,F,100,1661,0,1661
Launa,F,100,1540,0,1540
Markeese,M,100,0,445,445
Sevi,F,100,5,0,5
Ramaya,F,100,164,0,164
Abiegail,F,100,15,0,15
Xally,F,100,5,0,5
Hazelynn,F,100,50,0,50
Thoams,M,100,0,180,180
Tarahji,F,92,84,7,91
Babajide,M,100,0,44,44
Derl,M,100,0,94,94
Tsianna,F,100,5,0,5
Tishawn,M,81,52,222,274
Kiarra,F,100,3574,0,3574
Rayshad,M,100,0,202,202
Gabor,M,100,0,121,121
Kadarious,M,100,0,71,71
Toronda,F,100,59,0,59
Hussen,M,100,0,10,10
Burech,M,100,0,42,42
Galaxy,F,100,116,0,116
Dorthula,F,100,6,0,6
Edlyn,F,100,396,0,396
Covin,M,100,0,44,44
Jomana,F,100,47,0,47
Shekia,F,100,313,0,313
Kyliejo,F,100,16,0,16
Tylere,M,100,0,27,27
Azaiah,M,88,39,295,334
Adileni,F,100,52,0,52
Doreatha,F,100,438,0,438
Tyshawnna,F,100,5,0,5
Mehret,F,100,5,0,5
Turner,M,97,188,5281,5469
Kadeen,M,100,0,82,82
Zalan,M,100,0,42,42
Gissell,F,100,1259,0,1259
Myha,F,100,72,0,72
Nirmeen,F,100,5,0,5
Doulgas,M,100,0,42,42
Aundreya,F,100,121,0,121
Xzavia,F,70,60,26,86
Chutney,F,100,13,0,13
Braden,M,99,273,42060,42333
Betony,F,100,8,0,8
Saajida,F,100,5,0,5
Jamilee,F,100,231,0,231
Jaielle,F,100,50,0,50
Imajae,F,100,6,0,6
Shonetta,F,100,39,0,39
Domynick,M,100,0,5,5
Mondale,M,100,0,21,21
Alby,M,67,5,10,15
Kullen,M,100,0,505,505
Mrk,M,100,0,85,85
Gertie,F,100,482,0,482
Airabelle,F,100,11,0,11
Catalya,F,100,12,0,12
Juliauna,F,100,178,0,178
Shaleek,M,100,0,38,38
Zarae,F,100,43,0,43
Cheslea,F,100,45,0,45
Buford,M,100,5,2252,2257
Tjaden,M,100,0,44,44
Damond,M,100,5,2006,2011
Varad,M,100,0,24,24
Taniyla,F,100,23,0,23
Naeemah,F,100,562,0,562
Truda,F,100,34,0,34
Randeisha,F,100,5,0,5
Jasia,F,99,430,6,436
Delain,F,100,30,0,30
Ambrosio,M,100,0,532,532
Mayson,M,75,841,2551,3392
Maisy,F,100,1409,0,1409
Rackel,F,100,5,0,5
Duniya,F,100,5,0,5
Roley,M,100,0,10,10
Denille,F,100,34,0,34
Mckynze,F,100,5,0,5
Hannaha,F,100,23,0,23
Jevyn,M,100,0,18,18
Koua,M,100,0,63,63
Amelah,F,100,5,0,5
Nakala,F,100,36,0,36
Robinn,F,100,71,0,71
Janiese,F,100,12,0,12
Christo,M,100,0,441,441
Aracely,F,100,8389,11,8400
Eliahs,M,100,0,45,45
Lilu,F,100,119,0,119
Nashely,F,100,38,0,38
Haylynn,F,100,95,0,95
Arnasia,F,100,54,0,54
Zaneya,F,100,11,0,11
Baltasar,M,100,0,49,49
Kaiicen,M,100,0,6,6
Alessandria,F,100,130,0,130
Laronn,M,100,0,103,103
Harrie,M,86,7,44,51
Cavalli,M,100,0,41,41
Ginia,F,100,79,0,79
Anyhia,F,100,10,0,10
Caryann,F,100,11,0,11
Beronica,F,100,1011,0,1011
Maron,M,82,33,151,184
Namrata,F,100,164,0,164
Jenneth,F,100,15,0,15
Mueed,M,100,0,5,5
Giuliana,F,100,7497,0,7497
Shanekia,F,100,283,0,283
Alexsia,F,100,321,0,321
Ghita,F,100,35,0,35
Berlinda,F,100,893,0,893
Warnie,M,100,0,16,16
Faren,F,100,267,0,267
Allysha,F,100,507,0,507
Dasiah,F,100,152,0,152
Anothny,M,100,0,36,36
Valerye,F,100,112,0,112
Corianne,F,100,373,0,373
Debriana,F,100,55,0,55
Nobel,M,100,0,117,117
Keavion,M,100,0,18,18
Janiely,F,100,5,0,5
Rhoslyn,F,100,6,0,6
Richara,F,100,6,0,6
Easter,F,100,1167,0,1167
Maebree,F,100,25,0,25
Desani,F,78,62,17,79
Jecorey,M,100,0,36,36
Kissa,F,100,68,0,68
Braxden,M,100,0,112,112
Donald,M,100,2550,621798,624348
Banna,F,100,10,0,10
Ignazio,M,100,0,98,98
Soraiya,F,100,51,0,51
Zek,M,100,0,5,5
Taraoluwa,F,100,8,0,8
Atiim,M,100,0,19,19
Lassana,M,100,0,13,13
Jordi,M,94,143,2275,2418
Aerilynn,F,100,48,0,48
Saskia,F,100,924,0,924
Blima,F,100,1025,0,1025
Chelli,F,100,86,0,86
Devie,F,100,35,0,35
Liron,M,66,38,74,112
Sukhpreet,F,85,33,6,39
Camdyn,M,52,1786,1926,3712
Vitalia,F,100,79,0,79
Hollen,F,100,26,0,26
Lukka,M,100,0,18,18
Caramie,F,100,13,0,13
Macedonio,M,100,0,39,39
Jahmar,M,100,0,465,465
Nakendra,F,100,52,0,52
Shyonna,F,100,50,0,50
Luccia,F,100,48,0,48
Zxavian,M,100,0,5,5
Dhruvi,F,100,172,0,172
Mosiah,M,100,0,365,365
Kinsie,F,100,131,0,131
Kashema,F,100,5,0,5
Omarah,F,100,5,0,5
Charlesetta,F,100,763,0,763
Thackery,M,100,0,6,6
Jonthan,M,100,0,990,990
Bobbilee,F,100,5,0,5
Shamelia,F,100,45,0,45
Nichaela,F,100,18,0,18
Mayreli,F,100,63,0,63
Keene,M,100,0,360,360
Mashari,F,100,5,0,5
Delois,F,100,3646,0,3646
Raquia,F,100,5,0,5
Morrissa,F,100,86,0,86
Zenya,F,100,95,0,95
Sorelle,F,100,44,0,44
Stratten,M,100,0,7,7
Hoshi,F,100,6,0,6
Lakecha,F,100,51,0,51
Caselynn,F,100,12,0,12
Kerilyn,F,100,355,0,355
Gerlyn,F,100,10,0,10
Yovonne,F,100,28,0,28
Kenicia,F,100,45,0,45
Siris,M,100,0,67,67
Moorea,F,100,150,0,150
Abryanna,F,100,221,0,221
Jaquitta,F,100,60,0,60
Millenia,F,100,86,0,86
Reiken,M,100,0,10,10
Tonnetta,F,100,16,0,16
Uchechi,F,100,97,0,97
Zyla,F,100,473,0,473
Nakiera,F,100,15,0,15
Shauniqua,F,100,19,0,19
Kaybri,F,100,32,0,32
Kartrina,F,100,5,0,5
Annesha,F,100,72,0,72
Wylie,M,90,280,2483,2763
Mie,F,100,22,0,22
Maxxwel,M,100,0,6,6
Antiono,M,100,0,339,339
Jaymari,M,100,0,80,80
Tecora,F,100,93,0,93
Aneicia,F,100,5,0,5
Alec,M,99,331,48330,48661
Likhita,F,100,6,0,6
Tylerlee,M,100,0,5,5
Usamah,M,100,0,42,42
Heiress,F,100,181,0,181
Montrell,M,99,28,3513,3541
Gibril,M,100,0,53,53
Jaelithe,F,100,5,0,5
Fatima,F,100,28222,46,28268
Camely,F,100,5,0,5
Lilien,F,100,12,0,12
Qualiek,M,100,0,6,6
Nuam,F,100,6,0,6
Verdi,F,100,5,0,5
Apryll,F,100,71,0,71
Denica,F,100,194,0,194
Anjelia,F,100,19,0,19
Rith,M,100,0,5,5
Kaman,M,100,0,29,29
Lulla,F,100,6,0,6
Takira,F,100,937,0,937
Kensha,F,100,6,0,6
Corvell,M,100,0,35,35
Cenia,F,100,103,0,103
Damyrion,M,100,0,5,5
Shanene,F,100,16,0,16
Pavni,F,100,5,0,5
Finbar,M,100,0,118,118
Farooq,M,100,0,62,62
Tennill,F,100,5,0,5
Cully,M,100,0,234,234
Trevore,M,100,0,5,5
Shaela,F,100,1054,0,1054
Giabella,F,100,180,0,180
Foram,F,100,5,0,5
Krislin,F,100,28,0,28
Ilicia,F,100,40,0,40
Luchanna,F,100,5,0,5
Amanat,F,100,11,0,11
Sirina,F,100,33,0,33
Bobbylee,M,100,0,15,15
Dameron,M,72,15,39,54
Dannille,F,100,10,0,10
Kolina,F,100,64,0,64
Cansu,F,100,5,0,5
Barnaby,M,100,0,314,314
Tonny,M,100,0,773,773
Cristelle,F,100,41,0,41
Bladyn,M,100,0,74,74
Niakia,F,100,5,0,5
Quamayne,M,100,0,10,10
Zhanee,F,100,23,0,23
Carliegh,F,100,17,0,17
Jasnoor,F,93,62,5,67
Azalea,F,100,3574,0,3574
Terrik,M,100,0,29,29
Robroy,M,100,0,22,22
Kimber,F,96,6629,241,6870
Takedra,F,100,5,0,5
Detricia,F,100,8,0,8
Jemika,F,100,44,0,44
Nyeasia,F,100,5,0,5
Zaivion,M,100,0,59,59
Diedrich,M,100,0,21,21
Kendee,F,100,12,0,12
Xavior,M,100,0,1050,1050
Laraine,F,100,1518,0,1518
Jayzier,M,100,0,5,5
Kierce,M,100,0,32,32
Raeyonna,F,100,13,0,13
Suyog,M,100,0,15,15
Koebe,M,100,0,12,12
Libertad,F,100,51,0,51
Chanlee,F,100,5,0,5
Loretto,F,100,106,0,106
Leaf,M,100,0,99,99
Jaquale,M,100,0,10,10
Illana,F,100,157,0,157
Nohelly,F,100,5,0,5
Annastyn,F,100,101,0,101
Carrieanne,F,100,209,0,209
Fabiola,F,99,8200,53,8253
Chantill,F,100,10,0,10
Blanka,F,100,68,0,68
Einav,F,100,5,0,5
Eleesia,F,100,11,0,11
Nefateria,F,100,5,0,5
Xochi,F,100,21,0,21
Estreya,F,100,180,0,180
Tabytha,F,100,491,0,491
Kethia,F,100,5,0,5
Michaelpatrick,M,100,0,5,5
Shianna,F,100,899,0,899
Richarda,F,100,31,0,31
Markies,M,100,0,85,85
Charnele,F,100,195,0,195
Blaiz,M,100,0,32,32
Lonisha,F,100,61,0,61
Mychala,F,100,28,0,28
Melessa,F,100,501,0,501
Ellie,F,99,40561,224,40785
Timouthy,M,100,0,76,76
Maleiah,F,100,172,0,172
Haliana,F,100,6,0,6
Shaiel,F,100,58,0,58
Demariyah,F,100,22,0,22
Tramia,F,100,36,0,36
Sanah,F,100,309,0,309
Keshawnda,F,100,10,0,10
Tondra,F,100,614,0,614
Emmalyse,F,100,19,0,19
Saned,F,100,5,0,5
Sitha,F,62,8,5,13
Kalmen,M,100,0,41,41
Taha,M,100,0,1526,1526
Chari,F,100,1099,0,1099
Larosha,F,100,5,0,5
Crystallynn,F,100,66,0,66
Shaz,M,100,0,6,6
Clarene,F,100,112,0,112
Latayshia,F,100,9,0,9
Jellisa,F,100,29,0,29
Allanna,F,100,221,0,221
Deangleo,M,100,0,57,57
Tanysha,F,100,228,0,228
Jacsen,M,100,0,28,28
Ozias,M,100,0,259,259
Giuliette,F,100,13,0,13
Lacondra,F,100,5,0,5
Tawan,M,85,60,334,394
Andriel,M,56,31,40,71
Farrell,M,89,272,2180,2452
Natanya,F,100,582,0,582
Illyas,M,100,0,5,5
Seviah,F,100,5,0,5
Vachon,M,100,0,15,15
Arbaz,M,100,0,25,25
Saana,F,100,26,0,26
Belsy,F,100,6,0,6
Stepheno,M,100,0,6,6
Aleynna,F,100,11,0,11
Maritssa,F,100,82,0,82
Beverlie,F,100,90,0,90
Donney,M,100,0,96,96
Caresha,F,100,5,0,5
Corazon,F,100,228,0,228
Haram,F,58,7,5,12
Khyron,M,100,0,105,105
Amaud,M,100,0,29,29
Addelyne,F,100,5,0,5
Draydon,M,100,0,81,81
Zacardi,M,100,0,11,11
Cidnie,F,100,5,0,5
Jakirria,F,100,5,0,5
Verdelle,F,100,19,0,19
Jalon,M,97,74,2223,2297
Alon,M,97,24,901,925
Kona,M,69,117,255,372
Anabeth,F,100,147,0,147
Kitra,F,100,38,0,38
Wess,M,100,0,343,343
Norrisa,F,100,11,0,11
Lekita,F,100,134,0,134
Yamara,F,100,5,0,5
Trinita,F,100,205,0,205
Datreon,M,100,0,5,5
Jamesdean,M,100,0,22,22
Kreston,M,100,0,59,59
Adric,M,100,0,332,332
Miyon,M,100,0,17,17
Jorgealberto,M,100,0,5,5
Mickala,F,100,299,0,299
Calida,F,100,36,0,36
Chereese,F,100,101,0,101
Bjay,M,100,0,6,6
Brittainey,F,100,11,0,11
Martaz,M,100,0,11,11
Jerron,M,100,0,1589,1589
Arhianna,F,100,185,0,185
Graviela,F,100,60,0,60
Jeramey,M,100,0,636,636
Zephyn,M,100,0,5,5
Jiancarlos,M,100,0,18,18
Leacy,F,100,5,0,5
Keleen,F,100,11,0,11
Dezlyn,F,100,19,0,19
Samwise,M,100,0,36,36
Hien,F,52,327,298,625
Ipsa,F,100,5,0,5
Anyriah,F,100,5,0,5
Biafra,F,100,5,0,5
Nanya,M,100,0,16,16
Januari,F,100,44,0,44
Meshal,M,100,0,16,16
Nycere,M,100,0,65,65
Harmoniee,F,100,13,0,13
Aquilina,F,100,5,0,5
Izzy,F,68,274,126,400
Sona,F,100,924,0,924
Deianira,F,100,36,0,36
Jesiel,M,100,0,55,55
Nickali,M,100,0,28,28
Maddisyn,F,100,772,0,772
Latrevion,M,100,0,30,30
Kanoa,M,100,0,579,579
Kaleem,M,100,0,334,334
Keiarriyen,M,100,0,5,5
Jenisys,F,100,7,0,7
Griffyn,M,91,22,223,245
Elaney,F,100,19,0,19
Ellyanna,F,100,315,0,315
Deanndra,F,100,197,0,197
Moussa,M,100,0,666,666
Yui,F,100,335,0,335
Nelwyn,F,100,137,0,137
Jammey,M,100,0,31,31
Mulani,F,100,11,0,11
Khaylee,F,100,53,0,53
Jeanette,F,100,77513,278,77791
Gerri,F,100,4645,17,4662
Avyukt,M,100,0,88,88
Evia,F,100,164,0,164
Lariesha,F,100,5,0,5
Srivatsa,M,100,0,32,32
Chona,F,100,21,0,21
Denerick,M,100,0,10,10
Celester,M,62,48,78,126
Jeylanie,F,100,5,0,5
Dylanne,F,100,27,0,27
Charemon,F,100,17,0,17
Janahla,F,100,12,0,12
Kaylynn,F,100,9773,5,9778
Mariadel,F,100,150,0,150
Kanosha,F,100,36,0,36
Denessa,F,100,151,0,151
Keyawna,F,100,31,0,31
Christopherjose,M,100,0,17,17
Dare,M,66,22,42,64
Theron,M,100,21,7527,7548
Akshaya,F,100,384,0,384
Amparo,F,100,1748,7,1755
Anooj,M,100,0,5,5
Tavarius,M,100,0,651,651
Jevita,F,100,5,0,5
Mykael,M,77,126,424,550
Chosen,M,74,20,57,77
Everlee,F,100,506,0,506
Onie,F,80,65,16,81
Myya,F,100,99,0,99
Nathalya,F,100,185,0,185
Adonica,F,100,376,0,376
Briyanah,F,100,10,0,10
Asher,M,98,550,31912,32462
Aliecia,F,100,39,0,39
Aasim,M,100,0,195,195
Mashelle,F,100,114,0,114
Priyasha,F,100,17,0,17
Jermain,M,100,0,1921,1921
Malenda,F,100,11,0,11
Faustin,M,100,0,15,15
Ayslin,F,100,71,0,71
Shakkia,F,100,23,0,23
Kohlten,M,100,0,22,22
Tassie,F,100,275,0,275
Ziyan,M,56,95,123,218
Izzat,M,100,0,11,11
Dorianna,F,100,104,0,104
Kyleena,F,100,80,0,80
Devontea,M,100,0,47,47
Raelyne,F,100,38,0,38
Teniel,F,100,5,0,5
Shannah,F,100,1372,0,1372
Cobain,M,100,0,69,69
Honey,F,100,2624,0,2624
Coedy,M,100,0,6,6
Shanekwa,F,100,23,0,23
Krishen,M,100,0,5,5
Con,M,100,0,133,133
Dorothe,F,100,21,0,21
Abinadi,M,100,0,22,22
Sadieann,F,100,18,0,18
Laraven,F,100,47,0,47
Shauneen,F,100,15,0,15
Eliejah,M,100,0,15,15
Tykese,M,100,0,53,53
Rhyannon,F,100,36,0,36
Ahmyra,F,100,16,0,16
Tiann,F,100,67,0,67
Tramesha,F,100,20,0,20
Carielle,F,100,5,0,5
Toi,F,97,1487,53,1540
Mychelle,F,100,626,0,626
Tiahja,F,100,7,0,7
Raynna,F,100,26,0,26
Lorri,F,100,7967,0,7967
Turley,M,100,0,5,5
Shantazia,F,100,14,0,14
Apoorva,F,100,151,0,151
Khaalis,M,88,5,35,40
Adison,F,83,2892,611,3503
Chandris,F,100,5,0,5
Laniyia,F,100,5,0,5
Ariya,F,98,1744,30,1774
Jiquan,M,100,0,14,14
Keeno,M,100,0,6,6
Zylah,F,100,286,0,286
Ivaan,M,100,0,46,46
Graesen,M,100,0,10,10
Aziza,F,100,1356,0,1356
Neale,M,99,5,365,370
Olabode,M,100,0,5,5
Avari,F,89,579,71,650
Averymarie,F,100,5,0,5
Jayah,F,100,414,0,414
Shivany,F,100,5,0,5
Aleaya,F,100,106,0,106
Randey,M,100,0,31,31
Dinnia,F,100,10,0,10
Blaklee,F,100,51,0,51
Aerian,M,100,0,5,5
Telisha,F,100,1182,0,1182
Earlyne,F,100,33,0,33
Zuree,F,100,16,0,16
Yomira,F,100,124,0,124
Bridie,F,100,177,0,177
Lamekia,F,100,80,0,80
Antonny,M,100,0,5,5
Giorgia,F,100,231,0,231
Deangelo,M,100,21,10554,10575
Pasquale,M,100,0,3462,3462
Delilah,F,100,25626,0,25626
Tewana,F,100,73,0,73
Loreley,F,100,67,0,67
Cherryann,F,100,5,0,5
Jihae,F,100,5,0,5
Aseelah,F,100,19,0,19
Allyshia,F,100,41,0,41
Aquino,M,100,0,13,13
Kawaii,F,100,25,0,25
Denise,F,100,358597,1341,359938
Anhthu,F,100,135,0,135
Lynora,F,100,130,0,130
Kreed,M,100,0,194,194
Katrice,F,100,2187,0,2187
Aimen,F,54,31,26,57
Alverda,F,100,5,0,5
Crys,F,100,15,0,15
Carsynn,F,100,34,0,34
Pernella,F,100,16,0,16
Cornie,M,100,0,6,6
Marinee,F,100,5,0,5
Bohden,M,100,0,62,62
Elixander,M,100,0,5,5
Maelynn,F,100,832,0,832
Brixtyn,F,100,11,0,11
Adael,M,100,0,154,154
Collins,M,60,1176,1797,2973
Delan,M,100,0,148,148
Latoy,F,100,136,0,136
Kelia,F,100,852,0,852
Addey,F,100,11,0,11
Jonmark,M,100,0,10,10
Sephora,F,100,557,0,557
Isavel,F,100,48,0,48
Debraoh,F,100,5,0,5
Kalil,M,100,0,1083,1083
Shandon,M,80,184,717,901
Marjean,F,100,556,0,556
Stephens,M,100,0,272,272
Azaneth,F,100,7,0,7
Tiernan,M,87,175,1136,1311
Corby,M,81,303,1281,1584
Gayathri,F,100,128,0,128
Dmarko,M,100,0,5,5
Ajaylah,F,100,25,0,25
Leilan,M,100,0,86,86
Hemi,M,73,32,85,117
Yaneiry,F,100,33,0,33
Henoc,M,100,0,11,11
Keidyn,M,100,0,34,34
Dixi,F,100,46,0,46
Jordany,M,100,0,341,341
Artur,M,100,0,613,613
Marlaysha,F,100,5,0,5
Khadijiah,F,100,5,0,5
Maiyer,F,100,10,0,10
Cliffard,M,100,0,11,11
Madelline,F,100,138,0,138
Saahiti,F,100,9,0,9
Magalena,F,100,5,0,5
Brihana,F,100,168,0,168
Zamair,M,100,0,5,5
Nichella,F,100,5,0,5
Octavus,M,100,0,5,5
Aydali,F,100,5,0,5
Pol,M,100,0,5,5
Aragon,M,100,0,57,57
Marquitia,F,100,32,0,32
Niaya,F,100,214,0,214
Jahden,M,100,0,108,108
Airron,M,100,0,5,5
Arny,M,100,0,5,5
Tuf,M,100,0,18,18
Sandford,M,100,0,177,177
Jaslean,F,100,5,0,5
Gresa,F,100,6,0,6
Shikema,F,100,5,0,5
Tonatiuh,M,100,0,228,228
Kaylarae,F,100,5,0,5
Kisten,F,100,29,0,29
Nehir,F,100,24,0,24
Gaylynn,F,100,369,0,369
Kindell,F,76,168,52,220
Yule,M,100,0,5,5
Rella,F,100,214,0,214
Shamita,F,100,12,0,12
Boyan,M,100,0,13,13
Jeimi,F,100,43,0,43
Reydavid,M,100,0,12,12
Ginnette,F,100,92,0,92
Arriyanna,F,100,62,0,62
Delmira,F,100,52,0,52
Mashia,F,100,19,0,19
Asimina,F,100,10,0,10
Nyel,M,72,16,42,58
Casiano,M,100,0,15,15
Jayan,M,100,0,172,172
Geffory,M,100,0,6,6
Rosemery,F,100,23,0,23
Katyann,F,100,7,0,7
Yosvany,M,100,0,5,5
Nawaf,M,100,0,129,129
Neamiah,M,100,0,75,75
Mukesh,M,100,0,5,5
Airion,M,100,0,18,18
Wyitt,M,100,0,37,37
Alayza,F,100,149,0,149
Aniya,F,100,14497,0,14497
Kinnith,M,100,0,6,6
Hilery,F,100,36,0,36
Riena,F,100,22,0,22
Taiyari,F,100,16,0,16
Karriem,M,99,5,484,489
Glory,F,100,2963,8,2971
Monsita,F,100,5,0,5
Davee,M,52,10,11,21
Lequinton,M,100,0,5,5
Marysol,F,100,1402,0,1402
Kalysia,F,100,14,0,14
Jamarrion,M,100,0,333,333
Krysha,F,100,6,0,6
Rishi,M,100,0,3352,3352
Rykker,M,100,0,50,50
Syrenna,F,100,5,0,5
Leketha,F,100,11,0,11
Alexi,F,72,3721,1457,5178
Alyxis,F,100,274,0,274
Roony,M,100,0,13,13
Arles,M,100,0,50,50
Sadiq,M,100,0,486,486
Lavetta,F,100,774,0,774
Deriel,M,100,0,12,12
Aleric,M,100,0,139,139
Minnah,F,100,135,0,135
Efia,F,100,20,0,20
Evva,F,100,57,0,57
Kimyata,F,100,153,0,153
Kylieann,F,100,135,0,135
Hooper,M,100,0,25,25
Mittie,F,100,533,0,533
Yaniyah,F,100,83,0,83
Donnica,F,100,93,0,93
Boris,M,100,0,3201,3201
Eisha,F,100,253,0,253
Teyton,M,100,0,81,81
Jontavius,M,100,0,247,247
Antwoine,M,100,0,1003,1003
Khiara,F,100,350,0,350
Jelia,F,100,10,0,10
Leonie,F,100,663,0,663
Jarry,M,100,0,90,90
Ralph,M,100,553,125561,126114
Manouchka,F,100,8,0,8
Garima,F,100,72,0,72
Marlaya,F,100,59,0,59
Jandel,M,98,5,229,234
Sheronica,F,100,157,0,157
Birdie,F,100,925,0,925
Jonmichael,M,100,0,1366,1366
Layanne,F,100,5,0,5
Clarabella,F,100,28,0,28
Breaker,M,100,0,36,36
Measia,F,100,56,0,56
Norrell,M,100,0,5,5
Heinrich,M,100,0,322,322
Echoe,F,100,16,0,16
Tykiria,F,100,11,0,11
Tige,M,100,0,333,333
Parmis,F,100,27,0,27
Cynethia,F,100,190,0,190
Cherylene,F,100,224,0,224
Parthena,F,100,23,0,23
Mahlon,M,100,11,2192,2203
Joliana,F,100,62,0,62
Jasselle,F,100,5,0,5
Damaje,M,100,0,6,6
Tyvez,M,100,0,5,5
Avaliese,F,100,5,0,5
Maidah,F,100,7,0,7
Artin,M,100,0,293,293
Raquita,F,100,36,0,36
Musaab,M,100,0,21,21
Kethan,M,100,0,125,125
Janyus,M,100,0,5,5
Zeniyah,F,100,173,0,173
Zavi,M,100,0,5,5
Kristelle,F,100,245,0,245
Naterria,F,100,11,0,11
Jayelle,F,100,128,0,128
Leilene,F,100,151,0,151
Sonye,F,100,11,0,11
Tyanni,F,100,5,0,5
Jovannah,F,100,46,0,46
Richelle,F,100,8218,0,8218
Korrigan,M,100,0,10,10
Cordea,M,100,0,5,5
Tocha,F,100,5,0,5
Anaruth,F,100,6,0,6
Jamesen,M,95,5,92,97
Jayanni,F,100,14,0,14
Lovanda,F,100,10,0,10
Aavi,M,100,0,12,12
Kyosuke,M,100,0,5,5
Christhopher,M,100,0,41,41
Darrayl,M,100,0,8,8
Albertus,M,100,0,31,31
Nathanial,M,100,0,9572,9572
Latana,F,100,79,0,79
Jaimison,M,75,5,15,20
Treyveon,M,100,0,323,323
Lawanika,F,100,5,0,5
Kenyeta,F,100,10,0,10
Shanythia,F,100,12,0,12
Breyonce,F,100,18,0,18
Briyelle,F,100,25,0,25
Apriel,F,100,5,0,5
Nissy,F,100,5,0,5
Jackline,F,100,303,0,303
Tei,M,100,0,11,11
Malechi,M,100,0,52,52
Jedarius,M,100,0,12,12
Tachaka,F,100,8,0,8
Kiyara,F,100,291,0,291
Jakie,M,95,11,208,219
Johnnyjoe,M,100,0,5,5
Lisajo,F,100,10,0,10
Nikolus,M,100,0,173,173
Krystalann,F,100,24,0,24
Dianalee,F,100,5,0,5
Janeeva,F,100,10,0,10
Versie,F,98,364,6,370
Elizaeth,F,100,28,0,28
Juneau,F,79,23,6,29
Agusta,F,100,5,0,5
Prabhjot,M,87,17,117,134
Calem,M,100,0,298,298
Aracelli,F,100,272,0,272
Xalen,M,100,0,15,15
Aiiden,M,100,0,40,40
Fanita,F,100,33,0,33
Steban,M,100,0,22,22
Ahlyvia,F,100,5,0,5
Mytien,F,100,6,0,6
Dexton,M,100,0,212,212
Zophia,F,100,356,0,356
Shuayb,M,100,0,55,55
Inna,F,100,350,0,350
Roary,M,100,0,35,35
Lester,M,99,304,38906,39210
Lavoy,M,100,0,51,51
Severa,F,100,77,0,77
Sude,F,100,45,0,45
Swanda,F,100,5,0,5
Bernaldo,M,100,0,31,31
Quinlan,M,80,532,2122,2654
Gerone,M,100,0,44,44
Shamaria,F,100,525,0,525
Indhira,F,100,5,0,5
Aakiyah,F,100,5,0,5
Heathyr,F,100,5,0,5
Rigel,M,99,5,373,378
Rayanna,F,100,1854,0,1854
Shem,M,99,5,594,599
Fela,F,64,9,5,14
Nthony,M,100,0,61,61
Sherod,M,100,0,560,560
Mecos,M,100,0,11,11
Zaila,F,100,291,0,291
Laneka,F,100,180,0,180
Jacquisha,F,100,22,0,22
Daylinn,F,100,10,0,10
Shaira,F,100,316,0,316
Odera,F,52,14,13,27
Berek,M,100,0,5,5
Demarrio,M,100,0,186,186
Delmy,F,100,520,0,520
Yvonnda,F,100,21,0,21
Zarrius,M,100,0,6,6
Malo,M,100,0,45,45
Shivika,F,100,24,0,24
Laikin,F,100,47,0,47
Pastor,M,100,0,134,134
Crista,F,100,4192,0,4192
Sabrinia,F,100,197,0,197
Dumaka,M,100,0,5,5
Bernedette,F,100,139,0,139
Kaitlen,F,100,758,0,758
Ezzah,F,100,13,0,13
Charliemae,F,100,5,0,5
Keylah,F,100,74,0,74
Shamonia,F,100,5,0,5
Schronda,F,100,25,0,25
Willean,F,100,58,0,58
Addylin,F,100,30,0,30
Zakariah,M,89,71,577,648
Yanneli,F,100,51,0,51
Ardie,M,79,55,205,260
Chenia,F,100,10,0,10
Jeesica,F,100,5,0,5
Sharanya,F,100,259,0,259
Jamontez,M,100,0,5,5
Donjuan,M,100,0,71,71
Enzley,F,100,10,0,10
Benisha,F,100,91,0,91
Shieda,F,100,14,0,14
Shaheen,M,76,142,444,586
Brannan,M,97,11,370,381
Valyncia,F,100,112,0,112
Lyllah,F,100,22,0,22
Kryztal,F,100,5,0,5
Evontae,M,100,0,5,5
Amedeo,M,100,0,172,172
Cashlynn,F,100,59,0,59
Lyndley,F,100,17,0,17
Jalesse,F,100,5,0,5
Londin,F,100,115,0,115
Sonic,M,100,0,5,5
Magdiel,M,94,26,419,445
Gevin,M,100,0,96,96
Emirhan,M,100,0,29,29
Claudene,F,100,168,0,168
Lucreshia,F,100,6,0,6
Denicka,F,100,5,0,5
Alaa,F,71,939,381,1320
Juancarlo,M,100,0,5,5
Lorette,F,100,431,0,431
Miata,F,100,175,0,175
Lukis,M,100,0,162,162
Chareese,F,100,105,0,105
Trinton,M,100,0,669,669
Dezyrae,F,100,69,0,69
Hallema,F,100,5,0,5
Cordney,M,94,12,190,202
Jothan,M,100,0,15,15
Rachit,M,100,0,82,82
Tashawnna,F,100,15,0,15
Latracy,F,100,5,0,5
Baryn,M,100,0,5,5
Willma,F,100,87,0,87
Ivica,M,100,0,11,11
Jhaki,M,100,0,5,5
Rydin,M,100,0,9,9
Feliscia,F,100,6,0,6
Norelys,F,100,5,0,5
Rictoria,F,100,5,0,5
Zivah,F,100,90,0,90
Talon,M,96,415,9175,9590
Steveson,M,100,0,17,17
Gretha,F,100,6,0,6
Adonijah,M,93,26,324,350
Ramiyah,F,100,676,0,676
Sheindy,F,100,34,0,34
Mahealani,F,100,444,0,444
Kiser,M,100,0,15,15
Yesinia,F,100,48,0,48
Leanthony,M,100,0,286,286
Malene,F,100,120,0,120
Aliviah,F,100,609,0,609
Roshon,M,73,60,166,226
Jerran,M,100,0,191,191
Verble,M,100,0,6,6
Jadarrious,M,100,0,5,5
Mandana,F,100,43,0,43
Marieclaire,F,100,66,0,66
Meryl,F,98,3409,59,3468
Paulino,M,100,0,1262,1262
Shahidah,F,100,227,0,227
Milisha,F,100,5,0,5
Iesa,M,100,0,5,5
Ivone,F,100,410,0,410
Drin,M,100,0,29,29
Armanii,F,70,151,66,217
Maraja,F,100,11,0,11
Deakon,M,100,0,274,274
Dawayne,M,100,0,1541,1541
Marieke,F,100,117,0,117
Ellan,F,100,128,0,128
Daijah,F,100,2131,0,2131
Fleta,F,100,90,0,90
Remie,F,100,196,0,196
Taronza,F,100,5,0,5
Bareerah,F,100,5,0,5
Xou,M,100,0,11,11
Ramelle,F,50,11,11,22
Sana,F,100,3323,5,3328
Jaleena,F,100,186,0,186
Mazen,M,100,0,829,829
Taleb,M,100,0,30,30
Inetta,F,100,184,0,184
Jacop,M,100,0,13,13
Dycen,M,100,0,8,8
Secunda,F,100,10,0,10
Isabell,F,100,5867,0,5867
Dushane,M,100,0,5,5
Malayha,F,100,11,0,11
Joelee,F,100,106,0,106
Danni,F,96,1875,72,1947
Arriane,F,100,5,0,5
Keeon,M,100,0,113,113
Fabiha,F,100,48,0,48
Maranatha,F,100,271,0,271
Lameer,M,100,0,5,5
Nainoa,M,100,0,453,453
Raziel,M,98,18,857,875
Jimenna,F,100,29,0,29
Milos,M,100,0,264,264
Najha,F,100,33,0,33
Velvetta,F,100,10,0,10
Deekshitha,F,100,5,0,5
Jaysion,M,100,0,42,42
Paula,F,100,221264,715,221979
Elaiya,F,100,5,0,5
Raymar,M,100,0,141,141
Danetta,F,100,856,0,856
Zikiria,F,100,5,0,5
Kendarius,M,100,0,914,914
Lalisa,F,100,92,0,92
Hadeer,F,100,5,0,5
Yeimy,F,100,276,0,276
Kwanza,F,84,227,42,269
Shlome,M,100,0,428,428
Aiyah,F,100,89,0,89
Leyanna,F,100,140,0,140
Faun,F,100,97,0,97
Takea,F,100,40,0,40
Evalette,F,100,72,0,72
Cambridge,F,53,40,36,76
Syndia,F,100,5,0,5
Zyair,M,88,89,662,751
Maylena,F,100,18,0,18
Anteaus,M,100,0,8,8
Chiamaka,F,100,440,0,440
Amazen,F,100,11,0,11
Annielaurie,F,100,11,0,11
Evadne,F,100,27,0,27
Debbee,F,100,5,0,5
Ronnae,F,100,114,0,114
Marquita,F,100,10381,30,10411
Lilyahna,F,100,111,0,111
Rashand,M,100,0,5,5
Morningstar,F,100,172,0,172
Merely,F,100,5,0,5
Anapaola,F,100,117,0,117
Mckinli,F,100,14,0,14
Sadonna,F,100,163,0,163
Shykeria,F,100,80,0,80
Franzetta,F,100,15,0,15
Quartez,M,100,0,356,356
Raenette,F,100,70,0,70
Ram,M,100,0,667,667
Moayad,M,100,0,8,8
Alexiah,F,100,417,0,417
Celene,F,100,1485,0,1485
Lorijo,F,100,24,0,24
Kerrilee,F,100,15,0,15
Arielyz,F,100,11,0,11
Caelainn,F,100,6,0,6
Kasady,F,100,22,0,22
Gethsemani,F,100,13,0,13
Maurine,F,100,1124,0,1124
Chevi,F,100,55,0,55
Majken,F,100,5,0,5
Muscab,M,100,0,27,27
Lalah,F,100,244,0,244
Mick,M,100,0,1822,1822
Latayvia,F,100,86,0,86
Maydell,F,100,10,0,10
Derran,M,100,0,67,67
Gaber,M,100,0,5,5
Melveen,F,100,5,0,5
Liddia,F,100,6,0,6
Lakhia,F,100,72,0,72
Loralyn,F,100,329,0,329
Fentress,M,100,0,10,10
Kaliber,M,100,0,6,6
Emonnie,F,100,134,0,134
Amil,M,63,230,398,628
Jaimari,M,100,0,5,5
Kaleyah,F,100,312,0,312
Dheer,M,100,0,8,8
Shateya,F,100,5,0,5
Savannahlynn,F,100,10,0,10
Ryyan,M,100,0,23,23
Homero,M,100,0,3059,3059
Hylan,M,100,0,22,22
Valonda,F,100,36,0,36
Elijahpaul,M,100,0,6,6
Markila,F,100,12,0,12
Lorese,F,100,7,0,7
Garris,M,100,0,75,75
Calia,F,100,519,0,519
Jelisia,F,100,10,0,10
Deriya,F,100,13,0,13
Raishawn,M,100,0,45,45
Jaivin,M,100,0,30,30
Braylin,M,64,1017,1781,2798
Kiva,F,97,689,24,713
Alonda,F,100,871,0,871
Lennin,M,100,0,177,177
Raffaela,F,100,108,0,108
Tesheena,F,100,13,0,13
Latwan,M,100,0,62,62
Yareth,F,64,213,120,333
Deliany,F,100,5,0,5
Yariely,F,100,17,0,17
Malijah,F,68,88,41,129
Kameira,F,100,15,0,15
Jhene,F,100,115,0,115
Tamba,F,52,12,11,23
Agent,M,100,0,5,5
Shuvon,F,100,6,0,6
Sabur,M,100,0,5,5
Denisa,F,100,965,0,965
Anamda,F,100,6,0,6
Yaasmiyn,F,100,5,0,5
Mahkyla,F,100,5,0,5
Angee,F,100,153,0,153
Lindora,F,100,80,0,80
Dyann,F,100,731,0,731
Omarien,M,100,0,23,23
Gerline,F,100,86,0,86
Halena,F,100,272,0,272
Jealyn,F,100,11,0,11
Pragati,F,100,9,0,9
Marguette,M,100,0,28,28
Ryanmatthew,M,100,0,5,5
Inza,F,100,5,0,5
Yamillet,F,100,35,0,35
Carlitta,F,100,5,0,5
Burhanuddin,M,100,0,80,80
Euclides,M,100,0,20,20
Jaiya,F,100,457,0,457
Mylan,M,72,288,732,1020
Anavay,F,100,5,0,5
Jihoo,M,100,0,10,10
Vannette,F,100,34,0,34
Arlete,F,100,5,0,5
Monea,F,100,289,0,289
Lilya,F,100,284,0,284
Ricahrd,M,100,0,207,207
Harlei,F,100,164,0,164
Shirrel,F,100,10,0,10
Velia,F,100,1338,0,1338
Ashlyne,F,100,412,0,412
Nickolas,M,100,47,33450,33497
Tniya,F,100,104,0,104
Shiryl,F,100,67,0,67
Naiovy,F,100,17,0,17
Zaydon,M,100,0,152,152
Regan,F,82,14695,3290,17985
Raidyn,M,88,27,198,225
Whit,M,100,0,408,408
Tatina,F,100,21,0,21
Nardia,F,100,23,0,23
Jonath,M,100,0,35,35
Orland,M,100,0,408,408
Lind,F,88,71,10,81
Aaliyha,F,100,422,0,422
Jocelle,F,100,5,0,5
Converse,M,100,0,5,5
Brynly,F,100,36,0,36
Sophorn,F,100,11,0,11
Nadav,M,100,0,518,518
Laiba,F,100,519,0,519
Akriti,F,100,14,0,14
Tammra,F,100,583,0,583
Semyah,F,100,17,0,17
Lafeyette,M,100,0,5,5
Romar,M,100,0,172,172
Normalinda,F,100,32,0,32
Chike,M,100,0,159,159
Javeyah,F,100,23,0,23
Kaleob,M,100,0,19,19
Hylee,F,100,32,0,32
Elad,M,100,0,205,205
Kailani,F,99,2588,17,2605
Scyler,M,71,5,12,17
Cami,F,100,5167,0,5167
Tekiyah,F,100,27,0,27
Kornelius,M,100,0,46,46
Neelesh,M,100,0,51,51
Packer,M,100,0,23,23
Kennede,F,100,135,0,135
Takeema,F,100,51,0,51
Jaanai,F,100,98,0,98
Nakeesha,F,100,193,0,193
Lexey,F,100,203,0,203
Keiuna,F,100,5,0,5
Ndidi,F,100,65,0,65
Erasmus,M,100,0,26,26
Hareem,F,100,148,0,148
Sadielee,F,100,5,0,5
Justy,F,100,10,0,10
Zack,M,100,0,5309,5309
Kyria,F,100,672,0,672
Zayleigh,F,100,244,0,244
Julius,M,99,186,35889,36075
Zeven,M,100,0,95,95
Dung,M,62,287,469,756
Bryer,M,93,75,1039,1114
Zellie,F,100,21,0,21
Yajaira,F,100,5326,5,5331
Siobhon,F,100,5,0,5
Shunte,F,100,142,0,142
Kyriah,F,100,38,0,38
Kaylene,F,100,4259,0,4259
Lyneth,F,100,16,0,16
Tedrick,M,100,0,682,682
Jameeka,F,100,166,0,166
Alexuss,F,100,10,0,10
Mckensie,F,100,711,0,711
Zael,M,100,0,95,95
Laraina,F,100,50,0,50
Jainee,F,100,5,0,5
Jodana,F,100,5,0,5
Dezmond,M,100,0,2504,2504
Ericamarie,F,100,5,0,5
Rennata,F,100,6,0,6
Everlena,F,100,119,0,119
Maryssa,F,100,1635,0,1635
Aarit,M,100,0,64,64
Morgon,M,71,42,101,143
Tegon,M,100,0,5,5
Mapuana,F,100,5,0,5
Ronaldino,M,100,0,11,11
Jantzen,M,98,14,616,630
Michia,F,100,19,0,19
Walee,M,100,0,5,5
Hridhaan,M,100,0,69,69
Elrey,M,100,0,23,23
Jaiel,M,58,47,65,112
Ivannah,F,100,44,0,44
Myauna,F,100,17,0,17
Jalonda,F,100,150,0,150
Anjelika,F,100,340,0,340
Marvens,M,100,0,174,174
Itay,M,100,0,100,100
Narelle,F,100,23,0,23
Yolandra,F,100,128,0,128
Maryn,F,100,1846,0,1846
Rope,M,100,0,34,34
Ronella,F,100,16,0,16
Ronav,M,100,0,168,168
Clete,M,100,0,268,268
Lyanie,F,100,5,0,5
Jodie,F,93,25940,1867,27807
Natavia,F,100,565,0,565
Cesily,F,100,97,0,97
Kadaysia,F,100,5,0,5
Alyssabeth,F,100,123,0,123
Kinzli,F,100,15,0,15
Geffen,M,100,0,12,12
Philson,M,100,0,5,5
Lung,M,100,0,7,7
Natusha,F,100,30,0,30
Leamon,M,100,0,858,858
Shantanu,M,100,0,69,69
Ayrah,F,100,9,0,9
Brookley,F,100,75,0,75
Delsa,F,100,56,0,56
Delanee,F,100,301,0,301
Greidys,F,100,337,0,337
Marcy,F,99,19880,138,20018
Burnadine,F,100,5,0,5
Ameesha,F,100,10,0,10
Takahiro,M,100,0,94,94
Kenye,M,100,0,21,21
Baylie,F,99,3062,26,3088
Tacita,F,100,16,0,16
Oley,M,100,0,52,52
Lura,F,100,1923,0,1923
Thandi,F,100,36,0,36
Drequan,M,100,0,458,458
Jann,F,93,1743,127,1870
Gawaine,M,100,0,5,5
Emrey,F,77,112,34,146
Shateema,F,100,15,0,15
Trezden,M,100,0,13,13
Elanda,F,100,246,0,246
Damitri,M,100,0,33,33
Theotis,M,100,0,663,663
Eliesha,F,100,11,0,11
Gabriely,F,100,10,0,10
Jaylei,F,100,162,0,162
Christopherdavi,M,100,0,5,5
Deborahh,F,100,23,0,23
Allieana,F,100,7,0,7
Jealisa,F,100,9,0,9
Chenea,F,100,23,0,23
Mordechi,M,100,0,5,5
Akshitha,F,100,75,0,75
Hixon,M,100,0,6,6
Kiylie,F,100,6,0,6
Josiha,M,100,0,12,12
Kenaja,F,100,5,0,5
Abreona,F,100,6,0,6
Lucianne,F,100,206,0,206
Shaundrika,F,100,5,0,5
Angelian,F,100,6,0,6
Doanld,M,100,0,41,41
Keiven,M,100,0,37,37
Raynelle,F,100,205,0,205
Kellsea,F,100,13,0,13
Argyle,M,100,0,7,7
Haashir,M,100,0,6,6
Dominicka,F,100,5,0,5
Jaiquan,M,100,0,403,403
Mikah,M,61,1284,2011,3295
Datrell,M,100,0,69,69
Avneesh,M,100,0,25,25
Yilda,F,100,33,0,33
Naoma,F,100,265,0,265
Riquelme,M,100,0,56,56
Mackinley,M,55,227,279,506
Deepesh,M,100,0,5,5
Cottie,F,100,5,0,5
Gayle,F,97,38128,1238,39366
Rowann,F,100,10,0,10
Joyleen,F,100,27,0,27
Jacqueline,F,100,319698,1097,320795
Lorree,F,100,64,0,64
Anacristina,F,100,223,0,223
Afonso,M,100,0,5,5
Shoneen,F,100,12,0,12
Marie,F,99,137164,706,137870
Shamma,F,100,5,0,5
Duncan,M,100,6,15119,15125
Makaylie,F,100,255,0,255
Leiah,F,100,893,0,893
Laquinn,M,91,5,53,58
Nahlia,F,100,123,0,123
Toler,M,100,0,5,5
Kedrin,M,100,0,57,57
Brilea,F,100,16,0,16
Suella,F,100,145,0,145
Kemba,F,100,169,0,169
Makenzlee,F,100,8,0,8
Latreena,F,100,5,0,5
Aviyana,F,100,87,0,87
Lyzeth,F,100,19,0,19
Kaliope,F,100,65,0,65
Makaley,F,100,120,0,120
Ashleymarie,F,100,356,0,356
Orlanda,M,71,207,505,712
Reilley,F,64,180,102,282
Kaitlind,F,100,16,0,16
Avree,F,97,379,11,390
Magie,F,100,75,0,75
Orquidea,F,100,43,0,43
Delany,F,100,787,0,787
Makhari,M,80,12,47,59
Jammar,M,100,0,33,33
Ashraf,M,100,0,728,728
Azareya,F,100,34,0,34
Jaleia,F,100,155,0,155
Livya,F,100,33,0,33
Deanette,F,100,114,0,114
Carzell,M,100,0,46,46
Jasmary,F,100,6,0,6
Tenille,F,100,955,0,955
Mikaia,F,100,105,0,105
Sylvestre,M,100,0,80,80
Lamoria,F,100,5,0,5
Chyna,F,100,5178,0,5178
Hawra,F,100,39,0,39
Abranda,F,100,5,0,5
Banjamin,M,100,0,281,281
Yosiel,M,100,0,39,39
Juvonte,M,100,0,10,10
Ragnar,M,100,0,43,43
Deklyn,M,80,57,227,284
Ignatius,M,100,0,1004,1004
Teandra,F,100,309,0,309
Idessa,F,100,5,0,5
Taejuan,M,100,0,5,5
Talie,F,100,11,0,11
Jazzelle,F,100,225,0,225
Ameyah,F,100,130,0,130
Meylin,F,100,279,0,279
Luwam,F,100,41,0,41
Hylie,F,100,5,0,5
Deaundria,F,100,45,0,45
Stephaie,F,100,136,0,136
Antanasia,F,100,69,0,69
Randene,F,100,5,0,5
Jebron,M,100,0,25,25
Lilyann,F,100,2093,0,2093
Rodericus,M,100,0,5,5
Tenessa,F,100,74,0,74
Laryssa,F,100,1184,0,1184
Navpreet,F,100,75,0,75
Haroldo,M,100,0,16,16
Antha,F,100,17,0,17
Yuji,M,100,0,213,213
Khriston,M,100,0,5,5
Adyen,M,100,0,66,66
Yenia,F,100,37,0,37
Breigh,F,100,213,0,213
Wilna,F,100,10,0,10
Chalis,F,100,5,0,5
Anesti,F,50,5,5,10
Aaric,M,100,0,382,382
Akira,F,84,5234,990,6224
Kylieanne,F,100,7,0,7
Rilah,F,100,5,0,5
Vannya,F,100,33,0,33
Korbin,M,98,101,5718,5819
Jouri,F,100,25,0,25
Antoria,F,100,196,0,196
Klea,F,100,133,0,133
Valentine,M,73,808,2202,3010
Mirandy,F,100,12,0,12
Minique,F,100,15,0,15
Kaedin,M,98,5,316,321
Emanda,F,100,36,0,36
Quraan,M,100,0,12,12
Hedieh,F,100,5,0,5
Alizay,F,99,644,5,649
Elixabeth,F,100,11,0,11
Roseangela,F,100,5,0,5
Margarine,F,100,7,0,7
Anthonyjoseph,M,100,0,44,44
Kaashvi,F,100,21,0,21
Kinverli,F,100,5,0,5
Linnzi,F,100,17,0,17
Julysa,F,100,58,0,58
Pershing,M,100,0,12,12
Candece,F,100,33,0,33
Meshel,F,100,5,0,5
Jousha,M,100,0,431,431
Depriest,M,100,0,6,6
Daquian,M,100,0,5,5
Andren,M,100,0,74,74
Coderro,M,100,0,5,5
Trejohn,M,100,0,20,20
Jeremi,M,97,44,1479,1523
Mellisia,F,100,10,0,10
Jacolbi,M,100,0,27,27
Fadwa,F,100,17,0,17
Rajahn,M,100,0,29,29
Corrice,M,100,0,5,5
Branasia,F,100,16,0,16
Damiel,M,100,0,83,83
Armony,F,100,29,0,29
Samael,M,100,0,131,131
Tonie,F,91,2295,238,2533
Yanela,F,100,13,0,13
Kaeyla,F,100,17,0,17
Oneta,F,100,115,0,115
Seema,F,100,1095,0,1095
Stavro,M,100,0,22,22
Keeana,F,100,180,0,180
Yunier,M,100,0,5,5
Vuthy,M,100,0,37,37
Odessey,F,100,25,0,25
Ozan,M,100,0,156,156
Layanna,F,100,155,0,155
Savonna,F,100,166,0,166
Anyea,F,100,57,0,57
Noeh,M,100,0,83,83
Beto,M,100,0,48,48
Tangee,F,100,358,0,358
Robie,M,71,319,776,1095
Oprah,F,100,99,0,99
Obehi,F,100,5,0,5
Rajit,M,100,0,14,14
Olaiya,F,100,8,0,8
Bronze,M,100,0,21,21
Tennis,M,100,0,61,61
Kolter,M,100,0,477,477
Faatimah,F,100,120,0,120
Tangina,F,100,44,0,44
Lieren,F,100,16,0,16
Shawnia,F,100,168,0,168
Toranio,M,100,0,5,5
Isabele,F,100,150,0,150
Breyell,F,100,5,0,5
Mashika,F,100,11,0,11
Zac,M,100,0,1009,1009
Tyquarious,M,100,0,5,5
Zacariah,M,99,5,361,366
Kordelia,F,100,43,0,43
Rhonnie,M,100,0,10,10
Kellyanna,F,100,8,0,8
Deiondre,M,100,0,414,414
Kanoe,F,100,81,0,81
Lynndsey,F,100,5,0,5
Shamaka,F,100,39,0,39
Silena,F,100,145,0,145
Chaning,F,52,14,13,27
Kesly,F,100,5,0,5
Emelyn,F,100,1639,0,1639
Jhanna,F,100,10,0,10
Jordy,M,99,31,4342,4373
Kalyiah,F,100,64,0,64
Bandy,M,67,30,62,92
Tomeisha,F,100,15,0,15
Souren,M,100,0,5,5
Darlen,F,100,164,0,164
Starisha,F,100,11,0,11
Jaislyn,F,100,46,0,46
Ferra,F,100,5,0,5
Khaleya,F,100,30,0,30
Nahia,F,100,58,0,58
Berman,M,100,0,37,37
Fernell,M,100,0,6,6
Shaneice,F,100,485,0,485
Stephn,M,100,0,10,10
Zaelia,F,100,5,0,5
Ilija,M,100,0,108,108
Shadya,F,100,6,0,6
Treyvin,M,100,0,117,117
Shelyn,F,100,5,0,5
Armonte,M,100,0,190,190
Shahadah,F,100,43,0,43
Neomie,F,100,6,0,6
Shewanna,F,100,32,0,32
Aryel,F,95,435,25,460
Dynisty,F,100,40,0,40
Tymond,M,100,0,5,5
Javarris,M,100,0,15,15
Hartej,M,100,0,11,11
Ligita,F,100,5,0,5
Thomasene,F,100,87,0,87
Yaqoub,M,100,0,6,6
Dantley,M,100,0,5,5
Ladarrious,M,100,0,77,77
Blas,M,100,0,1880,1880
Deona,F,100,1119,0,1119
Jaylena,F,100,112,0,112
Glenna,F,100,8696,0,8696
Ancil,M,100,0,251,251
Gemia,F,100,10,0,10
Alyca,F,100,7,0,7
Arizbeth,F,100,353,0,353
Alecsandra,F,100,16,0,16
Emerick,M,100,0,209,209
Mkenna,F,100,25,0,25
Makay,F,51,37,35,72
Mccade,M,100,0,99,99
Marceil,F,100,67,0,67
Najeli,F,100,11,0,11
Graylen,M,100,0,70,70
Lysle,M,100,0,75,75
Barrie,F,68,1326,615,1941
Cairra,F,100,40,0,40
Kimberlynn,F,100,682,0,682
Macaria,F,100,218,0,218
Donneisha,F,100,83,0,83
Trenasia,F,100,5,0,5
Saira,F,100,2666,0,2666
Nichael,M,100,0,92,92
Dasani,F,74,912,324,1236
Shyon,M,100,0,46,46
Wynnie,F,100,19,0,19
Marquece,M,100,0,39,39
Jamill,M,100,0,347,347
Dallanara,F,100,58,0,58
Xayden,M,100,0,307,307
Malay,F,100,83,0,83
Michah,M,95,17,320,337
Hazely,F,100,43,0,43
Areia,F,100,25,0,25
Shacorra,F,100,10,0,10
Luceal,F,100,5,0,5
Shalai,F,100,19,0,19
Tavarious,M,100,0,175,175
Quinaya,F,100,5,0,5
Rufina,F,100,358,0,358
Juila,F,100,10,0,10
Chinedu,M,100,0,345,345
Korinn,F,100,60,0,60
Marje,F,100,5,0,5
Kengston,M,100,0,7,7
Jerrylee,M,100,0,13,13
Danielia,F,100,5,0,5
Aleceia,F,100,5,0,5
Sneyder,M,100,0,5,5
Bess,F,100,1230,0,1230
Quindarrius,M,100,0,69,69
Rushawn,M,100,0,93,93
Anamary,F,100,5,0,5
Jalesa,F,100,647,0,647
Jacayla,F,100,91,0,91
Or,M,100,0,10,10
Manard,M,100,0,6,6
Mihaela,F,100,36,0,36
Sibrina,F,100,5,0,5
Johntrell,M,100,0,57,57
Zira,F,100,58,0,58
Kyaire,M,100,0,246,246
Torri,F,89,2879,341,3220
Brynne,F,100,2328,0,2328
Anayaa,F,100,14,0,14
Barnard,M,100,0,428,428
Cecil,M,98,626,29798,30424
Rbecca,F,100,5,0,5
Estella,F,100,10976,10,10986
Dravid,M,100,0,5,5
Evalyna,F,100,16,0,16
Rosaysela,F,100,7,0,7
Francina,F,100,1125,0,1125
Martisa,F,100,19,0,19
Gurtaaj,M,100,0,7,7
Monterrio,M,100,0,112,112
Crysten,F,100,154,0,154
Tahtiana,F,100,110,0,110
Jayniyah,F,100,7,0,7
Smyan,M,100,0,34,34
Roshelle,F,100,845,0,845
Cayse,M,59,20,29,49
Zisel,F,100,39,0,39
Lakeisa,F,100,122,0,122
Chrystopher,M,100,0,346,346
Phuong,F,79,1033,282,1315
Brenesha,F,100,37,0,37
Levian,F,50,5,5,10
Terick,M,100,0,50,50
Lachel,F,100,10,0,10
Sakaria,M,100,0,12,12
Travianna,F,100,5,0,5
Mahkai,M,100,0,213,213
Jutin,M,100,0,13,13
Anthonee,M,100,0,207,207
Lekeith,M,100,0,125,125
Shonnell,F,100,10,0,10
Seandrea,F,100,5,0,5
Nyvea,F,100,6,0,6
Kamaury,M,96,5,109,114
Adiyan,M,100,0,20,20
Josslyn,F,100,1502,0,1502
Abdourahmane,M,100,0,18,18
Anker,M,100,0,5,5
Mavery,F,100,34,0,34
Devionte,M,100,0,7,7
Nikeeta,F,100,29,0,29
Sheriah,F,100,53,0,53
Semon,F,100,5,0,5
Danian,M,100,0,55,55
Adilee,F,100,143,0,143
Renald,M,100,0,232,232
Julieanna,F,100,1357,0,1357
Shanieca,F,100,5,0,5
Madaleno,M,100,0,6,6
Marvely,F,100,6,0,6
Rouguiatou,F,100,12,0,12
Taiven,M,100,0,101,101
Jerom,M,100,0,11,11
Kyresha,F,100,5,0,5
Cambren,M,100,0,89,89
Deshante,F,78,68,19,87
Jamiee,F,100,361,0,361
Karmynn,F,100,34,0,34
Kinney,M,100,0,250,250
Cyra,F,100,528,0,528
Leelee,F,100,25,0,25
Oanh,F,100,237,0,237
Pandora,F,100,2435,0,2435
Sensi,F,100,5,0,5
Franccesca,F,100,11,0,11
Kristeen,F,100,1243,0,1243
Nollan,M,100,0,50,50
Haruma,M,100,0,14,14
Jaritsa,F,100,9,0,9
Caitlyne,F,100,86,0,86
Iyanah,F,100,455,0,455
Arathi,F,100,10,0,10
Ewin,M,100,0,5,5
Cyann,F,100,253,0,253
Torion,M,100,0,178,178
Jaetyn,M,100,0,28,28
Chanika,F,100,233,0,233
Kalenna,F,100,33,0,33
Takanori,M,100,0,6,6
Kray,M,100,0,16,16
Mischelle,F,100,953,0,953
Desire,F,100,4335,11,4346
Josejuan,M,100,0,233,233
Jetlyn,F,100,5,0,5
Janyll,F,100,35,0,35
Dejenae,F,100,16,0,16
Khloi,F,100,128,0,128
Treigh,M,100,0,20,20
Leasha,F,100,309,0,309
Meara,F,100,918,0,918
Gleen,M,100,0,290,290
Janemarie,F,100,50,0,50
Karanbir,M,100,0,5,5
Romualdo,M,100,0,344,344
Lilliah,F,100,119,0,119
Monifah,F,100,135,0,135
Jill,F,100,194044,477,194521
Shaarav,M,100,0,40,40
Crystan,F,100,28,0,28
Starasia,F,100,308,0,308
Guilliana,F,100,7,0,7
Teionna,F,100,54,0,54
Kristel,F,100,2575,0,2575
Eveli,F,100,7,0,7
Tyletha,F,100,5,0,5
Guendalina,F,100,5,0,5
Alekzandr,M,100,0,22,22
Cavari,M,100,0,5,5
Neile,F,100,35,0,35
Kaj,M,100,0,396,396
Yulemi,F,100,5,0,5
Naeema,F,100,219,0,219
Esequiel,M,100,0,2110,2110
Alenis,F,100,20,0,20
Jaze,M,100,0,47,47
Vyshnavi,F,100,23,0,23
Darden,M,100,0,16,16
Dossie,M,85,10,56,66
Izna,F,100,12,0,12
Criselle,F,100,6,0,6
Chrystian,M,91,70,690,760
Casie,F,100,4712,18,4730
Sureena,F,100,10,0,10
Ruiz,M,100,0,5,5
Emmasue,F,100,5,0,5
Arniesha,F,100,5,0,5
Mikhaila,F,100,427,0,427
Akili,M,63,225,384,609
Karmin,F,100,786,0,786
Jurnee,F,100,2257,7,2264
Lateasha,F,100,439,0,439
Androw,M,100,0,5,5
Zenovia,F,100,261,0,261
Jakaylin,F,77,34,10,44
Finnbar,M,100,0,70,70
Lakrisha,F,100,327,0,327
Saundra,F,100,9519,0,9519
Herry,M,100,0,21,21
Lalita,F,100,712,0,712
Kametria,F,100,23,0,23
Khadejia,F,100,11,0,11
Fletcher,M,100,5,6930,6935
Lantz,M,100,0,522,522
Loic,M,100,0,229,229
Reizy,F,100,41,0,41
Tadashi,M,100,0,60,60
Usra,F,100,5,0,5
Darrius,M,100,0,7096,7096
Bolden,M,100,0,10,10
Di,F,80,51,13,64
Cerise,F,100,681,0,681
Rolley,M,100,0,6,6
Za,M,100,0,5,5
Danson,M,100,0,28,28
Tyquis,M,100,0,5,5
Bryona,F,100,181,0,181
Mariene,F,100,13,0,13
Marshelle,F,100,548,0,548
Cathay,F,100,17,0,17
Rameel,M,100,0,5,5
Yojana,F,100,19,0,19
Keola,M,94,31,494,525
Ilario,M,100,0,139,139
Orien,M,100,0,230,230
Ermias,M,100,0,57,57
Chezky,M,100,0,7,7
Tawanica,F,100,5,0,5
Leary,M,100,0,35,35
Lisania,F,100,58,0,58
Ahmonie,F,100,5,0,5
Khadidra,F,100,15,0,15
Alleria,F,100,10,0,10
Roseanne,F,100,5092,0,5092
Jamarquez,M,100,0,33,33
Sambhav,M,100,0,23,23
Sharale,F,100,8,0,8
Dalena,F,100,984,0,984
Shaman,M,100,0,71,71
Lakshman,M,100,0,10,10
Cornellius,M,100,0,144,144
Walda,F,100,44,0,44
Laurelee,F,100,20,0,20
Itati,F,100,361,0,361
Maybre,F,100,5,0,5
Aleily,F,100,5,0,5
Nye,M,100,0,10,10
Stevin,M,100,0,432,432
Lakiva,F,100,36,0,36
Shayln,F,100,16,0,16
Jarita,F,100,206,0,206
Jermaria,F,100,6,0,6
Welby,M,100,0,74,74
Syleena,F,100,100,0,100
Nijai,F,100,18,0,18
Yanneth,F,100,5,0,5
Xyliana,F,100,5,0,5
Tipton,M,96,5,108,113
Daviah,F,100,19,0,19
Marten,M,100,0,365,365
Keolani,F,100,5,0,5
Edyth,F,100,291,0,291
Kanai,M,70,68,160,228
Elieana,F,100,5,0,5
Mckinely,M,100,0,5,5
Sura,F,100,221,0,221
Janaysia,F,100,155,0,155
Shanlee,F,100,34,0,34
Adorah,F,100,15,0,15
Harsimar,M,100,0,5,5
Ruthanne,F,100,1542,0,1542
Lyndle,M,100,0,34,34
Tavain,M,100,0,5,5
Anatalia,F,100,40,0,40
Robel,M,100,0,508,508
Yordan,M,100,0,106,106
Ceirra,F,100,573,0,573
Jachelle,F,100,120,0,120
Krag,M,100,0,22,22
Shivaan,M,100,0,40,40
Cobb,M,100,0,5,5
Ruchoma,F,100,19,0,19
Imaya,F,100,112,0,112
Tashieka,F,100,35,0,35
Sierramarie,F,100,5,0,5
Whittney,F,100,1633,5,1638
Zebula,M,100,0,6,6
Ender,M,100,0,599,599
Jermarion,M,100,0,205,205
Abbigael,F,100,162,0,162
Trax,M,100,0,19,19
Catileya,F,100,5,0,5
Shereen,F,100,1522,0,1522
Maleisha,F,100,7,0,7
Szander,M,100,0,5,5
Bahiya,F,100,15,0,15
Tilla,F,100,7,0,7
Blessen,F,100,86,0,86
Quentyn,M,100,0,174,174
Patron,M,100,0,11,11
Arlynn,F,93,311,22,333
Taffney,F,100,10,0,10
Maizy,F,100,679,0,679
Laquanya,F,100,15,0,15
Nefertiti,F,100,726,0,726
Dajana,F,100,173,0,173
Zahniya,F,100,71,0,71
Iishia,F,100,5,0,5
Aayansh,M,100,0,34,34
Markess,M,100,0,5,5
Bailasan,F,100,6,0,6
Cloria,F,100,36,0,36
Oracio,M,100,0,416,416
Arwin,M,100,0,79,79
Sorella,F,100,5,0,5
Sincear,M,100,0,46,46
Romel,M,100,0,2046,2046
Tywuan,M,100,0,50,50
Ramzie,F,100,5,0,5
Kishla,F,100,5,0,5
Tesa,F,100,1338,0,1338
Jalaiyah,F,100,71,0,71
Jamesdaniel,M,100,0,5,5
Devontrey,M,100,0,5,5
Seab,M,100,0,7,7
Keneshia,F,100,331,0,331
Zarihanna,F,100,20,0,20
Jacquelin,F,100,7072,0,7072
Shequan,M,100,0,17,17
Costello,M,100,0,51,51
Karely,F,100,1524,0,1524
Brayton,M,99,22,1933,1955
Jacarious,M,100,0,34,34
Tywaun,M,100,0,211,211
Jasir,M,100,0,809,809
Latarah,F,100,5,0,5
Rena,F,100,17131,75,17206
Rovena,F,100,58,0,58
Louwanna,F,100,16,0,16
Tira,F,100,974,0,974
Divid,M,100,0,5,5
Yareny,F,100,28,0,28
Eyvin,M,100,0,5,5
Lucyana,F,100,27,0,27
Mercutio,M,100,0,10,10
Yoshiko,F,100,157,0,157
Korbynn,F,100,6,0,6
Dynasty,F,100,1924,0,1924
Brenda,F,100,488331,1793,490124
Dyuthi,F,100,20,0,20
Roxann,F,100,8195,0,8195
Kenndy,F,59,10,7,17
Lukah,M,100,0,141,141
Kiev,M,100,0,74,74
Rojelio,M,100,0,2417,2417
Shaylyn,F,100,1950,0,1950
Beunca,F,100,17,0,17
Timiah,F,100,59,0,59
Izell,M,100,0,452,452
Laportia,F,100,219,0,219
Gael,M,98,347,15239,15586
Ekram,F,100,37,0,37
Annastassia,F,100,5,0,5
Brynda,F,100,129,0,129
Zakara,F,100,72,0,72
Lamontae,M,100,0,228,228
Kesean,M,100,0,1095,1095
Rajae,M,66,22,42,64
Jerrius,M,100,0,42,42
Maressa,F,100,468,0,468
Canda,F,100,165,0,165
Eizabella,F,100,11,0,11
Nadija,F,100,34,0,34
Alexaundria,F,100,57,0,57
Raelea,F,100,60,0,60
Arrion,M,76,79,245,324
Metra,F,100,30,0,30
Ceasare,M,100,0,13,13
Roxy,F,99,2324,20,2344
Jayza,F,100,5,0,5
Aashini,F,100,5,0,5
Alheli,F,100,37,0,37
Malayla,F,100,137,0,137
Antyon,M,100,0,11,11
Jaquante,M,100,0,43,43
Baily,F,75,1277,417,1694
Codylee,M,100,0,72,72
Raime,F,100,52,0,52
Maynor,M,100,0,661,661
Kayonna,F,100,428,0,428
Minerva,F,100,6791,0,6791
Emara,F,100,48,0,48
Kurtina,F,100,5,0,5
Jasraj,M,100,0,102,102
Jaraya,F,100,24,0,24
Dhiren,M,100,0,80,80
Syndal,F,100,12,0,12
Sameria,F,100,220,0,220
Shantika,F,100,106,0,106
Gable,M,99,6,523,529
Kable,M,100,0,98,98
Izaih,M,100,0,154,154
Vyshonne,M,100,0,12,12
Mourice,M,100,0,18,18
Bla,F,100,5,0,5
Shanequia,F,100,162,0,162
Jeshwa,M,100,0,5,5
Emelia,F,100,5538,0,5538
Heaton,M,100,0,56,56
Shonett,F,100,5,0,5
Tiffaine,F,100,5,0,5
Khrystopher,M,100,0,42,42
Hoai,M,85,6,35,41
Aggie,F,100,285,0,285
Lavoris,M,57,163,212,375
Seneatha,F,100,6,0,6
Annabel,F,100,9106,0,9106
Mashanti,F,100,7,0,7
Arad,M,100,0,67,67
Patrise,F,100,28,0,28
Sunaina,F,100,102,0,102
Riyaq,F,100,5,0,5
Feffrey,M,100,0,6,6
Clista,F,100,65,0,65
Yanisse,F,100,7,0,7
Tierna,F,100,5,0,5
Breeann,F,100,1355,0,1355
Dhameer,M,100,0,10,10
Kinzy,F,100,161,0,161
Aqil,M,100,0,41,41
Dlylah,F,100,14,0,14
Johncarlo,M,100,0,262,262
Lizneidy,F,100,5,0,5
Shacole,F,100,39,0,39
Soniyah,F,100,69,0,69
Kortland,M,100,0,116,116
Dahir,M,100,0,99,99
Cornellia,F,100,12,0,12
Nevaeh,F,99,64713,380,65093
Olisa,F,100,51,0,51
Mahak,F,100,51,0,51
Shaiasia,F,100,6,0,6
Thaer,M,100,0,61,61
Ankit,M,100,0,762,762
Rajene,F,100,22,0,22
Marfa,F,100,10,0,10
Nancylee,F,100,70,0,70
Callalily,F,100,5,0,5
Enely,F,100,6,0,6
Eiza,F,100,406,0,406
Raylea,F,100,119,0,119
Decarlos,M,100,0,1135,1135
Doranne,F,100,63,0,63
Katalia,F,100,86,0,86
Vassie,F,100,37,0,37
Bonnell,F,100,21,0,21
Seliah,F,100,5,0,5
Torrence,M,94,166,2780,2946
Shannetta,F,100,51,0,51
Thermond,M,100,0,5,5
Loura,F,100,447,0,447
Nikolas,M,100,15,19026,19041
Crisette,F,100,7,0,7
Glenden,M,100,0,22,22
Tye,M,94,320,4623,4943
Sherrlyn,F,100,40,0,40
Desmand,M,100,0,11,11
Nikila,F,100,17,0,17
Brilyn,F,85,226,40,266
Anshul,M,100,0,363,363
Meekah,F,100,37,0,37
Nektarios,M,100,0,26,26
Latham,M,100,0,335,335
Ebonique,F,100,299,0,299
Kaytie,F,100,576,0,576
Everli,F,100,13,0,13
Mikeayla,F,100,5,0,5
Kaitlon,F,100,7,0,7
Jewelee,F,100,15,0,15
Cheryllynn,F,100,69,0,69
Everlea,F,100,9,0,9
Suhayla,F,100,155,0,155
Caryssa,F,100,198,0,198
Zareah,F,100,62,0,62
Cecilee,F,100,207,0,207
Cameika,F,100,5,0,5
Charmie,F,100,5,0,5
Kyleerae,F,100,7,0,7
Roddney,M,100,0,6,6
Belden,M,100,0,25,25
Tahya,F,100,53,0,53
Alonna,F,100,1970,0,1970
Annlee,F,100,55,0,55
Najay,F,50,26,26,52
Booker,M,100,0,3104,3104
Daria,F,100,7362,5,7367
Otniel,M,100,0,83,83
Ebunoluwa,F,100,60,0,60
Nachmen,M,100,0,66,66
Phara,F,100,16,0,16
Xiong,M,100,0,176,176
Redgie,M,100,0,17,17
Sanika,F,100,357,0,357
Tychicus,M,100,0,28,28
Lekeesha,F,100,21,0,21
Dynalee,F,100,5,0,5
Sofee,F,100,28,0,28
Ellanore,F,100,118,0,118
Syir,M,100,0,8,8
Suriyah,F,100,121,0,121
Marayla,F,100,7,0,7
Bevery,F,100,11,0,11
Afia,F,100,387,0,387
Kelvisha,F,100,12,0,12
Ailea,F,100,88,0,88
Quinlen,M,100,0,15,15
Delmonica,F,100,12,0,12
Gurpreet,M,64,172,311,483
Emese,F,100,31,0,31
Nikos,M,100,0,696,696
Khamon,M,100,0,5,5
Velvette,F,100,7,0,7
Pameal,F,100,5,0,5
Ily,F,100,412,0,412
Nivaeh,F,100,25,0,25
Haleema,F,100,273,0,273
Nace,M,100,0,24,24
Gurman,M,94,6,97,103
Ashonda,F,100,36,0,36
Zeplin,M,100,0,18,18
Lashanae,F,100,56,0,56
Malaena,F,100,5,0,5
Najat,F,100,96,0,96
Romuald,M,100,0,21,21
Maryjo,F,100,5344,0,5344
Ramar,M,100,0,262,262
Dinnie,M,76,5,16,21
Ratzy,F,100,17,0,17
Johnvictor,M,100,0,19,19
Janeanne,F,100,27,0,27
Paisli,F,100,49,0,49
Hanns,M,100,0,5,5
Marisa,F,100,47952,66,48018
Mache,F,100,6,0,6
Gladies,F,100,13,0,13
Lovonia,F,100,5,0,5
Zanab,F,100,25,0,25
Tarrance,M,100,0,865,865
Dharmesh,M,100,0,8,8
Letcher,M,100,0,46,46
Murlin,M,100,0,6,6
Doryce,F,100,21,0,21
Kentron,M,100,0,5,5
Draizy,F,100,11,0,11
Shonya,F,100,117,0,117
Jeancarlos,M,100,0,913,913
Tiamarie,F,100,134,0,134
Revia,F,100,27,0,27
Merek,M,100,0,261,261
Sarahi,F,100,5376,0,5376
Mikhala,F,100,127,0,127
Oakie,M,100,0,5,5
Saneya,F,100,5,0,5
Vann,M,98,24,1291,1315
Farhad,M,100,0,241,241
Jacqulyne,F,100,150,0,150
Lakshmi,F,100,625,0,625
Sabriya,F,100,328,0,328
Jordanny,M,100,0,88,88
Jaion,M,100,0,232,232
Delannie,F,100,10,0,10
Aimal,M,100,0,6,6
Augusta,F,81,2494,593,3087
Brittanymarie,F,100,5,0,5
Breshayla,F,100,5,0,5
Addeline,F,100,203,0,203
Jamiron,M,100,0,6,6
Osirus,M,100,0,36,36
Chemise,F,100,43,0,43
Teira,F,100,292,0,292
Jakalya,F,100,39,0,39
Clarixa,F,100,5,0,5
Gwain,M,100,0,5,5
Jabraylen,M,100,0,26,26
Laguisha,F,100,28,0,28
Rickiah,F,100,12,0,12
Jamarius,M,100,0,1577,1577
Stathan,M,100,0,5,5
Jaylis,F,100,17,0,17
Lebrandon,M,100,0,26,26
Candes,F,100,7,0,7
Tashad,M,100,0,16,16
Carolus,M,100,0,10,10
Dinero,M,100,0,112,112
Lateef,M,100,0,848,848
Diani,F,100,141,0,141
Sharima,F,100,28,0,28
Keanen,M,100,0,126,126
Cadin,M,97,16,607,623
Karlisa,F,100,120,0,120
Elanor,F,100,619,0,619
Weldon,M,100,0,4470,4470
Adante,M,100,0,165,165
Dshae,F,100,5,0,5
Clydene,F,100,91,0,91
Gwynetta,F,100,5,0,5
Doy,M,98,5,209,214
Kavone,M,100,0,10,10
Polly,F,100,13690,0,13690
Michaelin,F,100,5,0,5
Jahmiah,F,85,29,5,34
Jusiah,M,100,0,196,196
Faizan,M,100,0,485,485
Megam,F,100,5,0,5
Yanissa,F,100,68,0,68
Damyan,M,100,0,334,334
Sanjna,F,100,140,0,140
Georgiann,F,100,882,0,882
Huxton,M,100,0,42,42
Khalidah,F,100,67,0,67
Chesterfield,M,100,0,5,5
Josselyn,F,100,2606,0,2606
Shemera,F,100,5,0,5
Khamil,F,100,48,0,48
Nahema,F,100,8,0,8
Mandey,F,100,8,0,8
Rolayne,F,100,13,0,13
Tulisa,F,100,5,0,5
Braxtynn,M,69,5,11,16
Lapresha,F,100,11,0,11
Aasir,M,100,0,29,29
Cinda,F,100,3298,0,3298
Shiley,F,100,43,0,43
Jasean,M,100,0,797,797
Shaia,F,100,52,0,52
Shamilla,F,100,11,0,11
Ambika,F,100,327,0,327
Natalieann,F,100,11,0,11
Destinee,F,100,15506,0,15506
Sidak,M,100,0,20,20
Azalie,F,100,82,0,82
Layth,M,100,0,436,436
Yafi,M,100,0,16,16
Jameta,F,100,5,0,5
Raelah,F,100,5,0,5
Angelou,M,100,0,5,5
Griscelda,F,100,5,0,5
Madon,M,100,0,10,10
Viktorya,F,100,89,0,89
Jamecca,F,100,5,0,5
Helayne,F,100,162,0,162
Tairiq,M,100,0,6,6
Artha,F,78,53,15,68
Sloan,F,65,3413,1832,5245
Kuyper,M,100,0,6,6
Alleen,F,100,107,0,107
Jabrill,M,100,0,16,16
Deette,F,100,421,0,421
Larrisha,F,100,104,0,104
Roseana,F,100,82,0,82
Kiani,F,97,973,30,1003
Hulices,M,100,0,24,24
Sevak,M,100,0,37,37
Earnie,M,98,8,500,508
Sentell,M,100,0,33,33
Mystie,F,100,243,0,243
Willson,M,100,0,204,204
Latresa,F,100,549,0,549
Dziyah,F,100,29,0,29
Jakolbe,M,100,0,5,5
Dakhia,F,100,16,0,16
Stormie,F,100,3035,0,3035
Demareo,M,100,0,39,39
Denitta,F,100,5,0,5
Andera,F,98,724,18,742
Chukwuka,M,100,0,59,59
Jaylee,F,98,5467,87,5554
Elenora,F,100,391,0,391
Yasser,M,100,0,672,672
Cindya,F,100,5,0,5
Kiplin,M,100,0,5,5
Shakaira,F,100,25,0,25
Teshima,F,100,12,0,12
Haidi,F,100,46,0,46
Beatriz,F,100,14898,53,14951
Axelle,F,100,87,0,87
Delmarco,M,100,0,10,10
Jaecee,F,100,13,0,13
Myleene,F,100,8,0,8
Ladontae,M,100,0,7,7
Roert,M,100,0,24,24
Jailiyah,F,100,6,0,6
Yolani,F,100,66,0,66
Mandeep,M,61,160,251,411
Kamarcus,M,100,0,6,6
Deantrae,M,100,0,7,7
Gerad,M,100,0,595,595
Klifton,M,100,0,5,5
Ahjanay,F,100,17,0,17
Joshoa,M,100,0,97,97
Kadan,M,98,7,410,417
Kazumi,F,100,11,0,11
Bri,F,100,187,0,187
Cataleia,F,100,16,0,16
Pearlina,F,100,22,0,22
Treyshaun,M,100,0,120,120
Luchia,F,100,5,0,5
Deondray,M,100,0,288,288
Tarynn,F,100,484,0,484
Ivanya,F,100,6,0,6
Yiselle,F,100,119,0,119
Jahnasia,F,100,85,0,85
Ducati,M,100,0,5,5
Arna,F,100,228,0,228
Marshon,M,97,15,506,521
Emilyn,F,100,983,0,983
Valicia,F,100,251,0,251
Aleezah,F,100,11,0,11
Burgess,M,100,0,359,359
Miquella,F,100,5,0,5
Dhana,F,100,105,0,105
Mirari,F,100,42,0,42
Aqeel,M,100,0,149,149
Yairely,F,100,5,0,5
Japji,F,100,34,0,34
Irfan,M,100,0,481,481
Laderius,M,100,0,61,61
Emmette,M,100,0,256,256
Nichcole,F,100,5,0,5
Vihan,M,100,0,201,201
Braeden,M,98,230,12358,12588
Talor,F,74,551,196,747
Zhari,F,100,6,0,6
Dakarion,M,100,0,5,5
Samrat,M,100,0,32,32
Dartagnon,M,100,0,8,8
Penney,F,100,1678,0,1678
Calice,F,100,5,0,5
Florance,F,100,248,0,248
Kallysta,F,100,53,0,53
Yorman,M,100,0,22,22
Samir,M,99,54,6735,6789
Arthella,F,100,23,0,23
Michaelanne,F,100,59,0,59
Kinaya,F,100,73,0,73
Shalethia,F,100,12,0,12
Keelyn,F,78,700,193,893
Nyda,F,100,5,0,5
Manish,M,100,0,512,512
Fotini,F,100,358,0,358
Chico,M,100,0,882,882
Adeli,F,100,51,0,51
Laman,M,100,0,25,25
Tacory,M,100,0,5,5
Jarrah,F,92,54,5,59
Saman,M,69,117,258,375
Julioalberto,M,100,0,5,5
Arul,M,100,0,80,80
Haddy,F,95,105,5,110
Jaquan,M,99,58,9644,9702
Jocqueline,F,100,10,0,10
Lashown,F,100,5,0,5
Briyanna,F,100,698,0,698
Hallei,F,100,15,0,15
Lord,M,100,0,419,419
Trayvond,M,100,0,79,79
Taketa,F,100,43,0,43
Wenson,M,100,0,5,5
Nadara,F,100,5,0,5
Geniel,F,100,5,0,5
Sumya,F,100,30,0,30
Aliyia,F,100,5,0,5
Sahiyah,F,100,5,0,5
Christan,M,51,1366,1403,2769
Lutrica,F,100,10,0,10
Elizha,M,100,0,8,8
Denira,F,100,17,0,17
Akam,M,100,0,5,5
Makeia,F,100,39,0,39
Anzlie,F,100,5,0,5
Dawne,F,100,2238,0,2238
Shauntee,F,100,152,0,152
Ayyoub,M,100,0,13,13
Avieon,M,100,0,11,11
Javen,M,97,100,2790,2890
Jomarcus,M,100,0,6,6
Toshua,F,70,129,55,184
Amberlynn,F,100,1083,0,1083
Roi,M,88,19,143,162
Nisha,F,100,2826,0,2826
Breda,F,100,90,0,90
Symaria,F,100,40,0,40
Rakiyah,F,100,358,0,358
Aneisa,F,100,121,0,121
Piera,F,100,60,0,60
Mykaella,F,100,6,0,6
Brunhilda,F,100,16,0,16
Yousef,M,100,0,3702,3702
Kharmin,F,100,6,0,6
Karilyn,F,100,769,0,769
Cheryle,F,100,3917,0,3917
Calvan,M,100,0,5,5
Raine,F,82,1780,385,2165
Dalli,F,100,31,0,31
Teahna,F,100,5,0,5
Jarden,M,100,0,19,19
Roshaad,M,100,0,5,5
Daisean,M,100,0,164,164
Elhana,F,100,5,0,5
Valon,M,97,5,176,181
Abbegail,F,100,246,0,246
Shyeeda,F,100,6,0,6
Tangi,F,100,338,0,338
Jomarion,M,100,0,97,97
Hipolito,M,100,0,1408,1408
Zerion,M,100,0,23,23
Janese,F,100,1042,0,1042
Jolonda,F,100,81,0,81
Ebert,M,100,0,31,31
Tavalas,M,100,0,5,5
Amritha,F,100,95,0,95
Nikiesha,F,100,67,0,67
Eufemio,M,100,0,39,39
Shannequa,F,100,6,0,6
Oland,M,100,0,16,16
Koya,F,100,71,0,71
Melike,F,100,21,0,21
Jolyn,F,100,1795,0,1795
Loma,F,100,319,0,319
Kemiyah,F,100,269,0,269
Shellyann,F,100,76,0,76
Germany,F,57,231,177,408
Damitra,F,100,40,0,40
Amiyrah,F,100,47,0,47
Aveona,F,100,21,0,21
Asena,F,100,15,0,15
Arshon,M,100,0,5,5
Janyra,F,100,94,0,94
Kiambu,M,100,0,5,5
Akshata,F,100,23,0,23
Samori,M,100,0,31,31
Karese,F,100,5,0,5
Derec,M,100,0,104,104
Keymia,F,100,8,0,8
Stoney,M,99,27,2546,2573
Sacoria,F,100,19,0,19
Vatche,M,100,0,25,25
Vishal,M,100,0,1676,1676
Patrizia,F,100,385,0,385
Teshayla,F,100,5,0,5
Hasaan,M,100,0,495,495
Srihita,F,100,21,0,21
Carlyse,F,100,6,0,6
Jelyssa,F,100,21,0,21
Chesni,F,100,49,0,49
Sanaaya,F,100,13,0,13
Rhaya,F,100,70,0,70
Tommisha,F,100,5,0,5
Nysean,M,100,0,23,23
Alyea,F,100,24,0,24
Colley,M,100,0,18,18
Hiba,F,100,1387,0,1387
Jasine,F,100,5,0,5
Trenesha,F,100,59,0,59
Yacquelin,F,100,12,0,12
Galisa,F,100,18,0,18
Kimberlee,F,100,17274,0,17274
Rosary,F,100,249,0,249
Edir,M,100,0,5,5
Kaysan,M,100,0,132,132
Kalis,F,98,196,5,201
Kasan,M,100,0,38,38
Kanyen,M,81,5,21,26
Lasonia,F,100,450,0,450
Quashawn,M,99,5,649,654
Calon,M,100,0,57,57
Kilea,F,100,79,0,79
Jacole,F,96,127,5,132
Areiona,F,100,11,0,11
Yazel,F,100,10,0,10
Sereda,F,100,6,0,6
Tequoia,F,100,11,0,11
Anette,F,100,2321,0,2321
Jaylese,F,100,10,0,10
Macenna,F,100,6,0,6
Elishea,F,100,10,0,10
Kendrel,M,100,0,5,5
Wilfrido,M,100,0,347,347
Azzaria,F,100,35,0,35
Lynsay,F,100,307,0,307
Vernard,M,100,0,1058,1058
Shanbria,F,100,10,0,10
Sadir,M,100,0,5,5
Dupree,M,100,0,655,655
Jazzilyn,F,100,30,0,30
Samontha,F,100,5,0,5
Consuella,F,100,591,0,591
Marilisa,F,100,50,0,50
Safal,M,100,0,29,29
Kashondra,F,100,7,0,7
Cheyla,F,100,318,0,318
Annese,F,100,5,0,5
Achante,F,100,35,0,35
Brunilda,F,100,974,0,974
Anays,F,100,86,0,86
Suede,M,100,0,68,68
Fahd,M,100,0,208,208
Yuisa,F,100,11,0,11
Pavlina,F,100,5,0,5
Savaughn,M,96,5,132,137
Myar,F,100,31,0,31
Taneia,F,100,126,0,126
Izabele,F,100,7,0,7
Azell,M,100,0,70,70
Medardo,M,100,0,268,268
Sushmita,F,100,19,0,19
Finch,M,100,0,37,37
Loressa,F,100,18,0,18
Nicaya,F,100,5,0,5
Keiaja,F,100,5,0,5
Tamee,F,100,127,0,127
Osbert,M,100,0,11,11
Dalet,F,100,7,0,7
Creon,M,100,0,10,10
Rayaan,M,86,73,436,509
Seferino,M,100,0,673,673
Dera,F,100,186,0,186
Kovi,M,100,0,5,5
Adriella,F,100,64,0,64
Chato,M,100,0,27,27
Tybresha,F,100,6,0,6
Kichelle,F,100,5,0,5
Vernika,F,100,18,0,18
Gabriell,F,79,1263,343,1606
Hiroko,F,100,75,0,75
Kazmira,F,100,26,0,26
Othniel,M,100,0,262,262
Reginae,F,100,568,0,568
Areion,F,100,31,0,31
Tayvonne,M,100,0,5,5
Ninon,F,100,16,0,16
Loammi,F,100,6,0,6
Aatish,M,100,0,16,16
Janaye,F,100,895,0,895
Ashlae,F,100,5,0,5
Barbette,F,100,303,0,303
Caliegh,F,100,85,0,85
Jashanpreet,M,100,0,5,5
Sierre,F,100,36,0,36
Mareco,M,100,0,8,8
Averick,M,100,0,5,5
Minga,F,100,5,0,5
Nathena,F,100,16,0,16
Yolanda,F,99,94203,490,94693
Zowii,F,100,6,0,6
Hennessey,F,100,259,0,259
Olyvia,F,100,1969,0,1969
Shenay,F,100,162,0,162
Keith,M,100,1848,378076,379924
Drago,M,100,0,42,42
Yuika,F,100,13,0,13
Creedon,M,100,0,46,46
Mackenzee,F,100,719,0,719
Ridhaan,M,100,0,52,52
Kywan,M,100,0,31,31
Elvenia,F,100,17,0,17
Juanantonio,M,100,0,391,391
Brandyn,M,92,414,4503,4917
Azurie,F,100,5,0,5
Jaxie,F,100,56,0,56
Rebeca,F,100,11455,5,11460
Cassius,M,100,0,3674,3674
Romil,M,100,0,23,23
Tatsuya,M,100,0,104,104
Ashunti,F,100,296,0,296
Michaelpaul,M,100,0,115,115
Charlyann,F,100,6,0,6
Juriah,M,100,0,11,11
Shayle,F,100,159,0,159
Raunak,M,100,0,124,124
Nevena,F,100,47,0,47
Jyia,F,100,5,0,5
Miarah,F,100,5,0,5
Scot,M,100,11,13512,13523
Bennye,F,100,11,0,11
Tracyn,M,100,0,24,24
Recco,M,100,0,50,50
Jessabella,F,100,28,0,28
Wauneta,F,100,5,0,5
Sharica,F,100,249,0,249
Jorddy,M,100,0,16,16
Moreno,M,100,0,11,11
Terra,F,100,14417,5,14422
Jenara,F,100,16,0,16
Brucelee,M,100,0,5,5
Jyniah,F,100,12,0,12
Chukwuebuka,M,100,0,98,98
Jarette,M,100,0,35,35
Alvontae,M,100,0,5,5
Shakelia,F,100,218,0,218
Gypsy,F,100,844,0,844
Starkesha,F,100,35,0,35
Erikka,F,100,981,0,981
Tyquesha,F,100,42,0,42
Deniella,F,100,5,0,5
Warnell,M,94,6,89,95
Musa,M,100,0,2113,2113
Konnie,F,100,888,0,888
Laneika,F,100,11,0,11
Harvin,M,92,7,84,91
Raza,M,100,0,273,273
Izola,F,100,96,0,96
Aalon,M,100,0,5,5
Kajah,F,100,81,0,81
Synetta,F,100,48,0,48
Sharnea,F,100,12,0,12
Norelia,F,100,5,0,5
Zakhi,M,100,0,188,188
Izabella,F,100,20566,0,20566
Ronja,F,100,16,0,16
Stephaun,M,100,0,132,132
Delbert,M,100,23,13927,13950
Deajia,F,100,24,0,24
Artasia,F,100,199,0,199
Khaylie,F,100,5,0,5
Myalynn,F,100,84,0,84
Lillyahna,F,100,54,0,54
Shereda,F,100,67,0,67
Laron,M,98,119,4697,4816
Kupono,M,100,0,62,62
Rosebud,F,100,23,0,23
Shanquita,F,100,105,0,105
Yazzmine,F,100,18,0,18
Gordy,M,100,0,248,248
Diadra,F,100,6,0,6
Jeselle,F,100,159,0,159
Lyberty,F,100,26,0,26
Stirling,M,92,41,491,532
Roseellen,F,100,5,0,5
Batool,F,100,252,0,252
Breiah,F,100,7,0,7
Mackenzye,F,100,126,0,126
Iveth,F,100,561,0,561
Ethon,M,100,0,262,262
Neko,M,79,169,633,802
Ammanda,F,100,106,0,106
Kiaeem,M,100,0,25,25
Saki,F,96,269,11,280
Jacine,F,100,5,0,5
Billyjo,F,56,44,34,78
Danika,F,100,9133,0,9133
Leslee,F,98,4299,96,4395
Makinzi,F,100,168,0,168
Anavae,F,100,12,0,12
Bayla,F,100,608,0,608
Keile,F,100,10,0,10
Macilynn,F,100,33,0,33
Nakie,M,64,8,14,22
Yang,M,84,47,256,303
Amrin,F,100,10,0,10
Mufasa,M,100,0,7,7
Sabion,M,100,0,15,15
Yukia,F,100,17,0,17
Matasha,F,100,229,0,229
Blayton,M,100,0,235,235
Avid,M,100,0,227,227
Taunda,F,100,6,0,6
Gelson,M,100,0,7,7
Calisi,F,100,32,0,32
Trecia,F,100,606,0,606
Kyrillos,M,100,0,163,163
Hastin,M,100,0,48,48
Angely,F,100,1742,0,1742
Kaycie,F,100,2016,0,2016
Abdelkareem,M,100,0,10,10
Takeria,F,100,312,0,312
Candela,F,100,60,0,60
Jerriann,F,100,96,0,96
Marieanne,F,100,76,0,76
Kilia,F,100,34,0,34
Lakenya,F,100,1664,0,1664
Maridith,F,100,19,0,19
Jeannell,F,100,5,0,5
Ilse,F,100,1788,0,1788
Nikeea,F,100,5,0,5
Jacarr,M,100,0,5,5
Corron,M,100,0,33,33
Marguerita,F,100,632,0,632
Lameir,M,100,0,5,5
Johansel,M,100,0,19,19
Ravaughn,M,100,0,29,29
Dartisha,F,100,5,0,5
Osahon,M,100,0,10,10
Ndeye,F,100,370,0,370
Ayeshia,F,100,114,0,114
Jenique,F,100,60,0,60
Reydan,M,100,0,7,7
Shams,F,62,70,42,112
Veralyn,F,100,33,0,33
Luvern,F,69,11,5,16
Lakyndra,F,100,5,0,5
Nazyiah,F,100,41,0,41
Jkira,F,100,7,0,7
Buell,M,100,0,83,83
Melesha,F,100,18,0,18
Jamarieon,M,100,0,16,16
Nicolyn,F,100,5,0,5
Carrye,F,100,23,0,23
Anacarina,F,100,6,0,6
Chisum,M,100,0,67,67
Dazha,F,100,115,0,115
Turk,M,100,0,39,39
Yoandry,M,100,0,23,23
Saveon,M,100,0,194,194
Janete,F,100,75,0,75
Tayja,F,100,163,0,163
Niome,F,100,42,0,42
Vernise,F,100,10,0,10
Iva,F,98,4896,76,4972
Jacquilynn,F,100,19,0,19
Skyla,F,100,9302,0,9302
Kibwe,M,100,0,19,19
Lakida,F,100,22,0,22
Vonzell,M,100,0,167,167
Bethena,F,100,27,0,27
Jayshun,M,100,0,94,94
Tanaisa,F,100,26,0,26
Diondre,M,100,0,1286,1286
Shikia,F,100,42,0,42
Nio,M,100,0,13,13
Gioconda,F,100,5,0,5
Ramie,F,73,630,231,861
Johnwesley,M,100,0,61,61
Kaelana,F,100,16,0,16
Kalan,M,82,237,1050,1287
Arnon,M,100,0,5,5
Rika,F,100,507,0,507
Virgina,F,100,809,0,809
Delorenzo,M,100,0,7,7
Magin,F,93,69,5,74
Sumaia,F,100,17,0,17
Briellah,F,100,43,0,43
Nyomie,F,100,127,0,127
Ranjana,F,100,5,0,5
Olly,M,100,0,5,5
Chaylee,F,100,172,0,172
Paydin,M,100,0,6,6
Devanne,F,100,30,0,30
Linford,M,100,0,307,307
Suresh,M,100,0,140,140
Talal,M,100,0,513,513
Rhodes,M,98,7,297,304
Makenzye,F,100,169,0,169
Almondo,M,100,0,5,5
Madiba,M,100,0,5,5
Ladaniel,M,100,0,32,32
Racquelle,F,100,114,0,114
Viviette,F,100,5,0,5
Styler,M,100,0,5,5
Bar,F,59,17,12,29
Saladine,M,100,0,5,5
Jerion,M,100,0,29,29
Zahyir,M,100,0,16,16
Kema,F,100,185,0,185
Daxten,M,100,0,120,120
Keeley,F,99,5623,49,5672
Chaysen,M,100,0,72,72
Janeva,F,100,249,0,249
Tristann,F,100,5,0,5
Ettalyn,F,100,5,0,5
Lucritia,F,100,15,0,15
Kingdavid,M,100,0,87,87
Idahlia,F,100,6,0,6
Germaine,F,55,2797,2270,5067
Maxymilian,M,100,0,26,26
Kendayl,F,100,5,0,5
Armone,M,84,10,53,63
Adikus,M,100,0,5,5
Cromwell,M,100,0,5,5
Marrell,M,100,0,106,106
Anson,M,100,5,4719,4724
Kameyah,F,100,11,0,11
Lashanna,F,100,806,0,806
Tevarus,M,100,0,5,5
Buzz,M,100,0,204,204
Nelly,F,99,5515,38,5553
Tameisha,F,100,391,0,391
Eris,F,75,925,308,1233
Labritney,F,100,5,0,5
Berenize,F,100,99,0,99
Shamica,F,100,606,0,606
Shanqua,F,100,5,0,5
Albertina,F,100,606,0,606
Amod,M,100,0,26,26
Kiean,M,100,0,5,5
Daivid,M,100,0,5,5
Altavious,M,100,0,10,10
Lorraina,F,100,305,0,305
Afi,F,100,52,0,52
Michaeljoseph,M,100,0,96,96
Kattia,F,100,67,0,67
Jendaya,F,100,74,0,74
Catelynn,F,100,746,0,746
Soledad,F,100,2711,5,2716
Trenard,M,100,0,39,39
Evannah,F,100,5,0,5
Atlee,M,79,173,637,810
Kandus,F,100,27,0,27
Leemarie,F,100,5,0,5
Trajon,M,100,0,71,71
Alhassan,M,100,0,133,133
Chayanna,F,100,11,0,11
Makayda,F,100,11,0,11
Camira,F,100,130,0,130
Briyon,M,100,0,23,23
Zaniylah,F,100,20,0,20
Kayliah,F,100,139,0,139
Teagin,F,63,26,15,41
Carbon,M,100,0,25,25
Zeev,M,100,0,55,55
Jadyel,M,100,0,21,21
Johngabriel,M,100,0,48,48
Jaronda,F,100,16,0,16
Ballarie,F,100,5,0,5
Jesska,F,100,23,0,23
Maicie,F,100,89,0,89
Dreu,M,100,0,13,13
Raymiah,F,100,5,0,5
Rhyana,F,100,50,0,50
Javarrion,M,100,0,12,12
Kruti,F,100,109,0,109
Ryhan,M,100,0,17,17
Harlean,F,100,5,0,5
Avrohom,M,100,0,2406,2406
Lenoria,F,100,75,0,75
Debe,F,100,122,0,122
Tamaro,F,100,5,0,5
Zebediah,M,100,0,446,446
Loris,F,87,525,76,601
Gricelda,F,100,1534,0,1534
Rasheeda,F,99,1687,10,1697
Michale,M,90,327,3076,3403
Helam,M,100,0,5,5
Nashaya,F,100,56,0,56
Kanisha,F,100,2559,0,2559
Loring,M,95,22,422,444
Bellami,F,100,12,0,12
Nasiir,M,100,0,51,51
Gabrielangelo,M,100,0,5,5
Mackensy,F,100,5,0,5
Starleana,F,100,11,0,11
Kothan,M,100,0,6,6
Webster,M,100,0,1452,1452
Davika,F,100,8,0,8
Neomia,F,100,107,0,107
Tiquan,M,100,0,287,287
Savvas,M,100,0,60,60
Porfirio,M,100,0,2134,2134
Johnathan,M,100,349,89049,89398
Madona,F,100,10,0,10
Chrystalyn,F,100,5,0,5
Alvia,F,68,106,51,157
Montell,M,100,0,776,776
Kjersti,F,100,249,0,249
Chevon,F,90,555,63,618
Brandalyn,F,100,569,0,569
Ciree,M,100,0,5,5
Denico,M,100,0,39,39
Tanaiyah,F,100,22,0,22
Aladino,M,100,0,26,26
Phoebe,F,100,21039,5,21044
Simote,M,100,0,5,5
Nadra,F,100,234,0,234
Ritisha,F,100,56,0,56
Gwynn,F,96,670,31,701
Cordario,M,100,0,41,41
Manushri,F,100,6,0,6
Timitra,F,100,23,0,23
Amierah,F,100,26,0,26
Musfirah,F,100,6,0,6
Noriana,F,100,12,0,12
Jamilyn,F,100,636,0,636
Ladavid,M,100,0,5,5
Phonesavanh,F,100,5,0,5
Joselinne,F,100,77,0,77
Abagail,F,100,5368,0,5368
Aleydis,F,100,49,0,49
Gomer,M,100,0,24,24
Dajanique,F,100,204,0,204
Rundy,M,100,0,5,5
Ezaria,F,100,32,0,32
Caylie,F,100,1406,0,1406
Sherene,F,100,724,0,724
Dineshia,F,100,10,0,10
Grier,F,63,230,136,366
Donalynn,F,100,5,0,5
Bekett,M,100,0,5,5
Carmilita,F,100,33,0,33
Madajah,F,100,19,0,19
Daune,F,75,148,50,198
Avivah,F,100,5,0,5
Keishawna,F,100,81,0,81
Leeah,F,100,1022,0,1022
Jaileah,F,100,18,0,18
Sajjad,M,100,0,104,104
Davindra,M,100,0,5,5
Emmi,F,100,1123,0,1123
Cerrissa,F,100,10,0,10
Vue,M,100,0,109,109
Soha,F,100,548,0,548
Jashanna,F,100,11,0,11
Shanigua,F,100,59,0,59
Lytina,F,100,5,0,5
Kadynn,F,82,58,13,71
Keyonne,M,100,0,27,27
Wakeisha,F,100,15,0,15
Kreyton,M,100,0,10,10
Kurstie,F,100,45,0,45
Edoardo,M,100,0,174,174
Neylah,F,100,5,0,5
Shamelle,F,100,23,0,23
Felicite,F,100,101,0,101
Cya,F,100,5,0,5
Jonathandavid,M,100,0,55,55
Zarrea,F,100,14,0,14
Bridney,F,100,182,0,182
Nalda,F,100,6,0,6
Alira,F,100,60,0,60
Gwilym,M,100,0,5,5
Elisjah,M,100,0,5,5
Raynel,M,87,5,34,39
Phinneas,M,100,0,90,90
Lakim,M,100,0,41,41
Adreon,M,100,0,29,29
Himmat,M,100,0,21,21
Rasheena,F,100,358,0,358
Lashala,F,100,56,0,56
Grey,M,87,365,2542,2907
Diyari,M,100,0,64,64
Adraine,F,98,222,5,227
Jynessa,F,100,25,0,25
Luanna,F,100,1102,0,1102
Adre,M,100,0,6,6
Ni,F,100,22,0,22
Peirce,M,100,0,89,89
San,F,74,1513,530,2043
Antanique,F,100,35,0,35
Rmontay,M,100,0,9,9
Kaylise,F,100,40,0,40
Lavontre,M,100,0,15,15
Tenesia,F,100,169,0,169
Alishaba,F,100,5,0,5
Clearance,M,100,0,99,99
Clintona,F,100,30,0,30
Valery,F,99,5359,64,5423
Kanetra,F,100,89,0,89
Klarke,F,100,14,0,14
Rayvaughn,M,100,0,35,35
Halynn,F,100,105,0,105
Mariem,F,100,142,0,142
Detwan,M,100,0,26,26
Khalon,M,100,0,154,154
Roanld,M,100,0,20,20
Allanmichael,M,100,0,22,22
Nickson,M,100,0,170,170
Daleyah,F,100,14,0,14
Ticara,F,100,56,0,56
Saharsh,M,100,0,222,222
Raiden,M,97,136,4220,4356
Danicka,F,100,164,0,164
Chevonne,F,100,602,0,602
Dalynn,F,89,365,44,409
Shaqueil,M,100,0,7,7
Contance,F,100,12,0,12
Luispablo,M,100,0,6,6
Marz,M,100,0,17,17
Cathey,F,100,1800,0,1800
Eziquio,M,100,0,5,5
Samandar,M,100,0,5,5
Ahkai,M,100,0,6,6
Edwyna,F,100,17,0,17
Shakir,M,99,10,1020,1030
Zanayah,F,100,163,0,163
Carterjames,M,100,0,5,5
Airyana,F,100,193,0,193
Ediz,M,100,0,7,7
Rhondia,F,100,32,0,32
Brea,F,100,4867,0,4867
Medelyn,F,100,15,0,15
Alieshia,F,100,5,0,5
Jehonadab,M,100,0,7,7
Cassey,F,91,1656,155,1811
Antar,M,100,0,208,208
Laisa,F,100,219,0,219
Anaisha,F,100,184,0,184
Aadian,M,100,0,5,5
Leshia,F,100,517,0,517
Jalique,M,100,0,31,31
Leelani,F,100,5,0,5
Behtzy,F,100,7,0,7
Jonahtan,M,100,0,188,188
Taela,F,100,120,0,120
Khalijah,M,100,0,6,6
Traice,F,72,13,5,18
Vidalia,F,100,129,0,129
Rafiel,M,100,0,81,81
Earnest,M,99,251,18592,18843
Anntionette,F,100,93,0,93
Aubery,M,72,63,162,225
Laurisa,F,100,310,0,310
Fayla,F,100,10,0,10
Tyndale,M,100,0,5,5
Tinika,F,100,564,0,564
Shaqura,F,100,11,0,11
Razi,M,100,0,85,85
Johnn,M,100,0,303,303
Jaxs,M,100,0,11,11
Jaymin,M,100,0,472,472
Allyra,F,100,7,0,7
Mana,F,91,457,47,504
Falak,F,100,40,0,40
Sundus,F,100,394,0,394
Kathlean,F,100,132,0,132
Treygan,M,100,0,26,26
Kubra,F,100,10,0,10
Annslee,F,100,282,0,282
Deklan,M,100,0,996,996
Caytlyn,F,100,157,0,157
Dysheka,F,100,6,0,6
Sreenidhi,F,100,71,0,71
Averion,M,100,0,11,11
Areyah,F,100,13,0,13
Zahcary,M,100,0,5,5
Santana,F,55,4606,3739,8345
Ertha,F,100,41,0,41
Rick,M,100,130,74880,75010
Vedette,F,100,5,0,5
Jakelynn,F,100,5,0,5
Trava,F,100,5,0,5
Track,M,100,0,8,8
Lakeycha,F,100,5,0,5
Corde,M,99,5,546,551
Shareda,F,100,42,0,42
Tobechi,M,100,0,13,13
Liliano,F,100,5,0,5
Geovany,M,100,0,1404,1404
Ellissia,F,100,10,0,10
Lazaya,F,100,27,0,27
Khason,M,100,0,7,7
Christina,F,100,451746,1975,453721
Carinne,F,100,211,0,211
Bryxton,M,100,0,6,6
Quannell,M,100,0,5,5
Shanthi,F,100,44,0,44
Khusbu,F,100,37,0,37
Kehila,F,100,7,0,7
Jahlaya,F,100,34,0,34
Thuytrang,F,100,24,0,24
Mckaylynn,F,100,6,0,6
Jacelle,F,100,38,0,38
Makua,M,100,0,9,9
Jermir,M,100,0,10,10
Katricia,F,100,313,0,313
Deshandra,F,100,16,0,16
Jeanluc,M,100,0,804,804
Calaya,F,100,97,0,97
Lacynda,F,100,10,0,10
Leyland,M,100,0,152,152
Billee,F,100,213,0,213
Makahi,M,100,0,48,48
Shenille,F,100,7,0,7
Silje,F,100,27,0,27
Bengamin,M,100,0,23,23
Daronta,M,100,0,5,5
Thurston,M,100,0,1594,1594
Little,M,86,144,879,1023
Tremond,M,100,0,87,87
Lylian,F,100,267,0,267
Isobel,F,100,1528,0,1528
Jacqulynn,F,100,321,0,321
Janely,F,100,1555,0,1555
Russell,M,100,910,209955,210865
Jahniel,M,100,0,7,7
Nalu,M,100,0,66,66
Telissa,F,100,118,0,118
Iddo,M,100,0,11,11
Taka,F,100,46,0,46
Xi,F,100,6,0,6
Nubaid,M,100,0,23,23
Dawn,F,100,274350,925,275275
Bentely,M,100,0,6,6
Desha,F,99,812,5,817
Spiritual,F,100,28,0,28
Khurram,M,100,0,40,40
Rashell,F,100,1170,0,1170
Iran,M,74,408,1184,1592
Marreco,M,100,0,5,5
Ronee,F,100,379,0,379
Zmiyah,F,100,10,0,10
Kymberlie,F,100,185,0,185
Denilzon,M,100,0,5,5
Mayella,F,100,20,0,20
Tayari,M,85,13,72,85
Layloni,F,100,144,0,144
Jarel,M,99,6,1017,1023
Kiniya,F,100,11,0,11
Gaoussou,M,100,0,5,5
Alonza,M,100,6,1598,1604
Jaydien,M,100,0,150,150
Jeydi,F,100,86,0,86
Emalee,F,100,3243,0,3243
Zykiria,F,100,88,0,88
Keonna,F,100,1731,0,1731
Lurdes,F,100,422,0,422
Quayshun,M,100,0,14,14
Maybelle,F,100,393,0,393
Vanessamarie,F,100,40,0,40
Tajveer,M,100,0,5,5
Anyanka,F,100,16,0,16
Kathlee,F,100,93,0,93
Nichalous,M,100,0,52,52
Abshir,M,100,0,48,48
Eniylah,F,100,5,0,5
Robbi,F,83,1514,312,1826
Aashana,F,100,5,0,5
Sabiya,F,100,5,0,5
Wasyl,M,100,0,38,38
Clement,M,100,0,3992,3992
Yalixa,F,100,27,0,27
Durell,M,100,0,1347,1347
Gerron,M,100,0,289,289
Kenyah,F,100,340,0,340
Alexandira,F,100,5,0,5
Lamona,F,100,241,0,241
Loni,F,97,3518,108,3626
Mikenzie,F,100,819,0,819
Corienne,F,100,5,0,5
Anderea,F,100,5,0,5
Rosi,F,100,344,0,344
Rhetta,F,100,279,0,279
Apria,F,100,16,0,16
Marena,F,100,1103,0,1103
Larisha,F,100,385,0,385
Lidiya,F,100,93,0,93
Malieka,F,100,21,0,21
Lenz,M,100,0,5,5
Jomayra,F,100,75,0,75
Darleane,F,100,15,0,15
Herson,M,100,0,446,446
Portlyn,F,100,5,0,5
Syere,M,100,0,5,5
Celiyah,F,100,12,0,12
Adran,M,100,0,31,31
Martinique,F,100,460,0,460
Kiaran,M,100,0,6,6
Therea,F,100,11,0,11
Syntia,F,100,10,0,10
Torray,M,100,0,15,15
Zakaria,M,82,351,1631,1982
Kelena,F,100,50,0,50
Iraima,F,100,30,0,30
Brieanna,F,100,3117,0,3117
Nyha,F,100,32,0,32
Dominiqua,F,100,80,0,80
Axten,M,100,0,31,31
Sariah,F,100,6288,0,6288
Damyron,M,100,0,5,5
Sevena,F,100,5,0,5
Basheba,F,100,24,0,24
Irania,F,100,208,0,208
Janye,F,100,57,0,57
Dhyani,F,100,20,0,20
Betha,F,100,48,0,48
Brandtly,M,100,0,15,15
Audrianna,F,100,3735,0,3735
Eillie,F,100,5,0,5
Rhunette,F,100,25,0,25
Hira,F,100,487,0,487
Wolfram,M,100,0,15,15
Moyses,M,100,0,116,116
Briania,F,100,33,0,33
Kyzier,M,100,0,6,6
Hayley,F,100,47088,46,47134
Chol,M,100,0,17,17
Hayaa,F,100,5,0,5
Darail,M,100,0,14,14
Josje,M,100,0,6,6
Montsho,M,100,0,6,6
Kimberley,F,99,37545,228,37773
Neema,F,61,404,256,660
Leica,F,100,14,0,14
Latrel,M,100,0,92,92
Saniyha,F,100,30,0,30
Javianna,F,100,17,0,17
Saberina,F,100,11,0,11
Escher,M,100,0,149,149
Yocheved,F,100,1630,0,1630
Keonne,M,100,0,22,22
Devora,F,100,1976,0,1976
Rivkah,F,100,869,0,869
Litcy,F,100,6,0,6
Aylamae,F,100,5,0,5
Veloria,F,100,6,0,6
Hermione,F,100,725,0,725
Kahlid,M,100,0,26,26
Sandon,M,100,0,225,225
Cristoffer,M,100,0,5,5
Taneil,F,100,133,0,133
Nahun,M,100,0,85,85
Biana,F,100,210,0,210
Ardath,F,100,78,0,78
Myiona,F,100,6,0,6
Lacasha,F,100,5,0,5
Aahana,F,100,377,0,377
Jaimen,M,100,0,177,177
Shunell,F,100,5,0,5
Theresita,F,100,21,0,21
Tinita,F,100,99,0,99
Ambry,F,100,113,0,113
Cruize,M,100,0,25,25
Towan,M,100,0,27,27
Eadon,M,100,0,6,6
Deveon,M,100,0,609,609
Rahf,F,100,8,0,8
Jeraldo,M,100,0,58,58
Lorryn,F,100,45,0,45
Demoris,M,100,0,5,5
Zanoviah,F,100,6,0,6
Velora,F,100,43,0,43
Bryton,M,94,163,2500,2663
Maxon,M,100,0,607,607
Murron,F,100,5,0,5
Dodge,M,100,0,445,445
Abdulhakeem,M,100,0,30,30
Luv,F,66,64,33,97
Reeda,F,100,161,0,161
Ivonne,F,100,5711,14,5725
Allyson,F,100,48193,21,48214
Jakare,M,100,0,10,10
September,F,100,1909,0,1909
Joelan,M,100,0,5,5
Tamere,M,100,0,11,11
Charrie,F,100,60,0,60
Brentan,M,100,0,36,36
Nidhish,M,100,0,6,6
Rochele,F,100,512,0,512
Aveana,F,100,5,0,5
Guru,M,100,0,5,5
Ferna,F,100,7,0,7
Lindia,F,100,289,0,289
Adriane,F,96,5912,274,6186
Shael,M,100,0,18,18
Yasiin,M,100,0,11,11
Liseth,F,100,679,0,679
Warda,F,100,119,0,119
Mehjabeen,F,100,13,0,13
Lananh,F,100,29,0,29
Jr,M,100,0,1054,1054
Kenyiah,F,100,6,0,6
Tykiesha,F,100,5,0,5
Rashina,F,100,15,0,15
Sonnya,F,100,16,0,16
Xzavier,M,100,0,6076,6076
Uzma,F,100,150,0,150
Arcadian,M,100,0,5,5
Waverly,F,60,1253,827,2080
Arend,M,100,0,125,125
Dartanyon,M,100,0,98,98
Giovonna,F,100,21,0,21
Aaraon,M,100,0,5,5
Gaddiel,M,100,0,139,139
Jakilah,F,100,17,0,17
Tashiana,F,100,479,0,479
Geroge,M,100,0,652,652
Conisha,F,100,47,0,47
Corletta,F,100,14,0,14
Camrie,F,100,370,0,370
Darric,M,100,0,100,100
Cletis,M,100,0,568,568
Beaulah,F,100,105,0,105
Jarmarcus,M,100,0,166,166
Jhari,M,100,0,20,20
Deyssi,F,100,7,0,7
Deeandra,F,100,72,0,72
Wyndsor,F,100,6,0,6
Cassadi,F,100,108,0,108
Shamae,F,100,12,0,12
Thorian,M,100,0,10,10
Breyanne,F,100,17,0,17
Dallyn,M,91,18,186,204
Erric,M,100,0,336,336
Jevonne,F,100,26,0,26
Audwin,M,100,0,351,351
Auriah,F,100,23,0,23
Marcilene,F,100,5,0,5
Shyrle,F,100,6,0,6
Payam,M,100,0,193,193
Tamron,M,78,5,18,23
Nalyn,F,100,5,0,5
Shaday,F,100,350,0,350
Kennika,F,100,5,0,5
Waunita,F,100,90,0,90
Carriann,F,100,105,0,105
Cammie,F,100,3111,12,3123
Flower,F,100,74,0,74
Adasia,F,100,229,0,229
Hiilei,F,100,63,0,63
Zurri,F,100,24,0,24
Ramero,M,100,0,22,22
Mars,M,100,0,228,228
Yale,M,100,0,731,731
Kell,M,100,0,207,207
Kerea,F,100,6,0,6
Danal,M,100,0,10,10
Zahria,F,100,791,0,791
Amarachi,F,100,397,0,397
Pericles,M,100,0,46,46
Khaleil,M,100,0,15,15
Emile,M,86,456,2829,3285
Madrid,F,71,12,5,17
Gevon,M,100,0,101,101
Thienkim,F,100,38,0,38
Arissa,F,100,2064,0,2064
Yvett,F,100,333,0,333
Umberto,M,100,0,534,534
Mckaylia,F,100,6,0,6
Judeth,F,100,107,0,107
Dajia,F,100,432,0,432
Sakib,M,100,0,65,65
Reisa,F,100,60,0,60
Senida,F,100,5,0,5
Brendon,M,100,22,18997,19019
Vontrice,F,100,35,0,35
Jakyrian,M,100,0,6,6
Shanteria,F,100,703,0,703
Jeremya,M,73,7,19,26
Herndon,M,100,0,14,14
Jadrien,M,98,5,320,325
Mickenzie,F,93,589,44,633
Karylle,F,100,8,0,8
Inez,F,96,8534,331,8865
Rosaria,F,100,1062,0,1062
Iralyn,F,100,11,0,11
Mirsab,M,100,0,5,5
Antonitte,F,100,16,0,16
Sukina,F,100,10,0,10
Ange,F,98,278,5,283
Alixandra,F,100,954,0,954
Sharniqua,F,100,12,0,12
Zori,F,100,290,0,290
Malakyi,M,100,0,13,13
Demyra,F,100,23,0,23
Simuel,M,100,0,156,156
Kennyth,M,100,0,21,21
Jermiane,M,100,0,13,13
Sequina,F,100,5,0,5
Apollonia,F,100,457,0,457
Chayla,F,100,905,0,905
Dameisha,F,100,88,0,88
Keimora,F,100,99,0,99
Leonor,F,100,3079,5,3084
Umber,F,100,5,0,5
Nyima,F,100,184,0,184
Julann,F,100,144,0,144
Anisha,F,100,4003,0,4003
Vihaanreddy,M,100,0,6,6
Marion,F,57,25462,18942,44404
Myazia,F,100,18,0,18
Trinisha,F,100,84,0,84
Jamerion,M,100,0,117,117
Chanteal,F,100,44,0,44
Gayane,F,100,57,0,57
Onyinyechukwu,F,100,11,0,11
Lynward,M,100,0,17,17
Roslyn,F,100,9405,0,9405
Marsela,F,100,248,0,248
Cosha,F,100,6,0,6
Yema,F,100,5,0,5
Keir,M,93,64,904,968
Izreal,M,100,0,190,190
Jyana,F,100,53,0,53
Malisa,F,100,2294,0,2294
Salaam,M,100,0,65,65
Sherea,F,100,231,0,231
Jawan,M,99,12,1367,1379
Dequavion,M,100,0,130,130
Cathlean,F,100,5,0,5
Princejohn,M,100,0,6,6
Benelli,F,100,37,0,37
Kaleia,F,100,412,0,412
Evangely,F,100,5,0,5
Faithmarie,F,100,39,0,39
Gabrylle,F,100,5,0,5
Draiven,M,100,0,16,16
Jinna,F,100,163,0,163
Cyndee,F,100,696,0,696
Toyota,F,100,6,0,6
Saraphina,F,100,89,0,89
Kurtus,M,100,0,29,29
Nataliah,F,100,245,0,245
Mykah,F,61,915,579,1494
Michiel,M,99,5,860,865
Takobe,M,100,0,6,6
Arsene,M,100,0,5,5
Haynes,M,100,0,142,142
Arial,F,100,1075,0,1075
Decarlo,M,100,0,614,614
Penina,F,100,727,0,727
Keidrick,M,100,0,126,126
Chariya,F,100,32,0,32
Markavius,M,100,0,10,10
Tascha,F,100,205,0,205
Ilana,F,100,4730,0,4730
Adrean,M,63,405,701,1106
Alaisa,F,100,91,0,91
Graci,F,100,1303,0,1303
Anavela,F,100,5,0,5
Jackilyn,F,100,306,0,306
Deseria,F,100,5,0,5
Lenix,M,72,23,58,81
Kalli,F,100,4536,0,4536
Theresamarie,F,100,17,0,17
Lija,F,100,11,0,11
Hosanna,F,100,873,0,873
Lynnleigh,F,100,61,0,61
Bishara,M,100,0,28,28
Tannika,F,100,21,0,21
Qing,F,100,5,0,5
Faylyn,F,100,10,0,10
Jenaiah,F,100,5,0,5
Taziah,F,100,57,0,57
Gessica,F,100,200,0,200
Latresha,F,100,464,0,464
Chadi,M,100,0,43,43
Cullyn,M,100,0,11,11
Odes,M,100,0,16,16
Haben,M,78,10,36,46
Solace,F,68,90,43,133
Sandino,M,100,0,5,5
Ceinna,F,100,5,0,5
Alper,M,100,0,48,48
Nashaly,F,100,343,0,343
Merridith,F,100,59,0,59
Kutter,M,100,0,355,355
Jerard,M,100,0,945,945
Jakolbi,M,100,0,5,5
Skylaar,F,100,16,0,16
Gunner,M,100,5,11760,11765
Donevan,M,100,0,169,169
Daizon,M,100,0,32,32
Glyn,M,94,31,523,554
Tamara,F,100,127167,417,127584
Annalecia,F,100,17,0,17
Dalvin,M,100,0,1417,1417
Abdulrhman,M,100,0,28,28
Tramine,M,86,5,30,35
Chelisa,F,100,96,0,96
Lucindia,F,100,12,0,12
Muaad,M,100,0,35,35
Aanaya,F,100,7,0,7
Xiomara,F,100,6779,0,6779
Danyielle,F,100,15,0,15
Tenzin,M,56,705,910,1615
Devoria,F,100,40,0,40
Maryha,F,100,5,0,5
Vendela,F,100,64,0,64
Heiko,M,100,0,15,15
Ashantey,F,100,5,0,5
Yerai,M,100,0,8,8
Illyana,F,100,432,0,432
Tyhler,M,100,0,7,7
Josepha,F,100,126,0,126
Ikechukwu,M,100,0,428,428
Jatia,F,100,113,0,113
Bingham,M,100,0,36,36
Oaks,M,100,0,11,11
Antionio,M,100,0,381,381
Kennise,F,100,19,0,19
Kiely,F,100,765,0,765
Chunta,F,100,5,0,5
Nalina,F,100,69,0,69
Kindy,F,100,26,0,26
Sarsh,F,100,5,0,5
Lorrell,F,100,7,0,7
Arvid,M,100,0,527,527
Teliah,F,100,69,0,69
Lindajean,F,100,12,0,12
Shera,F,100,1420,0,1420
Ahlena,F,100,11,0,11
Anari,F,96,435,18,453
Kebron,M,81,11,47,58
Tameaka,F,100,159,0,159
Haik,M,100,0,95,95
Alfonzia,M,100,0,110,110
Jaimon,M,100,0,78,78
Naymon,M,100,0,7,7
Rember,M,100,0,5,5
Sophanna,F,59,10,7,17
Gasia,F,100,5,0,5
Khristin,F,100,103,0,103
Constantin,M,100,0,134,134
Thaxter,M,100,0,5,5
Franchette,F,100,12,0,12
Korrion,M,100,0,6,6
Wataru,M,100,0,69,69
Kaniesha,F,100,259,0,259
Benyam,M,100,0,25,25
Kuulei,F,100,152,0,152
Conchita,F,100,749,0,749
Kesiha,F,100,5,0,5
Maryona,F,100,6,0,6
Toby,M,87,4392,30010,34402
Keniqua,F,100,5,0,5
Dajauna,F,100,10,0,10
Tejaswini,F,100,10,0,10
Susej,F,100,16,0,16
Muntaz,F,100,27,0,27
Marijke,F,100,105,0,105
Elrita,F,100,5,0,5
Ferdie,M,100,0,15,15
Amerah,F,100,258,0,258
Ajana,F,100,41,0,41
Marija,F,100,462,0,462
Brentson,M,100,0,11,11
Saquana,F,100,32,0,32
Daouda,M,100,0,87,87
Lathe,M,100,0,18,18
Deniesha,F,100,98,0,98
Sarthak,M,100,0,183,183
Khylia,F,100,10,0,10
Maxamus,M,100,0,175,175
Marcelle,F,84,2359,437,2796
Paten,M,100,0,13,13
Levit,M,100,0,10,10
Matthews,M,100,0,1047,1047
Erikah,F,100,306,0,306
Khairi,M,99,5,351,356
Sydne,F,100,812,0,812
Juleigh,F,100,53,0,53
Caniya,F,100,238,0,238
Ariday,F,100,105,0,105
Disney,F,96,114,5,119
Jadeveon,M,100,0,29,29
Yin,F,100,13,0,13
Hughes,M,100,0,244,244
Timberlee,F,100,63,0,63
Alani,F,99,5037,44,5081
Salsabeel,F,100,50,0,50
Bryttani,F,100,205,0,205
Damarri,M,100,0,105,105
Breinne,F,100,7,0,7
Tehran,M,96,5,119,124
Teja,F,88,559,73,632
Yoandra,F,100,32,0,32
Jackey,M,94,33,504,537
Tyniesha,F,100,114,0,114
Altagracia,F,100,541,0,541
Sirr,M,100,0,186,186
Nazaiah,M,100,0,57,57
Tonique,F,100,207,0,207
Sandeep,M,88,115,805,920
Hanaan,F,100,76,0,76
Gabryel,M,65,176,333,509
Elnita,F,100,26,0,26
Jaelan,M,86,39,238,277
Adilenne,F,100,136,0,136
Hla,F,100,5,0,5
Ludie,F,84,87,16,103
Malloree,F,100,233,0,233
Endyah,F,100,5,0,5
Ludene,F,100,6,0,6
Lucciana,F,100,90,0,90
Shubha,F,100,5,0,5
Macee,F,100,1553,0,1553
Geovannie,M,100,0,142,142
Camilla,F,100,13531,0,13531
Talent,M,100,0,14,14
Saudah,F,100,16,0,16
Itta,F,100,33,0,33
Braddock,M,100,0,315,315
Yanik,M,100,0,16,16
Belvie,F,100,16,0,16
Meggi,F,100,7,0,7
Lynzee,F,100,784,0,784
Timmeka,F,100,23,0,23
Muneer,M,100,0,174,174
Lovada,F,100,6,0,6
Destinei,F,100,15,0,15
Aveda,F,100,5,0,5
Teigen,M,79,44,166,210
Nasean,M,100,0,162,162
Shontel,F,98,771,19,790
Hamse,M,100,0,32,32
Braely,F,100,31,0,31
Kono,M,100,0,6,6
Aryen,M,100,0,12,12
Samara,F,100,12419,0,12419
Tymarian,M,100,0,5,5
Tashiba,F,100,138,0,138
Madysyn,F,100,118,0,118
Tiffin,F,100,60,0,60
Laredo,M,79,5,19,24
Libertee,F,100,45,0,45
Addicyn,F,100,33,0,33
Travon,M,100,28,6119,6147
Janyl,F,100,6,0,6
Kelsey,F,97,143599,4686,148285
Danzell,M,100,0,199,199
Ashleah,F,100,178,0,178
Jeromy,M,100,0,4744,4744
Shamir,M,84,213,1133,1346
Alae,F,100,5,0,5
Anastasiya,F,100,357,0,357
Jevonn,M,100,0,6,6
Keisy,F,100,308,0,308
Landrea,F,100,33,0,33
Ladeidre,F,100,5,0,5
Coyle,M,100,0,27,27
Amino,F,100,5,0,5
Isaul,M,100,0,152,152
Derreon,M,100,0,124,124
Rosaleah,F,100,34,0,34
Zerenity,F,100,104,0,104
Darrence,M,100,0,28,28
Nieves,F,62,503,304,807
Dezarae,F,100,1365,0,1365
Cara,F,100,48826,62,48888
Emalene,F,100,6,0,6
Rudene,F,100,73,0,73
Traneisha,F,100,22,0,22
Quorra,F,100,127,0,127
Trissie,F,100,6,0,6
Jahmyia,F,100,5,0,5
Karri,F,100,4385,0,4385
Ishmil,M,100,0,19,19
Reyniel,M,100,0,19,19
Aljay,M,100,0,5,5
Noahjames,M,100,0,29,29
Tyric,M,100,0,403,403
Ingrit,F,100,6,0,6
Caran,F,100,105,0,105
Jisela,F,100,368,0,368
Henchy,F,100,135,0,135
Devia,F,100,10,0,10
Nekira,F,100,7,0,7
Philicia,F,100,502,0,502
Margrette,F,100,67,0,67
Catina,F,100,4171,8,4179
Ahir,M,100,0,5,5
Jarmar,M,100,0,359,359
Enio,M,100,0,42,42
Kasiem,M,100,0,23,23
Veniamin,M,100,0,84,84
Mabelyn,F,100,6,0,6
Tahlaya,F,100,5,0,5
Seigo,M,100,0,5,5
Anwesha,F,100,41,0,41
Brigden,M,100,0,11,11
Mora,F,100,410,0,410
Enriquez,M,100,0,32,32
Trevonta,M,100,0,60,60
Recina,F,100,5,0,5
Katniss,F,100,67,0,67
Elianna,F,100,4219,0,4219
Airan,M,100,0,5,5
Haylen,F,83,494,103,597
Surena,F,100,94,0,94
Zykeria,F,100,858,0,858
Grinda,F,100,5,0,5
Lisandro,M,100,5,1607,1612
Hanin,F,100,89,0,89
Vaimoana,F,100,5,0,5
Reshae,F,100,5,0,5
Adeanna,F,100,5,0,5
Seychelle,F,100,29,0,29
Carmaleta,F,100,31,0,31
Jabreon,M,100,0,10,10
Jniyah,F,100,216,0,216
Eshawn,M,100,0,139,139
Aeryona,F,100,5,0,5
Mykenzi,F,100,145,0,145
Gavi,F,100,11,0,11
Geraldy,F,100,74,0,74
Lyvonne,F,100,77,0,77
Kamaya,F,100,1144,0,1144
Sayer,M,98,5,279,284
Kynsleigh,F,100,148,0,148
Brianda,F,100,1770,5,1775
Yiyang,M,100,0,6,6
Anayelly,F,100,6,0,6
Raelin,F,100,530,0,530
Rylii,F,100,6,0,6
Shun,M,97,30,841,871
Darice,F,99,1263,13,1276
Shawntane,F,100,5,0,5
Demaria,F,83,290,59,349
Ikraan,F,100,11,0,11
Abibail,F,100,6,0,6
Sitlali,F,100,139,0,139
Kaseton,M,100,0,8,8
Refujio,M,100,0,170,170
Alexandia,F,100,17,0,17
Kayhan,M,100,0,30,30
Anyssia,F,100,37,0,37
Lornell,M,100,0,6,6
Tavy,F,100,5,0,5
Idia,F,100,5,0,5
Turron,M,100,0,5,5
Zoila,F,100,1357,0,1357
Kylun,M,100,0,5,5
Shareeka,F,100,84,0,84
Finnlee,F,57,20,15,35
Lyanni,F,100,6,0,6
Lisett,F,100,488,0,488
Lennea,F,100,30,0,30
Zahia,F,100,23,0,23
Mercedez,F,100,2826,0,2826
Shakyra,F,100,1122,0,1122
Diandria,F,100,31,0,31
Shantivia,F,100,10,0,10
Macker,M,100,0,6,6
Kaelin,F,76,2543,824,3367
Aniel,M,100,0,307,307
Ezekio,M,100,0,13,13
Nash,M,100,25,6914,6939
Daytin,M,100,0,56,56
Patrici,F,100,216,0,216
Lewanna,F,100,76,0,76
Jasman,F,85,259,46,305
Rainen,M,100,0,76,76
Emmalise,F,100,125,0,125
Ciyah,F,100,5,0,5
Mckinlie,F,100,30,0,30
Antea,F,100,5,0,5
Clorinda,F,100,464,0,464
Jahrel,M,100,0,74,74
Bryhana,F,100,14,0,14
Ryce,M,79,10,37,47
Lindale,M,100,0,11,11
Keelie,F,100,1320,0,1320
Geniya,F,100,138,0,138
Hollianne,F,100,60,0,60
Feather,F,100,499,0,499
Zarahi,F,100,154,0,154
Brooke,F,99,182735,1676,184411
Goerge,M,100,0,147,147
Aneika,F,100,10,0,10
Jermale,M,100,0,209,209
Mahlet,F,100,166,0,166
Elisianna,F,100,5,0,5
Krystalina,F,100,10,0,10
Tiffonie,F,100,15,0,15
Etan,M,100,0,285,285
Reif,M,100,0,23,23
Nalin,M,89,21,168,189
Ewaoluwa,F,100,18,0,18
Demarri,M,100,0,43,43
Alijah,M,88,969,7015,7984
Neshay,F,100,10,0,10
Myan,F,54,94,80,174
Rachiel,F,100,44,0,44
Iylee,F,100,18,0,18
Arnav,M,100,0,2866,2866
Jira,F,100,5,0,5
Cagan,M,100,0,11,11
Caimin,M,100,0,6,6
Marit,F,100,639,0,639
Jeness,F,100,5,0,5
Atyana,F,100,37,0,37
Shametra,F,100,102,0,102
Ahmarie,F,100,14,0,14
Brigina,F,100,6,0,6
Alexica,F,100,63,0,63
Jesean,M,100,0,52,52
Dallana,F,100,441,0,441
Quwan,M,100,0,5,5
Dulaney,F,100,13,0,13
Kaela,F,100,6076,0,6076
Jianni,M,51,98,102,200
Symmone,F,100,22,0,22
Shavondra,F,100,53,0,53
Dianalynn,F,100,10,0,10
Ayrihanna,F,100,5,0,5
Nenia,F,100,12,0,12
Darcia,F,100,515,0,515
Sumika,F,100,11,0,11
Dijonae,F,100,24,0,24
Rikia,F,100,110,0,110
Ghislaine,F,100,175,0,175
Damacio,M,100,0,178,178
Dorotea,F,100,31,0,31
Marieo,M,100,0,21,21
Sarita,F,100,4333,0,4333
Tattiana,F,100,176,0,176
Querida,F,100,127,0,127
Ipolito,M,100,0,5,5
Demani,M,77,95,314,409
Eylul,F,100,7,0,7
Kendrah,F,100,409,0,409
Aziya,F,100,285,0,285
Anaida,F,100,15,0,15
Bren,M,78,130,457,587
Mikeala,F,100,334,0,334
Vontina,F,100,15,0,15
Zyiana,F,100,13,0,13
Catessa,F,100,29,0,29
Shondell,M,53,237,262,499
Jediah,M,100,0,528,528
Dezare,F,100,42,0,42
Tiani,F,100,647,0,647
Donte,M,99,137,14499,14636
Taliya,F,100,752,0,752
Jaelon,M,100,0,617,617
Jovie,F,100,1141,0,1141
Jordani,M,100,0,64,64
Larelle,F,52,15,14,29
Margaro,M,100,0,5,5
Lavera,F,100,672,0,672
Maimouna,F,100,336,0,336
Connel,M,100,0,6,6
Danaja,F,100,251,0,251
Chavon,F,92,671,55,726
Vanesia,F,100,57,0,57
Josten,M,100,0,260,260
Blaik,M,100,0,34,34
Danayia,F,100,5,0,5
Marqurita,F,100,5,0,5
Teerica,F,100,44,0,44
Razmig,M,100,0,6,6
Johnovan,M,100,0,11,11
Ciearra,F,100,247,0,247
Merna,F,100,504,0,504
Gerrie,F,99,699,6,705
Celebrity,F,100,5,0,5
Katashia,F,100,12,0,12
Talsha,F,100,5,0,5
Brave,M,100,0,79,79
Aamiya,F,100,31,0,31
Noranne,F,100,5,0,5
Shmuel,M,100,0,3531,3531
Calleen,F,100,240,0,240
Jaceton,M,100,0,15,15
Hassain,M,100,0,6,6
Jaice,M,81,84,369,453
Idalina,F,100,5,0,5
Jaquarious,M,100,0,176,176
Ethelene,F,100,257,0,257
Terranesha,F,100,6,0,6
Renetta,F,100,1183,0,1183
Kaheem,M,100,0,292,292
Cache,M,59,458,646,1104
Tysheria,F,100,43,0,43
Kristin,F,99,176857,1629,178486
Brisais,F,100,6,0,6
Sherlita,F,100,25,0,25
Zinna,F,100,22,0,22
Pennelope,F,100,167,0,167
Loreto,M,96,11,262,273
Dyllian,M,100,0,5,5
Junetta,F,100,92,0,92
Teanna,F,100,2224,0,2224
Yarexi,F,100,111,0,111
Elvie,F,62,213,129,342
Delilahrose,F,100,5,0,5
Czar,M,100,0,105,105
Catonya,F,100,38,0,38
Caleesi,F,100,36,0,36
Daizie,F,100,34,0,34
Nodia,F,100,12,0,12
Hilliary,F,100,303,0,303
Liborio,M,100,0,269,269
Verenice,F,100,1534,0,1534
Latrice,F,100,9068,17,9085
Kendan,M,100,0,195,195
Nickalaus,M,100,0,281,281
Ashlei,F,100,2044,0,2044
Aleesha,F,100,1844,0,1844
Vici,F,100,163,0,163
Saanchi,F,100,14,0,14
Kahmiyah,F,100,20,0,20
Treveon,M,100,0,1281,1281
Amyrion,M,100,0,6,6
Henrry,M,100,0,548,548
Urana,F,100,5,0,5
Darvell,M,100,0,276,276
Demarreon,M,100,0,5,5
Akebia,F,100,7,0,7
Liem,M,100,0,449,449
Jeanean,F,100,176,0,176
Laurence,M,99,148,16417,16565
Rayshod,M,100,0,26,26
Kezzie,F,100,5,0,5
Kriz,M,100,0,25,25
Katari,F,55,6,5,11
Jerine,F,100,19,0,19
Jadian,M,89,16,126,142
Anas,M,100,0,1473,1473
Christell,F,100,226,0,226
Treava,F,100,5,0,5
Swathi,F,100,227,0,227
Jayanth,M,100,0,125,125
Deajane,F,100,6,0,6
Jennavie,F,100,104,0,104
Kinda,F,100,233,0,233
Justhin,M,100,0,5,5
Antwoin,M,100,0,312,312
Zniya,F,100,94,0,94
Runa,F,100,77,0,77
Quindara,F,100,17,0,17
Marihelen,F,100,5,0,5
Dujuan,M,100,0,1128,1128
Jiesha,F,100,5,0,5
Zaidah,F,100,21,0,21
Waker,M,100,0,5,5
Kahler,M,87,6,40,46
Fardi,M,100,0,7,7
Kaitleen,F,100,11,0,11
Cristyle,F,100,5,0,5
Yoan,M,100,0,297,297
Dollicia,F,100,24,0,24
Olivette,F,100,78,0,78
Taku,M,100,0,36,36
Mckenly,F,90,44,5,49
Tegra,F,100,24,0,24
Jovanta,M,100,0,11,11
Jakhai,M,98,5,212,217
Rosland,F,100,280,0,280
Chap,M,100,0,37,37
Taisei,M,100,0,110,110
Tadeh,M,100,0,21,21
Sukhjit,M,52,10,11,21
Rickeshia,F,100,18,0,18
Amonte,M,100,0,559,559
Hiroki,M,100,0,326,326
Marnita,F,100,789,0,789
Timmesha,F,100,27,0,27
Nathon,M,100,0,1276,1276
Safiyah,F,100,427,0,427
Huntur,M,100,0,16,16
Daric,M,100,0,596,596
Zikeria,F,100,88,0,88
Belissa,F,100,63,0,63
Aceton,M,100,0,39,39
Angleica,F,100,17,0,17
Smrithi,F,100,91,0,91
Jamarin,M,100,0,10,10
Camesha,F,100,457,0,457
Lezly,F,100,523,0,523
Ammaarah,F,100,10,0,10
Tirso,M,100,0,223,223
Kamare,M,97,5,182,187
Iyad,M,100,0,127,127
Alleena,F,100,36,0,36
Salaya,F,100,81,0,81
Obie,M,100,0,1331,1331
Aung,M,100,0,30,30
Marietou,F,100,35,0,35
Dominion,M,100,0,34,34
Baird,M,100,0,266,266
Adesha,F,100,5,0,5
Tamicha,F,100,16,0,16
Suhail,M,91,25,244,269
Cazandra,F,100,54,0,54
Gabrielly,F,100,113,0,113
Sagar,M,100,0,993,993
Mammie,F,100,320,0,320
Siavash,M,100,0,11,11
Annalouise,F,100,10,0,10
Fanci,F,100,15,0,15
Shafon,F,100,5,0,5
Emlynn,F,100,18,0,18
Ailton,M,100,0,62,62
Harolyn,F,100,321,0,321
Brocha,F,100,671,0,671
Shlanda,F,100,22,0,22
Jovanii,M,100,0,7,7
Devota,F,100,14,0,14
Treyvond,M,100,0,19,19
Jaynne,F,100,10,0,10
Nirvaan,M,100,0,112,112
Amid,M,100,0,10,10
Dalyah,F,100,32,0,32
Vashonda,F,100,11,0,11
Mayari,F,100,29,0,29
Sharre,F,100,5,0,5
Teegun,M,100,0,7,7
Brinly,F,100,174,0,174
Agel,M,100,0,5,5
Dannah,F,100,508,0,508
Ritaann,F,100,22,0,22
Keyontai,M,100,0,5,5
Yossi,M,100,0,196,196
Jhayden,M,96,6,142,148
Deretha,F,100,54,0,54
Asahel,M,100,0,176,176
Mirah,F,100,340,0,340
Enayah,F,100,22,0,22
Arnulfo,M,100,0,4875,4875
Gamalier,M,100,0,40,40
Shaheem,M,100,0,640,640
Narcisa,F,100,57,0,57
Joynae,F,100,5,0,5
Shaneia,F,100,25,0,25
Koreena,F,100,90,0,90
Mecole,F,100,24,0,24
Jarrelle,M,100,0,11,11
Malaun,F,100,32,0,32
Aidden,M,100,0,254,254
Josiyah,M,100,0,302,302
Kannan,M,100,0,127,127
Nivedita,F,100,85,0,85
Elana,F,100,7403,0,7403
Alechia,F,100,82,0,82
Sanjan,M,100,0,5,5
Kamee,F,100,89,0,89
Tariana,F,100,159,0,159
Keldric,M,100,0,152,152
Charmecia,F,100,10,0,10
Anike,F,100,20,0,20
Taisen,M,100,0,6,6
Sanyla,F,100,113,0,113
Torianne,F,100,78,0,78
Takako,F,100,5,0,5
Devita,F,100,241,0,241
Charlay,F,100,5,0,5
Pinar,F,100,16,0,16
Alexzandrya,F,100,8,0,8
Dora,F,100,26522,94,26616
Kerstan,F,100,33,0,33
Sadman,M,100,0,5,5
Jenzel,M,100,0,6,6
Anganette,F,100,19,0,19
Ramces,M,100,0,99,99
Sweetie,F,100,5,0,5
Sharesa,F,100,115,0,115
Ryn,F,64,35,20,55
Bertran,M,100,0,46,46
Keyshonda,F,100,16,0,16
Ahanu,M,100,0,6,6
Benee,F,100,6,0,6
Shontea,F,100,17,0,17
Jaleyiah,F,100,11,0,11
Syera,F,100,43,0,43
Laqueita,F,100,10,0,10
Xinyi,F,100,68,0,68
Asaiya,F,100,5,0,5
Fredrica,F,100,537,0,537
Mikiala,F,100,49,0,49
Itzuri,F,100,13,0,13
Labiba,F,100,44,0,44
Floretha,F,100,15,0,15
Amarae,F,100,33,0,33
Autzen,M,100,0,8,8
Shiasia,F,100,93,0,93
Edric,M,100,0,1037,1037
Salahudeen,M,100,0,10,10
Kahniyah,F,100,8,0,8
Camelo,M,100,0,5,5
Sugar,F,74,130,46,176
Latoyla,F,100,5,0,5
Zuleikha,F,100,5,0,5
Latoina,F,100,5,0,5
Josede,M,100,0,92,92
Dequindre,M,100,0,17,17
Symonne,F,100,49,0,49
Aleatha,F,100,407,0,407
Katilyn,F,100,1697,0,1697
Vasilisa,F,100,89,0,89
Apollo,M,100,0,2043,2043
Erice,M,89,30,234,264
Lucelenia,F,100,16,0,16
Neelie,F,100,84,0,84
Darick,M,100,0,1214,1214
Gryffon,M,100,0,5,5
Grettel,F,100,318,0,318
Cardiss,F,100,5,0,5
Kiet,M,100,0,317,317
Weylan,M,100,0,6,6
Dikembe,M,100,0,31,31
Sheandra,F,100,5,0,5
Tamme,F,100,267,0,267
Lyliana,F,100,276,0,276
Catia,F,100,289,0,289
Lydiana,F,100,68,0,68
Alelia,F,100,11,0,11
Draiden,M,100,0,172,172
Vanny,F,75,49,16,65
Keeara,F,100,64,0,64
Sunnie,F,99,1445,10,1455
Makinlee,F,100,284,0,284
Renesme,F,100,45,0,45
Verita,F,100,141,0,141
Rayborn,M,100,0,11,11
Felipe,M,99,128,24382,24510
Katharine,F,100,27293,11,27304
Sheela,F,100,629,0,629
Nina,F,100,74312,151,74463
Shanetta,F,100,913,0,913
Sharene,F,100,517,0,517
Violetta,F,100,1018,0,1018
Matisen,F,100,23,0,23
Koltyn,M,99,5,622,627
Carmyn,F,100,567,0,567
Jeannice,F,100,5,0,5
Jinah,F,100,5,0,5
Damin,M,100,0,524,524
Rabekah,F,100,50,0,50
Nerina,F,100,5,0,5
Saber,M,83,37,182,219
Ksandra,F,100,5,0,5
Rasool,M,100,0,109,109
Kwame,M,99,38,3467,3505
Roee,M,100,0,56,56
Lalainia,F,100,5,0,5
Djenabou,F,100,14,0,14
Sabra,F,100,3641,0,3641
Naavah,F,100,23,0,23
La,F,81,1251,289,1540
Alikai,M,100,0,6,6
Zayona,F,100,5,0,5
Kson,M,100,0,6,6
Fidel,M,100,0,7984,7984
Dreema,F,100,6,0,6
Carmon,F,75,1080,368,1448
Fatime,F,100,75,0,75
Renato,M,100,6,2363,2369
Mouna,F,100,46,0,46
Jelysa,F,100,6,0,6
Rhaniyah,F,100,12,0,12
Kendral,F,100,10,0,10
Kassedy,F,100,16,0,16
Zahkee,M,100,0,5,5
Gaquan,M,100,0,5,5
Markevious,M,100,0,269,269
Yaxel,M,100,0,10,10
Rason,M,100,0,59,59
Nylene,F,100,37,0,37
Letisia,F,100,933,0,933
Adelena,F,100,156,0,156
Janah,F,100,293,0,293
Nithin,M,100,0,313,313
Jaliah,F,99,789,6,795
Nameera,F,100,17,0,17
Kellei,F,100,5,0,5
Wayne,M,100,804,194861,195665
Chermaine,F,100,178,0,178
Attallah,F,100,55,0,55
Tenneille,F,100,5,0,5
Yakia,F,100,29,0,29
Calliana,F,100,35,0,35
Daijanae,F,100,111,0,111
Trafton,M,100,0,62,62
Alvester,M,100,0,221,221
Reymon,M,100,0,58,58
Kaolin,F,100,5,0,5
Vonmarie,F,100,6,0,6
Tyberius,M,100,0,204,204
Piercen,M,100,0,130,130
Trestyn,M,100,0,33,33
Trichelle,F,100,165,0,165
Cheralee,F,100,6,0,6
Aaidyn,M,100,0,38,38
Niv,M,100,0,39,39
Derriah,F,100,5,0,5
Narcisse,M,100,0,5,5
Natishia,F,100,48,0,48
Evemarie,F,100,11,0,11
Teni,F,100,6,0,6
Willamae,F,100,10,0,10
Marilin,F,100,738,0,738
Petula,F,100,179,0,179
Jais,M,100,0,59,59
Dyllon,M,100,0,1206,1206
Kentara,F,100,26,0,26
Jesicah,F,100,5,0,5
Johao,M,100,0,11,11
Shondia,F,100,21,0,21
Latrese,F,100,810,0,810
Adryana,F,100,470,0,470
Nekya,F,100,5,0,5
Arabellah,F,100,18,0,18
Khady,F,100,151,0,151
Beige,F,100,7,0,7
Hasani,M,99,11,876,887
Charissma,F,100,6,0,6
Robertha,F,100,133,0,133
Corrado,M,100,0,197,197
Pierette,F,100,6,0,6
Rufus,M,100,32,10515,10547
Nymir,M,100,0,84,84
Keiralyn,F,100,6,0,6
Bosten,M,100,0,80,80
Sufiyan,M,100,0,33,33
Ayira,F,100,34,0,34
Londell,M,100,0,560,560
Khedra,F,100,15,0,15
Quandarius,M,100,0,246,246
Bellamy,F,100,433,0,433
Donjae,M,100,0,10,10
Shai,F,54,1095,941,2036
Demerick,M,100,0,21,21
Mliss,F,100,93,0,93
Kamontae,M,100,0,10,10
Vivenne,F,100,7,0,7
Gesica,F,100,5,0,5
Tanyla,F,100,234,0,234
Juridia,F,100,42,0,42
Jahmila,F,100,31,0,31
Asianae,F,100,82,0,82
Anastatia,F,100,18,0,18
Janei,F,100,120,0,120
Cyndil,F,100,7,0,7
Jaquelyn,F,100,2530,0,2530
Desaraye,F,100,10,0,10
Mahalah,F,100,54,0,54
Shakiva,F,100,5,0,5
Caralynn,F,100,251,0,251
Oscardaniel,M,100,0,5,5
Raymart,M,100,0,12,12
Jahking,M,100,0,24,24
Lequinta,F,100,7,0,7
Zakrey,M,100,0,6,6
Reg,M,100,0,120,120
Seanmichael,M,100,0,577,577
Khadar,M,100,0,57,57
Schad,M,100,0,28,28
Tamekea,F,100,5,0,5
Jizel,F,100,130,0,130
Tekesha,F,100,222,0,222
Gidget,F,100,1575,0,1575
Dmauri,M,100,0,46,46
Ilka,F,100,246,0,246
Voronica,F,100,10,0,10
Anelis,F,100,122,0,122
Idaly,F,100,811,0,811
Pritam,M,100,0,11,11
Azareeyah,F,100,5,0,5
Joenathan,M,100,0,235,235
Aagam,M,100,0,8,8
Garytt,M,100,0,5,5
Rosenda,F,100,503,0,503
Nik,M,100,0,169,169
Thibault,M,100,0,24,24
Devynn,F,82,867,184,1051
Laith,M,100,0,1595,1595
Cayleigh,F,100,1676,0,1676
Asadullah,M,100,0,19,19
Eleyah,F,100,11,0,11
Ikea,F,98,580,9,589
Fortune,F,69,185,84,269
Ruskin,M,100,0,5,5
Meryssa,F,100,23,0,23
Damyria,F,100,31,0,31
Kurt,M,100,196,79609,79805
Equan,M,100,0,164,164
Christianjames,M,100,0,131,131
Edden,M,80,6,24,30
Nero,M,100,0,158,158
Emareon,M,100,0,5,5
Neena,F,100,1526,0,1526
Thaily,F,100,268,0,268
Tremaine,M,93,288,3955,4243
Laklynn,F,100,7,0,7
Kyoko,F,100,205,0,205
Dondi,M,67,375,764,1139
Dessirae,F,100,81,0,81
Ronnika,F,100,135,0,135
Erroll,M,100,0,662,662
Abdoul,M,100,0,368,368
Tikiya,F,100,15,0,15
Navor,M,100,0,10,10
Shamon,M,81,140,606,746
Karrson,M,100,0,30,30
Alishia,F,100,2708,0,2708
Conception,F,100,165,0,165
Maverik,M,100,0,261,261
Lanaysha,F,100,33,0,33
Wayland,M,100,0,1947,1947
Carressa,F,100,19,0,19
Kedar,M,100,0,459,459
Quetcy,F,100,51,0,51
Analuisa,F,100,334,0,334
Zeinah,F,100,5,0,5
Rakiya,F,100,380,0,380
Kayvan,M,100,0,95,95
Barek,M,100,0,5,5
Rilley,M,55,56,69,125
Rakyah,F,100,48,0,48
Stardust,F,100,5,0,5
Daneja,F,100,30,0,30
Radwa,F,100,20,0,20
Maryanna,F,100,1466,0,1466
Amaya,F,100,23544,12,23556
Courtnye,F,100,5,0,5
Carinda,F,100,8,0,8
Muhammadali,M,100,0,42,42
Birl,M,100,0,12,12
Yuni,F,100,5,0,5
Lavont,M,100,0,16,16
Jamichael,M,100,0,1268,1268
Keiliana,F,100,5,0,5
Eita,M,100,0,28,28
Bionda,F,100,5,0,5
Bengy,M,100,0,52,52
Shmya,F,100,40,0,40
Dimario,M,100,0,32,32
Ashleigh,F,100,31315,83,31398
Alynia,F,100,5,0,5
Jessamyn,F,99,703,5,708
Haileyjo,F,100,5,0,5
Demarcus,M,100,29,12257,12286
Jasha,F,100,249,0,249
Lynnea,F,100,1418,0,1418
Anniqua,F,100,5,0,5
Thida,F,100,23,0,23
Emanee,F,100,21,0,21
Trenten,M,100,0,3025,3025
Aidon,M,100,0,424,424
Joli,F,100,1062,0,1062
Milynda,F,100,7,0,7
Morse,M,100,0,72,72
Jabarr,M,100,0,11,11
Oleg,M,100,0,330,330
Raihana,F,100,53,0,53
Beau,M,98,438,28251,28689
Hanzel,M,100,0,136,136
Onesti,F,100,61,0,61
Denne,F,100,5,0,5
Toryn,F,50,246,244,490
Keeli,F,100,1104,0,1104
Kd,F,100,35,0,35
Laterrius,M,100,0,20,20
Makahia,F,100,6,0,6
Jemery,M,100,0,88,88
Jisel,F,100,362,0,362
Johansen,M,100,0,23,23
Shatera,F,100,300,0,300
Jacqual,M,100,0,5,5
Analeece,F,100,7,0,7
Alexander,M,99,4205,573654,577859
Shamena,F,100,7,0,7
Avalanna,F,100,8,0,8
Averionna,F,100,10,0,10
Farrakhan,M,100,0,11,11
Gilberta,F,100,74,0,74
Murtaza,M,100,0,229,229
Marquesha,F,100,471,0,471
Tange,F,100,64,0,64
Daaron,M,100,0,236,236
Costas,M,100,0,194,194
Agnes,F,100,11822,0,11822
Dewy,M,100,0,5,5
Val,M,72,1177,3084,4261
Dayshawna,F,100,22,0,22
Josepablo,M,100,0,11,11
Charnel,F,100,66,0,66
Madyx,M,73,23,63,86
Alaisha,F,100,480,0,480
Shakell,M,74,10,29,39
Cassiopeia,F,100,257,0,257
Fradel,F,100,330,0,330
Khadidiatou,F,100,19,0,19
Jahir,M,100,0,1729,1729
Niaja,F,100,183,0,183
Taraja,F,100,34,0,34
Zefram,M,100,0,10,10
Derisha,F,100,52,0,52
Jayly,F,100,5,0,5
Kicha,F,100,7,0,7
Taran,M,75,560,1701,2261
Nattaly,F,100,109,0,109
Zurielle,F,100,35,0,35
Omarius,M,100,0,77,77
Jasion,M,100,0,32,32
Agustus,M,100,0,213,213
Vincenzio,M,100,0,5,5
Tryce,M,100,0,119,119
Bisan,F,100,23,0,23
Marbeli,F,100,6,0,6
Zadarius,M,100,0,31,31
Izayiah,M,100,0,198,198
Annistyn,F,100,300,0,300
Nadene,F,100,765,0,765
Mystique,F,100,430,0,430
Kaisee,F,100,24,0,24
Chitara,F,100,47,0,47
Trennedy,F,100,10,0,10
Shya,F,100,267,0,267
Benjerman,M,100,0,111,111
Misti,F,100,8320,0,8320
Deidrick,M,100,0,109,109
Kashaundra,F,100,6,0,6
Andrika,F,100,75,0,75
Veranda,F,100,37,0,37
Alexssa,F,100,35,0,35
Daishanay,F,100,6,0,6
Vulnavia,F,100,6,0,6
Khaaliq,M,100,0,48,48
Orvin,M,100,0,176,176
Gratia,F,100,6,0,6
Shynika,F,100,12,0,12
Eimile,F,100,28,0,28
Kendarion,M,100,0,5,5
Janick,M,100,0,5,5
Jessalee,F,100,18,0,18
Lamanda,F,100,364,0,364
Thomass,M,100,0,5,5
Jeremery,M,100,0,5,5
Niara,F,100,807,0,807
Emsley,F,100,297,0,297
Sadaya,F,100,38,0,38
Santia,F,100,254,0,254
Laquandra,F,100,432,0,432
Akaycia,F,100,5,0,5
Rileah,F,100,6,0,6
Jalencia,F,100,15,0,15
Thiara,F,100,42,0,42
Graycen,F,70,459,198,657
Solomona,M,100,0,5,5
Rayanne,F,100,1125,0,1125
Taheed,M,100,0,10,10
Sharvani,F,100,6,0,6
Vernita,F,100,2648,0,2648
Oluwatamilore,F,84,98,18,116
Diantha,F,100,398,0,398
Darian,M,70,6064,14231,20295
Chiani,F,100,5,0,5
Keyuanna,F,100,5,0,5
Tarl,M,100,0,166,166
Tyliek,M,100,0,105,105
Aubryn,F,100,286,0,286
Annastasia,F,100,1461,0,1461
Yanilen,F,100,76,0,76
Zein,M,100,0,182,182
Zaydyn,M,100,0,98,98
Lyriq,F,89,430,55,485
Jasik,M,100,0,5,5
Clarisha,F,100,17,0,17
Lovi,F,100,10,0,10
Aaliyah,F,100,69833,84,69917
Jaileen,F,100,830,0,830
Taresa,F,100,422,0,422
Shamequa,F,100,24,0,24
Laurne,F,100,15,0,15
Kamaree,M,66,127,252,379
Seriah,F,100,361,0,361
Myong,F,100,44,0,44
Neythan,M,100,0,57,57
Sidratul,F,100,5,0,5
Jaqulynn,F,100,5,0,5
Amardeep,M,100,0,17,17
Bodie,M,100,0,2417,2417
Rashadd,M,100,0,24,24
Odell,M,94,291,4665,4956
Shaquilla,F,94,520,36,556
Ayauna,F,100,67,0,67
Maricus,M,100,0,125,125
Jalissa,F,100,3044,0,3044
Lachasity,F,100,12,0,12
Shaquawn,M,100,0,17,17
Martricia,F,100,6,0,6
Makenzi,F,100,3003,0,3003
Israella,F,100,66,0,66
Sophronia,F,100,295,0,295
Isebella,F,100,86,0,86
Emary,F,100,81,0,81
Delno,M,100,0,5,5
Thunder,M,100,0,348,348
Joffre,M,100,0,62,62
Chin,M,100,0,21,21
Charlyee,F,100,5,0,5
Bellamae,F,100,16,0,16
Queen,F,100,4514,0,4514
Chavely,F,100,38,0,38
Shaivi,F,100,94,0,94
Lurinda,F,100,15,0,15
Christoval,M,100,0,42,42
Deandrick,M,100,0,12,12
Payten,F,83,2729,570,3299
Quenesha,F,100,70,0,70
Analeyah,F,100,16,0,16
Kamariyon,M,100,0,8,8
Rackwon,M,100,0,15,15
Annamaria,F,100,3345,0,3345
Jahaire,M,100,0,28,28
Jordane,F,96,159,7,166
Shyiem,M,100,0,13,13
Vermon,M,100,0,30,30
Envi,F,100,54,0,54
Amanie,F,97,160,5,165
Nashyah,F,100,10,0,10
Aviral,M,100,0,5,5
Felesha,F,100,177,0,177
Dashon,M,98,33,1456,1489
Shakee,M,100,0,6,6
Ariez,M,93,5,69,74
Ayric,M,100,0,5,5
Oslo,M,100,0,58,58
Kaream,M,100,0,28,28
Kiesel,F,100,5,0,5
Taleiah,F,100,36,0,36
Brenee,F,100,158,0,158
Angelite,F,100,5,0,5
Prabjot,M,100,0,5,5
Toshia,F,100,1154,0,1154
Aldon,M,100,0,717,717
Kimily,F,100,20,0,20
Evora,F,100,35,0,35
Jadeann,F,100,17,0,17
Jamyrie,F,100,6,0,6
Irwing,M,100,0,12,12
Zakariyya,M,100,0,139,139
Johnan,M,100,0,6,6
Tamyrah,F,100,62,0,62
Azayah,F,67,36,18,54
Gaela,F,100,5,0,5
Brisny,F,100,5,0,5
Pnina,F,100,22,0,22
Kendyll,F,98,1213,19,1232
Prish,M,100,0,12,12
Jerimah,M,100,0,176,176
Connstance,F,100,5,0,5
Tove,F,100,124,0,124
Tyranique,F,100,5,0,5
Chiante,F,94,74,5,79
Vernia,F,100,237,0,237
Raymie,F,60,168,112,280
Siyah,F,100,63,0,63
Merleen,F,100,32,0,32
Essey,M,100,0,25,25
Shaye,F,78,2021,562,2583
Elazia,F,100,5,0,5
Angil,F,100,5,0,5
Jarif,M,100,0,19,19
Elean,M,83,5,25,30
Kedeshia,F,100,5,0,5
Rakisha,F,100,173,0,173
Cheryll,F,100,1944,0,1944
Ruca,F,100,12,0,12
Geraldene,F,100,115,0,115
Pa,F,100,1338,5,1343
Alysun,F,100,5,0,5
Johneric,M,100,0,71,71
Sindel,F,100,34,0,34
Jacquece,F,100,5,0,5
Stepfan,M,100,0,21,21
Tahjee,M,100,0,32,32
Deverie,F,100,5,0,5
Zymair,M,100,0,6,6
Brook,F,76,10085,3101,13186
Cordie,F,82,136,30,166
Briawna,F,100,115,0,115
Jordanlee,M,100,0,18,18
Zahraa,F,100,663,0,663
Babak,M,100,0,287,287
Katrianna,F,100,69,0,69
Josejesus,M,100,0,24,24
Brysyn,M,100,0,70,70
Giancarlo,M,100,0,6679,6679
Shivangi,F,100,149,0,149
Taviyon,M,100,0,10,10
Markum,M,100,0,9,9
Swendy,F,100,6,0,6
Shondi,F,100,22,0,22
Petunia,F,100,5,0,5
Annella,F,100,116,0,116
Kadesha,F,100,417,0,417
Tace,M,100,0,5,5
Isbella,F,100,108,0,108
Jakirah,F,100,144,0,144
Tyrei,M,100,0,22,22
Jessey,M,75,270,823,1093
Gabreilla,F,100,56,0,56
Nasirah,F,100,76,0,76
Dearies,M,100,0,92,92
Elikem,M,100,0,5,5
Lakesiha,F,100,11,0,11
Jeanett,F,100,673,0,673
Sarahmae,F,100,34,0,34
Namiya,F,100,43,0,43
Malick,M,100,0,435,435
Traeshawn,M,100,0,35,35
Joletha,F,100,6,0,6
Kaysaun,M,100,0,5,5
Samanatha,F,100,601,0,601
Kismet,F,100,169,0,169
Clutch,M,100,0,6,6
Jerricha,F,100,6,0,6
Jermesha,F,100,109,0,109
Ilyssa,F,100,709,0,709
Esabel,F,100,23,0,23
Chiane,F,100,56,0,56
Tahseen,M,100,0,6,6
Blossie,F,100,5,0,5
Takyia,F,100,85,0,85
Marines,F,100,6,0,6
Zamon,M,100,0,26,26
Indyah,F,100,81,0,81
Laressa,F,100,257,0,257
Bradney,M,100,0,5,5
Nashae,F,100,227,0,227
Maegen,F,100,875,0,875
Durante,M,100,0,116,116
Tylia,F,100,480,0,480
Tarvin,M,100,0,5,5
Jainie,F,100,5,0,5
Bridyn,M,100,0,5,5
Teiana,F,100,69,0,69
Maryellis,F,100,5,0,5
Kristiena,F,100,5,0,5
Ajak,M,100,0,16,16
Rayne,F,86,4491,739,5230
Tayli,F,100,102,0,102
Hiatt,M,100,0,24,24
Alayia,F,100,302,0,302
Betsabet,F,100,5,0,5
Kaiyana,F,100,80,0,80
Razan,F,100,530,0,530
Chandel,F,100,143,0,143
Elmina,F,100,112,0,112
Jnaya,F,100,85,0,85
Stockton,M,100,0,828,828
Tylashia,F,100,35,0,35
Timaka,F,100,39,0,39
Katalynna,F,100,12,0,12
Jessianne,F,100,10,0,10
Nihar,M,100,0,265,265
Tatsu,M,100,0,5,5
Sheala,F,100,278,0,278
Jamesanthony,M,100,0,55,55
Mckenley,F,88,207,29,236
Saniqua,F,100,5,0,5
Zion,M,81,4865,20857,25722
Travie,M,100,0,10,10
Craigory,M,100,0,98,98
Charlayne,F,100,157,0,157
Azavion,M,100,0,121,121
Kerrissa,F,100,15,0,15
Daveen,F,100,26,0,26
Marshonda,F,100,5,0,5
Guisselle,F,100,5,0,5
Madilee,F,100,52,0,52
Lovey,F,100,226,0,226
Leauna,F,100,58,0,58
Shalah,F,100,138,0,138
Arthas,M,100,0,5,5
Elsi,F,100,253,0,253
Beric,M,100,0,5,5
Courteny,F,100,63,0,63
Tieria,F,100,15,0,15
Avaleigh,F,100,360,0,360
Bracey,M,59,20,29,49
Jennie,F,100,32187,74,32261
Abrie,F,100,215,0,215
Sharlayne,F,100,6,0,6
Varetta,F,100,63,0,63
Dashna,F,100,5,0,5
Dexter,M,100,115,26727,26842
Alenka,F,100,16,0,16
Brentley,M,93,162,2004,2166
Yazaira,F,100,48,0,48
Zetta,F,100,371,0,371
Abiodun,M,100,0,18,18
Hiten,M,100,0,10,10
Ndea,F,100,190,0,190
Henryetta,F,100,20,0,20
Loryn,F,100,1453,0,1453
Lyndsee,F,100,311,0,311
Doni,F,83,656,134,790
Patracia,F,100,11,0,11
Ernisha,F,100,62,0,62
Crystin,F,100,219,0,219
Jitzel,F,100,25,0,25
Joeana,F,100,6,0,6
Debbora,F,100,221,0,221
Doresa,F,100,37,0,37
Jaes,M,100,0,5,5
Hezeki,M,100,0,15,15
Arena,F,100,265,0,265
Lehna,F,100,5,0,5
Leiana,F,100,629,0,629
Mirabella,F,100,635,0,635
Keric,M,100,0,79,79
Rien,M,76,29,91,120
Alexandrya,F,100,343,0,343
Julianie,F,100,19,0,19
Tierni,F,100,6,0,6
Minhthu,F,100,16,0,16
Shantail,F,100,10,0,10
Kahliel,M,100,0,13,13
Sveva,F,100,5,0,5
Paxten,M,84,26,132,158
Lala,F,100,407,0,407
Mikesha,F,100,283,0,283
Brighten,M,57,56,75,131
Alohilani,F,100,65,0,65
Kynzley,F,100,46,0,46
Mollyann,F,100,121,0,121
Betsy,F,100,33139,5,33144
Merinda,F,100,531,0,531
Asami,F,100,52,0,52
Tarajai,F,100,7,0,7
Gladystine,F,100,9,0,9
Jomar,M,100,0,1607,1607
Creta,F,100,46,0,46
Naidely,F,100,53,0,53
Linell,F,63,215,125,340
Akhia,F,100,56,0,56
Liannette,F,100,6,0,6
Kristine,F,100,79406,185,79591
Dionicio,M,100,0,1354,1354
Lyberti,F,100,77,0,77
Jerre,M,64,178,312,490
Jenilyn,F,100,136,0,136
Karitza,F,100,39,0,39
Thersa,F,100,813,0,813
Benecio,M,100,0,59,59
Kahle,M,100,0,109,109
Briannon,F,100,130,0,130
Irieana,F,100,11,0,11
Pearline,F,100,1232,0,1232
Aolani,F,100,668,0,668
Lotta,F,100,21,0,21
Meridee,F,100,125,0,125
Mishary,M,100,0,10,10
Maddee,F,100,6,0,6
Saraann,F,100,285,0,285
Jonnetta,F,100,50,0,50
Traci,F,100,52029,233,52262
Tysheema,F,100,16,0,16
Jiselle,F,100,1707,0,1707
Corrianna,F,100,14,0,14
Sherion,F,100,114,0,114
Jazelynn,F,100,39,0,39
Lavon,M,61,2031,3149,5180
Barrington,M,100,0,1076,1076
Terriann,F,100,489,0,489
Jakhye,M,100,0,5,5
Anietra,F,100,5,0,5
Aukeem,M,100,0,5,5
Adaliz,F,100,240,0,240
Avangaline,F,100,5,0,5
Zyrese,M,100,0,5,5
Lacourtney,F,100,48,0,48
Hazeline,F,100,28,0,28
Juwaan,M,100,0,47,47
Lakaiya,F,100,44,0,44
Jaterrica,F,100,11,0,11
Nyckolas,M,100,0,5,5
Wessley,M,100,0,237,237
Sadrac,M,100,0,98,98
Shivaansh,M,100,0,5,5
Jumanah,F,100,37,0,37
Alexsus,F,100,99,0,99
Tajir,M,100,0,39,39
Tajae,F,60,256,173,429
Lawrene,F,60,15,10,25
Dionnie,F,100,18,0,18
Joaovictor,M,100,0,120,120
Eshani,F,100,93,0,93
Joangel,M,100,0,143,143
Joylene,F,100,239,0,239
Ulisa,F,100,17,0,17
Rodnesia,F,100,7,0,7
Averey,F,67,307,151,458
Megon,F,100,161,0,161
Jenesi,F,100,5,0,5
Seily,F,100,6,0,6
Broder,M,100,0,6,6
Cordarro,M,100,0,105,105
Jiquez,M,100,0,5,5
Jayaun,M,100,0,5,5
Edlin,F,95,284,14,298
Shontisha,F,100,5,0,5
Meyling,F,100,6,0,6
Marieta,F,100,118,0,118
Alondre,M,100,0,28,28
Garrison,M,100,5,6593,6598
Josslynne,F,100,5,0,5
Larion,M,100,0,5,5
Sisco,M,100,0,6,6
Naeli,F,100,18,0,18
Nanor,F,100,5,0,5
Yehoshua,M,100,0,1559,1559
Tobais,M,100,0,10,10
Felimon,M,100,0,31,31
Adia,F,100,2502,0,2502
Ellajo,F,100,5,0,5
Antwanne,M,100,0,12,12
Demetriona,F,100,11,0,11
Wynna,F,100,7,0,7
Ollen,M,100,0,32,32
Ranard,M,100,0,64,64
Jssica,F,100,11,0,11
Meeah,F,100,55,0,55
Diondra,F,99,688,5,693
Lyann,F,100,258,0,258
Tyona,F,100,327,0,327
Phia,F,100,5,0,5
Aletse,F,100,28,0,28
Lexandra,F,100,129,0,129
Varee,F,100,6,0,6
Blue,M,72,200,518,718
Gardner,M,100,5,1161,1166
Cheenue,M,100,0,5,5
Azhane,F,100,155,0,155
Samnang,M,83,28,139,167
Lewey,M,100,0,6,6
Mieshia,F,100,149,0,149
Rugiatu,F,100,5,0,5
Narita,F,100,17,0,17
Marieelena,F,100,68,0,68
Arame,F,100,15,0,15
Bolaji,M,100,0,6,6
Elie,M,87,238,1566,1804
Lilynn,F,100,8,0,8
Brittanae,F,100,6,0,6
Sohaila,F,100,10,0,10
Alecander,M,100,0,5,5
Ivelyn,F,100,15,0,15
Thailee,F,100,7,0,7
Cress,M,100,0,5,5
Makaila,F,100,4368,0,4368
Junah,M,91,6,61,67
Reshika,F,100,6,0,6
Ilori,F,100,5,0,5
Karenna,F,100,320,0,320
Aanijah,F,100,5,0,5
Bonniejean,F,100,67,0,67
Shamyah,F,100,255,0,255
Kavyn,M,100,0,19,19
Denetra,F,100,470,0,470
Marissah,F,100,110,0,110
Ambreen,F,100,91,0,91
Lorris,M,100,0,5,5
Alyceia,F,100,5,0,5
Joee,F,94,84,5,89
Jeffrery,M,100,0,5,5
Jabali,M,100,0,16,16
Daemeon,M,100,0,44,44
Ellexus,F,100,17,0,17
Faison,M,100,0,44,44
Fabrice,M,100,0,434,434
Teshina,F,100,5,0,5
Wadie,M,100,0,27,27
Jazalynn,F,100,171,0,171
Horrace,M,100,0,6,6
Korby,M,89,12,94,106
Briseidy,F,100,89,0,89
Mayte,F,100,2652,0,2652
Hannelore,F,100,229,0,229
Mamadou,M,100,0,1154,1154
Travelle,M,100,0,273,273
Jaspen,M,100,0,11,11
Chevette,F,100,113,0,113
Zanobia,F,100,71,0,71
Sendi,F,100,41,0,41
Ferrante,M,100,0,5,5
Deney,M,100,0,7,7
Yer,F,80,572,142,714
Meilanie,F,100,5,0,5
Hanady,F,100,11,0,11
Margarethe,F,100,23,0,23
Deontez,M,100,0,109,109
Brennin,M,100,0,202,202
Ressa,F,100,25,0,25
Almira,F,100,434,0,434
Lindella,F,100,5,0,5
Demarus,M,100,0,65,65
Makkah,F,100,15,0,15
Ezavier,M,100,0,14,14
Amecia,F,100,27,0,27
Juanmanuel,M,100,0,699,699
Sharyce,F,100,17,0,17
Destry,M,91,145,1404,1549
Quora,F,100,5,0,5
Carya,F,100,5,0,5
Kenyon,M,97,187,6835,7022
Ellinor,F,100,189,0,189
Yacqub,M,100,0,40,40
Alda,F,100,803,0,803
Jabrel,M,100,0,5,5
Fitima,F,100,16,0,16
Rithvik,M,100,0,531,531
Kealie,F,100,83,0,83
Chrisoula,F,100,97,0,97
Alaysha,F,100,1385,0,1385
Laquain,M,100,0,5,5
Makaveli,M,100,0,61,61
Ephram,M,100,0,251,251
Danniele,F,100,51,0,51
Anzlee,F,100,63,0,63
Unyque,F,100,12,0,12
Taquanta,F,100,5,0,5
Reiner,M,100,0,164,164
Nevaehtnes,F,100,5,0,5
Dextyn,M,100,0,5,5
Riddick,M,100,0,358,358
Sanne,F,100,37,0,37
Drucilla,F,100,1354,0,1354
Shirlee,F,100,1361,0,1361
Chazz,M,98,29,1222,1251
Dward,M,100,0,6,6
Emira,F,100,134,0,134
Osyris,M,100,0,10,10
Irael,M,100,0,5,5
Leileen,F,100,26,0,26
Malory,F,100,1248,0,1248
Lorenda,F,100,742,0,742
Jilliana,F,100,181,0,181
Nakkia,F,100,118,0,118
Lemaj,M,100,0,6,6
Hasley,F,100,17,0,17
Dedrick,M,100,16,4117,4133
Zelta,F,100,11,0,11
Antwan,M,99,113,11614,11727
Daeshia,F,100,20,0,20
Raychael,F,100,5,0,5
Arick,M,100,0,841,841
Estibaliz,F,100,6,0,6
Aynia,F,100,11,0,11
Henrie,M,74,5,14,19
Vernisha,F,100,333,0,333
Geniene,F,100,80,0,80
Rontez,M,100,0,47,47
Lyndel,M,71,89,220,309
Royall,M,100,0,5,5
Loren,M,67,11552,23982,35534
Keilana,F,100,388,0,388
Jaylece,F,100,5,0,5
Marrico,M,100,0,12,12
Frita,F,100,5,0,5
Renaldo,M,100,0,2420,2420
Prashant,M,100,0,264,264
Tyna,F,100,628,0,628
Blayne,M,90,366,3351,3717
Marketia,F,100,55,0,55
Abrielle,F,100,2909,0,2909
Libni,F,100,254,0,254
Tiaona,F,100,5,0,5
Shayona,F,100,82,0,82
Jura,F,100,5,0,5
Kemmie,F,100,5,0,5
Meraly,F,100,15,0,15
Chanyce,F,100,5,0,5
Avrahom,M,100,0,43,43
Nevaeha,F,100,885,0,885
Bently,M,96,68,1732,1800
Elaina,F,100,18962,0,18962
Alonni,F,100,51,0,51
Nashly,F,100,182,0,182
Ahlam,F,100,632,0,632
Sharayu,F,100,5,0,5
Raiyan,M,100,0,204,204
Breezi,F,100,17,0,17
Anesty,F,100,10,0,10
Neriya,F,100,59,0,59
Kellyjo,F,100,196,0,196
Maesyn,F,89,156,19,175
Shafeeq,M,100,0,6,6
Sanel,M,100,0,79,79
Santresa,F,100,64,0,64
Krishelle,F,100,37,0,37
Levert,M,100,0,301,301
Derian,M,90,130,1118,1248
Kabriel,M,100,0,5,5
Angelina,F,100,86293,80,86373
Noalani,F,100,11,0,11
Terryona,F,100,10,0,10
Roetta,F,100,11,0,11
Deboroh,F,100,10,0,10
Endesha,F,100,12,0,12
Fawnna,F,100,5,0,5
Shernita,F,100,136,0,136
Heriberto,M,100,16,8960,8976
Clu,M,100,0,5,5
Lynnasia,F,100,10,0,10
Terrod,M,100,0,16,16
Dimia,F,100,5,0,5
Jerrail,M,100,0,6,6
Mertha,F,100,11,0,11
Courtlyn,F,99,668,10,678
Derryon,M,100,0,5,5
Lindberg,M,100,0,68,68
Brejae,F,100,7,0,7
Delancey,F,69,63,28,91
Semaya,F,100,92,0,92
Nacola,F,100,17,0,17
Launi,F,100,71,0,71
Dewana,F,100,530,0,530
Totianna,F,100,34,0,34
Kaitley,F,100,15,0,15
Thayli,F,100,6,0,6
Samuele,M,100,0,207,207
Quinetta,F,100,373,0,373
Manolo,M,100,0,661,661
Yupheng,M,100,0,7,7
Kirbie,F,100,207,0,207
Atoria,F,100,10,0,10
Feleicia,F,100,10,0,10
Serynity,F,100,33,0,33
Annjanette,F,100,148,0,148
Edony,F,100,5,0,5
Baliegh,F,100,6,0,6
Thaisha,F,100,15,0,15
Imere,M,100,0,18,18
Mazey,F,100,94,0,94
Shey,M,51,135,139,274
Juliannah,F,100,143,0,143
Janet,F,100,311060,842,311902
Marctavious,M,100,0,5,5
Latshia,F,100,7,0,7
Per,M,100,0,344,344
Eleftheria,F,100,202,0,202
Jylon,M,100,0,23,23
Hartly,F,100,13,0,13
Kaylanee,F,100,9,0,9
Creyton,M,100,0,6,6
Ziad,M,100,0,718,718
Timiki,F,100,12,0,12
Jaqueria,F,100,12,0,12
Aliciah,F,100,21,0,21
Niani,F,100,202,0,202
Saniah,F,100,1352,0,1352
Malenna,F,100,5,0,5
Caylei,F,100,91,0,91
Jade,F,93,72632,5249,77881
Jerediah,M,100,0,16,16
Azariyah,F,99,463,5,468
Aleiya,F,100,224,0,224
Mamy,F,100,5,0,5
Lillianna,F,100,3934,0,3934
Verdia,F,100,74,0,74
Sahar,F,99,1888,23,1911
Mirenda,F,100,79,0,79
Zadrien,M,100,0,5,5
Sheehan,M,93,5,69,74
Tomohiro,M,100,0,35,35
Fariha,F,100,366,0,366
Chealsey,F,100,128,0,128
Latoyta,F,100,17,0,17
Zyrell,M,100,0,96,96
Neya,F,100,183,0,183
Chadae,F,100,29,0,29
Sandip,M,100,0,82,82
Rayola,F,100,11,0,11
Linze,F,100,17,0,17
Jaylinn,F,95,555,28,583
Corbett,M,100,0,1463,1463
Deaken,M,100,0,119,119
Jabron,M,100,0,140,140
Wolfgang,M,100,0,1768,1768
Loran,M,64,803,1416,2219
Gracin,M,67,196,391,587
Enjolie,F,100,28,0,28
Esohe,F,100,5,0,5
Felando,M,100,0,6,6
Darle,M,100,0,17,17
Domian,M,100,0,5,5
Nequita,F,100,11,0,11
Sorsha,F,100,40,0,40
Cristien,M,100,0,21,21
Panayiota,F,100,86,0,86
Dhiraj,M,100,0,20,20
Karlin,F,55,400,324,724
Maguadalupe,F,100,69,0,69
Demii,F,100,23,0,23
Jawon,M,99,5,740,745
Adonys,M,100,0,133,133
Maysun,F,95,90,5,95
Danese,F,100,82,0,82
Takeita,F,100,11,0,11
Derrall,M,100,0,95,95
Deloice,F,100,5,0,5
Skylan,F,63,230,135,365
Zazil,F,100,5,0,5
Ajooni,F,100,29,0,29
Elaiza,F,100,72,0,72
Jaleria,F,100,12,0,12
Chavah,F,100,5,0,5
Mariaisabella,F,100,21,0,21
Shantrece,F,100,12,0,12
Kristieann,F,100,5,0,5
Jaeveon,M,100,0,91,91
Chanille,F,100,12,0,12
Keziyah,F,100,94,0,94
Rubiel,M,100,0,6,6
Blanchie,F,100,146,0,146
Karelys,F,100,38,0,38
Caziah,M,68,18,39,57
Aracelia,F,100,420,0,420
Sahian,F,100,72,0,72
Kennaya,F,100,6,0,6
Amirea,F,100,5,0,5
Taevyn,M,100,0,53,53
Jhori,F,100,5,0,5
Tennessee,F,55,199,163,362
Mahmud,M,100,0,135,135
Dano,M,100,0,36,36
Falonda,F,100,25,0,25
Lucresha,F,100,73,0,73
Khyrell,M,100,0,10,10
Jaydalise,F,100,7,0,7
Deauntre,M,100,0,7,7
Shurhonda,F,100,5,0,5
Carmelitta,F,100,12,0,12
Sabrinah,F,100,34,0,34
Clayten,M,100,0,207,207
Lauralee,F,100,1638,0,1638
Takuya,M,100,0,145,145
Jazara,F,100,182,0,182
Keteria,F,100,5,0,5
Nazyah,F,100,25,0,25
Anayelis,F,100,5,0,5
Heberto,M,100,0,103,103
Noahgabriel,M,100,0,15,15
Trevontae,M,100,0,149,149
Leloni,F,100,5,0,5
Gerry,M,82,2141,9892,12033
Aunnika,F,100,5,0,5
Toris,M,100,0,120,120
Leisl,F,100,79,0,79
Letizia,F,100,325,0,325
Bb,M,100,0,34,34
Orley,M,100,0,16,16
Naelle,F,100,35,0,35
Abigale,F,100,5206,0,5206
Antravious,M,100,0,45,45
Latoria,F,100,2690,0,2690
Aften,F,100,102,0,102
Tanedra,F,100,5,0,5
Jemmie,M,100,0,6,6
Lianna,F,100,4173,0,4173
Sofija,F,100,195,0,195
Quazar,M,100,0,5,5
Markayla,F,100,1925,0,1925
Kenai,M,94,31,502,533
Siarah,F,100,259,0,259
Yarely,F,100,2672,0,2672
Anahli,F,100,38,0,38
Tahesha,F,100,165,0,165
Dangkhoa,M,100,0,5,5
Nasira,F,100,214,0,214
Aythen,M,100,0,15,15
Sanna,F,100,541,0,541
Deeana,F,100,337,0,337
Justyse,F,100,16,0,16
Laylagrace,F,100,6,0,6
Barkot,F,100,6,0,6
Chieko,F,100,12,0,12
Malanda,F,100,12,0,12
Lakendrick,M,100,0,792,792
Serenna,F,100,188,0,188
Sirrah,F,100,5,0,5
Chukwuemeka,M,100,0,548,548
Olutoyin,F,100,5,0,5
Cherril,F,100,24,0,24
Breelyn,F,100,746,0,746
Kadejiah,F,100,7,0,7
Malex,M,100,0,5,5
Latifa,F,100,705,0,705
Purva,F,100,64,0,64
Brayonna,F,100,15,0,15
Nakima,F,100,173,0,173
Nadilee,F,100,10,0,10
Clementene,F,100,11,0,11
Aksana,F,100,7,0,7
Jeppie,M,100,0,5,5
Zinachidi,F,100,18,0,18
Bintou,F,100,354,0,354
Taekwon,M,100,0,39,39
Adilah,F,100,24,0,24
Ofir,M,90,5,46,51
Matiah,F,100,5,0,5
Aamari,M,57,67,88,155
Quintaya,F,100,7,0,7
Nakyrah,F,100,12,0,12
Lezer,M,100,0,5,5
Aureliano,M,100,0,414,414
Rennee,F,100,153,0,153
Emony,F,100,120,0,120
Melindasue,F,100,6,0,6
Hawkeye,M,100,0,11,11
Marianthi,F,100,23,0,23
Regena,F,100,1905,0,1905
Abbegale,F,100,82,0,82
Aishlin,F,100,5,0,5
Yanetzi,F,100,7,0,7
Bashan,M,100,0,16,16
Shaelah,F,100,28,0,28
Zahn,M,100,0,28,28
Tanille,F,100,46,0,46
Krystaline,F,100,5,0,5
Swarna,F,100,6,0,6
Reighn,F,100,21,0,21
Johnetta,F,100,2239,0,2239
Pual,M,100,0,42,42
Thorn,M,100,0,229,229
Zhariyah,F,100,36,0,36
Jannah,F,100,1418,0,1418
Kashlynn,F,100,81,0,81
Chaitanya,M,100,0,144,144
Alany,F,100,311,0,311
Wyatt,M,100,244,116260,116504
Costantino,M,100,0,27,27
Raya,F,100,2589,0,2589
Jakyran,M,100,0,6,6
Ayvree,F,100,45,0,45
Kindle,F,92,442,37,479
Helio,M,100,0,218,218
Ermie,M,100,0,5,5
Daiveon,M,100,0,179,179
Keymiah,F,100,56,0,56
Maurisha,F,100,227,0,227
Tawann,F,100,5,0,5
Jacobdaniel,M,100,0,5,5
Karlye,F,100,383,0,383
Makennah,F,100,545,0,545
Mayar,F,98,311,7,318
Maizie,F,100,753,0,753
Norval,M,100,0,348,348
Deandrey,M,100,0,7,7
Nyron,M,100,0,112,112
Caydn,M,100,0,75,75
Evalet,F,100,19,0,19
Latinya,F,100,23,0,23
Preeya,F,100,60,0,60
Hickory,M,100,0,5,5
Heather,F,100,521400,1482,522882
Marcenia,F,100,21,0,21
Zylia,F,100,13,0,13
Aidyn,M,82,660,2968,3628
Latoscha,F,100,6,0,6
Dagim,M,100,0,24,24
Alonzia,F,100,17,0,17
Sirinity,F,100,44,0,44
Chontell,F,100,16,0,16
Tavores,M,100,0,5,5
Ules,M,100,0,5,5
Archimedes,M,100,0,43,43
Zaira,F,100,3155,0,3155
Marciel,M,100,0,5,5
Imisioluwa,F,100,5,0,5
Caliph,M,100,0,191,191
Rasiyah,F,100,5,0,5
Aaronjohn,M,100,0,21,21
Brionna,F,100,4728,0,4728
Malaak,F,100,218,0,218
Keerat,F,92,59,5,64
Dexiree,F,100,10,0,10
Tason,M,100,0,35,35
Shantrell,F,98,620,10,630
Lillyanne,F,100,687,0,687
Krysti,F,100,793,0,793
Quamesha,F,100,68,0,68
Elliona,F,100,69,0,69
Basel,M,100,0,314,314
Joseguadalupe,M,100,0,147,147
Adetokunbo,M,94,5,84,89
Lezli,F,100,348,0,348
Nazeli,F,100,6,0,6
Antwaun,M,100,5,1371,1376
Chasia,F,100,5,0,5
Shaynelle,F,100,5,0,5
Remijio,M,100,0,47,47
Shavonta,F,93,141,10,151
Reasia,F,100,10,0,10
Nagee,M,100,0,74,74
Cyleigh,F,100,162,0,162
France,F,90,501,56,557
Manisa,F,100,5,0,5
Saja,F,100,597,0,597
Paulet,F,100,23,0,23
Alnita,F,100,129,0,129
Celess,F,100,5,0,5
Thaisa,F,100,5,0,5
Nathanieljames,M,100,0,12,12
Diaundra,F,100,5,0,5
Anabia,F,100,118,0,118
Glorian,F,100,6,0,6
Aneli,F,100,166,0,166
Nyrie,F,100,80,0,80
Nadia,F,100,37929,62,37991
Daytona,F,74,605,218,823
Seara,F,100,156,0,156
Varvara,F,100,77,0,77
Celecia,F,100,49,0,49
Casto,M,100,0,5,5
Thiana,F,100,31,0,31
Chambria,F,100,15,0,15
Mohammedali,M,100,0,46,46
Zareena,F,100,54,0,54
Shanonn,F,100,5,0,5
Devam,M,100,0,12,12
Zaniel,M,100,0,168,168
Natashi,F,100,13,0,13
Jennavicia,F,100,40,0,40
Ebony,F,99,38580,455,39035
Flay,M,100,0,5,5
Kailob,M,100,0,14,14
Biren,M,100,0,6,6
Ainesh,M,100,0,11,11
Azavier,M,100,0,121,121
Mekail,M,100,0,6,6
Daijohn,M,100,0,5,5
Annalycia,F,100,81,0,81
Jonecia,F,100,23,0,23
Jeylon,M,100,0,6,6
Shaterrika,F,100,10,0,10
Charay,F,100,18,0,18
Tunyia,F,100,5,0,5
Helene,F,100,10270,0,10270
Siddhartha,M,100,0,355,355
Naidelin,F,100,221,0,221
Bera,M,55,5,6,11
Autumnn,F,100,12,0,12
Lei,F,96,540,25,565
Madisson,F,100,916,0,916
Jurni,F,100,189,0,189
Herbey,M,100,0,5,5
Azurdee,F,100,12,0,12
Aulii,F,100,16,0,16
Brylee,F,95,6873,400,7273
Mayes,M,91,5,48,53
Mansi,F,100,452,0,452
Drelon,M,100,0,37,37
Ac,M,100,0,57,57
Chumy,F,100,16,0,16
Jandell,M,79,6,22,28
Kiora,F,100,98,0,98
Lillien,F,100,209,0,209
Kea,F,100,637,0,637
Kavious,M,100,0,33,33
Noreene,F,100,26,0,26
Colena,F,100,33,0,33
Rook,M,100,0,194,194
Keimon,M,100,0,126,126
Olumuyiwa,M,100,0,5,5
Daleena,F,100,57,0,57
Notasha,F,100,21,0,21
Lexiana,F,100,124,0,124
Syhir,M,100,0,6,6
Shunterria,F,100,5,0,5
Hongyu,M,100,0,5,5
Verenis,F,100,68,0,68
Joceleen,F,100,5,0,5
Latrail,M,89,13,107,120
Yorick,M,100,0,38,38
Lahni,F,100,5,0,5
Senna,F,95,403,23,426
Andras,M,100,0,190,190
Haedon,M,100,0,5,5
Tamaria,F,100,806,0,806
Izavion,M,100,0,7,7
Nassim,M,89,21,178,199
Hartwell,M,100,0,83,83
Anyah,F,100,1333,0,1333
Jovonie,M,100,0,17,17
Malesha,F,100,72,0,72
Mayleigh,F,100,304,0,304
Hulon,M,100,0,249,249
Blazen,M,100,0,33,33
Tamala,F,100,2878,0,2878
Demier,M,100,0,5,5
Pessie,F,100,23,0,23
Belia,F,100,1003,0,1003
Tameia,F,100,153,0,153
Caline,F,100,10,0,10
Taneya,F,100,367,0,367
Giavonni,F,61,142,91,233
Orpah,F,100,5,0,5
Britnae,F,100,5,0,5
Garratt,M,100,0,5,5
Andree,F,60,1264,855,2119
Jaylah,F,100,6427,0,6427
Quina,F,100,68,0,68
Karizma,F,100,1060,0,1060
Oshen,M,92,5,58,63
Kenyia,F,100,91,0,91
Healani,F,100,6,0,6
Genuine,M,100,0,16,16
Eldon,M,100,0,6545,6545
Birder,F,100,5,0,5
Enam,M,100,0,6,6
Tyairah,F,100,5,0,5
Alyciana,F,100,32,0,32
Nayquan,M,100,0,76,76
Hansford,M,100,0,78,78
Marilynne,F,100,231,0,231
Averley,F,100,16,0,16
Jermayne,M,100,0,362,362
Smauel,M,100,0,52,52
Shandara,F,100,5,0,5
Amitoj,M,100,0,19,19
Sadaq,M,100,0,5,5
Alassane,M,100,0,96,96
Daronda,F,100,39,0,39
Linnaea,F,100,133,0,133
Brittnae,F,100,72,0,72
Kathiana,F,100,17,0,17
Engelbert,M,100,0,100,100
Tip,M,100,0,29,29
Yensy,F,100,6,0,6
Johnathen,M,100,0,1274,1274
Teasha,F,100,665,0,665
Whiteny,F,100,29,0,29
Coltrane,M,100,0,248,248
Nyemiah,F,100,5,0,5
Zehava,F,100,64,0,64
Dazhia,F,100,10,0,10
Hessa,F,100,8,0,8
Kalonda,F,100,16,0,16
Twanna,F,100,1327,0,1327
Meridth,F,100,5,0,5
Vicke,F,100,144,0,144
Kedan,M,100,0,49,49
Sriyah,F,100,12,0,12
Koressa,F,100,6,0,6
Aariya,F,100,72,0,72
Kameryn,F,74,1705,604,2309
Kenetra,F,100,140,0,140
Roena,F,100,152,0,152
Markease,M,100,0,5,5
Kymarion,M,100,0,31,31
Abyan,M,76,28,87,115
Darrianna,F,100,31,0,31
Symona,F,100,5,0,5
Medra,F,100,16,0,16
Phillips,M,100,0,650,650
Lars,M,100,0,5478,5478
Troye,M,77,22,75,97
Leeyah,F,100,262,0,262
Vetta,F,100,61,0,61
Bowin,M,100,0,10,10
Oluwatomiwa,M,100,0,51,51
Cobra,M,100,0,20,20
Dashani,F,100,10,0,10
Mahya,F,100,24,0,24
Kailee,F,100,10735,23,10758
Lilita,F,100,5,0,5
Gillianne,F,100,38,0,38
Charlese,F,100,474,0,474
Qiara,F,100,104,0,104
Auna,F,100,393,0,393
Steave,M,100,0,12,12
Lorreen,F,100,15,0,15
Karess,F,100,112,0,112
Sadler,M,100,0,105,105
Sergi,M,100,0,35,35
Kalii,F,100,49,0,49
Rodas,F,100,11,0,11
Dael,M,100,0,162,162
Derone,M,100,0,55,55
Seraphim,F,77,146,43,189
Demark,M,100,0,29,29
Derekia,F,100,6,0,6
Perseis,F,100,24,0,24
Brelen,M,100,0,5,5
Rontasia,F,100,5,0,5
Khyati,F,100,11,0,11
Madine,F,100,24,0,24
Alie,F,88,411,55,466
Zamariya,F,100,73,0,73
Letha,F,100,4343,0,4343
Kenniah,F,100,46,0,46
Danila,F,80,103,25,128
Rylin,F,60,941,635,1576
Prestina,F,100,79,0,79
Layali,F,100,115,0,115
Micalyn,F,100,11,0,11
Riyansh,M,100,0,40,40
Maryhannah,F,100,5,0,5
Onisty,F,100,13,0,13
Gregary,M,100,0,481,481
Emeri,F,95,861,48,909
Tavares,M,99,23,2785,2808
Esmerald,F,100,11,0,11
Floria,F,100,456,0,456
Tnyah,F,100,17,0,17
Shaisha,F,100,5,0,5
Kilie,F,100,252,0,252
Anyjah,F,100,84,0,84
Vianney,F,100,1915,0,1915
Feona,F,100,29,0,29
Kristyl,F,100,211,0,211
Reannon,F,100,260,0,260
Nealy,F,97,172,5,177
Fariz,M,100,0,5,5
Claria,F,100,25,0,25
Mitza,F,100,5,0,5
Tyasia,F,100,1977,0,1977
Landry,M,55,2708,3290,5998
Lafrances,F,100,29,0,29
Tywona,F,100,12,0,12
Jenicia,F,100,6,0,6
Maneh,F,100,45,0,45
Ranada,F,100,309,0,309
Ping,F,62,10,6,16
Avanicole,F,100,6,0,6
Viva,F,100,574,0,574
Katlin,F,98,5331,126,5457
Cannan,M,100,0,118,118
Fattima,F,100,5,0,5
Aralynne,F,100,17,0,17
Frenda,F,100,10,0,10
Tiffannee,F,100,5,0,5
Nain,M,100,0,182,182
Agness,F,100,10,0,10
Tenelle,F,100,67,0,67
Prahlad,M,100,0,45,45
Praneet,M,100,0,12,12
Taelon,M,100,0,74,74
Yarali,F,100,7,0,7
Oyinkansola,F,100,64,0,64
Marquiese,M,100,0,44,44
Isael,M,100,0,1644,1644
Keante,M,94,13,208,221
Stefhon,M,100,0,5,5
Kamdyn,M,55,1201,1442,2643
Lloydene,F,100,6,0,6
Emyli,F,100,55,0,55
Gani,M,100,0,5,5
Amariyanna,F,100,16,0,16
Markai,M,76,10,32,42
Toriann,F,100,169,0,169
Adrionna,F,100,832,0,832
Sirenity,F,100,248,0,248
Taelor,F,92,2057,173,2230
Relina,F,100,17,0,17
Coltyn,M,100,0,1087,1087
Amiaya,F,100,192,0,192
Laverle,F,100,5,0,5
Lavaria,F,100,21,0,21
Jenziel,M,100,0,11,11
Mishelle,F,100,1104,0,1104
Josaiah,M,100,0,286,286
Sharmell,F,100,32,0,32
Alero,F,100,5,0,5
Naweed,M,100,0,20,20
Mannix,M,100,0,367,367
Amabelle,F,100,6,0,6
Kalyl,M,100,0,6,6
Estevan,M,100,10,7589,7599
Triton,M,100,0,827,827
Jordache,M,100,0,30,30
Marliah,F,100,6,0,6
Jaylaun,M,100,0,6,6
Yoshica,F,100,6,0,6
Aws,M,100,0,41,41
Helaena,F,100,11,0,11
Orsen,M,100,0,5,5
Keedyn,M,100,0,13,13
Ratha,M,74,18,50,68
Toa,M,100,0,54,54
Kaywin,F,100,5,0,5
Shaheed,M,100,0,1031,1031
Reanee,F,100,15,0,15
Yarah,F,100,146,0,146
Vinton,M,100,0,402,402
Talbert,M,100,0,383,383
Daymien,M,100,0,331,331
Tiahna,F,100,427,0,427
Daveney,F,100,17,0,17
Qualee,M,100,0,16,16
Jamain,M,100,0,57,57
Marvins,M,100,0,34,34
Patryce,F,100,114,0,114
Jimal,M,100,0,10,10
Jamus,M,100,0,98,98
Jaun,M,100,0,532,532
Tenia,F,100,964,0,964
Zecheriah,M,100,0,25,25
Marcellis,M,100,0,270,270
Briceton,M,100,0,37,37
Quadier,M,100,0,5,5
Fatemeh,F,100,37,0,37
Mckinnah,F,100,11,0,11
Akie,M,100,0,5,5
Charnessa,F,100,23,0,23
Khamille,F,100,97,0,97
Marqez,M,100,0,27,27
Siaki,M,100,0,10,10
Harron,M,100,0,5,5
Gretchin,F,100,36,0,36
Kealyn,F,100,45,0,45
Izayha,M,100,0,12,12
Luba,F,100,282,0,282
Corneshia,F,100,80,0,80
Markeys,M,100,0,5,5
Furnell,M,100,0,27,27
Aniruddha,M,100,0,26,26
Nora,F,100,64032,199,64231
Neela,F,100,863,0,863
Jmarie,F,100,34,0,34
Emilyelizabeth,F,100,41,0,41
Jerome,M,99,633,91973,92606
Shaunyce,F,100,6,0,6
Gattlin,M,100,0,12,12
Jino,M,100,0,25,25
Frayda,F,100,25,0,25
Ghadah,F,100,7,0,7
Joshalynn,F,100,39,0,39
Adelyn,F,100,9219,6,9225
Brianka,F,100,5,0,5
Guransh,M,100,0,15,15
Aritza,F,100,136,0,136
Sofiya,F,100,566,0,566
Tarun,M,100,0,731,731
Maylon,M,92,7,86,93
Taichi,M,100,0,106,106
Bethany,F,100,94232,184,94416
Delonia,F,100,5,0,5
Dirck,M,100,0,97,97
Jerius,M,100,0,36,36
Shellisa,F,100,5,0,5
Tyche,F,100,5,0,5
Thailyn,F,86,63,10,73
Jakora,F,100,11,0,11
Jessieca,F,100,115,0,115
Maryjoan,F,100,21,0,21
Kynadie,F,100,49,0,49
Dillion,M,100,0,3401,3401
Arfan,M,100,0,29,29
Hedit,F,100,5,0,5
Melida,F,100,534,0,534
Yagmur,F,100,45,0,45
Kesi,F,100,221,0,221
Sumit,M,100,0,250,250
Cedrina,F,100,26,0,26
Jorge,M,99,689,122452,123141
Carrigan,F,99,929,10,939
Bolton,M,100,0,106,106
Jaceline,F,100,5,0,5
Semajah,F,100,26,0,26
Kholton,M,100,0,39,39
Jermel,M,100,5,1266,1271
Veria,F,100,83,0,83
Deahna,F,100,33,0,33
Jande,F,100,7,0,7
Breneshia,F,100,5,0,5
Hibaq,F,100,28,0,28
Cymone,F,100,445,0,445
Tandra,F,100,1378,0,1378
Donsha,F,51,26,25,51
Britiany,F,100,180,0,180
Hermino,M,100,0,5,5
Keslynn,F,100,22,0,22
Adavia,F,100,5,0,5
Kashmira,F,100,5,0,5
Garv,M,100,0,77,77
Tahsha,F,100,10,0,10
Andrej,M,100,0,263,263
Rosamarie,F,100,40,0,40
Javonti,M,100,0,5,5
Kyonna,F,100,390,0,390
Sabriye,F,100,5,0,5
Ceona,F,100,22,0,22
Rupen,M,100,0,5,5
Tribecca,F,100,5,0,5
Edvard,M,100,0,5,5
Trenece,F,100,15,0,15
Cheyanna,F,100,1406,0,1406
Srah,F,100,84,0,84
Donail,M,100,0,5,5
Shundrea,F,100,18,0,18
Yuya,M,100,0,83,83
Alameen,M,100,0,15,15
Ostin,M,100,0,211,211
Harinder,M,100,0,10,10
Trezure,F,100,154,0,154
Audeliz,M,100,0,6,6
Emilija,F,100,163,0,163
Merchelle,F,100,5,0,5
Shaheer,M,100,0,309,309
Ayantu,F,100,11,0,11
Mariannah,F,100,5,0,5
Raliyah,F,100,60,0,60
Adassa,F,100,18,0,18
Nickloas,M,100,0,5,5
Tarnya,F,100,5,0,5
Taalor,F,100,5,0,5
Jahnia,F,100,231,0,231
Manus,M,100,0,36,36
Caitlynn,F,100,4644,0,4644
Azikiwe,M,100,0,18,18
Laiya,F,100,218,0,218
Soniya,F,100,251,0,251
Keyuna,F,100,168,0,168
Miley,F,100,10490,7,10497
Reginna,F,100,87,0,87
Parma,F,100,5,0,5
Padma,F,100,35,0,35
Zophie,F,100,6,0,6
Loray,F,100,65,0,65
Natlie,F,100,357,0,357
Anja,F,100,2193,0,2193
Mikiela,F,100,12,0,12
Zealyn,F,100,5,0,5
Brynnli,F,100,17,0,17
Shakeyia,F,100,41,0,41
Montserat,F,100,8,0,8
Darletha,F,100,27,0,27
Aaronmichael,M,100,0,74,74
Lyndzi,F,100,59,0,59
Verene,F,100,5,0,5
Nemanja,M,100,0,50,50
Allyssa,F,100,6428,0,6428
Clydeen,F,100,5,0,5
Pleasant,M,78,11,38,49
Kayto,M,100,0,5,5
Laurenashley,F,100,76,0,76
Blanch,F,100,407,0,407
Jaza,F,100,32,0,32
Jeadon,M,100,0,5,5
Mallee,F,100,6,0,6
Zephyr,M,82,177,794,971
Shaquasha,F,100,78,0,78
Ainhara,F,100,7,0,7
Kabrea,F,100,61,0,61
Richette,F,100,5,0,5
Nykiera,F,100,10,0,10
Chequita,F,100,325,0,325
Nayani,F,100,20,0,20
Kjell,M,100,0,350,350
Airiona,F,100,5,0,5
Hennley,F,100,6,0,6
Aurora,F,100,30488,5,30493
Giovanne,M,100,0,108,108
Kawthar,F,100,122,0,122
Joelyn,F,100,624,0,624
Terreal,M,100,0,5,5
Trequan,M,100,0,801,801
Cobe,M,100,0,577,577
Tyreese,M,97,49,1798,1847
Khloie,F,100,620,0,620
Murrie,F,100,5,0,5
Lindsey,F,97,154457,4885,159342
Nataliya,F,100,465,0,465
Robbyn,F,100,1039,0,1039
Sarit,F,100,159,0,159
Dominigue,F,78,165,46,211
Narcizo,M,100,0,5,5
Preshus,F,100,59,0,59
Jocqua,M,100,0,5,5
Bright,M,97,5,162,167
Mahum,F,100,190,0,190
Jamillah,F,100,1005,0,1005
Kief,M,100,0,12,12
Taronica,F,100,6,0,6
Fraidel,F,100,5,0,5
Sharifah,F,100,145,0,145
Camyron,M,69,5,11,16
Satori,F,97,291,10,301
Paraskevas,M,100,0,5,5
Evah,F,100,255,0,255
Keeran,M,100,0,41,41
Dantwan,M,100,0,22,22
Antonise,F,100,26,0,26
Toccora,F,100,32,0,32
Bahiyyah,F,100,6,0,6
Celestia,F,100,446,0,446
Carlasia,F,100,36,0,36
Youness,M,100,0,35,35
Tianne,F,100,190,0,190
Bela,F,64,506,286,792
Yolunda,F,100,240,0,240
Daisa,F,100,223,0,223
Lundyn,F,99,690,6,696
Suriana,F,100,20,0,20
Shauntaye,F,100,5,0,5
Novelle,F,100,34,0,34
Diyon,M,100,0,5,5
Joriann,F,100,5,0,5
Brycon,M,100,0,7,7
Naavya,F,100,22,0,22
Brice,M,97,335,12998,13333
Jazzie,F,100,123,0,123
Tylah,F,100,393,0,393
Yira,F,100,13,0,13
Havick,M,100,0,6,6
Kiata,F,100,9,0,9
Koni,F,100,282,0,282
Sharmake,M,100,0,5,5
Kemeisha,F,100,5,0,5
Joelle,F,97,12075,327,12402
Jaelynne,F,100,308,0,308
Jamessa,F,100,21,0,21
Adler,M,91,131,1386,1517
Derik,M,100,0,5185,5185
Longino,M,100,0,45,45
Arlynne,F,100,30,0,30
Nikol,F,100,806,0,806
Sahori,F,100,37,0,37
Joshuah,M,100,0,2713,2713
Kashun,M,100,0,33,33
Triniyah,F,100,6,0,6
Jazaria,F,100,359,0,359
Kla,F,100,235,0,235
Mckennzie,F,100,24,0,24
Ema,F,100,2574,0,2574
Markeyda,F,100,16,0,16
Zalia,F,100,158,0,158
Demeka,F,100,273,0,273
Shaundra,F,100,977,0,977
Grazia,F,100,149,0,149
Elieen,F,100,6,0,6
Chrishayla,F,100,11,0,11
Zimaria,F,100,5,0,5
Chelsa,F,100,1107,0,1107
Darryon,M,100,0,111,111
Etnie,F,100,5,0,5
Ahmid,M,100,0,7,7
Kevontae,M,100,0,370,370
Saija,F,100,21,0,21
Tinasha,F,100,10,0,10
Roni,F,86,4156,689,4845
Kaliona,F,100,5,0,5
Othman,M,100,0,252,252
Shaqwana,F,100,47,0,47
Kailo,M,100,0,17,17
Renate,F,100,1172,0,1172
Lizzi,F,100,7,0,7
Trunetta,F,100,7,0,7
Lunna,F,100,130,0,130
Giannarose,F,100,5,0,5
Floreen,F,100,28,0,28
Semara,F,100,12,0,12
Elysa,F,100,1355,0,1355
Faheem,M,100,0,661,661
Radlee,M,100,0,15,15
Kayedence,F,100,18,0,18
Zendre,F,100,35,0,35
Bronica,F,100,5,0,5
Sole,F,100,403,0,403
Akhirah,F,100,10,0,10
Mackinzie,F,98,781,15,796
Cristol,F,100,62,0,62
Aaira,F,100,73,0,73
Dennine,F,100,50,0,50
Ashelyn,F,100,279,0,279
Avryl,F,100,74,0,74
Jahnai,F,90,97,11,108
Chakia,F,100,159,0,159
Shepard,M,99,5,917,922
Korea,F,100,222,0,222
Anjelicia,F,100,24,0,24
Trever,M,100,0,6103,6103
Jonetta,F,100,780,0,780
Marioalberto,M,100,0,44,44
Guilmar,M,100,0,5,5
Aneeza,F,100,14,0,14
Cambron,M,100,0,54,54
Tomer,M,100,0,405,405
Taycen,M,100,0,16,16
Komora,F,100,5,0,5
Edmundo,M,100,0,2396,2396
Antonett,F,100,11,0,11
Arriyana,F,100,64,0,64
Kvon,M,100,0,348,348
Larita,F,100,1238,0,1238
Shaqwan,M,100,0,24,24
Thomesa,F,100,5,0,5
Helen,F,100,127497,401,127898
Cruse,M,100,0,25,25
Charlesia,F,100,92,0,92
Bellatrix,F,100,66,0,66
Julianny,F,100,60,0,60
Danja,F,100,5,0,5
Kassadi,F,100,173,0,173
Nagely,F,100,20,0,20
Deliza,F,100,21,0,21
Asijah,F,100,55,0,55
Brandilee,F,100,60,0,60
Lindamarie,F,100,57,0,57
Aliana,F,100,4406,0,4406
Shyne,M,77,66,217,283
Elery,M,100,0,29,29
Arnardo,M,100,0,5,5
Sayyid,M,100,0,113,113
Dainan,M,100,0,5,5
Karuna,F,100,98,0,98
Chantay,F,100,1108,0,1108
Laronna,F,100,23,0,23
Monina,F,100,10,0,10
Senica,M,73,27,72,99
Marleisha,F,100,5,0,5
Donzell,M,99,5,936,941
Daleyssa,F,100,34,0,34
Jasear,M,100,0,6,6
Ahmare,M,100,0,23,23
Jamiria,F,100,85,0,85
Trajuan,M,100,0,5,5
Aseda,M,100,0,5,5
Kyrique,M,100,0,17,17
Iyaunna,F,100,5,0,5
Ontonio,M,100,0,11,11
Leini,F,100,5,0,5
Khiri,M,100,0,12,12
Lenai,F,100,5,0,5
Zeta,F,100,506,0,506
Marirose,F,100,70,0,70
Trei,M,100,0,149,149
Cawanda,F,100,19,0,19
Tanayshia,F,100,5,0,5
Griffen,M,100,0,1497,1497
Sanai,F,99,2661,15,2676
Tornisha,F,100,5,0,5
Keslie,F,100,203,0,203
Loanne,F,100,72,0,72
Earlyn,F,100,35,0,35
Donaldo,M,100,0,293,293
Redmond,M,100,0,362,362
Kailia,F,100,120,0,120
Preonda,F,100,6,0,6
Alexee,F,100,87,0,87
Severyn,M,100,0,5,5
Zeriyah,F,100,39,0,39
Dyanara,F,100,75,0,75
Kado,M,100,0,34,34
Janaya,F,100,3277,0,3277
Joal,M,81,20,84,104
Haytham,M,100,0,170,170
Seham,F,100,120,0,120
Jeanmichel,M,100,0,42,42
Jacaden,M,100,0,63,63
Chavella,F,100,6,0,6
Gaynell,F,100,1555,0,1555
Shawntez,M,100,0,119,119
Debora,F,100,28554,28,28582
Vita,F,100,1977,0,1977
Cai,M,73,220,585,805
Riannon,F,100,250,0,250
Arieh,M,100,0,61,61
Lyndelle,F,100,10,0,10
Quentarius,M,100,0,25,25
Wyona,F,100,99,0,99
Sadane,M,100,0,5,5
Aleema,F,100,13,0,13
Jaleal,M,100,0,158,158
Walter,M,99,1003,185810,186813
Mirranda,F,100,245,0,245
Brandin,M,95,137,2639,2776
Trinese,F,100,25,0,25
Osman,M,100,0,2078,2078
Demerius,M,100,0,128,128
Eeshan,M,100,0,94,94
Inaya,F,100,1020,0,1020
Heatherlee,F,100,12,0,12
Khamiah,F,100,22,0,22
Ercilia,F,100,57,0,57
Jayveer,M,100,0,5,5
Dayeli,F,100,21,0,21
Kashvi,F,100,224,0,224
Darrik,M,100,0,89,89
Detron,M,100,0,146,146
Weyman,M,100,0,141,141
Lakechia,F,100,86,0,86
Cyle,M,99,15,1925,1940
Pharoh,M,100,0,27,27
Aarish,M,100,0,92,92
Nasiem,M,100,0,22,22
Chimeng,M,100,0,20,20
Beckie,F,100,2254,0,2254
Teaunna,F,100,36,0,36
Gwendlyn,F,100,343,0,343
Kalayla,F,100,83,0,83
Chasyn,M,100,0,79,79
Likesha,F,100,12,0,12
Leily,F,100,113,0,113
Drian,M,100,0,11,11
Chrishae,F,100,12,0,12
Dorma,F,100,115,0,115
Hafiz,M,100,0,80,80
Destinnie,F,100,5,0,5
Denzel,M,100,11,8951,8962
Travonte,M,100,0,454,454
Luchiana,F,100,5,0,5
Ruya,F,100,20,0,20
Schwanna,F,100,35,0,35
Manveer,M,94,10,144,154
Mandi,F,100,9931,0,9931
Maryiah,F,100,145,0,145
Azuzena,F,100,5,0,5
Yaira,F,100,455,0,455
Santiel,M,100,0,8,8
Tylek,M,100,0,114,114
Losie,F,100,5,0,5
Jakyle,M,100,0,80,80
Demario,M,100,17,5781,5798
Arrika,F,100,19,0,19
Kiree,M,85,16,89,105
Talyr,F,100,6,0,6
Abiha,F,100,79,0,79
Avika,F,100,179,0,179
Karthika,F,100,51,0,51
Prima,F,100,89,0,89
Ayrian,F,70,28,12,40
Ukiah,M,92,6,74,80
Adderly,M,100,0,11,11
Elania,F,100,105,0,105
Jali,F,100,44,0,44
Zamoni,F,100,16,0,16
Rheaann,F,100,5,0,5
Kyliann,F,100,10,0,10
Aakeem,M,100,0,16,16
Sherrylyn,F,100,19,0,19
Kahmar,M,100,0,5,5
Loralea,F,100,10,0,10
Vinetta,F,100,121,0,121
Kaishonta,F,100,6,0,6
Molly,F,100,143114,360,143474
Daiden,M,100,0,127,127
Takirah,F,100,75,0,75
Cindylee,F,100,34,0,34
Cayetano,M,100,0,396,396
Darrious,M,100,0,374,374
Cateria,F,100,32,0,32
Laelah,F,100,217,0,217
Archelle,F,100,6,0,6
Jenanne,F,100,5,0,5
Cyrielle,F,100,7,0,7
Yahara,F,100,6,0,6
Mellssa,F,100,5,0,5
Deethya,F,100,29,0,29
Imee,F,100,8,0,8
Laquinthia,F,100,5,0,5
Chariah,F,100,100,0,100
Artyom,M,100,0,131,131
Gionny,M,100,0,29,29
Jerrika,F,100,593,0,593
Trulee,F,100,64,0,64
Aazim,M,100,0,15,15
Dashiyah,F,100,6,0,6
Whendy,F,100,12,0,12
Nanditha,F,100,13,0,13
Mayo,M,92,28,333,361
Dymone,F,100,38,0,38
Natazia,F,100,25,0,25
Jadir,M,100,0,35,35
Eriyan,F,100,9,0,9
Raenisha,F,100,20,0,20
Milford,M,100,0,1476,1476
Toniann,F,100,1262,0,1262
Natanel,M,100,0,174,174
Orfalinda,F,100,6,0,6
Mckean,M,100,0,5,5
An,F,54,986,852,1838
Janeira,F,100,26,0,26
Hassane,M,100,0,11,11
Ireoluwa,F,61,39,25,64
Kyrek,M,100,0,5,5
Rustin,M,100,0,2338,2338
Jake,M,100,205,104342,104547
Orbie,M,100,0,79,79
Baley,F,76,319,103,422
Letoya,F,100,282,0,282
Tyreana,F,100,55,0,55
Cortlynn,F,100,123,0,123
Lenor,F,100,178,0,178
Saedi,F,100,15,0,15
Sharrell,F,100,396,0,396
Iviana,F,100,140,0,140
Alizeah,F,100,36,0,36
Raydel,M,100,0,86,86
Debr,F,100,6,0,6
Keaden,M,100,0,81,81
Zharya,F,100,5,0,5
Shany,F,100,63,0,63
Hatziry,F,100,5,0,5
Maurika,F,100,10,0,10
Tisha,F,100,9339,0,9339
Aireonna,F,100,174,0,174
Hillarey,F,100,7,0,7
Kennidee,F,100,99,0,99
Aizayah,M,100,0,11,11
Enise,F,100,15,0,15
Ade,M,98,5,237,242
Jeria,F,100,6,0,6
Rieanna,F,100,21,0,21
Janaea,F,100,43,0,43
Danay,F,100,586,0,586
Vertie,F,100,82,0,82
Birkley,F,100,22,0,22
Mycal,M,100,0,141,141
Amaan,M,100,0,725,725
Demeturis,M,100,0,12,12
Gianfranco,M,100,0,899,899
Abiah,F,100,21,0,21
Katonya,F,100,292,0,292
Candrea,F,100,11,0,11
Roselind,F,100,212,0,212
Tillie,F,100,1246,0,1246
Keiron,M,100,0,394,394
Brinya,F,100,22,0,22
God,M,100,0,11,11
Jaileene,F,100,12,0,12
Jakk,M,100,0,10,10
Woodfin,M,100,0,6,6
Alex,M,97,7959,226471,234430
Eshell,F,100,5,0,5
Chastelyne,F,100,8,0,8
Zaima,F,100,43,0,43
Karmoni,F,100,7,0,7
Aaminah,F,100,271,0,271
Auriyana,F,100,14,0,14
Dianthia,F,100,5,0,5
Epifania,F,100,80,0,80
Kharli,F,100,19,0,19
Habram,M,100,0,28,28
Kelsa,F,100,147,0,147
Tynae,F,100,57,0,57
Yaritzia,F,100,11,0,11
Bradshaw,M,100,0,68,68
Javone,M,97,11,414,425
Truely,F,100,10,0,10
Tayleigh,F,100,210,0,210
Decoda,M,100,0,88,88
Wakenda,F,100,5,0,5
Chariti,F,100,229,0,229
Rilo,M,100,0,10,10
Kaitlee,F,100,35,0,35
Yarisma,F,100,5,0,5
Javarious,M,100,0,438,438
Phillistine,F,100,5,0,5
Wilkin,M,100,0,71,71
Cicily,F,100,606,0,606
Vanitie,F,100,5,0,5
Jazmari,F,100,18,0,18
Katira,F,100,67,0,67
Jaimere,M,100,0,70,70
Hec,M,100,0,5,5
Cledith,M,79,5,19,24
Duriyah,F,100,5,0,5
Fotis,M,100,0,17,17
Marrin,F,100,35,0,35
Annjelica,F,100,5,0,5
Njideka,F,100,11,0,11
Leanord,M,100,0,122,122
Azaliya,F,100,6,0,6
Porfiria,F,100,22,0,22
Blanton,M,100,0,153,153
Jerad,M,100,0,3769,3769
Maretha,F,100,10,0,10
Kardyn,F,100,13,0,13
Achai,M,100,0,6,6
Izsak,M,100,0,50,50
Brianney,F,100,5,0,5
Shuntel,F,100,140,0,140
Tymiere,M,100,0,19,19
Mollyrose,F,100,5,0,5
Deziraye,F,100,10,0,10
Kaysey,F,100,143,0,143
Ibe,M,100,0,7,7
Nakeitha,F,100,82,0,82
Izabelah,F,100,13,0,13
Charizma,F,100,163,0,163
Rhoads,M,100,0,5,5
Julonda,F,100,5,0,5
Aibhilin,F,100,11,0,11
Chemaine,F,100,23,0,23
Biancha,F,100,54,0,54
Sadeel,F,100,83,0,83
Nickalous,M,100,0,172,172
Dibanhi,F,100,18,0,18
Evertte,M,100,0,10,10
Oluwatofunmi,F,86,30,5,35
Tressel,M,100,0,16,16
Aunisti,F,100,11,0,11
Odila,F,100,5,0,5
Eleta,F,100,12,0,12
Michaylah,F,100,5,0,5
Daizhane,F,100,20,0,20
Mahkenna,F,100,12,0,12
Kamyrah,F,100,97,0,97
Aquisha,F,100,38,0,38
Gurshawn,M,100,0,11,11
Masato,M,100,0,127,127
Neka,F,100,155,0,155
Lashante,F,100,272,0,272
Rosaelena,F,100,63,0,63
Khamilah,F,100,5,0,5
Beck,M,100,0,1955,1955
Davada,F,100,5,0,5
Tred,M,100,0,10,10
Raevan,F,100,26,0,26
Yom,M,100,0,6,6
Casiah,F,100,10,0,10
Emberly,F,100,689,0,689
Ramzi,M,99,5,655,660
Tarian,M,100,0,26,26
Yashveer,M,100,0,5,5
Meosha,F,100,500,0,500
Asjha,F,100,28,0,28
Ameah,F,100,65,0,65
Abba,M,100,0,27,27
Herlane,F,100,6,0,6
Areyanna,F,100,134,0,134
Zakeyah,F,100,5,0,5
Lenzi,F,100,122,0,122
Wilford,M,100,0,2537,2537
Antashia,F,100,6,0,6
Safi,M,95,6,106,112
Luiggi,M,100,0,13,13
Bertice,F,100,6,0,6
Nayalee,F,100,26,0,26
Kensei,M,100,0,32,32
Dravion,M,100,0,5,5
Laraea,F,100,5,0,5
Hadari,M,100,0,6,6
Harbin,M,100,0,6,6
Valora,F,100,183,0,183
Canice,F,100,38,0,38
Victoire,F,100,42,0,42
Burwell,M,100,0,16,16
Perrin,M,75,355,1053,1408
Yarethzy,F,100,74,0,74
Sasharae,F,100,5,0,5
Kristiano,M,100,0,16,16
Willoe,F,100,27,0,27
Marla,F,100,34321,38,34359
Sadae,F,100,72,0,72
Gabirel,M,100,0,25,25
Aniza,F,100,128,0,128
Javius,M,100,0,205,205
Tahera,F,100,18,0,18
Demariah,F,100,23,0,23
Soul,M,80,22,86,108
Andie,F,94,2955,184,3139
Alizzon,F,100,61,0,61
Kalicia,F,100,231,0,231
Arianis,F,100,35,0,35
Jujuan,M,99,5,439,444
Venitra,F,100,5,0,5
Ayvan,M,100,0,11,11
Mckae,F,100,6,0,6
Aibhlinn,F,100,74,0,74
Deuntay,M,100,0,22,22
Makhail,M,100,0,29,29
Jakelyn,F,100,344,0,344
Maguire,M,89,63,499,562
Alivianna,F,100,12,0,12
Kaibree,F,100,7,0,7
Angilique,F,100,18,0,18
Cristalle,F,100,64,0,64
Rorry,M,100,0,21,21
Jeiri,F,100,5,0,5
Sarahrose,F,100,47,0,47
Meleyah,F,100,5,0,5
Kabreyia,F,100,15,0,15
Rikkie,F,100,20,0,20
Shawnelle,F,100,117,0,117
Daysen,M,100,0,78,78
Demica,F,100,75,0,75
Korei,M,100,0,6,6
Soliana,F,100,261,0,261
Tray,M,100,0,1437,1437
Juhi,F,100,337,0,337
Jamayel,M,100,0,7,7
Joron,M,100,0,74,74
Kirstey,F,100,5,0,5
Charrisse,F,100,79,0,79
Halyn,F,100,258,0,258
Sein,M,100,0,6,6
Chazmin,F,100,57,0,57
Sharnique,F,100,13,0,13
Mykesha,F,100,51,0,51
Elowen,F,100,72,0,72
Chelbi,F,100,124,0,124
Wylma,F,100,13,0,13
Ajna,F,100,52,0,52
Lucita,F,100,143,0,143
Raphael,M,99,153,14136,14289
Valla,F,100,69,0,69
Carthell,M,100,0,5,5
Giget,F,100,5,0,5
Torino,M,79,12,45,57
Kevisha,F,100,49,0,49
Zeila,F,100,17,0,17
Aland,M,100,0,78,78
Camauri,M,62,66,107,173
Kimbrley,F,100,5,0,5
Aaniya,F,100,253,0,253
Kenslie,F,100,231,0,231
Arasele,F,100,7,0,7
Teondre,M,100,0,66,66
Trinidee,F,100,123,0,123
Keaire,F,60,15,10,25
Verdina,F,100,16,0,16
Teddi,F,100,1453,0,1453
Fleeta,F,100,62,0,62
Khamauri,M,94,5,75,80
Raeven,F,100,707,0,707
Floydene,F,100,10,0,10
Gustavia,F,100,25,0,25
Melyna,F,100,172,0,172
Qierra,F,100,5,0,5
Anjolique,F,100,5,0,5
Jkobe,M,100,0,51,51
Marquetia,F,100,8,0,8
Christieann,F,100,6,0,6
Lakee,F,54,7,6,13
Elizabeath,F,100,5,0,5
Luxton,M,100,0,5,5
Hannahlynn,F,100,5,0,5
Jodarius,M,100,0,5,5
Burgandi,F,100,22,0,22
Tyranesha,F,100,10,0,10
Giselle,F,100,38688,44,38732
Dejahnae,F,100,34,0,34
Toron,M,100,0,61,61
Micayah,F,100,37,0,37
Taiyon,M,100,0,11,11
Gieselle,F,100,6,0,6
Atef,M,100,0,6,6
Jakita,F,100,117,0,117
Giezi,M,100,0,60,60
Kenseth,M,100,0,16,16
Papa,M,100,0,187,187
Brocton,M,100,0,15,15
Saretha,F,100,28,0,28
Kiyler,M,100,0,11,11
Hanifa,F,100,104,0,104
Yul,M,100,0,630,630
Keran,F,83,25,5,30
Xaniah,F,100,5,0,5
Nerlande,F,100,11,0,11
Naja,F,100,1215,6,1221
Eneyda,F,100,18,0,18
Breslin,M,62,57,95,152
Rachella,F,100,91,0,91
Philippa,F,100,852,0,852
Ceazar,M,100,0,29,29
Herick,M,100,0,5,5
Priansh,M,100,0,5,5
Caedyn,M,77,77,259,336
Hailye,F,100,11,0,11
Banita,F,100,96,0,96
Takhi,M,100,0,22,22
Cheresse,F,100,24,0,24
Jahlisa,F,100,65,0,65
Tacy,F,100,717,0,717
Maitte,F,100,29,0,29
Beliz,F,100,5,0,5
Miosha,F,100,92,0,92
Briceson,M,100,0,152,152
Jaywanna,F,100,8,0,8
Lashandra,F,100,960,0,960
Ezequiel,M,100,0,11212,11212
Tangelia,F,100,284,0,284
Emeryn,F,100,8,0,8
Octave,M,100,0,35,35
Christaphor,M,100,0,6,6
Danilyn,F,100,105,0,105
Zendayah,F,100,37,0,37
Anthon,M,100,0,322,322
Auja,F,100,36,0,36
Nel,F,100,34,0,34
Ceyonce,F,100,5,0,5
Isaque,M,100,0,5,5
Antwonne,M,100,0,37,37
Izack,M,100,0,340,340
Roxette,F,100,35,0,35
Kolette,F,100,244,0,244
Jasmarie,F,100,170,0,170
Krisit,F,100,5,0,5
Quadeer,M,100,0,6,6
Massen,M,100,0,10,10
Hoan,M,100,0,43,43
Tydaisha,F,100,5,0,5
Deitrich,M,100,0,119,119
Jaelei,F,100,5,0,5
Dasean,M,100,0,1248,1248
Alezandria,F,100,5,0,5
Raanan,M,100,0,16,16
Shantella,F,100,197,0,197
Issay,M,100,0,5,5
Vale,M,71,24,58,82
Janessia,F,100,10,0,10
Dorra,F,100,5,0,5
Orenthal,M,100,0,277,277
Cemone,F,100,17,0,17
Trumaine,M,100,0,400,400
Laquisha,F,100,2728,0,2728
Khamal,M,100,0,30,30
Attilio,M,100,0,192,192
Jasna,F,100,10,0,10
Alea,F,100,3431,0,3431
Seirra,F,100,885,0,885
Fahima,F,100,124,0,124
Tavean,M,100,0,5,5
Azavian,M,100,0,10,10
Gara,F,100,275,0,275
Neoma,F,100,378,0,378
Arsal,M,100,0,86,86
Ruchir,M,100,0,10,10
Alaris,F,100,12,0,12
Desten,M,100,0,61,61
Willasia,F,100,5,0,5
Tervon,M,100,0,21,21
Dayro,M,100,0,6,6
Yamel,F,85,153,26,179
Bisher,M,100,0,12,12
Treyshawn,M,100,0,310,310
Aarik,M,100,0,122,122
Cael,M,100,13,2977,2990
Noelan,M,100,0,19,19
Barrett,M,95,670,13105,13775
Denzell,M,100,0,1181,1181
Deauna,F,100,84,0,84
Arkeshia,F,100,11,0,11
Muhamad,M,100,0,193,193
Lamarrion,M,100,0,32,32
Annitta,F,100,60,0,60
Saikou,M,100,0,6,6
Cherylan,F,100,7,0,7
Alexzis,F,100,5,0,5
Emmalia,F,100,164,0,164
Audreyrose,F,100,5,0,5
Matisyn,F,100,81,0,81
Apolonio,M,100,0,819,819
Vaibhavi,F,100,26,0,26
Joshual,M,100,0,146,146
Brenetta,F,100,264,0,264
Lupita,F,100,4566,0,4566
Lennia,F,100,5,0,5
Janette,F,100,22600,42,22642
Cherronda,F,100,5,0,5
Khadejah,F,100,279,0,279
Amy,F,100,658028,1819,659847
Ozella,F,100,283,0,283
Latisia,F,100,71,0,71
Myaire,M,76,5,16,21
Pepper,F,91,1804,172,1976
Tinishia,F,100,29,0,29
Giona,F,100,58,0,58
Siesta,F,100,5,0,5
Tuscany,F,100,35,0,35
Olive,F,100,7189,11,7200
Pranshu,M,100,0,50,50
Evertt,M,100,0,131,131
Mickaylah,F,100,6,0,6
Tyesa,F,100,5,0,5
Wences,M,100,0,30,30
Sarahjane,F,100,390,0,390
Charnesha,F,100,23,0,23
Janitza,F,100,284,0,284
Jamont,M,100,0,95,95
Lexsie,F,100,5,0,5
Kianga,F,100,37,0,37
Charmaigne,F,100,35,0,35
Velina,F,100,345,0,345
Navell,M,100,0,17,17
Geovanie,M,100,0,84,84
Jeweliana,F,100,243,0,243
Brye,M,74,10,28,38
Larianna,F,100,10,0,10
Naol,M,100,0,46,46
Aubreah,F,100,5,0,5
Sanskar,M,100,0,25,25
Zaden,M,100,0,1483,1483
Ghianna,F,100,22,0,22
Nishal,M,100,0,18,18
Mostafa,M,100,0,542,542
Johnise,F,100,37,0,37
Tametria,F,100,63,0,63
Deza,F,100,6,0,6
Mayzi,F,100,9,0,9
Bartolomeo,M,100,0,5,5
Annecy,F,100,17,0,17
Alanya,F,100,136,0,136
Tiniki,F,100,8,0,8
Shaquita,F,100,2391,5,2396
Felena,F,100,6,0,6
Amella,F,100,6,0,6
Sonie,F,100,45,0,45
Mackenna,F,100,2784,8,2792
Demetrios,M,100,0,2439,2439
Alayzah,F,100,10,0,10
Lulya,F,100,6,0,6
Layana,F,100,227,0,227
Ghavin,M,100,0,5,5
Latorrie,F,100,10,0,10
Giordano,M,100,0,227,227
Marshae,F,100,561,0,561
Belisario,M,100,0,7,7
Dwight,M,99,273,51813,52086
Aftab,M,100,0,20,20
Noretta,F,100,110,0,110
Thresea,F,100,177,0,177
Atasha,F,100,215,0,215
Jencarlos,M,100,0,742,742
Silveria,F,100,23,0,23
Norlisha,F,100,16,0,16
Algis,M,100,0,104,104
Chizoba,F,100,14,0,14
Iosif,M,100,0,10,10
Abbeygail,F,100,66,0,66
Joen,M,76,10,32,42
Shelese,F,100,15,0,15
Moneeb,M,100,0,5,5
Jaely,F,100,115,0,115
Rockne,M,100,0,240,240
Jordain,F,78,215,59,274
Maykaylee,F,100,5,0,5
Emmanuela,F,100,524,0,524
Tamarie,F,100,52,0,52
Tachelle,F,100,50,0,50
Ilanny,F,100,5,0,5
Santoya,F,100,22,0,22
Rauchelle,F,100,6,0,6
Qwentin,M,100,0,48,48
Auriya,F,100,7,0,7
Lemia,F,100,26,0,26
Oaklee,F,82,594,128,722
Wessam,M,100,0,17,17
Quinntin,M,100,0,125,125
Nitza,F,100,535,0,535
Adannaya,F,100,5,0,5
Michealla,F,100,54,0,54
Himari,F,100,5,0,5
Alyissa,F,100,476,0,476
Tristain,M,97,11,330,341
Junella,F,100,24,0,24
Nayirah,F,100,13,0,13
Jaleh,F,100,45,0,45
Teranique,F,100,6,0,6
Paraskeve,F,100,7,0,7
Breshawna,F,100,24,0,24
Katleen,F,100,184,0,184
Nakyla,F,100,366,0,366
Nathalye,F,100,47,0,47
Kaydn,M,76,59,188,247
Shantaye,F,100,46,0,46
Rowan,M,60,8293,12465,20758
Jamyson,M,100,0,64,64
Argenis,M,100,0,856,856
Worthington,M,100,0,12,12
Veeksha,F,100,21,0,21
Antwion,M,100,0,130,130
Wassim,M,100,0,157,157
Jessikah,F,100,101,0,101
Saadia,F,100,591,0,591
Khylige,M,100,0,5,5
Zakiyya,F,100,39,0,39
Avanya,F,100,7,0,7
Myna,F,100,107,0,107
Gurbani,F,100,30,0,30
Felicea,F,100,17,0,17
Aviah,F,100,181,0,181
Jereimah,M,100,0,5,5
Deundra,M,62,102,163,265
Latique,M,100,0,6,6
Kyllie,F,100,192,0,192
Loukas,M,100,0,285,285
Ayerim,F,100,82,0,82
Azir,M,100,0,106,106
Jakiah,F,88,357,48,405
Aliea,F,100,123,0,123
Alauni,F,100,33,0,33
Lucabella,F,100,6,0,6
Rorik,M,100,0,47,47
Adrell,M,100,0,5,5
Syretta,F,100,392,0,392
Hyson,M,100,0,5,5
Amryn,F,87,41,6,47
Dorothie,F,100,13,0,13
Jaythian,M,100,0,6,6
Saniia,F,100,18,0,18
Ahnaleigh,F,100,5,0,5
Kermith,M,100,0,10,10
Deepika,F,100,227,0,227
Akhilesh,M,100,0,132,132
Ramonte,M,100,0,69,69
Anique,F,100,287,0,287
Tracia,F,100,414,0,414
Avetis,M,100,0,34,34
Cartisha,F,100,5,0,5
Cavett,M,100,0,5,5
Chukwunonso,M,100,0,13,13
Kylar,M,70,530,1236,1766
Annesley,F,100,22,0,22
Adaelyn,F,100,6,0,6
Shabaz,M,100,0,13,13
Bearett,M,100,0,39,39
Erminio,M,100,0,61,61
Natily,F,100,58,0,58
Iridiana,F,100,154,0,154
Chiarra,F,100,5,0,5
Dilara,F,100,285,0,285
Dyanna,F,100,1501,0,1501
Cybele,F,100,148,0,148
Jaray,M,100,0,248,248
Mattisyn,F,100,147,0,147
Varonda,F,100,11,0,11
Brintney,F,100,5,0,5
Tahji,M,100,0,141,141
Marlianna,F,100,11,0,11
Brightyn,F,100,103,0,103
Jaiah,F,100,112,0,112
Ajayceon,M,100,0,8,8
Mecedes,F,100,12,0,12
Virgil,M,99,251,19476,19727
Mikaylah,F,100,1317,0,1317
Kescha,F,100,6,0,6
Aeralyn,F,100,60,0,60
Keerthi,F,100,203,0,203
Hasmik,F,100,59,0,59
Shalika,F,100,109,0,109
Tehilla,F,100,294,0,294
Cobalt,M,100,0,7,7
Vanezza,F,100,39,0,39
Abdurrehman,M,100,0,30,30
Cecile,F,100,4107,5,4112
Caritina,F,100,17,0,17
Rylann,F,88,186,25,211
Xiana,F,100,259,0,259
Dystini,F,100,5,0,5
Osher,M,100,0,147,147
Rahaman,M,100,0,11,11
Addysn,F,100,6,0,6
Yosiah,M,100,0,93,93
Luretta,F,100,44,0,44
Branch,M,100,0,224,224
Nayelis,F,100,353,0,353
Rhett,M,100,63,12709,12772
Savina,F,100,888,0,888
Nekki,F,100,5,0,5
Kayleanna,F,100,68,0,68
Jordayn,F,100,84,0,84
Reja,F,100,6,0,6
Yeila,F,100,67,0,67
Krizia,F,100,410,0,410
Dedie,F,100,16,0,16
Zalmen,M,100,0,435,435
Laurice,F,92,1028,92,1120
Marloe,F,100,20,0,20
Ranasia,F,100,41,0,41
Tejus,M,100,0,13,13
Efua,F,100,11,0,11
Haylei,F,100,693,0,693
Zakaryah,M,100,0,5,5
Kenadee,F,100,1423,0,1423
Kaprisha,F,100,38,0,38
Edzon,M,100,0,5,5
Terrell,M,96,1367,31709,33076
Lynsey,F,100,4859,0,4859
Kewana,F,100,171,0,171
Marybell,F,100,314,0,314
Kenten,M,100,0,29,29
Khuong,M,100,0,40,40
Lorann,F,100,104,0,104
Hogan,M,100,0,1133,1133
Margarete,F,100,614,0,614
Vessica,F,100,33,0,33
Kalesia,F,100,5,0,5
Dorenda,F,100,450,0,450
Latiasha,F,100,11,0,11
Reagan,F,87,40076,5771,45847
Lurenda,F,100,5,0,5
Taquasia,F,100,44,0,44
Saria,F,100,677,0,677
Adeoluwa,M,100,0,42,42
Brien,M,100,5,3373,3378
Jenneffer,F,100,15,0,15
Nabhan,M,100,0,10,10
Eleshia,F,100,160,0,160
Daneca,F,100,5,0,5
Annjeanette,F,100,91,0,91
Nathally,F,100,52,0,52
Alandis,M,100,0,54,54
Kamaile,F,100,193,0,193
Deleah,F,100,120,0,120
Nene,F,100,120,0,120
Wellsley,F,100,10,0,10
Evalyne,F,100,25,0,25
Camello,M,100,0,10,10
Naul,M,100,0,5,5
Trudy,F,100,17722,0,17722
Jaidon,M,95,65,1215,1280
Mehar,F,95,184,10,194
Marlanda,F,100,5,0,5
Doriane,F,100,39,0,39
Karren,F,100,1428,0,1428
Dadrianna,F,100,5,0,5
Jacarie,M,100,0,59,59
Jekayla,F,100,36,0,36
Niyam,M,100,0,21,21
Clancie,F,100,5,0,5
Sommers,F,100,7,0,7
Glorious,F,100,106,0,106
Khorey,M,100,0,11,11
Maelin,F,100,172,0,172
Ryot,M,100,0,75,75
Zymarion,M,100,0,94,94
Charvez,M,100,0,92,92
Tahlik,M,100,0,14,14
Bryannah,F,100,248,0,248
Jawarren,M,100,0,5,5
Arina,F,100,475,0,475
Alaira,F,100,120,0,120
Adaja,F,100,100,0,100
Charnese,F,100,83,0,83
Guinness,M,100,0,24,24
Daryal,M,100,0,18,18
Lavant,M,100,0,20,20
Shameer,M,100,0,86,86
Jeiden,M,100,0,109,109
Serenia,F,100,46,0,46
Rabab,F,100,104,0,104
Greysun,M,100,0,12,12
Braycen,M,100,0,153,153
Talyssa,F,100,85,0,85
Jlyn,F,60,164,110,274
Coramae,F,100,5,0,5
Deshawna,F,100,640,0,640
Raesean,M,100,0,78,78
Arkin,M,100,0,76,76
Khadeidra,F,100,13,0,13
Amarri,M,52,225,243,468
Iisha,F,100,254,0,254
Tzvi,M,100,0,2353,2353
Jerrye,F,100,22,0,22
Ayreonna,F,100,18,0,18
Ramsay,M,88,34,252,286
Meagen,F,100,1182,0,1182
Draquan,M,100,0,5,5
Saura,F,100,12,0,12
Arlea,F,100,5,0,5
Cardella,F,100,20,0,20
Zayne,M,98,111,4632,4743
Evander,M,100,0,1305,1305
Margarita,F,100,28213,120,28333
Jonaven,M,100,0,105,105
Daanyal,M,100,0,16,16
Tykeyah,F,100,46,0,46
Holle,F,100,76,0,76
Jonadab,M,100,0,21,21
Polina,F,100,710,0,710
Amit,M,94,177,2736,2913
Tanashia,F,100,201,0,201
Sergey,M,100,0,378,378
Ranayah,F,100,6,0,6
Kalden,M,100,0,70,70
Grahame,M,100,0,6,6
Donniece,F,100,10,0,10
Lehua,F,100,253,0,253
Temekia,F,100,259,0,259
Doyl,M,100,0,5,5
Azeeza,F,100,5,0,5
Sophear,M,56,8,10,18
Masuma,F,100,5,0,5
Vanae,F,100,31,0,31
Rustyn,M,100,0,99,99
Adalys,F,100,30,0,30
Huzaifa,M,100,0,174,174
Jemekia,F,100,5,0,5
Lynna,F,100,1364,0,1364
Aleccia,F,100,6,0,6
Baraah,F,100,13,0,13
Teriyana,F,100,6,0,6
Sahith,M,100,0,98,98
Iktan,M,100,0,36,36
Mayanna,F,100,82,0,82
Hasson,M,100,0,324,324
Ritvika,F,100,15,0,15
Danielly,F,100,65,0,65
Mena,F,87,1002,145,1147
Evangelene,F,100,133,0,133
Reginea,F,100,5,0,5
Rokiya,F,100,5,0,5
Karmell,M,100,0,21,21
Tailyr,F,100,15,0,15
Zanaiyah,F,100,30,0,30
Kenniya,F,100,164,0,164
Guiselle,F,100,151,0,151
Duke,M,100,0,5048,5048
Haoxuan,M,100,0,8,8
Trinty,F,100,137,0,137
Mchale,M,100,0,33,33
Nirek,M,100,0,5,5
Timote,M,100,0,5,5
Sepp,M,100,0,5,5
Brityn,F,100,117,0,117
Cormick,M,100,0,77,77
Xariah,F,100,79,0,79
Ciaria,F,100,11,0,11
Sakya,F,100,10,0,10
Enaya,F,100,177,0,177
Shameekia,F,100,6,0,6
Dameika,F,100,5,0,5
Kaleiah,F,100,98,0,98
Stormi,F,100,1893,0,1893
Katey,F,100,2289,0,2289
Diyor,M,100,0,10,10
Dewyne,M,100,0,5,5
Jalijah,M,100,0,29,29
Artist,M,100,0,90,90
Zanda,F,100,7,0,7
Cosmos,M,100,0,9,9
Esaw,M,100,0,78,78
Roberth,M,100,0,62,62
Lashawna,F,100,1779,0,1779
Jonson,M,100,0,16,16
Mattye,F,100,24,0,24
Navan,M,100,0,5,5
Netta,F,100,328,0,328
Leonarda,F,100,309,0,309
Jodine,F,100,457,0,457
Akeiba,F,100,60,0,60
Jamerria,F,100,29,0,29
Dewanda,F,100,663,0,663
Kerstyn,F,100,421,0,421
Jyvon,M,100,0,5,5
Tajon,M,100,0,308,308
Amdrew,M,100,0,104,104
Tywane,M,100,0,5,5
Bayli,F,100,964,0,964
Lerhonda,F,100,19,0,19
Javea,F,100,5,0,5
Germani,F,100,100,0,100
Olamilekan,M,100,0,5,5
Missty,F,100,10,0,10
Jeaven,M,100,0,7,7
Breon,M,88,290,2082,2372
Vivyan,F,100,67,0,67
Kalifah,F,100,5,0,5
Mccauley,M,76,21,66,87
Aniella,F,100,120,0,120
Misato,F,100,35,0,35
Irem,F,100,78,0,78
Nelcy,F,100,11,0,11
Elza,M,51,225,233,458
Sarena,F,100,2298,0,2298
Sable,F,100,1361,0,1361
Anupama,F,100,171,0,171
Delmas,M,100,0,718,718
Yanay,F,100,5,0,5
Jincy,F,100,27,0,27
Jillienne,F,100,57,0,57
Laissa,F,100,12,0,12
Hulises,M,100,0,41,41
Zecharia,M,100,0,35,35
Naythan,M,100,0,631,631
Gabriella,F,100,99822,60,99882
Quentavious,M,100,0,184,184
Verta,F,100,124,0,124
Burklee,F,100,17,0,17
Kylasia,F,100,8,0,8
Isabellarose,F,100,99,0,99
Itsuki,M,100,0,30,30
Keyle,F,100,106,0,106
Donis,F,67,112,54,166
Roiza,F,100,101,0,101
Thamar,F,94,85,5,90
Abdulahi,M,100,0,344,344
Sandry,F,100,5,0,5
Tamaris,F,55,32,26,58
Khrystyna,F,100,65,0,65
Kunte,M,100,0,26,26
Brently,M,98,18,948,966
Chadd,M,100,0,2436,2436
Zarai,F,100,185,0,185
Marbeya,F,100,5,0,5
Ederson,M,100,0,26,26
Christlynn,F,100,6,0,6
Ziqi,F,100,19,0,19
Chalese,F,100,73,0,73
Mao,F,97,278,10,288
Alecxis,M,100,0,75,75
Kejon,M,100,0,64,64
Yarlin,F,100,89,0,89
Josha,M,94,28,426,454
Dinene,F,100,7,0,7
Latrenia,F,100,11,0,11
Jarieliz,F,100,22,0,22
Nathan,M,100,1650,490399,492049
Shantiel,F,100,5,0,5
Jabril,M,100,0,1192,1192
Ahnyia,F,100,5,0,5
Makinzie,F,100,784,0,784
Taraya,F,100,122,0,122
Jerimia,M,100,0,16,16
Aylin,F,100,8451,5,8456
Edras,M,100,0,42,42
Haaziq,M,100,0,14,14
Uvonka,F,100,5,0,5
Alexa,F,100,107727,241,107968
Talicia,F,100,542,0,542
Nekiesha,F,100,6,0,6
Elvyn,M,100,0,6,6
Briseida,F,100,2131,0,2131
Filmon,M,100,0,17,17
Demetras,F,100,5,0,5
Eagle,M,100,0,64,64
Carlitha,F,100,5,0,5
Stepanie,F,100,676,0,676
Cozmo,M,100,0,5,5
Avarey,F,100,113,0,113
Vishak,M,100,0,6,6
Genivieve,F,100,12,0,12
Vernasia,F,100,5,0,5
Meriyah,F,100,46,0,46
Richardd,M,100,0,31,31
Tasir,M,100,0,7,7
Chimamanda,F,100,130,0,130
Elspeth,F,100,632,0,632
Alyana,F,100,1174,0,1174
Dilin,M,100,0,24,24
Kimitra,F,100,6,0,6
Raengel,F,100,22,0,22
Greycin,M,100,0,6,6
Lianabel,F,100,5,0,5
Mckalyn,F,100,23,0,23
Antonae,F,100,89,0,89
Lanna,F,100,1627,0,1627
Halina,F,100,730,0,730
Jasiyah,F,64,301,166,467
Lulamae,F,100,6,0,6
Kuwanna,F,100,5,0,5
Dorain,M,85,7,40,47
Jeanny,F,100,361,0,361
Tysyn,M,100,0,6,6
Deboral,F,100,5,0,5
Ikesha,F,100,88,0,88
Yazareth,F,100,6,0,6
Bari,F,93,1553,111,1664
Condace,F,100,5,0,5
Shykim,M,100,0,13,13
Tiquisha,F,100,5,0,5
Dorrian,M,93,31,411,442
Saleigh,F,100,5,0,5
Jaosn,M,100,0,5,5
Demontay,M,100,0,202,202
Toussaint,M,100,0,363,363
Emra,F,100,10,0,10
Fynleigh,F,100,21,0,21
Tempe,F,100,34,0,34
Cornisha,F,100,227,0,227
Marleni,F,100,590,0,590
Shalexus,F,100,14,0,14
Jerilou,F,100,9,0,9
Tarah,F,100,4613,0,4613
Daimen,M,100,0,286,286
Christiann,F,100,303,0,303
Lisander,M,100,0,19,19
Azriela,F,100,34,0,34
Bezalel,M,100,0,17,17
Rychelle,F,100,37,0,37
Kishanna,F,100,5,0,5
Tawhid,M,100,0,27,27
Amato,M,100,0,5,5
Rhaheem,M,100,0,5,5
Brytin,M,100,0,10,10
Deverick,M,100,0,98,98
Demorion,M,100,0,26,26
Courtlin,M,78,13,46,59
Zeyna,F,100,32,0,32
Kellyjean,F,100,13,0,13
Chilton,M,100,0,52,52
Meradith,F,100,34,0,34
Bradyn,M,95,217,4040,4257
Kyleighann,F,100,6,0,6
Jawane,M,100,0,5,5
Jacklynn,F,100,1851,0,1851
Jase,M,99,89,14302,14391
Minely,F,100,5,0,5
Sayri,F,100,12,0,12
Iker,M,100,0,6714,6714
Thermon,M,100,0,146,146
Marvyn,M,100,0,203,203
Hanya,F,100,58,0,58
Yeny,F,100,108,0,108
Marili,F,100,255,0,255
Daine,M,50,285,288,573
Neeraja,F,100,11,0,11
Brisseida,F,100,5,0,5
Chikaima,F,100,12,0,12
Faustine,F,100,71,0,71
Mikkos,M,100,0,21,21
Chrishaun,M,98,5,239,244
Arrica,F,100,54,0,54
Stefannie,F,100,69,0,69
Cyrena,F,100,713,0,713
Shameah,F,100,7,0,7
Lawernce,M,100,0,443,443
Charmika,F,100,63,0,63
Diontray,M,100,0,5,5
Camoni,F,100,14,0,14
Neji,M,100,0,12,12
Arneisha,F,100,124,0,124
Kasie,F,99,4061,21,4082
Heavenlee,F,100,511,0,511
Sandee,F,100,1365,0,1365
Saumil,M,100,0,10,10
Robette,F,100,12,0,12
Lukes,M,100,0,52,52
Kadell,M,100,0,11,11
Victory,F,69,840,374,1214
Rod,M,100,0,7394,7394
Nanaakua,F,100,12,0,12
Fran,F,92,3340,284,3624
Krithika,F,100,133,0,133
Trail,M,100,0,5,5
Amany,F,100,175,0,175
Yoram,M,100,0,6,6
Shaula,F,100,50,0,50
Kishun,M,100,0,7,7
Bekam,M,100,0,6,6
Ginessa,F,100,21,0,21
Dequawn,M,100,0,59,59
Missi,F,100,222,0,222
Kyeron,M,100,0,10,10
Krisna,F,88,94,13,107
Leartis,M,100,0,19,19
Evangaline,F,100,92,0,92
Shareek,M,100,0,5,5
Rositta,F,100,10,0,10
Dayanni,F,100,52,0,52
Ansel,M,100,0,1804,1804
Irshad,M,100,0,5,5
Nahomi,F,100,957,0,957
Shawan,F,80,236,59,295
Ziraili,F,100,13,0,13
Zykira,F,100,245,0,245
Chenier,M,100,0,15,15
Nikeyia,F,100,5,0,5
Sanetra,F,100,10,0,10
Kimmey,F,100,23,0,23
Jemimah,F,100,263,0,263
Kealan,M,100,0,256,256
Shine,F,67,104,52,156
Jacqlyn,F,100,725,0,725
Rayea,F,100,5,0,5
Jahmaya,F,100,23,0,23
Elinda,F,100,207,0,207
Fleshia,F,100,24,0,24
Desyree,F,100,32,0,32
Delvonte,M,100,0,168,168
Paget,F,100,38,0,38
Geraline,F,100,138,0,138
Zonnie,M,65,6,11,17
Jamelle,M,68,364,761,1125
Chole,F,100,1507,0,1507
Kelinda,F,100,23,0,23
Daun,F,98,657,12,669
Quatavia,F,100,24,0,24
Smyrna,F,100,5,0,5
Jahmali,M,100,0,25,25
Ellodie,F,100,14,0,14
Hasita,F,100,11,0,11
Mylika,F,100,7,0,7
Jersiah,M,100,0,20,20
Syra,F,100,242,0,242
Temesgen,M,100,0,34,34
Zaray,F,100,66,0,66
Samisha,F,100,6,0,6
Tashayla,F,100,432,0,432
Sieglinde,F,100,16,0,16
Akhilleus,M,100,0,6,6
Zeasia,F,100,5,0,5
Akasha,F,100,1086,0,1086
Rodnee,M,100,0,10,10
Jensen,M,72,2178,5545,7723
Montanez,M,100,0,5,5
Haleyjo,F,100,5,0,5
Nikiea,F,100,7,0,7
Kaniya,F,100,2086,0,2086
Yesmin,F,100,150,0,150
Jakeia,F,100,99,0,99
Regis,M,95,128,2291,2419
Hendel,F,100,55,0,55
Ketzalli,F,100,5,0,5
Tammia,F,100,29,0,29
Cebria,F,100,5,0,5
Estill,M,100,0,278,278
Ermelinda,F,100,938,0,938
Deirra,F,100,16,0,16
Alanie,F,100,455,0,455
Jasilyn,F,100,92,0,92
Rixon,M,100,0,14,14
Jaymiya,F,100,5,0,5
Chia,F,76,214,69,283
Nicolete,F,100,5,0,5
Jiavanna,F,100,5,0,5
Dasaun,M,100,0,31,31
Wykesha,F,100,43,0,43
Amiryah,F,100,5,0,5
Bristyl,F,100,61,0,61
Artavion,M,100,0,46,46
Meagon,F,100,240,0,240
Elgin,M,100,0,2153,2153
Natsuki,F,100,28,0,28
Zinaya,F,100,17,0,17
Jing,F,92,120,10,130
Jacylyn,F,100,11,0,11
Elisbeth,F,100,5,0,5
Mailei,F,100,20,0,20
Sadeem,F,100,15,0,15
Price,M,99,24,1772,1796
Crisel,F,100,24,0,24
Preciousa,F,100,5,0,5
Loveleen,F,100,43,0,43
Burchell,M,100,0,10,10
Darionne,M,100,0,5,5
Josmarie,F,100,11,0,11
Renetha,F,100,22,0,22
Jeaneane,F,100,50,0,50
Dreshawn,M,100,0,595,595
Lataria,F,100,69,0,69
Bostin,M,100,0,17,17
Deniene,F,100,12,0,12
Susana,F,100,18565,52,18617
Delycia,F,100,6,0,6
Kayelyn,F,100,270,0,270
Yairy,F,100,5,0,5
Zani,F,78,70,20,90
Natara,F,100,154,0,154
Litia,F,100,31,0,31
Johnie,M,88,453,3172,3625
Paymon,M,100,0,57,57
Alfonse,M,100,0,356,356
Ridger,M,100,0,5,5
Nakuma,M,100,0,15,15
Warith,M,100,0,17,17
Dejia,F,100,228,0,228
Leveah,F,100,22,0,22
Jesyka,F,100,94,0,94
Breeah,F,100,41,0,41
Ede,F,100,17,0,17
Valiant,M,100,0,134,134
Tamka,F,100,9,0,9
Randine,F,100,22,0,22
Hondo,M,100,0,58,58
Yonah,M,100,0,569,569
Tangerine,F,100,39,0,39
Deziah,F,97,173,5,178
Halton,M,100,0,32,32
Latimer,M,100,0,17,17
Daleah,F,100,187,0,187
Idelle,F,100,99,0,99
Shanterra,F,100,36,0,36
Hajra,F,100,138,0,138
Dureen,F,100,15,0,15
Crichton,M,100,0,18,18
Willene,F,100,584,0,584
Lendra,F,100,5,0,5
Durga,F,100,39,0,39
Dakodah,M,59,28,41,69
Jaquavien,M,100,0,5,5
Katylynn,F,100,12,0,12
Tanetta,F,100,81,0,81
Nella,F,100,1022,0,1022
Lavander,M,100,0,15,15
Tamilla,F,100,17,0,17
Sedra,F,100,105,0,105
Clarissa,F,100,33930,21,33951
Jaiden,M,75,7728,23710,31438
Malachai,M,100,0,851,851
Stokes,M,100,0,30,30
Adynn,M,79,17,63,80
Shadrack,M,100,0,110,110
Chetara,F,100,73,0,73
Heartlee,F,100,15,0,15
Malley,F,100,165,0,165
Kenadey,F,100,5,0,5
Shenequa,F,100,506,0,506
Katedra,F,100,10,0,10
Heston,M,100,0,916,916
Zaeveon,M,100,0,11,11
Viral,M,100,0,63,63
Deyonte,M,100,0,127,127
Ioane,M,100,0,76,76
Marquette,M,65,647,1207,1854
Mahsiah,M,100,0,6,6
Nikolaas,M,100,0,11,11
Nekhi,M,100,0,117,117
Nikia,F,94,3714,246,3960
Faedra,F,100,7,0,7
Jerray,M,100,0,17,17
Jeymi,F,100,135,0,135
Carlet,F,100,8,0,8
Cadince,F,100,111,0,111
Paxon,M,100,0,240,240
Larue,M,57,462,609,1071
Chyral,F,100,15,0,15
Chavonne,F,100,512,0,512
Theres,F,100,23,0,23
Briceyda,F,100,187,0,187
Tarneisha,F,100,5,0,5
Demarlo,M,100,0,210,210
Shaqulia,F,100,10,0,10
Xenophon,M,100,0,5,5
Erinne,F,100,243,0,243
Kassidi,F,100,941,0,941
Seam,M,100,0,18,18
Harlen,M,99,9,1183,1192
Charisse,F,100,5225,0,5225
Justian,M,100,0,45,45
Silken,F,100,12,0,12
Dejanique,F,100,269,0,269
Rubi,F,100,6909,14,6923
Aubrin,F,100,11,0,11
Kylah,F,100,4268,0,4268
Lissbet,F,100,5,0,5
Rejanae,F,100,5,0,5
Gennell,F,100,84,0,84
Oddis,M,100,0,6,6
Lamarra,F,100,5,0,5
Enock,M,100,0,35,35
Zharyah,F,100,5,0,5
Diavion,F,87,99,15,114
Enajah,F,100,22,0,22
Elizabelle,F,100,42,0,42
Demisha,F,100,237,0,237
Michelann,F,100,8,0,8
Zacchaeus,M,100,0,1417,1417
Justys,M,100,0,5,5
Thana,F,100,36,0,36
Jatavis,M,100,0,80,80
Yeilin,F,100,194,0,194
Dequarious,M,100,0,20,20
Hernandez,M,100,0,109,109
Jakima,F,100,50,0,50
Joshu,M,100,0,96,96
Kimara,F,100,555,0,555
Beny,M,100,0,33,33
Anij,F,100,5,0,5
Kashaunda,F,100,5,0,5
Deshala,F,100,33,0,33
Cassadra,F,100,6,0,6
Kasidy,F,100,544,0,544
Armon,M,100,0,2357,2357
Amareah,F,100,5,0,5
Severen,M,100,0,5,5
Eola,F,100,11,0,11
Caitriona,F,100,186,0,186
Quashan,M,100,0,5,5
Quintus,M,100,0,324,324
Caffrey,M,100,0,14,14
Jaromir,M,100,0,6,6
Aliaya,F,100,30,0,30
Kahia,F,100,11,0,11
Jericca,F,100,68,0,68
Uzayr,M,100,0,10,10
Tirah,F,100,30,0,30
Bereket,M,100,0,100,100
Ariauna,F,100,347,0,347
Madisin,F,100,110,0,110
Brooklynne,F,100,1601,0,1601
Shanquille,M,100,0,9,9
Ineisha,F,100,16,0,16
Deisree,F,100,5,0,5
Shaqunda,F,100,30,0,30
Aglae,F,100,7,0,7
Alexson,M,100,0,5,5
Shamese,F,100,15,0,15
Daleila,F,100,5,0,5
Kajia,F,100,10,0,10
Antrice,F,100,55,0,55
Mekhai,M,100,0,306,306
Dashanae,F,100,160,0,160
Matylda,F,100,74,0,74
Paz,F,72,286,110,396
Hillari,F,100,250,0,250
Olicia,F,100,23,0,23
Biyanca,F,100,5,0,5
Rueben,M,100,0,2930,2930
Keiffer,M,100,0,164,164
Daylany,F,100,7,0,7
Damiyah,F,100,624,0,624
Nanayaw,M,100,0,29,29
Irbin,M,100,0,116,116
Cailon,F,100,7,0,7
Jaleshia,F,100,44,0,44
Brom,M,100,0,11,11
Deboarh,F,100,11,0,11
Norelle,F,100,102,0,102
Lucilla,F,100,378,0,378
Ravine,F,100,5,0,5
Masina,F,100,22,0,22
Hiroaki,M,100,0,20,20
Loral,F,100,83,0,83
Elsy,F,100,994,0,994
Lavonna,F,100,1273,0,1273
Lillyth,F,100,60,0,60
Elbis,M,100,0,5,5
Lusana,F,100,5,0,5
Shinise,F,100,10,0,10
Nyleve,F,100,5,0,5
Shyaira,F,100,10,0,10
Aleijah,F,100,59,0,59
Jahquez,M,100,0,136,136
Markitta,F,100,99,0,99
Taishaun,M,100,0,88,88
Maksym,M,100,0,271,271
Retisha,F,100,6,0,6
Ahmyiah,F,100,12,0,12
Diahanna,F,100,32,0,32
Gurjit,M,100,0,10,10
Jevaughn,M,100,0,154,154
Andino,M,100,0,7,7
Makil,M,100,0,11,11
Sulema,F,100,1522,0,1522
Zya,F,100,428,0,428
Shenna,F,100,1322,0,1322
Johntae,M,98,7,307,314
Kellin,M,86,83,528,611
Jamare,M,100,0,436,436
Morganna,F,100,121,0,121
Magabi,F,100,14,0,14
Dzire,F,100,12,0,12
Mirracle,F,100,8,0,8
Delishia,F,100,43,0,43
Sakurako,F,100,20,0,20
Chidiebube,M,100,0,6,6
Jazlena,F,100,5,0,5
Rachel,F,100,497681,1497,499178
Attison,F,100,39,0,39
Baillee,F,100,13,0,13
Ewanda,F,100,5,0,5
Josiel,M,100,0,229,229
Ishraq,M,100,0,25,25
Yanin,F,100,129,0,129
Amberlee,F,100,1709,0,1709
Baine,M,100,0,142,142
Rabeka,F,100,35,0,35
Isabeau,F,100,330,0,330
Etienne,M,94,81,1216,1297
Brander,M,100,0,5,5
Leston,M,100,0,33,33
Miyanah,F,100,27,0,27
Rian,M,60,2612,3875,6487
Ayannah,F,100,572,0,572
Leart,M,100,0,29,29
Courtenay,F,83,1151,229,1380
Frederik,M,100,0,425,425
Tayshaun,M,99,10,1188,1198
Zowie,F,100,685,0,685
Hommy,M,100,0,6,6
Ashwini,F,100,143,0,143
Laroy,M,100,0,778,778
Kaleea,F,100,70,0,70
Davidjames,M,100,0,77,77
Apples,F,100,6,0,6
Kaeveon,M,100,0,13,13
Rosilee,F,100,6,0,6
Suhan,M,100,0,47,47
Vinci,M,62,5,8,13
Quess,M,100,0,16,16
Kevinjoseph,M,100,0,15,15
Iraida,F,100,519,0,519
Arlester,M,100,0,83,83
Tetsuya,M,100,0,12,12
Jeenifer,F,100,5,0,5
Dazaria,F,100,99,0,99
Axiel,M,100,0,30,30
Catoria,F,100,6,0,6
Maleea,F,100,185,0,185
Kimberly,F,99,826857,4165,831022
Norwood,M,100,0,742,742
Ranea,F,100,59,0,59
Javieon,M,100,0,28,28
Topper,M,100,0,5,5
Odon,M,100,0,10,10
Indu,F,100,10,0,10
Lynnlea,F,100,5,0,5
Moniq,F,100,5,0,5
Andropolis,M,100,0,6,6
Tyresha,F,100,607,0,607
Eurydice,F,100,67,0,67
Yicel,F,100,86,0,86
Shanida,F,100,17,0,17
Noemy,F,100,1551,0,1551
Shaughn,M,99,5,387,392
Dnyah,F,100,20,0,20
Tiffiani,F,100,10,0,10
Alekxa,F,100,6,0,6
Adelbert,M,100,0,436,436
Raziyah,F,100,156,0,156
Adaku,F,100,7,0,7
Matty,F,94,458,30,488
Joerell,M,100,0,12,12
Eugune,M,100,0,49,49
Qianna,F,100,160,0,160
Wiktoria,F,100,258,0,258
Teena,F,100,5348,0,5348
Anaia,F,100,339,0,339
Roshunda,F,100,589,0,589
Quanta,F,57,93,70,163
Cammi,F,100,636,0,636
Keantay,M,100,0,5,5
Tjay,M,100,0,125,125
Cortez,M,100,33,8958,8991
Story,F,94,859,50,909
Marchetta,F,100,57,0,57
Mehan,F,100,22,0,22
Jawanna,F,100,306,0,306
Zali,F,100,32,0,32
Zaragoza,M,100,0,6,6
Coralin,F,100,6,0,6
Lajavion,M,100,0,26,26
Cheryln,F,100,175,0,175
Mlisa,F,100,10,0,10
Lanayah,F,100,180,0,180
Francelia,F,100,159,0,159
Xandar,M,100,0,15,15
Devinn,M,73,100,264,364
Shanmukh,M,100,0,5,5
Roneal,M,100,0,5,5
Jeet,M,100,0,179,179
Dequanta,M,100,0,22,22
Chaslynn,F,100,18,0,18
Lydell,M,100,0,1785,1785
Dayna,F,99,13866,87,13953
Randee,F,93,2533,179,2712
Akeda,F,100,7,0,7
Yonael,M,100,0,18,18
Luigi,M,100,0,3001,3001
Chaylyn,F,100,6,0,6
Hasset,F,100,57,0,57
Kenjanae,F,100,5,0,5
Brentney,F,100,107,0,107
Vaani,F,100,60,0,60
Lilian,F,100,12499,0,12499
Hatti,F,100,37,0,37
Owyn,M,98,10,458,468
Somiah,F,100,5,0,5
Khyan,M,100,0,44,44
Vonceil,F,100,73,0,73
Jonan,M,100,0,177,177
Delmario,M,100,0,11,11
Zaiyanna,F,100,5,0,5
Kailon,M,96,7,177,184
Yoskar,M,100,0,136,136
Arthi,F,100,85,0,85
Dayzhane,F,100,10,0,10
Marshell,F,64,636,358,994
Ngina,F,100,77,0,77
Zavien,M,100,0,553,553
Johnta,M,98,5,224,229
Tawonda,F,100,82,0,82
Monroe,M,72,1513,3979,5492
Marneisha,F,100,23,0,23
Kiondre,M,100,0,96,96
Michelangelo,M,100,0,794,794
Kaelob,M,100,0,170,170
Natylie,F,100,17,0,17
Jomiah,F,100,5,0,5
Wanza,F,100,101,0,101
Cynetha,F,100,6,0,6
Alyxander,M,100,0,123,123
Sohaan,M,100,0,6,6
Lubov,F,100,11,0,11
Milam,M,100,0,67,67
Thomesha,F,100,33,0,33
Jaso,M,100,0,12,12
Kline,M,100,0,64,64
Zykeith,M,100,0,20,20
Kiwan,M,100,0,97,97
Moneisha,F,100,140,0,140
Dequisha,F,100,27,0,27
Timberlynn,F,100,19,0,19
Dawone,M,100,0,22,22
Kagan,M,89,68,541,609
Briuna,F,100,50,0,50
Zayin,M,100,0,103,103
Peggie,F,100,2471,0,2471
Sohanny,F,100,14,0,14
Kuntakinte,M,100,0,6,6
Sevy,M,100,0,10,10
Reginaldo,M,100,0,368,368
Kail,M,94,36,519,555
Braeton,M,100,0,65,65
Joslen,F,100,16,0,16
Suzett,F,100,51,0,51
Kimmya,F,100,28,0,28
Shenetta,F,100,230,0,230
Megham,F,100,91,0,91
Keleigh,F,100,722,0,722
Jharline,F,100,25,0,25
Luwanna,F,100,160,0,160
Shanze,F,100,10,0,10
Zhaiden,M,100,0,16,16
Aryanah,F,100,255,0,255
Carnel,M,100,0,151,151
Makhi,M,99,39,2586,2625
Tonette,F,100,1439,0,1439
Massai,M,100,0,56,56
Veton,M,100,0,8,8
Bray,M,97,13,400,413
Analidia,F,100,5,0,5
Latreasa,F,100,15,0,15
Khyon,M,100,0,25,25
Sahen,M,100,0,5,5
Toyna,F,100,276,0,276
Chisara,F,100,5,0,5
Kassondra,F,100,927,0,927
Viktor,M,100,0,1934,1934
Shelline,F,100,11,0,11
Tawfiq,M,100,0,71,71
Yarett,F,100,5,0,5
Galene,F,100,42,0,42
Aditi,F,100,2697,0,2697
Verlina,F,100,27,0,27
Lohith,M,100,0,38,38
Erskine,M,100,0,936,936
Haitham,M,100,0,195,195
Leannah,F,100,179,0,179
Dacorian,M,100,0,55,55
Knoa,M,100,0,14,14
Tamikca,F,100,5,0,5
Mildre,F,100,5,0,5
Brenndan,M,100,0,56,56
Treylyn,M,100,0,6,6
Chaderick,M,100,0,45,45
Devn,M,100,0,5,5
Taurence,M,100,0,27,27
Kachet,F,100,6,0,6
Aryahna,F,100,74,0,74
Brig,M,100,0,42,42
Verronica,F,100,12,0,12
Desa,F,100,239,0,239
Daqwane,M,100,0,5,5
Marriann,F,100,20,0,20
Ellagrace,F,100,222,0,222
Keiondre,M,100,0,122,122
Praxton,M,100,0,11,11
Neimar,M,100,0,40,40
Deangelis,F,100,13,0,13
Elisei,M,100,0,5,5
Verlean,F,100,143,0,143
Haroun,M,100,0,139,139
Leviathan,M,100,0,216,216
Jimmi,F,84,260,49,309
Darron,M,100,5,5916,5921
Marsue,F,100,5,0,5
Jaeleigh,F,100,213,0,213
Jelena,F,100,1167,0,1167
Taft,M,100,0,682,682
Larina,F,100,414,0,414
Ulrica,F,100,60,0,60
Murilo,M,100,0,26,26
Aldonia,F,100,6,0,6
Jamaka,F,100,31,0,31
Hasti,F,100,29,0,29
Shley,F,100,127,0,127
Vedra,F,100,20,0,20
Demi,F,100,6771,0,6771
Zyrion,M,100,0,84,84
Elisabeta,F,100,5,0,5
Jayse,M,98,23,1309,1332
Abha,F,100,40,0,40
Dannaka,F,100,6,0,6
Suhaila,F,100,120,0,120
Kayven,M,100,0,114,114
Kadira,F,100,13,0,13
Alyce,F,100,4753,0,4753
Tynisa,F,100,215,0,215
Naleyah,F,100,45,0,45
Abreanna,F,100,256,0,256
Shirel,F,100,235,0,235
Damaury,M,100,0,18,18
Koven,M,100,0,73,73
Saina,F,100,145,0,145
Libia,F,100,62,0,62
Keimari,M,67,24,49,73
Levera,F,100,10,0,10
Rasheedah,F,100,930,0,930
Jamayka,F,100,16,0,16
Geomar,M,100,0,30,30
Nyosha,F,100,5,0,5
Zyanne,F,100,84,0,84
Mateen,M,100,0,454,454
Melisia,F,100,118,0,118
Maegan,F,100,9065,0,9065
Durward,M,100,0,463,463
Lakeria,F,100,259,0,259
Dasheika,F,100,5,0,5
Thurmon,M,100,0,244,244
Elijaha,M,100,0,38,38
Iryanna,F,100,16,0,16
Uyiosa,M,100,0,5,5
Timoty,M,100,0,141,141
Latreca,F,100,5,0,5
Wyvonna,F,100,5,0,5
Haddi,F,100,21,0,21
Reegan,F,79,964,263,1227
Mohanad,M,100,0,128,128
Cynthnia,F,100,6,0,6
Miu,F,100,67,0,67
Chelseaanne,F,100,10,0,10
Dashanti,F,100,181,0,181
Promize,F,100,25,0,25
Enyah,F,100,70,0,70
Caroll,F,67,506,248,754
Stylianos,M,100,0,51,51
Jahquel,M,100,0,29,29
Nijaya,F,100,27,0,27
Auther,M,100,0,435,435
Victorjr,M,100,0,10,10
Chrishanna,F,100,42,0,42
Jhase,M,100,0,179,179
Mayzee,F,100,78,0,78
Larnice,F,100,5,0,5
Ricci,M,51,826,848,1674
Jaivian,M,100,0,73,73
Cashous,M,100,0,11,11
Kean,M,100,0,784,784
Janetta,F,100,2282,0,2282
Friedrich,M,100,0,381,381
Narely,F,100,108,0,108
Wane,M,100,0,120,120
Krystall,F,100,170,0,170
Conswella,F,100,186,0,186
Gertrudis,F,100,17,0,17
Lamondre,M,100,0,74,74
Jenavieve,F,100,637,0,637
Tyrez,M,100,0,235,235
Linoy,F,100,13,0,13
Dezhan,M,100,0,5,5
Vamika,F,100,5,0,5
Nou,F,86,352,56,408
Amie,F,100,19204,19,19223
Cristofer,M,100,0,3404,3404
Jrayden,M,100,0,10,10
Sajda,F,100,13,0,13
Lukan,M,100,0,10,10
Taliek,M,100,0,44,44
Claudy,M,100,0,45,45
Brunson,M,100,0,10,10
Chelsie,F,100,13545,0,13545
Jalaylah,F,100,5,0,5
Skieler,F,100,5,0,5
Jennye,F,100,30,0,30
Shauntez,M,100,0,30,30
Estephanie,F,100,1724,0,1724
Asianah,F,100,5,0,5
Sarakate,F,100,12,0,12
Aaliha,F,100,12,0,12
Mantej,M,100,0,8,8
Yathziry,F,100,12,0,12
Tahis,F,100,14,0,14
Dionysus,M,100,0,27,27
Demetrias,M,72,49,127,176
Ashtin,M,51,1158,1206,2364
Nadea,F,100,64,0,64
Mohamedamin,M,100,0,95,95
Darylene,F,100,10,0,10
Dejanea,F,100,20,0,20
Mikailah,F,100,161,0,161
Danne,F,78,450,127,577
Jeanjacques,M,100,0,5,5
Raleen,F,100,5,0,5
Chakeya,F,100,5,0,5
Shone,M,87,51,335,386
Noelly,F,100,88,0,88
Giana,F,100,6990,0,6990
Wylliam,M,100,0,21,21
Lucyrose,F,100,5,0,5
Raynae,F,100,5,0,5
Kymarie,F,100,10,0,10
Ashlynd,F,100,236,0,236
Shambre,F,100,24,0,24
Malica,F,100,10,0,10
Cameshia,F,100,126,0,126
Jakalen,M,100,0,12,12
Elleanor,F,100,213,0,213
Jillyn,F,100,171,0,171
Aniqa,F,100,89,0,89
Gail,F,98,128911,2079,130990
Tasman,M,100,0,33,33
Donicia,F,100,56,0,56
Mahie,F,100,5,0,5
Jerrod,M,100,10,9118,9128
Chantil,F,100,221,0,221
Jeroen,M,100,0,6,6
Aleksandra,F,100,2361,0,2361
Cornecia,F,100,6,0,6
Ansh,M,100,0,1188,1188
Casius,M,100,0,15,15
Lynh,F,100,10,0,10
Nyteria,F,100,18,0,18
Tage,M,100,0,389,389
Adeniyi,M,100,0,20,20
Lyly,F,100,115,0,115
Nasteho,F,100,73,0,73
Altheria,F,100,54,0,54
Harlea,F,100,110,0,110
Merjem,F,100,15,0,15
Deerika,F,100,14,0,14
Stephenmichael,M,100,0,6,6
Mekih,M,100,0,5,5
Rickiya,F,100,83,0,83
Denoris,M,100,0,5,5
Steffany,F,100,1741,0,1741
Nyran,M,100,0,5,5
Seydina,M,100,0,41,41
Feliciano,M,100,0,1582,1582
Icee,F,100,10,0,10
Rayvn,F,100,52,0,52
Sloka,F,100,104,0,104
Zaylei,F,100,25,0,25
Rajvir,M,100,0,122,122
Deazia,F,100,62,0,62
Vidhi,F,100,451,0,451
Awbree,F,100,22,0,22
Ameriah,F,100,174,0,174
Alesana,F,100,136,0,136
Zailee,F,100,128,0,128
Caronda,F,100,53,0,53
Franyelis,F,100,5,0,5
Zoanne,F,100,50,0,50
Vernessa,F,100,866,0,866
Jazib,M,100,0,12,12
Ambr,F,100,10,0,10
Chandelle,F,100,242,0,242
Alander,M,100,0,5,5
Josemiguel,M,100,0,377,377
Liberato,M,100,0,5,5
Jaleisha,F,100,41,0,41
Keston,M,100,0,572,572
Taquesha,F,100,53,0,53
Roschelle,F,100,196,0,196
Halford,M,100,0,17,17
Braynt,M,100,0,5,5
Shakeim,M,100,0,48,48
Jabriah,F,100,33,0,33
Isom,M,100,0,469,469
Wilena,F,100,5,0,5
Hartley,F,64,787,452,1239
Loranna,F,100,7,0,7
Klisha,F,100,6,0,6
Talmon,M,100,0,5,5
Ashaiya,F,100,10,0,10
Lyrique,F,100,85,0,85
Punam,F,100,55,0,55
Jahiya,F,100,29,0,29
Keja,F,100,57,0,57
Ineke,F,100,25,0,25
Rita,F,100,116031,289,116320
Fleming,M,100,0,259,259
Levina,F,100,177,0,177
Whalen,M,100,0,86,86
Aquilino,M,100,0,19,19
Denarius,M,100,0,315,315
Emon,M,81,90,377,467
Keondra,F,98,1102,17,1119
Marketa,F,100,673,0,673
Janyth,F,100,17,0,17
Ziona,F,100,404,0,404
Wajiha,F,100,38,0,38
Takayla,F,100,982,0,982
Jemilla,F,100,6,0,6
Jamescia,F,100,6,0,6
Dreyken,M,100,0,10,10
Roselia,F,100,470,0,470
Karenina,F,100,14,0,14
Hijinio,M,100,0,10,10
Windi,F,100,458,0,458
Tenasha,F,100,24,0,24
Sheneaka,F,100,5,0,5
Alic,M,100,0,201,201
Siddarth,M,100,0,350,350
Suprenia,F,100,5,0,5
Jcion,M,100,0,38,38
Maninder,M,100,0,17,17
Namira,F,100,55,0,55
Shue,M,100,0,12,12
Surianna,F,100,5,0,5
Ceann,F,100,11,0,11
Wonder,F,100,159,0,159
Markaysha,F,100,5,0,5
Kolade,M,100,0,13,13
Jurie,F,100,8,0,8
Avaleen,F,100,42,0,42
Tkyra,F,100,6,0,6
Tamma,F,100,215,0,215
Benton,M,100,0,5510,5510
Ralanda,F,100,20,0,20
Arnecia,F,100,77,0,77
Gamel,M,100,0,15,15
Zackrey,M,100,0,170,170
Wandell,M,100,0,38,38
Jariana,F,100,100,0,100
Madhulika,F,100,6,0,6
Lalicia,F,100,5,0,5
Mcarthur,M,100,0,1245,1245
Yanetzy,F,100,15,0,15
Manzell,M,100,0,5,5
Elajuwon,M,100,0,6,6
Lenna,F,100,1289,0,1289
Melenda,F,100,95,0,95
Daphane,F,100,476,0,476
Mattaniah,M,100,0,5,5
Michaeljr,M,100,0,5,5
Regenia,F,100,1781,0,1781
Ladye,F,100,5,0,5
Zaraiah,F,100,5,0,5
Jaretsy,F,100,26,0,26
Chyenna,F,100,5,0,5
Goeffrey,M,100,0,54,54
Poncho,M,100,0,5,5
Jaicey,F,100,91,0,91
Dorianne,F,100,469,0,469
Anela,F,100,1283,0,1283
Shaquavia,F,100,95,0,95
Amyracle,F,100,33,0,33
Adila,F,100,33,0,33
Nedrick,M,100,0,5,5
Victoriya,F,100,95,0,95
Alissya,F,100,33,0,33
Bibiana,F,100,1173,0,1173
Pieter,M,100,0,860,860
Courney,F,100,69,0,69
Drevan,M,100,0,41,41
Kelik,M,100,0,5,5
Tanyette,F,100,11,0,11
Dathen,M,100,0,17,17
Ger,M,81,88,385,473
Trixie,F,100,745,0,745
Neeya,F,100,44,0,44
Syeed,M,100,0,50,50
Jahnel,F,100,12,0,12
Manami,F,100,104,0,104
Melvina,F,100,2235,0,2235
Ziaire,M,86,54,320,374
Khushi,F,100,1095,0,1095
Lonia,F,100,32,0,32
Lexanne,F,100,5,0,5
Ladijah,F,100,5,0,5
Samriddhi,F,100,6,0,6
Kenton,M,100,0,8575,8575
Brhianna,F,100,7,0,7
Lakieta,F,100,28,0,28
Cadisha,F,100,5,0,5
Sky,F,65,5885,3137,9022
Alleya,F,100,62,0,62
Crissey,F,100,20,0,20
Caretha,F,100,98,0,98
Hendrix,M,94,120,2033,2153
Fahad,M,100,0,969,969
Trust,M,71,45,111,156
Emberlee,F,100,213,0,213
Enora,F,100,29,0,29
Jainiyah,F,100,5,0,5
Macgyver,M,100,0,45,45
Cynamon,F,100,11,0,11
Zurii,F,100,24,0,24
Mckenziee,F,100,5,0,5
Nechama,F,100,2713,0,2713
Lacora,F,100,139,0,139
Elmyra,F,100,47,0,47
Tali,F,95,938,54,992
Demian,M,99,14,1550,1564
Jermie,M,100,0,327,327
Abad,M,100,0,82,82
Anila,F,100,365,0,365
Tiyler,M,100,0,16,16
Dorcus,F,96,126,5,131
Ranveer,M,100,0,222,222
Gaonou,F,100,51,0,51
Inita,F,100,142,0,142
Syvester,M,100,0,5,5
Arzoo,F,100,5,0,5
Elif,F,100,648,0,648
Strawberry,F,100,10,0,10
Kamila,F,100,7267,0,7267
Connal,M,100,0,5,5
Emett,M,100,0,81,81
Kirby,M,76,3303,10519,13822
Wayden,M,100,0,75,75
Karcyn,F,100,66,0,66
Devina,F,100,1049,0,1049
Ugne,F,100,5,0,5
Saaketh,M,100,0,55,55
Francetta,F,100,138,0,138
Cappy,F,50,5,5,10
Kashima,F,100,39,0,39
Jametra,F,100,22,0,22
Danforth,M,100,0,10,10
Jaquar,M,100,0,11,11
Richlyn,F,100,7,0,7
Landi,F,100,109,0,109
Arriell,F,100,6,0,6
Lavaeh,F,100,86,0,86
Aylinne,F,100,17,0,17
Brittan,F,64,787,435,1222
Meyson,M,100,0,5,5
Manoy,F,100,5,0,5
Markest,M,100,0,5,5
Hallelujah,F,100,50,0,50
Shalonda,F,100,4632,0,4632
Solanch,F,100,28,0,28
Jovari,M,100,0,5,5
Hydea,F,100,13,0,13
Dominykas,M,100,0,7,7
Phelan,M,88,63,478,541
Candida,F,100,2901,0,2901
Ayled,F,100,6,0,6
Kamryn,F,86,17308,2802,20110
Memoree,F,100,25,0,25
Porcsha,F,100,24,0,24
Kenzlei,F,100,25,0,25
Kasheen,M,100,0,5,5
Briniya,F,100,49,0,49
Rouchelle,F,100,5,0,5
Devanta,M,100,0,224,224
Yaneliz,F,100,233,0,233
Sharvil,M,100,0,29,29
Niels,M,100,0,933,933
Tamiki,F,100,61,0,61
Rhianah,F,100,10,0,10
Prayas,M,100,0,6,6
Shayana,F,100,227,0,227
Yuriko,F,100,331,0,331
Otman,M,100,0,5,5
Jamielee,F,100,465,0,465
Alveena,F,100,50,0,50
Prabhat,M,100,0,6,6
Angeldejesus,M,100,0,89,89
Poet,F,81,87,21,108
Sahmir,M,100,0,90,90
Emilyjane,F,100,5,0,5
Brystal,F,100,468,0,468
Soomin,F,100,5,0,5
Jorelys,F,100,5,0,5
Chandley,F,100,11,0,11
Cherell,F,100,395,0,395
Jkari,M,100,0,13,13
Jazilyn,F,100,145,0,145
Pearley,F,100,66,0,66
Jaspal,M,100,0,49,49
Driver,M,100,0,10,10
Sheleta,F,100,42,0,42
Juliah,F,100,252,0,252
Ulysses,M,100,15,9865,9880
Casden,M,100,0,6,6
Sueanna,F,100,44,0,44
Caprina,F,100,69,0,69
Jaran,M,100,0,236,236
Braxten,M,99,5,987,992
Jacquese,F,61,149,97,246
Averyona,F,100,7,0,7
Ami,F,96,7136,266,7402
Kandyce,F,100,1352,0,1352
Jeudy,M,100,0,28,28
Britlee,F,100,61,0,61
Herron,M,100,0,30,30
Tityana,F,100,79,0,79
Schmika,F,100,5,0,5
Yakita,F,100,30,0,30
Titilope,F,100,6,0,6
Corynn,F,100,671,0,671
Karolina,F,100,3169,0,3169
Verlie,F,94,183,11,194
Annamae,F,100,692,0,692
Amaryana,F,100,5,0,5
Javar,M,100,0,624,624
Kimoria,F,100,56,0,56
Riahanna,F,100,10,0,10
Jermika,F,100,83,0,83
Kalob,M,100,0,1599,1599
Jacquita,F,100,341,0,341
Charday,F,100,215,0,215
Halil,M,100,0,61,61
Trevonne,M,100,0,287,287
Torreon,M,100,0,45,45
Chyles,F,100,14,0,14
Jentry,F,73,625,236,861
Layan,F,100,857,0,857
Lyndy,F,100,311,0,311
Zaara,F,100,437,0,437
Dorsha,F,100,5,0,5
Josephpaul,M,100,0,5,5
Eriona,F,100,176,0,176
Markece,M,100,0,19,19
Shaelen,F,100,7,0,7
Julyana,F,100,226,0,226
Cammille,F,100,11,0,11
Akshit,M,100,0,20,20
Asjah,F,100,200,0,200
Josalina,F,100,5,0,5
Rayvyn,F,100,5,0,5
Rikkia,F,100,53,0,53
Jamicka,F,100,34,0,34
Liviah,F,100,32,0,32
Nathanyal,M,100,0,134,134
Jaimin,M,100,0,130,130
Guyon,M,100,0,10,10
Oniya,F,100,57,0,57
Jigna,F,100,19,0,19
Caasi,F,100,53,0,53
Keonta,M,86,64,407,471
Jurita,F,100,5,0,5
Kylor,M,99,5,361,366
Laterra,F,100,257,0,257
Cheynne,F,100,249,0,249
Rakeya,F,100,65,0,65
Nathias,M,100,0,17,17
Niosha,F,100,5,0,5
Fajr,F,100,129,0,129
Amanpreet,F,79,125,34,159
Valente,M,100,0,1395,1395
Vyron,M,100,0,57,57
Terry,M,81,79669,330645,410314
Saije,F,100,43,0,43
Krishna,M,50,1713,1715,3428
Meliya,F,100,65,0,65
Diora,F,100,83,0,83
Leylah,F,100,427,0,427
Paisleigh,F,100,565,0,565
Elsee,F,100,21,0,21
Vikkie,F,100,43,0,43
Saniy,F,100,18,0,18
Tylin,M,75,186,560,746
Tashyia,F,100,30,0,30
Kaitelynn,F,100,11,0,11
Runda,F,100,10,0,10
Rein,M,73,26,69,95
Jonnah,F,74,29,10,39
Ailany,F,100,304,0,304
Sumair,M,100,0,5,5
Manaswini,F,100,21,0,21
Christyn,F,99,985,6,991
Dekayla,F,100,270,0,270
Olimpia,F,100,266,0,266
Mancil,M,100,0,6,6
Nakita,F,99,2913,28,2941
Zyonn,M,100,0,10,10
Shacora,F,100,321,0,321
Davaney,F,100,5,0,5
Larsson,M,100,0,5,5
Judee,F,100,250,0,250
Neno,M,100,0,26,26
Fredina,F,100,5,0,5
Rayanah,F,100,14,0,14
Tikeyah,F,100,7,0,7
Syann,F,100,226,0,226
Shawun,M,100,0,5,5
Shawnice,F,100,435,0,435
Kemarion,M,100,0,656,656
Gloria,F,100,169752,788,170540
Miliany,F,100,29,0,29
Edwar,M,100,0,225,225
Alyne,F,100,171,0,171
Siann,F,100,52,0,52
Linen,F,100,5,0,5
Denys,F,73,409,148,557
Jamol,M,100,0,183,183
Shahreen,F,100,5,0,5
Ashyla,F,100,88,0,88
Jalana,F,100,284,0,284
Lebarron,M,100,0,29,29
Jaevion,M,100,0,300,300
Kiyasha,F,100,12,0,12
Mayia,F,100,79,0,79
Leaysia,F,100,5,0,5
Kerstein,F,100,10,0,10
Feleisha,F,100,5,0,5
Exzavier,M,100,0,266,266
Paxtyn,F,56,168,133,301
Kaymarie,F,100,29,0,29
Mashana,F,100,6,0,6
Rashaud,M,100,0,1151,1151
Darsy,F,100,10,0,10
Darsey,F,100,55,0,55
Chanton,M,100,0,5,5
Camillia,F,100,1193,0,1193
Jahne,F,100,96,0,96
Ryat,M,100,0,5,5
Gaudencio,M,100,0,77,77
Didier,M,100,0,690,690
Lamoni,F,66,35,18,53
Duglas,M,100,0,88,88
Tylicia,F,100,93,0,93
Jacci,F,100,236,0,236
Emah,F,100,47,0,47
Shermona,F,100,5,0,5
Arel,M,96,6,156,162
Elizaveta,F,100,255,0,255
Brenaya,F,100,5,0,5
Giovannie,M,99,6,585,591
Dauntay,M,100,0,5,5
Melindy,F,100,10,0,10
Jaszmine,F,100,102,0,102
Taiyah,F,100,32,0,32
Aubrianah,F,100,36,0,36
Kaitly,F,100,15,0,15
Zarianna,F,100,179,0,179
Fynn,M,93,37,508,545
Kitanna,F,100,34,0,34
Cheznie,F,100,21,0,21
Jal,M,100,0,17,17
Korra,F,100,312,0,312
Chantel,F,100,14702,11,14713
Cabe,M,100,0,160,160
Alberico,M,100,0,6,6
Keon,M,98,152,7507,7659
Aschton,M,100,0,5,5
Kieth,M,100,0,2218,2218
Zysean,M,100,0,5,5
Yaneris,F,100,20,0,20
Marlos,M,100,0,103,103
Fredonia,F,100,33,0,33
Shelette,F,100,5,0,5
Jenica,F,100,1898,0,1898
Patrricia,F,100,7,0,7
Pari,F,100,583,0,583
Uniquea,F,100,19,0,19
Daymond,M,100,0,709,709
Aubreauna,F,100,5,0,5
Utkarsh,M,100,0,32,32
Manit,M,100,0,29,29
Marixa,F,100,338,0,338
Dolce,F,100,114,0,114
Doniya,F,100,13,0,13
Cleary,F,100,8,0,8
Dajuana,F,100,132,0,132
Mairely,F,100,74,0,74
Jamarus,M,100,0,27,27
Gordean,F,100,6,0,6
Treaver,M,100,0,21,21
Tyshiana,F,100,17,0,17
Aleysha,F,100,361,0,361
Niclas,M,100,0,80,80
Demetriana,F,100,51,0,51
Siene,F,100,6,0,6
Niamke,M,100,0,7,7
Romyn,M,100,0,50,50
Charae,F,100,197,0,197
Tracilynn,F,100,6,0,6
Kentavion,M,100,0,46,46
Vasilis,M,100,0,175,175
Haliey,F,100,248,0,248
Kessie,F,100,67,0,67
Paelyn,F,100,60,0,60
Sayf,M,100,0,58,58
Adedamola,M,100,0,96,96
Demyah,F,100,87,0,87
Preethi,F,100,188,0,188
Prenella,F,100,5,0,5
Jorden,M,73,2227,6088,8315
Roselin,F,100,524,0,524
Ysabel,F,97,905,29,934
Aleksander,M,100,0,2642,2642
Matthue,M,100,0,40,40
Delba,F,100,5,0,5
Tyliah,F,100,303,0,303
Shamiek,M,100,0,5,5
Crystyle,F,100,5,0,5
Arica,F,100,2317,0,2317
Brishauna,F,100,5,0,5
Lilee,F,100,691,0,691
Raejon,M,100,0,58,58
Shahrazad,F,100,5,0,5
Taya,F,100,4913,0,4913
Dekyla,F,100,12,0,12
Jaiannah,F,100,25,0,25
Nastasja,F,100,10,0,10
Rorie,F,99,510,5,515
Darlynda,F,100,5,0,5
Sadira,F,100,233,0,233
Livvy,F,100,142,0,142
Shauniya,F,100,5,0,5
Eldo,M,100,0,6,6
Leisha,F,100,1963,0,1963
Yee,M,52,201,221,422
Quinisha,F,100,288,0,288
Annessa,F,100,616,0,616
Marwah,F,100,208,0,208
Julinda,F,100,5,0,5
Shakia,F,100,2351,0,2351
Kassy,F,100,860,0,860
Jordania,F,100,11,0,11
Anayansi,F,100,55,0,55
Leiann,F,100,229,0,229
Quetzalcoatl,M,100,0,10,10
Darey,M,100,0,450,450
Zaryab,M,100,0,5,5
Tayshawn,M,100,0,1133,1133
Yeiden,M,100,0,58,58
Eliah,M,71,272,679,951
Shereece,F,100,92,0,92
Graceland,F,100,59,0,59
Ellany,F,100,11,0,11
Zyquarius,M,100,0,29,29
Meeko,M,100,0,20,20
Klairissa,F,100,6,0,6
Alekay,M,100,0,5,5
Chiara,F,100,4004,0,4004
Lanard,M,100,0,333,333
Deronna,F,100,5,0,5
Raechal,F,100,86,0,86
Lemaya,F,100,7,0,7
Marillany,F,100,13,0,13
Kavayah,F,100,5,0,5
Ludia,F,100,11,0,11
Caydenn,M,100,0,17,17
Laziyah,F,100,41,0,41
Kachiri,F,100,18,0,18
Jeena,F,100,426,0,426
Vashion,M,69,5,11,16
Arris,M,100,0,25,25
Tramiya,F,100,33,0,33
Fayt,M,100,0,14,14
Ponciano,M,100,0,165,165
Giulliana,F,100,56,0,56
Cianni,F,100,367,0,367
Kelleye,F,100,16,0,16
Almetta,F,100,49,0,49
Yidel,M,100,0,165,165
Kasside,F,100,5,0,5
Lalana,F,100,60,0,60
Minard,M,100,0,5,5
Jakaris,M,100,0,5,5
Azlynn,F,100,638,0,638
Derrance,M,100,0,8,8
Maeson,M,72,155,391,546
Jamire,M,100,0,365,365
Deani,F,100,32,0,32
Ahron,M,100,0,733,733
Katin,M,77,6,20,26
Arykah,F,100,31,0,31
Jaysia,F,100,13,0,13
Icelynn,F,100,58,0,58
Charolotte,F,100,23,0,23
Latay,F,100,17,0,17
Aarsh,M,100,0,43,43
Emme,F,100,2299,0,2299
Alben,M,100,0,79,79
Evagelia,F,100,99,0,99
Mirna,F,100,3826,5,3831
Megghan,F,100,10,0,10
Jolean,F,100,235,0,235
Quiesha,F,100,12,0,12
Vandy,M,52,193,207,400
Jonta,M,86,33,211,244
Lejuan,M,100,0,197,197
Elisee,M,100,0,19,19
Gul,F,100,5,0,5
Myricle,F,100,26,0,26
Rock,M,100,0,2294,2294
Aayden,M,100,5,1006,1011
Elleora,F,100,5,0,5
Aemelia,F,100,6,0,6
Yashita,F,100,6,0,6
Martain,M,100,0,12,12
Jaselin,F,100,6,0,6
Zhakira,F,100,6,0,6
Ichiro,M,100,0,50,50
Cythina,F,100,110,0,110
Nakitta,F,100,25,0,25
Shakeshia,F,100,43,0,43
Virtue,F,100,10,0,10
Rebeccajo,F,100,6,0,6
Marianna,F,100,10643,0,10643
Lovisa,F,100,7,0,7
Tomeshia,F,100,76,0,76
Desting,F,100,16,0,16
Charlsea,F,100,17,0,17
Saugat,M,100,0,12,12
Aref,M,100,0,13,13
Jakayla,F,100,5643,0,5643
Maahi,F,100,184,0,184
Shefali,F,100,296,0,296
Arta,F,95,132,7,139
Sherrie,F,100,31232,11,31243
Anjelita,F,100,66,0,66
Taiwana,F,100,111,0,111
Corree,F,100,5,0,5
Ellaree,F,100,19,0,19
Sheylla,F,100,6,0,6
Stela,F,100,99,0,99
Damilola,F,77,142,43,185
Kayleighann,F,100,15,0,15
Graecen,M,100,0,5,5
Kynli,F,100,254,0,254
Detroy,M,100,0,28,28
Kalae,F,71,12,5,17
Gardell,M,100,0,47,47
Jahkobe,M,100,0,10,10
Maulik,M,100,0,15,15
Yulian,M,100,0,263,263
Careena,F,100,60,0,60
Develyn,F,100,54,0,54
Minha,F,100,141,0,141
Myleesha,F,100,5,0,5
Lb,M,100,0,6,6
Azarya,F,84,52,10,62
Murdoc,M,100,0,18,18
Kailash,M,100,0,180,180
Soraya,F,100,4305,0,4305
Kashten,M,100,0,41,41
Zurich,M,100,0,36,36
Nyeka,F,100,5,0,5
Dianthe,F,100,13,0,13
Kadeisha,F,100,120,0,120
Eiji,M,100,0,17,17
Kyrstan,F,100,62,0,62
Kern,M,100,0,485,485
Kimarley,M,100,0,7,7
Taelyr,F,100,87,0,87
Dieon,M,100,0,51,51
Aldrik,M,100,0,5,5
Kenitha,F,100,68,0,68
Maicyn,F,100,5,0,5
Aquira,F,100,44,0,44
Indira,F,100,1997,0,1997
Brayon,M,100,0,227,227
Hady,M,78,39,138,177
Besma,F,100,10,0,10
Fairah,F,100,6,0,6
Zyron,M,100,0,161,161
Ziyanna,F,100,117,0,117
Mayda,F,100,509,0,509
Koal,M,100,0,178,178
Eleany,F,100,11,0,11
Linette,F,100,3995,0,3995
Sulayman,M,100,0,346,346
Rogenia,F,100,70,0,70
Thomasita,F,100,5,0,5
Lauree,F,100,560,0,560
Darreld,M,100,0,40,40
Crespin,M,100,0,97,97
Kavir,M,100,0,11,11
Camaira,F,100,5,0,5
Inis,F,100,30,0,30
Markia,F,100,1584,0,1584
Trevino,M,100,0,157,157
Ondra,M,80,23,92,115
Eyana,F,100,199,0,199
Rishita,F,100,117,0,117
Niamh,F,100,1180,0,1180
Karetha,F,100,11,0,11
Quadijah,F,100,6,0,6
Mukarram,M,100,0,5,5
Clance,M,100,0,28,28
Anquinetta,F,100,5,0,5
Tysheen,M,100,0,49,49
Mandra,F,100,49,0,49
Nevo,M,100,0,17,17
Davinci,M,100,0,74,74
Tilar,F,61,20,13,33
Teion,M,100,0,117,117
Yannery,F,100,9,0,9
Ioana,F,100,61,0,61
Cedrianna,F,100,26,0,26
Aphrodite,F,100,301,0,301
Eloiza,F,100,30,0,30
Andrzej,M,100,0,321,321
Sakora,F,100,23,0,23
Braxon,M,100,0,156,156
Randll,M,100,0,5,5
Micia,F,100,6,0,6
Airelle,F,100,227,0,227
Hannan,F,82,395,87,482
Sandesh,M,100,0,10,10
Chataqua,F,100,5,0,5
Colten,M,100,0,12670,12670
Kimery,F,100,43,0,43
Shashawna,F,100,30,0,30
Kyly,F,100,22,0,22
Lachone,F,100,10,0,10
Hiroshi,M,100,0,353,353
Shamira,F,100,1410,0,1410
Kraig,M,100,0,5776,5776
Brendaliz,F,100,157,0,157
Carlota,F,100,760,0,760
Kayliani,F,100,28,0,28
Luticia,F,100,63,0,63
Hillis,M,100,0,35,35
Lc,M,100,0,243,243
Almarosa,F,100,144,0,144
Nadiv,M,100,0,5,5
Deshawnte,M,100,0,12,12
Stevana,F,100,69,0,69
Ahmar,M,100,0,145,145
Tieanna,F,100,11,0,11
Carlysia,F,100,35,0,35
Jalal,M,100,0,578,578
Reyce,M,85,12,69,81
Anaisa,F,100,353,0,353
Kohlee,F,100,5,0,5
Aine,F,100,1185,0,1185
Veronicka,F,100,5,0,5
Adwita,F,100,52,0,52
Kamiylah,F,100,17,0,17
Jernell,F,81,22,5,27
Melode,F,100,31,0,31
Typhani,F,100,23,0,23
Gennia,F,100,6,0,6
Omere,M,100,0,45,45
Curtiss,M,100,0,2953,2953
Philix,M,100,0,5,5
Jasminn,F,100,46,0,46
Sonum,F,100,5,0,5
Shanikqua,F,100,189,0,189
Quintavis,M,100,0,112,112
Oluwatoyin,F,100,120,0,120
Phillip,M,100,1097,233963,235060
Tiffeny,F,100,838,0,838
Aliezah,F,100,6,0,6
Philopater,M,100,0,52,52
Pearson,M,94,50,851,901
Tithi,F,100,11,0,11
Chrisinda,F,100,5,0,5
Shalean,F,100,11,0,11
Iveliz,F,100,147,0,147
Janard,M,100,0,163,163
Hades,M,100,0,17,17
Ishea,F,100,26,0,26
Chystal,F,100,45,0,45
Cariss,F,100,5,0,5
Reydon,M,100,0,5,5
Oveta,F,100,70,0,70
Teghveer,M,100,0,5,5
Jaiver,M,100,0,21,21
Keica,F,100,13,0,13
Gwanda,F,100,6,0,6
Jayni,F,84,155,30,185
Byan,M,100,0,75,75
Dhanvin,M,100,0,33,33
Ptolemy,M,100,0,18,18
Kialyn,F,100,6,0,6
Amol,M,100,0,227,227
Lonnisha,F,100,30,0,30
Zaily,F,100,28,0,28
Kyleanthony,M,100,0,19,19
Traciann,F,100,19,0,19
Mathyus,M,100,0,17,17
Pattie,F,100,4426,0,4426
Ranyah,F,100,139,0,139
Amahri,M,66,32,62,94
Addiston,F,100,5,0,5
Sherrelle,F,100,236,0,236
Chaneta,F,100,29,0,29
Geramy,M,100,0,57,57
Talita,F,100,203,0,203
Jymari,M,100,0,7,7
Simren,F,100,69,0,69
Cristabella,F,100,33,0,33
Charan,M,100,0,90,90
Louise,F,99,44759,460,45219
Zakkery,M,100,0,299,299
Dene,F,82,501,111,612
Rodolfo,M,100,83,26833,26916
Zakkai,M,100,0,29,29
Anndrea,F,100,612,0,612
Zaelen,M,100,0,30,30
Jeremial,M,100,0,6,6
Tennillie,F,100,7,0,7
Irie,F,82,1133,251,1384
Bartlomiej,M,100,0,81,81
Juliany,F,100,101,0,101
Japria,F,100,5,0,5
Jerrad,M,100,0,1748,1748
Ryssa,F,100,11,0,11
Felecity,F,100,84,0,84
Peggye,F,100,40,0,40
Kastin,M,100,0,43,43
Orla,F,99,396,6,402
Dakhi,M,100,0,6,6
Aaroh,M,100,0,5,5
Lamaria,F,100,368,0,368
Mustapha,M,100,0,480,480
Rachon,F,100,5,0,5
Clodagh,F,100,114,0,114
Anijae,F,100,5,0,5
Dayvion,M,100,0,591,591
Johnalbert,M,100,0,5,5
Franics,M,100,0,7,7
Telitha,F,100,135,0,135
Justinanthony,M,100,0,5,5
Seja,F,100,5,0,5
Ronia,F,100,167,0,167
Haein,F,100,5,0,5
California,F,100,148,0,148
Hydia,F,100,154,0,154
Marcianne,F,100,66,0,66
Jayvone,M,100,0,30,30
Jata,F,100,5,0,5
Mairenn,F,100,6,0,6
Marcquis,M,100,0,134,134
Hanni,F,100,85,0,85
Carleena,F,100,100,0,100
Dresdyn,M,100,0,5,5
Sukhleen,F,100,9,0,9
Arijana,F,100,108,0,108
Kelleen,F,100,653,0,653
Javarie,M,100,0,120,120
Janeesa,F,100,53,0,53
Arienette,F,100,5,0,5
Navee,F,100,13,0,13
Chinue,F,100,16,0,16
Abriyana,F,100,6,0,6
Tashea,F,100,266,0,266
Chrystle,F,100,249,0,249
Jessiyah,F,100,6,0,6
Yanko,M,100,0,5,5
Qi,M,100,0,18,18
Nishanth,M,100,0,182,182
Tydarious,M,100,0,17,17
Solen,M,100,0,12,12
Sanuel,M,100,0,118,118
Angline,F,100,21,0,21
Samueldavid,M,100,0,10,10
Joshlynn,F,100,506,0,506
Cristian,M,98,1102,57834,58936
Shaneeka,F,100,433,0,433
Lairen,F,100,5,0,5
Khalie,F,100,40,0,40
Tiwanda,F,100,177,0,177
Marlenne,F,100,436,0,436
Wyzetta,F,100,5,0,5
Ninti,F,100,27,0,27
Alyssah,F,100,603,0,603
Maysen,F,57,434,329,763
Ilenne,F,100,6,0,6
Mckaylan,F,100,6,0,6
Fong,M,98,5,295,300
Vashon,M,91,69,733,802
Leneta,F,100,5,0,5
Lumina,F,100,21,0,21
Xayvion,M,100,0,236,236
Tresean,M,100,0,572,572
Emeralda,F,100,5,0,5
Dylann,F,72,546,214,760
Rocklynn,F,100,13,0,13
Shacorey,M,100,0,11,11
Jynelle,F,100,31,0,31
Meleane,F,100,72,0,72
Kouki,M,100,0,22,22
Hartman,M,100,0,27,27
Darwing,M,100,0,5,5
Providence,F,100,160,0,160
Moisses,M,100,0,12,12
Leyah,F,100,799,0,799
Joaneliz,F,100,6,0,6
Ayvin,M,100,0,45,45
Corderick,M,100,0,5,5
Senobia,F,100,6,0,6
Shantrice,F,100,473,0,473
Kajira,F,100,6,0,6
Bartolo,M,100,0,479,479
Rahib,M,100,0,6,6
Tarajah,F,100,25,0,25
Anwyn,F,100,79,0,79
Oriya,F,100,41,0,41
Chiron,M,88,5,38,43
Danielle,F,99,362222,1895,364117
Desmend,M,100,0,10,10
Dmaria,F,100,6,0,6
Chu,M,100,0,13,13
Sophana,M,74,5,14,19
Janon,F,100,40,0,40
Piedad,F,100,115,0,115
Jazyia,F,100,11,0,11
Lexcie,F,100,5,0,5
Skilar,F,83,245,50,295
Ahlayah,F,100,72,0,72
Lizsandra,F,100,6,0,6
Sophiea,F,100,76,0,76
Korionna,F,100,5,0,5
Hurtis,M,100,0,19,19
Braeley,F,100,60,0,60
Saveliy,M,100,0,5,5
Subrena,F,100,191,0,191
Reyse,F,100,11,0,11
Ruthanna,F,100,281,0,281
Mirta,F,100,828,0,828
Shandria,F,100,303,0,303
Traeveon,M,100,0,17,17
Haward,M,100,0,5,5
Jolinda,F,100,847,0,847
Sandybell,F,100,5,0,5
Nzuri,F,100,10,0,10
Alexender,M,100,0,46,46
Dontajah,F,100,5,0,5
Jaslen,F,100,72,0,72
Roshanda,F,100,1163,0,1163
Evann,M,55,297,364,661
Sherinda,F,100,5,0,5
Arbor,F,81,74,17,91
Jasianna,F,100,5,0,5
Arlando,M,100,0,522,522
Shareese,F,100,507,0,507
Khiari,F,50,5,5,10
Brilan,M,100,0,19,19
Kamaren,M,100,0,22,22
Ginette,F,100,817,0,817
Earnestene,F,100,5,0,5
Karlson,M,100,0,5,5
Africia,F,100,5,0,5
Kendylle,F,100,17,0,17
Shameria,F,100,208,0,208
Dakya,F,100,6,0,6
Sonza,F,100,5,0,5
Sammye,F,100,202,0,202
Lateya,F,100,78,0,78
Jadence,F,83,142,30,172
Journiee,F,100,24,0,24
Levant,M,100,0,5,5
Renton,M,100,0,71,71
Mansour,M,100,0,271,271
Zarius,M,100,0,241,241
Shikira,F,100,143,0,143
Davona,F,100,290,0,290
Alaska,F,100,441,0,441
Jatziry,F,100,274,0,274
Imon,M,61,16,25,41
Dekel,M,100,0,22,22
Ceddrick,M,100,0,47,47
Calynne,F,100,5,0,5
Ramina,F,100,55,0,55
Tanja,F,100,2559,0,2559
Jasma,F,100,366,0,366
Jalaa,F,100,5,0,5
Braelyn,F,90,6187,697,6884
Clayne,M,100,0,5,5
Yashar,M,100,0,99,99
Kum,F,100,11,0,11
Channa,F,99,856,5,861
Jynae,F,100,10,0,10
Meriwether,F,100,5,0,5
Bentlea,F,100,8,0,8
Tihisha,F,100,5,0,5
Kennieth,M,100,0,379,379
Georgie,F,77,1988,607,2595
Tabbetha,F,100,214,0,214
Mayrelin,F,100,5,0,5
Desyrae,F,100,18,0,18
Geza,M,100,0,68,68
Mckailah,F,100,5,0,5
Narielle,F,100,5,0,5
Maddoux,M,100,0,5,5
Deneshia,F,100,347,0,347
Thessaly,F,100,50,0,50
Saunti,F,100,6,0,6
Lailanie,F,100,90,0,90
Avabelle,F,100,18,0,18
Konata,M,100,0,16,16
Delinah,F,100,43,0,43
Avriel,F,91,108,11,119
Kristyn,F,100,8651,0,8651
Adahlia,F,100,69,0,69
Ruy,M,100,0,24,24
Shaen,M,100,0,52,52
Leyani,F,100,50,0,50
Wissam,M,100,0,128,128
Niveditha,F,100,10,0,10
Qwanda,F,100,10,0,10
Sakae,F,100,5,0,5
Tanjanae,F,100,5,0,5
Joshuaalexander,M,100,0,5,5
Jadiana,F,100,5,0,5
Ashantia,F,100,71,0,71
Tamaki,F,100,35,0,35
Jonier,F,100,19,0,19
Bellasophia,F,100,6,0,6
Niana,F,100,146,0,146
Cerah,F,100,37,0,37
Dasheem,M,100,0,24,24
Quy,M,100,0,111,111
Kabresha,F,100,7,0,7
Krishang,M,100,0,42,42
Jedidiah,M,100,18,5761,5779
Mishaila,F,100,6,0,6
Beniamin,M,100,0,33,33
Aelita,F,100,12,0,12
Jevontae,M,100,0,35,35
Dymere,M,100,0,50,50
Antiona,M,78,5,18,23
Elihu,M,100,0,509,509
Dody,F,100,333,0,333
Orvil,M,100,0,231,231
Jayleon,M,100,0,65,65
Eziquel,M,100,0,5,5
Emmilie,F,100,5,0,5
Deatra,F,100,501,0,501
Rekha,F,100,212,0,212
Raines,M,100,0,13,13
Brittanny,F,100,389,0,389
Moreland,M,100,0,5,5
Hassel,M,100,0,74,74
Zarinah,F,100,177,0,177
Dekiyah,F,100,10,0,10
Lacresia,F,100,162,0,162
Karnisha,F,100,80,0,80
Annabele,F,100,12,0,12
Cailan,M,64,71,127,198
Ezikiel,M,100,0,28,28
Lorrianne,F,100,32,0,32
Diontre,M,100,0,152,152
Iason,M,100,0,20,20
Dshon,M,100,0,44,44
Emmeric,M,100,0,5,5
Luverne,F,51,38,37,75
Shantall,F,100,43,0,43
Shaddai,F,82,116,26,142
Kitzya,F,100,13,0,13
Lize,F,100,5,0,5
Nini,F,100,157,0,157
Gerrika,F,100,10,0,10
Nickita,F,66,40,21,61
Tremarion,M,100,0,39,39
Manica,F,100,39,0,39
Chakara,F,100,76,0,76
Shaquonda,F,100,21,0,21
Mackena,F,100,87,0,87
Sumera,F,100,22,0,22
Kap,M,100,0,25,25
Savir,M,100,0,76,76
Sadra,F,100,10,0,10
Charee,F,100,432,0,432
Zytaveon,M,100,0,15,15
Casch,M,100,0,5,5
Tonirose,F,100,6,0,6
Treysen,M,100,0,197,197
Scotlyn,F,100,434,0,434
Kaileah,F,100,194,0,194
Hollyanne,F,100,144,0,144
Delynn,F,91,680,70,750
Elise,F,100,51551,41,51592
Alizeya,F,100,16,0,16
Lakeith,M,100,0,628,628
Lyndol,M,100,0,21,21
Bryon,M,100,17,14049,14066
Jandy,F,92,77,7,84
Doctor,M,100,0,6,6
Niliyah,F,100,10,0,10
Coven,M,100,0,23,23
Kjay,M,100,0,10,10
Shariyka,F,100,5,0,5
Abagale,F,100,356,0,356
Tori,F,97,34019,1104,35123
Kenidi,F,100,105,0,105
Archith,M,100,0,13,13
Iana,F,100,536,0,536
Krishav,M,100,0,52,52
Tanar,M,100,0,11,11
Lijana,F,100,6,0,6
Latika,F,100,474,0,474
Kivin,M,100,0,20,20
Tralyn,M,100,0,18,18
Ayleene,F,100,27,0,27
Lanesha,F,100,900,0,900
Maryah,F,100,1808,0,1808
Reshell,F,100,50,0,50
Deetta,F,100,539,0,539
Najuan,M,100,0,5,5
Council,M,100,0,25,25
Charith,M,100,0,12,12
Mahliya,F,100,17,0,17
Yuan,M,85,14,77,91
Abdi,M,96,10,238,248
Jeser,M,100,0,11,11
Lanaria,F,100,11,0,11
Shaaz,M,100,0,10,10
Traevyn,M,100,0,15,15
Baldemar,M,100,0,1619,1619
Rieley,F,63,191,111,302
Elexas,F,100,16,0,16
Iliyana,F,100,73,0,73
Tilesha,F,100,17,0,17
Lerico,M,100,0,5,5
Shahada,F,100,38,0,38
Shelinda,F,100,47,0,47
Colum,M,100,0,80,80
Laurilyn,F,100,10,0,10
Aycen,M,100,0,56,56
Lynnae,F,100,1086,0,1086
Guiseppi,M,100,0,10,10
Carlen,F,87,430,64,494
Colbyn,M,100,0,11,11
Juwan,M,100,5,3531,3536
Chasty,F,100,92,0,92
Jazimine,F,100,16,0,16
Denamarie,F,100,10,0,10
Erandi,F,100,258,0,258
Laterrious,M,100,0,11,11
Nasaiah,M,100,0,12,12
Thoreau,M,100,0,5,5
Dionni,F,100,19,0,19
Zayna,F,100,991,0,991
Avantika,F,100,242,0,242
Lianet,F,100,34,0,34
Aril,F,100,10,0,10
Khahlil,M,100,0,7,7
Toyea,F,100,5,0,5
Kaysie,F,100,1085,0,1085
Dayonna,F,100,656,0,656
Anona,F,100,65,0,65
Cadarrius,M,100,0,44,44
Madison,F,99,346477,4981,351458
Jovontae,M,100,0,69,69
Jaderious,M,100,0,5,5
Rameer,M,100,0,11,11
Aubreana,F,100,179,0,179
Maclain,M,98,5,316,321
Carollynn,F,100,179,0,179
Nikul,M,100,0,6,6
Tijuanna,F,100,26,0,26
Zadian,M,100,0,16,16
Dquarious,M,100,0,5,5
Ylana,F,100,22,0,22
Yaqueline,F,100,214,0,214
Akiela,F,100,16,0,16
Quamell,M,100,0,10,10
Angelito,M,100,0,384,384
Sindhuja,F,100,29,0,29
Geetika,F,100,61,0,61
Tymirah,F,100,11,0,11
Shauntal,F,100,15,0,15
Imelda,F,100,5019,0,5019
Elviz,M,100,0,6,6
Vince,M,100,5,10184,10189
Ethean,M,100,0,13,13
Chinedum,M,100,0,59,59
Ryker,M,99,128,13283,13411
Leeana,F,100,596,0,596
Faatima,F,100,62,0,62
Devontay,M,100,0,779,779
Maka,F,100,19,0,19
Donamarie,F,100,5,0,5
Rietta,F,100,18,0,18
Panav,M,100,0,17,17
Deantre,M,100,0,202,202
Mertie,F,100,42,0,42
Tymothy,M,100,0,268,268
Kyliegh,F,100,405,0,405
Zayir,M,100,0,5,5
Sanae,F,100,276,0,276
Kashaun,M,100,0,312,312
Darrika,F,100,6,0,6
Tenesa,F,100,46,0,46
Tamathia,F,100,10,0,10
Shaundria,F,100,34,0,34
Kaira,F,100,1680,0,1680
Vergina,F,100,10,0,10
Jacque,F,68,3598,1678,5276
Bubby,M,100,0,10,10
Carlas,M,73,59,159,218
Mckenlie,F,100,17,0,17
Leilahni,F,100,18,0,18
Mariadelrosari,F,100,32,0,32
Gianna,F,100,54027,28,54055
Makanalei,F,100,5,0,5
Velicia,F,100,240,0,240
Azera,F,100,36,0,36
Bety,F,100,10,0,10
Kaileena,F,100,101,0,101
Marrian,F,100,35,0,35
Elizandra,F,100,26,0,26
Phoenixx,F,100,11,0,11
Kimbely,F,100,433,0,433
Bijoux,F,100,22,0,22
Rathanak,M,100,0,19,19
Gino,M,100,12,9690,9702
Segio,M,100,0,42,42
Saralee,F,100,321,0,321
Makalani,M,100,0,5,5
Amika,F,100,256,0,256
Mykai,M,100,0,64,64
Nahal,F,100,66,0,66
Jariah,F,84,839,160,999
Christinia,F,100,1182,0,1182
Erionna,F,100,337,0,337
Lashonda,F,100,9217,0,9217
Brynt,M,100,0,17,17
Marsean,M,100,0,313,313
Renitia,F,100,5,0,5
Sadiqua,F,100,15,0,15
Alizai,F,100,5,0,5
Jadarious,M,100,0,136,136
Cin,M,100,0,5,5
Kayenne,F,100,11,0,11
Amyjo,F,100,486,0,486
Meilynn,F,100,21,0,21
Achyut,M,100,0,44,44
Breanda,F,100,202,0,202
Alexcis,F,95,215,11,226
Reniyah,F,100,252,0,252
Wadell,M,100,0,157,157
Kamiria,F,100,5,0,5
Daydrian,M,100,0,15,15
Nebraska,F,76,16,5,21
Betzaida,F,100,1325,0,1325
Aryahi,F,100,48,0,48
Jazsmine,F,100,109,0,109
Bettejane,F,100,5,0,5
Ushna,F,100,15,0,15
Fidencia,F,100,15,0,15
Rayner,M,100,0,150,150
Tyffanie,F,100,18,0,18
Demetrial,F,100,5,0,5
Javayah,F,100,53,0,53
Eralynn,F,100,24,0,24
Kenson,M,100,0,299,299
Deneva,F,100,5,0,5
Canary,F,100,71,0,71
Jermyn,M,100,0,52,52
Evin,M,85,465,2660,3125
Dorthie,F,100,6,0,6
Kywuan,M,100,0,7,7
Taiyler,F,100,5,0,5
Labrittney,F,100,18,0,18
Tailah,F,100,28,0,28
Cambra,F,100,39,0,39
Zynaria,F,100,10,0,10
Aubryelle,F,100,5,0,5
Mocha,F,100,5,0,5
Marquinta,F,100,5,0,5
Sintia,F,100,444,0,444
Nekaybaw,F,100,23,0,23
Jadynne,F,100,10,0,10
Shaquor,M,100,0,5,5
Electra,F,100,778,0,778
Jerkayla,F,100,5,0,5
Kirstein,F,100,68,0,68
Yaxiry,F,100,6,0,6
Deyonce,F,89,58,7,65
Jaslena,F,100,5,0,5
Russel,M,100,0,6645,6645
Glorianna,F,100,350,0,350
Bayardo,M,100,0,27,27
Shamayia,F,100,10,0,10
Woodrow,M,100,6,7528,7534
Sardor,M,100,0,6,6
Malysa,F,100,11,0,11
Daniyla,F,100,31,0,31
Byanka,F,100,279,0,279
Jalila,F,100,157,0,157
Deera,F,100,5,0,5
Axle,M,100,0,419,419
Danyla,F,100,249,0,249
Maicee,F,100,123,0,123
Afomia,F,100,55,0,55
Samirah,F,100,1299,0,1299
Renick,M,100,0,5,5
Deighton,M,100,0,31,31
Xymena,F,100,22,0,22
Diogenes,M,100,0,153,153
Elishua,M,100,0,67,67
Brizeth,F,100,5,0,5
Aayusha,F,100,5,0,5
Amalyah,F,100,5,0,5
Daguan,M,100,0,15,15
Ferrin,F,80,90,22,112
Ashton,M,76,18026,58114,76140
Shatarra,F,100,114,0,114
Alferd,M,100,0,246,246
Aurick,M,100,0,20,20
Braidy,F,74,17,6,23
Soren,M,94,299,4966,5265
Navaeha,F,100,5,0,5
Goldy,F,100,838,0,838
Menah,F,100,16,0,16
Javery,M,100,0,29,29
Mariuxi,F,100,5,0,5
Tyreece,M,100,0,621,621
Dhanvi,F,100,87,0,87
Zeferino,M,100,0,250,250
Xin,F,84,165,31,196
Russella,F,100,29,0,29
Avamay,F,100,5,0,5
Yosuel,M,100,0,7,7
Delci,F,100,11,0,11
Dinasti,F,100,6,0,6
Marshun,M,100,0,199,199
Daymon,M,100,0,1289,1289
Dami,F,100,11,0,11
Teresaann,F,100,5,0,5
Tecola,F,100,5,0,5
Laquenta,F,100,69,0,69
Kanchan,F,100,7,0,7
Litsa,F,100,21,0,21
Cattibrie,F,100,10,0,10
Zamarah,F,100,41,0,41
Kamauria,F,100,22,0,22
Branda,F,100,1086,0,1086
Lindzee,F,100,97,0,97
Cecilly,F,100,17,0,17
Imanie,F,100,168,0,168
Demetrica,F,100,227,0,227
Trier,F,100,6,0,6
Jhosselyn,F,100,5,0,5
Samorah,F,100,40,0,40
Jassica,F,100,236,0,236
Kempton,M,100,0,196,196
Loraina,F,100,133,0,133
Sunita,F,100,601,0,601
Idesha,F,100,20,0,20
Kristara,F,100,35,0,35
Shatiera,F,100,26,0,26
Kentyn,M,100,0,6,6
Daquwan,M,100,0,8,8
Lucas,M,100,400,200205,200605
Antwanisha,F,100,17,0,17
Robinique,F,100,13,0,13
Julynn,F,100,10,0,10
Latanisha,F,100,5,0,5
Nadiya,F,100,1104,0,1104
Aliyah,F,100,31423,28,31451
Srihari,M,100,0,80,80
Masiel,F,100,139,0,139
Jadien,M,86,31,193,224
Sheterica,F,100,5,0,5
Avier,M,100,0,63,63
Arlonda,F,100,7,0,7
Osbourne,M,100,0,18,18
Jaelen,M,85,210,1189,1399
Angenetta,F,100,34,0,34
Gerran,M,100,0,11,11
Jazin,M,100,0,5,5
Jaquaze,M,100,0,5,5
Jaquita,F,100,733,0,733
Dennison,M,100,0,546,546
Scherrie,F,100,280,0,280
Lizzie,F,100,4564,0,4564
Anaiza,F,100,82,0,82
Tajmalik,M,100,0,5,5
Barbara,F,100,581823,1498,583321
Kentravius,M,100,0,10,10
Lorella,F,100,129,0,129
Masonjames,M,100,0,16,16
Gurvir,M,100,0,49,49
Onaleigh,F,100,7,0,7
Melly,F,100,25,0,25
Sajada,F,100,44,0,44
Anthoni,M,100,0,826,826
Xyomara,F,100,6,0,6
Yashir,M,100,0,5,5
Jaytin,M,100,0,29,29
Breshauna,F,100,38,0,38
Jmarion,M,100,0,135,135
Caysie,F,100,155,0,155
Keishanda,F,100,5,0,5
Jacolby,M,99,15,1326,1341
Avonni,F,100,6,0,6
Marvia,F,100,84,0,84
Sivani,F,100,41,0,41
Pete,M,100,62,18453,18515
Shakeena,F,100,508,0,508
Jaizen,M,100,0,17,17
Shakai,M,92,5,57,62
Alyssarae,F,100,5,0,5
Saturn,F,100,10,0,10
Jamaad,M,100,0,5,5
Sulmy,F,100,7,0,7
Albanie,F,100,20,0,20
Rakelle,F,100,21,0,21
Mayon,M,100,0,11,11
Ginney,F,100,5,0,5
Sanford,M,100,0,4827,4827
Deaveon,M,70,30,69,99
Turki,M,100,0,51,51
Akua,F,100,464,0,464
Savone,M,100,0,22,22
Calita,F,100,5,0,5
Zyaria,F,100,44,0,44
Kaysun,M,100,0,10,10
Junior,M,100,5,12705,12710
Jaquela,F,100,41,0,41
Fayelynn,F,100,41,0,41
Bam,M,100,0,39,39
Shadan,F,100,11,0,11
Maitland,F,70,107,46,153
Michyla,F,100,11,0,11
Kijani,M,100,0,21,21
Sarine,F,100,46,0,46
Namon,M,100,0,469,469
Evelynne,F,100,474,0,474
Rokeya,F,100,11,0,11
Yenna,F,100,39,0,39
Myshell,F,100,20,0,20
Jerusalem,F,80,192,49,241
Malekhi,M,100,0,31,31
Marelis,F,100,25,0,25
Kelce,F,100,25,0,25
Amberleigh,F,100,420,0,420
Yameka,F,100,18,0,18
Anjelica,F,100,4197,0,4197
Joselynne,F,100,119,0,119
Satyn,F,100,5,0,5
Amiya,F,100,5701,0,5701
Yaacov,M,100,0,121,121
Lhea,F,100,5,0,5
Selim,M,100,0,342,342
Altin,M,100,0,109,109
Lashaunna,F,100,39,0,39
Americo,M,100,0,1006,1006
Brek,M,100,0,306,306
Schantel,F,100,13,0,13
Bronc,M,100,0,91,91
Lisbett,F,100,11,0,11
Drevonte,M,100,0,7,7
Breania,F,100,19,0,19
Ereca,F,100,5,0,5
Damarion,M,100,0,3757,3757
Analu,M,100,0,10,10
Druscilla,F,100,162,0,162
Benzion,M,100,0,761,761
Maricar,F,100,50,0,50
Dahna,F,100,51,0,51
Louisa,F,100,8220,0,8220
Qua,M,100,0,10,10
Latashua,F,100,10,0,10
Corrida,F,100,11,0,11
Audrie,F,100,2616,0,2616
Alicen,F,100,961,0,961
Shauntrice,F,100,53,0,53
Mikayle,F,92,55,5,60
Daizah,F,100,44,0,44
Nazari,F,73,27,10,37
Mitsuki,F,100,11,0,11
Liva,F,100,10,0,10
Diyonna,F,100,5,0,5
Dang,M,98,6,293,299
Izyk,M,100,0,52,52
Jnasia,F,100,5,0,5
Jesses,M,100,0,22,22
Raydon,M,100,0,172,172
Lukacs,M,100,0,5,5
Sidonia,F,100,74,0,74
Rashetta,F,100,24,0,24
Lanayja,F,100,5,0,5
Josmary,F,100,35,0,35
Alioune,M,100,0,123,123
Jacquesha,F,100,12,0,12
Zyquavion,M,100,0,11,11
Sadarion,M,100,0,5,5
Marilena,F,100,492,0,492
Debbey,F,100,5,0,5
Janyah,F,100,960,0,960
Carmellia,F,100,82,0,82
Akhil,M,100,0,1458,1458
Milthon,M,100,0,12,12
Albaro,M,100,0,630,630
Stacha,F,100,38,0,38
Jahziah,M,92,11,132,143
Denasia,F,100,646,0,646
Trishna,F,100,95,0,95
Lakisia,F,100,11,0,11
Isoken,F,100,5,0,5
Jyena,F,100,5,0,5
Tha,M,57,10,13,23
Nichalaus,M,100,0,6,6
Tyger,M,86,54,326,380
Winsor,M,100,0,5,5
Terrye,F,100,400,0,400
Iselda,F,100,16,0,16
Greys,F,100,6,0,6
Kexin,F,100,18,0,18
Paelynn,F,100,11,0,11
Deyli,F,100,10,0,10
Mavis,F,100,3975,5,3980
Valiyah,F,100,34,0,34
Cloie,F,100,778,0,778
Unkown,M,54,42,49,91
Calliegh,F,100,54,0,54
Symon,M,97,10,356,366
Shaleah,F,100,469,0,469
Tyliyah,F,100,387,0,387
Cetera,F,100,53,0,53
Eilijah,M,100,0,5,5
Moeshia,F,100,52,0,52
Ryelan,M,93,5,70,75
Claudinette,F,100,7,0,7
Kekeli,F,100,12,0,12
Nuno,M,100,0,111,111
Yaritsa,F,100,116,0,116
Didi,F,100,181,0,181
Shneor,M,100,0,5,5
Emilyanne,F,100,258,0,258
Marthana,F,100,6,0,6
Daegon,M,100,0,70,70
Larell,M,98,5,316,321
Norberta,F,100,69,0,69
Romulo,M,100,0,603,603
Denyce,F,100,295,0,295
Miakka,F,100,5,0,5
Noach,M,100,0,200,200
Jeannea,F,100,5,0,5
Yevonne,F,100,202,0,202
Doneta,F,100,84,0,84
Shainia,F,100,9,0,9
Elazar,M,100,0,380,380
Daffy,F,100,8,0,8
Maxell,M,100,0,5,5
Alexys,F,92,3986,363,4349
Rajana,F,100,6,0,6
Jericho,M,93,242,3376,3618
Ethyl,F,100,93,0,93
Rahsean,M,100,0,27,27
Scion,M,100,0,15,15
Alysiah,F,100,72,0,72
Aidyen,M,100,0,5,5
Bricelyn,F,100,53,0,53
Annalena,F,100,193,0,193
Kasarah,F,100,111,0,111
Carolynne,F,100,610,0,610
Araceliz,F,100,5,0,5
Julienn,M,100,0,6,6
Kariel,F,73,46,17,63
Slate,M,100,0,374,374
Syani,F,100,10,0,10
Alliemae,F,100,12,0,12
Ravinder,M,95,5,93,98
Annaleisa,F,100,5,0,5
Niarose,F,100,6,0,6
Edalia,F,100,5,0,5
Thoeun,M,100,0,10,10
Aalayjah,F,100,6,0,6
Conor,M,100,69,19745,19814
Kymberli,F,100,574,0,574
Lynkin,M,100,0,54,54
Vikram,M,100,0,1555,1555
Grant,M,100,197,100692,100889
Olethia,F,100,6,0,6
Adony,M,100,0,16,16
Charmaine,F,100,12713,20,12733
Reshawnda,F,100,19,0,19
Lariyah,F,100,391,0,391
Seren,F,97,596,20,616
Nahyan,M,100,0,8,8
Joshuan,M,100,0,134,134
Joria,F,100,11,0,11
Buzzy,M,100,0,37,37
Ahriel,F,100,14,0,14
Ransel,M,100,0,8,8
Tilda,F,100,424,0,424
Mohagany,F,100,17,0,17
Amadu,M,100,0,81,81
Vsevolod,M,100,0,5,5
Kashayla,F,100,204,0,204
Daymion,M,100,0,187,187
Galon,M,100,0,5,5
Kyrrah,F,100,18,0,18
Euniqua,F,100,22,0,22
Glynnis,F,100,554,0,554
Lama,F,100,364,0,364
Lauriann,F,100,159,0,159
Amzie,F,100,65,0,65
Ashawnti,F,100,127,0,127
Ledon,M,100,0,70,70
Zakeyia,F,100,5,0,5
Jayvier,M,100,0,179,179
Leshea,F,100,108,0,108
Govani,M,100,0,75,75
Niko,M,94,342,5640,5982
Adlyn,F,100,82,0,82
Kaidan,M,93,59,752,811
Marnia,F,100,11,0,11
Gillis,M,100,0,234,234
Nidal,M,100,0,191,191
Luelle,F,100,5,0,5
Quana,F,100,260,0,260
Kynzlee,F,100,326,0,326
Martita,F,100,101,0,101
Dadrien,M,100,0,31,31
Ikera,F,100,11,0,11
Jaterion,M,100,0,10,10
Cashten,M,100,0,27,27
Binyamin,M,100,0,566,566
Arvell,M,100,0,175,175
Tilena,F,100,5,0,5
Pao,M,100,0,301,301
Ceceila,F,100,32,0,32
Kalop,M,100,0,10,10
Loki,M,96,26,712,738
Delfreda,F,100,7,0,7
Eyva,F,100,43,0,43
Dupri,M,100,0,26,26
Zeshaun,M,100,0,5,5
Chassiti,F,100,7,0,7
Wesson,M,100,0,548,548
Darshell,F,100,46,0,46
Diamantina,F,100,338,0,338
Tasnim,F,98,497,10,507
Gioacchino,M,100,0,15,15
Dashad,M,100,0,17,17
Isabelita,F,100,24,0,24
Hitney,F,100,6,0,6
Ellwood,M,100,0,208,208
Latoi,F,100,88,0,88
Barakah,F,100,5,0,5
Kayd,M,100,0,113,113
Lachae,F,100,64,0,64
Prezlee,F,100,13,0,13
Michaelle,F,100,1308,0,1308
Dawana,F,100,532,0,532
Lorrin,F,72,244,94,338
Mandelyn,F,100,16,0,16
Jacquane,M,100,0,5,5
Mava,F,100,10,0,10
Kinlynn,F,100,18,0,18
Keeven,M,100,0,66,66
Phillipmichael,M,100,0,12,12
Rayder,M,100,0,72,72
Mekko,M,100,0,12,12
Angeliz,F,100,334,0,334
Chanie,F,100,650,0,650
Yehezkel,M,100,0,5,5
Kyel,M,97,5,194,199
Natoshia,F,100,454,0,454
Reyad,M,100,0,16,16
Artia,F,100,73,0,73
Aliviyah,F,100,72,0,72
Naisa,F,100,11,0,11
Efrosini,F,100,6,0,6
Matvey,M,100,0,138,138
Orli,F,100,273,0,273
Jshon,M,100,0,101,101
Joselle,F,100,179,0,179
Deshondra,F,100,92,0,92
Taitlyn,F,100,33,0,33
Aresha,F,100,32,0,32
Shondrea,F,100,147,0,147
Jezzelle,F,100,5,0,5
Elijan,M,100,0,102,102
Melan,F,100,5,0,5
Laciana,F,100,24,0,24
Navier,M,100,0,23,23
Nusaybah,F,100,102,0,102
Illyssa,F,100,20,0,20
Haseebullah,M,100,0,5,5
Nazarah,F,100,11,0,11
Lavall,M,100,0,5,5
Jayace,M,100,0,6,6
Calyce,F,100,5,0,5
Devansh,M,100,0,209,209
Shadiyah,F,100,86,0,86
Pamel,F,100,48,0,48
Ashston,M,100,0,20,20
Mayan,F,64,192,106,298
Sophiagrace,F,100,80,0,80
Telia,F,100,638,0,638
Peggysue,F,100,54,0,54
Butterfly,F,100,10,0,10
Chantol,F,100,18,0,18
Saarth,M,100,0,18,18
Oluwadara,F,93,66,5,71
Calab,M,100,0,354,354
Kotryna,F,100,5,0,5
Ranata,F,100,80,0,80
Moryah,F,100,16,0,16
Kissiah,F,100,13,0,13
Fatai,M,100,0,5,5
Devorah,F,100,3291,0,3291
Zacorian,M,100,0,15,15
Yesenya,F,100,22,0,22
Ajmal,M,100,0,53,53
Jovanni,M,97,156,4442,4598
Reynaldo,M,100,23,16081,16104
Annettie,F,100,21,0,21
Yalda,F,100,51,0,51
Yaraliz,F,100,27,0,27
Christophere,M,100,0,189,189
Anariya,F,100,5,0,5
Agustin,M,100,21,11934,11955
Daraly,F,100,12,0,12
Larron,M,100,0,136,136
Ambee,F,100,5,0,5
Prerana,F,100,63,0,63
Jakyiah,F,100,83,0,83
Arieonna,F,100,301,0,301
Breajah,F,100,21,0,21
Theretha,F,100,16,0,16
Holliday,F,100,40,0,40
Atsushi,M,100,0,45,45
Parneet,F,100,120,0,120
Calieb,M,100,0,65,65
Ramiel,M,100,0,41,41
Breylan,M,100,0,131,131
Taleena,F,100,39,0,39
Ronetta,F,100,667,0,667
Nikema,F,100,38,0,38
Yashi,F,100,32,0,32
Brenisha,F,100,110,0,110
Theon,M,95,9,169,178
Bithiah,F,100,5,0,5
Floree,F,100,10,0,10
Starkeisha,F,100,74,0,74
Kevrick,M,100,0,5,5
Rashaya,F,100,6,0,6
Micahia,F,100,5,0,5
Gor,M,100,0,60,60
Tamarae,F,100,5,0,5
Keoshia,F,100,209,0,209
Fatmah,F,100,22,0,22
Caiya,F,100,249,0,249
Zody,F,100,5,0,5
Sharie,F,100,1745,0,1745
Shatonga,F,100,21,0,21
Kassi,F,100,2012,0,2012
Avrian,M,100,0,46,46
Matalyn,F,100,320,0,320
Chung,M,95,11,193,204
Bernadean,F,100,75,0,75
Amayrani,F,100,487,0,487
Gero,M,100,0,5,5
Timbre,F,100,20,0,20
Dounia,F,100,43,0,43
Caullin,M,100,0,18,18
Jaquavious,M,100,0,740,740
Izybella,F,100,13,0,13
Kielan,M,100,0,88,88
Aryell,F,100,17,0,17
Coit,M,100,0,7,7
Brittnye,F,100,97,0,97
Laylanii,F,100,10,0,10
Destenie,F,100,207,0,207
Vlada,F,100,49,0,49
Behnam,M,100,0,29,29
Raynita,F,100,24,0,24
Sigmund,M,100,0,520,520
Zennon,M,100,0,15,15
Khachik,M,100,0,16,16
Arceli,F,100,25,0,25
Tavari,M,100,0,57,57
Areyonna,F,100,33,0,33
Anjola,F,100,5,0,5
Debony,F,100,31,0,31
Kylenn,F,60,12,8,20
Latarra,F,100,87,0,87
Feltus,M,100,0,10,10
Adreanna,F,100,1487,0,1487
Yasniel,M,100,0,5,5
Ladd,M,100,0,840,840
Quincee,F,98,196,5,201
Pierrette,F,100,171,0,171
Autumne,F,100,62,0,62
Emmily,F,100,819,0,819
Kenshaun,M,100,0,6,6
Eirinn,F,100,19,0,19
Ellington,M,55,259,314,573
Jannete,F,100,58,0,58
Dyane,F,100,311,0,311
Mikaya,F,100,415,0,415
Waid,M,100,0,5,5
Myrin,M,100,0,6,6
Maciee,F,100,10,0,10
Darline,F,100,2391,0,2391
Barnes,M,100,0,22,22
Davionna,F,100,407,0,407
Thorson,M,100,0,5,5
Ahmer,M,100,0,43,43
Auguster,M,100,0,5,5
Bamby,F,100,5,0,5
Dairion,M,100,0,13,13
Jakoby,M,100,0,1036,1036
Shanton,M,74,15,43,58
Abbilyn,F,100,12,0,12
Kritzia,F,100,14,0,14
Breece,F,76,34,11,45
Jamorian,M,100,0,77,77
Natas,M,100,0,21,21
Shanard,M,100,0,133,133
Beather,F,100,5,0,5
Quanna,F,100,58,0,58
Sstephanie,F,100,5,0,5
Atesha,F,100,5,0,5
Davien,M,100,0,1034,1034
Eurica,F,100,16,0,16
Dawnya,F,100,224,0,224
Jagen,M,100,0,21,21
Yanett,F,100,175,0,175
Jalis,F,100,10,0,10
Indrani,F,100,16,0,16
Akil,M,100,0,1807,1807
Caly,F,100,117,0,117
Artesia,F,100,226,0,226
Franchesca,F,100,4088,0,4088
Nevine,F,100,5,0,5
Alfreddie,M,100,0,46,46
Kathlina,F,100,11,0,11
Syrina,F,100,175,0,175
Shalitha,F,100,26,0,26
Eriyona,F,100,11,0,11
Olubukola,F,100,11,0,11
Teyon,M,100,0,178,178
Jaona,F,100,10,0,10
Terronda,F,100,5,0,5
Brithney,F,100,124,0,124
Toshiro,M,100,0,44,44
Hiede,F,100,12,0,12
Emyle,F,100,29,0,29
Zonna,F,100,18,0,18
Camary,F,100,63,0,63
Andry,M,98,5,197,202
Haoyang,M,100,0,5,5
Quishawn,M,100,0,23,23
Charlieann,F,100,29,0,29
Tysheonna,F,100,5,0,5
Marlenie,F,100,21,0,21
Datril,M,55,5,6,11
Parren,M,100,0,6,6
Lillianah,F,100,78,0,78
Eliyanna,F,100,45,0,45
Bobak,M,100,0,122,122
Leire,F,100,5,0,5
Catherin,F,100,862,0,862
Emmamae,F,100,78,0,78
Marcell,M,87,538,3698,4236
Jesy,M,67,5,10,15
Teshana,F,100,17,0,17
Ormand,M,100,0,10,10
Yakov,M,100,0,1934,1934
Khalisha,F,100,54,0,54
Arelyn,F,100,39,0,39
Reuel,M,100,0,378,378
Yzabelle,F,100,62,0,62
Katyna,F,100,11,0,11
Cashay,F,100,141,0,141
Sonika,F,100,122,0,122
Katana,F,100,1077,0,1077
Kaliee,F,100,6,0,6
Martesha,F,100,90,0,90
Teneeka,F,100,5,0,5
Gelisha,F,100,6,0,6
Powell,M,100,0,548,548
Jeileen,F,100,27,0,27
Jakeriya,F,100,5,0,5
Yarik,M,100,0,6,6
Page,F,82,3440,779,4219
Jannice,F,100,475,0,475
Laquilla,F,100,77,0,77
Adylan,F,100,22,0,22
Tykaria,F,100,5,0,5
Lolla,F,100,16,0,16
Pearlee,F,100,7,0,7
Azhia,F,100,88,0,88
Deontrey,M,100,0,97,97
Antonio,M,99,1660,213546,215206
Klarity,F,100,18,0,18
Aritzi,F,100,12,0,12
Marshaye,F,100,7,0,7
Aliceann,F,100,17,0,17
Kermitt,M,100,0,66,66
Diksha,F,100,50,0,50
Willia,F,58,485,350,835
Ruffin,M,100,0,173,173
Teela,F,100,800,0,800
Bryttney,F,100,62,0,62
Novaleigh,F,100,158,0,158
Azur,F,100,13,0,13
Jascha,M,100,0,32,32
Navay,F,100,5,0,5
Brenasia,F,100,39,0,39
Kenden,M,100,0,254,254
Patricie,F,100,70,0,70
Darleth,F,100,5,0,5
Jahiem,M,100,0,1298,1298
Breighlynn,F,100,15,0,15
Lexilynn,F,100,5,0,5
Aniyan,F,100,17,0,17
Aakash,M,100,0,877,877
Veeta,F,100,10,0,10
Radia,F,100,21,0,21
Darsie,F,100,12,0,12
Jazziel,M,100,0,63,63
Crislynn,F,100,42,0,42
Veanna,F,100,79,0,79
Elysiana,F,100,10,0,10
Wyvonia,F,100,16,0,16
Arsenio,M,100,0,1717,1717
Desara,F,100,5,0,5
Sinthia,F,100,246,0,246
Calle,F,100,218,0,218
Mauren,F,100,26,0,26
Deianeira,F,100,49,0,49
Lacia,F,100,50,0,50
Aishatu,F,100,5,0,5
Ranelle,F,100,377,0,377
Earle,M,100,0,2271,2271
Karrar,M,100,0,11,11
Talulah,F,100,188,0,188
Yavanna,F,100,5,0,5
Rudransh,M,100,0,14,14
Keirra,F,100,1362,0,1362
Keylei,F,100,25,0,25
Elahna,F,100,5,0,5
Zacharia,M,99,22,1537,1559
Zamarian,M,100,0,65,65
Kingsley,M,83,479,2416,2895
Aashish,M,100,0,132,132
Sakeenah,F,100,229,0,229
Maryesther,F,100,16,0,16
Damarlo,M,100,0,5,5
Jawvan,M,100,0,5,5
Chamberlain,M,93,6,85,91
Jowell,M,99,5,569,574
Deztiney,F,100,5,0,5
Royan,M,100,0,10,10
Arby,M,100,0,34,34
Keirah,F,100,325,0,325
Ezio,M,100,0,323,323
Tamasha,F,100,108,0,108
Laurissa,F,100,724,0,724
Dessiah,F,100,17,0,17
Rayya,F,100,135,0,135
Nicoles,M,100,0,103,103
Hather,F,100,11,0,11
Kryslin,F,100,20,0,20
Zaniyla,F,100,31,0,31
Nandhan,M,100,0,5,5
Zakkiyya,F,100,75,0,75
Regla,F,100,65,0,65
Aponi,F,100,10,0,10
Cosetta,F,100,31,0,31
Reather,F,100,103,0,103
Lavania,F,100,11,0,11
Mitesh,M,100,0,147,147
Zymeria,F,100,55,0,55
Kendrica,F,100,5,0,5
Zephram,M,100,0,10,10
Kenyel,F,100,5,0,5
Anngelica,F,100,11,0,11
Sheina,F,100,395,0,395
Jazlynne,F,100,254,0,254
Rishitha,F,100,11,0,11
Maleigh,F,100,163,0,163
Naija,F,100,236,0,236
Samekia,F,100,5,0,5
Yuvette,F,100,54,0,54
Cambryn,F,87,112,17,129
Michelyn,F,100,64,0,64
Starrla,F,100,44,0,44
Saw,M,100,0,93,93
Jaidee,F,100,55,0,55
Uver,M,100,0,5,5
Serianna,F,100,23,0,23
Lucino,M,100,0,36,36
Suezette,F,100,63,0,63
Kurosh,M,100,0,11,11
Donnelle,F,56,299,236,535
Kosei,M,100,0,67,67
Adrija,F,100,23,0,23
Temecia,F,100,6,0,6
Ishmael,M,100,0,4294,4294
Cabella,F,100,103,0,103
Jamiel,M,98,19,750,769
Zyshon,M,100,0,19,19
Aicha,F,100,678,0,678
Kiai,M,100,0,12,12
Rayman,M,100,0,74,74
Verginia,F,100,21,0,21
Shellsea,F,100,127,0,127
March,F,61,82,53,135
Saarim,M,100,0,15,15
Zakkary,M,100,0,1100,1100
Yuleiky,F,100,5,0,5
Abbee,F,100,158,0,158
Damya,F,100,1133,0,1133
Shakor,M,100,0,17,17
Jeraldy,F,100,51,0,51
Tushima,F,100,5,0,5
Maloree,F,100,271,0,271
Dominga,F,100,1181,0,1181
Nadjah,F,100,22,0,22
Tyquann,M,100,0,23,23
Sharda,F,100,613,0,613
Jaiana,F,100,281,0,281
Tishia,F,100,285,0,285
Anjanique,F,100,13,0,13
Beauford,M,100,0,197,197
Neolani,F,100,6,0,6
Milly,F,100,1558,0,1558
Leith,M,83,92,457,549
Leeanah,F,100,5,0,5
Ruqaya,F,100,63,0,63
Pennie,F,100,4278,0,4278
Liahna,F,100,139,0,139
Ladaruis,M,100,0,10,10
Tash,F,50,15,15,30
Taaliah,F,100,10,0,10
Myrlin,F,100,5,0,5
Niyanna,F,100,214,0,214
Lanaja,F,100,58,0,58
Syriah,F,100,477,0,477
Shericka,F,100,324,0,324
Katerinne,F,100,11,0,11
Bobbe,F,100,135,0,135
Caroly,F,100,96,0,96
Yerly,F,100,7,0,7
Aurion,F,65,30,16,46
Shykia,F,100,21,0,21
Asean,M,100,0,51,51
Immacolata,F,100,11,0,11
Zyrus,M,100,0,51,51
Kaylonnie,F,100,17,0,17
Kama,F,100,710,0,710
Tyelise,F,100,6,0,6
Jasel,F,100,37,0,37
Cye,M,100,0,46,46
Geonni,M,100,0,26,26
Magnus,M,100,0,2290,2290
Kamaiyah,F,100,22,0,22
Tasheena,F,100,838,0,838
Jashya,F,100,41,0,41
Lamarria,F,100,39,0,39
Leshawn,M,70,312,736,1048
Laneshia,F,100,225,0,225
Cortland,M,98,32,1518,1550
Niyema,F,100,6,0,6
Keshante,F,100,5,0,5
Glanda,F,100,62,0,62
Freddie,M,94,2196,36943,39139
Josejulian,M,100,0,137,137
Terrial,M,100,0,28,28
Laasya,F,100,312,0,312
Kedron,M,97,5,145,150
Pricila,F,100,1083,0,1083
Wyteria,F,100,5,0,5
Jeon,M,100,0,5,5
Barbie,F,100,3691,0,3691
Isiaha,M,100,0,339,339
Sabia,F,100,10,0,10
Jakavious,M,100,0,30,30
Areionna,F,100,5,0,5
Caitin,F,100,21,0,21
Quida,F,100,46,0,46
Jahzara,F,100,1084,0,1084
Hongan,F,100,5,0,5
Brionica,F,100,5,0,5
Jocques,M,100,0,13,13
Myanna,F,100,452,0,452
Kiven,M,100,0,303,303
Stephanieanne,F,100,10,0,10
Khoen,M,100,0,41,41
Quinncy,M,67,5,10,15
Barby,F,100,121,0,121
Antranette,F,100,38,0,38
Kristn,F,100,22,0,22
Kouri,F,100,5,0,5
Janayia,F,100,137,0,137
Zorana,F,100,102,0,102
Radiya,F,100,18,0,18
Michai,M,100,0,211,211
Aleyah,F,100,1606,0,1606
Railee,F,100,187,0,187
Corbitt,M,100,0,44,44
Jaydem,M,100,0,28,28
Aundrey,M,98,5,309,314
Elian,M,99,44,3996,4040
Teresha,F,100,150,0,150
Jasee,F,100,5,0,5
Sehar,F,100,156,0,156
Curtesha,F,100,5,0,5
Tho,M,88,6,46,52
Cirila,F,100,6,0,6
Mariavictoria,F,100,133,0,133
Unborn,F,80,32,8,40
Kanijha,F,100,5,0,5
Auttum,F,100,5,0,5
Kollen,M,100,0,94,94
Ryia,F,100,30,0,30
Hoda,F,100,406,0,406
Evaan,M,100,0,27,27
Sheronne,F,100,19,0,19
Marlys,F,100,2094,0,2094
Jasminemarie,F,100,93,0,93
Trevaris,M,100,0,102,102
Leighna,F,100,20,0,20
Alaye,M,69,5,11,16
Eizabeth,F,100,44,0,44
Delaila,F,100,191,0,191
Raviv,M,100,0,6,6
Tene,F,100,324,0,324
Kiairra,F,100,22,0,22
Macon,M,88,129,972,1101
Meriem,F,100,79,0,79
Bobbilynn,F,100,5,0,5
Aviannah,F,100,82,0,82
Shawnteria,F,100,7,0,7
Salbador,M,100,0,278,278
Jarvion,M,100,0,16,16
Suzzanna,F,100,20,0,20
Sager,M,100,0,10,10
Tamarkus,M,100,0,7,7
Varnika,F,100,123,0,123
Jomo,M,100,0,355,355
Rakaya,F,100,16,0,16
Darinel,M,100,0,57,57
Alsiha,F,100,6,0,6
Tenlee,F,100,168,0,168
Nasir,M,100,29,9364,9393
Cameron,M,91,25360,250921,276281
Neeyah,F,100,15,0,15
Ribhi,M,100,0,5,5
Matlock,M,100,0,5,5
Zanniyah,F,100,5,0,5
Reynald,M,100,0,106,106
Suttyn,F,100,35,0,35
Tradell,M,100,0,13,13
Morgaine,F,100,175,0,175
Rifky,F,100,356,0,356
Marleth,F,100,23,0,23
Sharonette,F,100,5,0,5
Joylin,F,100,33,0,33
Aricca,F,100,11,0,11
Breland,M,85,52,304,356
Miracle,F,98,12825,240,13065
Dekanye,M,100,0,5,5
Kayzlie,F,100,5,0,5
Traiden,M,100,0,28,28
Nickolaos,M,100,0,148,148
Dionah,F,100,5,0,5
Geraldo,M,100,0,2295,2295
Kijana,M,66,137,264,401
Sequeena,F,100,5,0,5
Marielena,F,100,1189,0,1189
Kodiak,M,100,0,452,452
Samson,M,100,0,6689,6689
Demethra,F,100,12,0,12
Christiaan,M,100,0,834,834
Serafim,M,100,0,15,15
Ryelee,F,77,187,57,244
Rilynne,F,100,69,0,69
Jorri,F,100,10,0,10
Allimae,F,100,5,0,5
Tamikia,F,100,367,0,367
Jostyn,M,80,12,48,60
Tyyana,F,100,29,0,29
Ronnice,F,100,8,0,8
Ishaaq,M,100,0,53,53
Brigdon,M,100,0,11,11
Shanleigh,F,100,25,0,25
Pragnya,F,100,33,0,33
Chelseay,F,100,12,0,12
Manolis,M,100,0,18,18
Zanyria,F,100,6,0,6
Aneia,F,100,16,0,16
Lexon,M,100,0,10,10
Chenique,F,100,42,0,42
Kamau,M,100,0,800,800
Jahmyah,F,100,15,0,15
Verba,F,100,44,0,44
Chabeli,F,100,95,0,95
Deneka,F,100,183,0,183
Bronte,F,98,809,18,827
Albertha,F,100,780,0,780
Keesha,F,100,2699,0,2699
Melbourne,M,100,0,111,111
Antoniyah,F,100,13,0,13
Venishia,F,100,6,0,6
Dianalaura,F,100,10,0,10
Jenalee,F,100,437,0,437
Thelisa,F,100,5,0,5
Ramier,M,100,0,36,36
Dyani,F,99,1028,10,1038
Kinta,M,84,14,73,87
Malania,F,100,175,0,175
Joshya,M,100,0,12,12
Pacey,M,72,192,494,686
Briyah,F,100,152,0,152
Sephia,F,100,10,0,10
Jandery,F,100,5,0,5
Tamsen,F,100,389,0,389
Breyden,M,100,0,841,841
Shaqulle,M,100,0,6,6
Adelene,F,100,310,0,310
Sharlane,F,100,11,0,11
Sunidhi,F,100,11,0,11
Dyonne,F,100,26,0,26
Lindo,M,100,0,5,5
Sudays,M,100,0,11,11
Kalynne,F,100,266,0,266
Celin,F,100,55,0,55
Najirah,F,100,5,0,5
Catoya,F,100,20,0,20
Ryton,M,100,0,5,5
Steeven,M,100,0,25,25
Jialin,F,100,5,0,5
Willona,F,100,82,0,82
Virgena,F,100,12,0,12
Julieza,F,100,5,0,5
Jelani,M,91,380,3641,4021
Marycarmen,F,100,344,0,344
Solmarie,F,100,21,0,21
Efrain,M,100,29,16245,16274
Gaile,F,100,391,0,391
Ethen,M,100,0,3350,3350
Caydon,M,100,0,506,506
Santanah,F,100,5,0,5
Daylie,F,100,17,0,17
Eileen,F,100,84701,161,84862
Evert,M,100,0,726,726
Nanaama,F,100,11,0,11
Hayson,M,100,0,5,5
Dmarco,M,100,0,430,430
Mads,M,100,0,19,19
Watson,M,100,0,1326,1326
Ched,M,100,0,39,39
Chrie,F,100,6,0,6
Avalei,F,100,29,0,29
Genifer,F,100,185,0,185
Nkauj,F,100,14,0,14
Abanoub,M,100,0,117,117
Randy,M,99,4194,311142,315336
Myson,M,100,0,211,211
Rosio,F,99,2454,19,2473
Raynald,M,100,0,63,63
Mairany,F,100,85,0,85
Jowana,F,100,107,0,107
Meghean,F,100,5,0,5
Isaiahmichael,M,100,0,5,5
Talbott,M,100,0,6,6
Giah,F,100,48,0,48
Nashiem,M,100,0,19,19
Ibukunoluwa,M,58,17,23,40
Idell,F,100,313,0,313
Jauan,M,100,0,190,190
Jeneba,F,100,5,0,5
Oseas,M,100,0,205,205
Kailan,F,59,417,287,704
Mikos,M,100,0,29,29
Rozlin,F,100,24,0,24
Takecia,F,100,19,0,19
Kix,M,100,0,29,29
Kauner,M,100,0,5,5
Orly,F,100,532,0,532
Moosa,M,100,0,146,146
Jawonna,F,100,5,0,5
Keyleigh,F,100,171,0,171
Jalilah,F,100,117,0,117
Itiana,F,100,8,0,8
Ashira,F,100,416,0,416
Breese,F,100,5,0,5
Joani,F,100,565,0,565
Kyonte,M,100,0,8,8
Jennevy,F,100,5,0,5
Fredna,F,100,84,0,84
Nykeah,F,100,6,0,6
Megin,F,100,294,0,294
Tayo,M,100,0,75,75
Zakayden,M,100,0,5,5
Bridget,F,100,83593,149,83742
Peirre,M,100,0,24,24
Adama,F,60,423,286,709
Yanine,F,100,26,0,26
Jawanza,M,98,5,201,206
Zarriah,F,100,333,0,333
Kerisha,F,100,146,0,146
Julena,F,100,93,0,93
Nehan,M,100,0,41,41
Everest,M,93,43,559,602
Hae,F,100,127,0,127
Allya,F,100,5,0,5
Tavona,F,100,10,0,10
Evodio,M,100,0,18,18
Evee,F,100,251,0,251
Sharmonique,F,100,17,0,17
Elliahna,F,100,36,0,36
Caryle,F,100,59,0,59
Jehu,M,100,0,637,637
Motaz,M,100,0,35,35
Jarell,M,100,0,2627,2627
Ikenna,M,100,0,546,546
Pilot,M,100,0,89,89
Dayanna,F,100,2481,0,2481
Shenitta,F,100,9,0,9
Deivion,M,59,7,10,17
Eleasa,F,100,5,0,5
Rylynn,F,96,1156,52,1208
Trvis,M,100,0,15,15
Albrey,F,100,13,0,13
Muse,M,100,0,38,38
Nayli,F,100,19,0,19
Tyneka,F,100,131,0,131
Deshonna,F,100,159,0,159
Trayton,M,100,0,792,792
Harlyn,F,72,234,92,326
Yarianny,F,100,6,0,6
Gennie,F,98,867,16,883
Darcella,F,100,143,0,143
Roly,M,100,0,7,7
Rinna,F,100,22,0,22
Slavica,F,100,5,0,5
Zurisadai,F,100,440,0,440
Harmone,F,100,47,0,47
Hiran,M,100,0,72,72
Trystan,M,86,619,3656,4275
Nahely,F,100,5,0,5
Justino,M,100,0,909,909
Cita,F,100,10,0,10
Jariely,F,100,10,0,10
Besiana,F,100,5,0,5
Morgayne,F,100,5,0,5
Riyonna,F,100,6,0,6
Jahvion,M,100,0,40,40
Canela,F,100,45,0,45
Thach,M,100,0,11,11
Hjordis,F,100,6,0,6
Sabastien,M,100,0,87,87
Ozvaldo,M,100,0,6,6
Eliazer,M,100,0,85,85
Pratt,M,100,0,22,22
Hisela,F,100,5,0,5
Anjli,F,100,11,0,11
Semaiah,F,100,17,0,17
Kytana,F,100,11,0,11
Gennetta,F,100,31,0,31
Tonna,F,100,720,0,720
Tamaurice,M,100,0,5,5
Pinkney,M,100,0,35,35
Haidon,M,100,0,47,47
Khevin,M,100,0,14,14
Tennelle,F,100,64,0,64
Rosilyn,F,100,420,0,420
Emalynn,F,100,348,0,348
Kristyan,M,67,5,10,15
Demitris,M,100,0,142,142
Craige,M,100,0,339,339
Annette,F,100,118221,350,118571
Jeniyah,F,100,416,0,416
Trippton,M,100,0,6,6
Elzy,M,100,0,34,34
Kamariah,F,100,173,0,173
Suhailah,F,100,81,0,81
Philisha,F,100,109,0,109
Shakenna,F,100,52,0,52
Sarynity,F,100,22,0,22
Tayvon,M,100,0,1193,1193
Atziri,F,100,421,0,421
Eshanti,F,100,27,0,27
Hersel,M,100,0,10,10
Kennell,M,100,0,6,6
Bjana,F,100,9,0,9
Bunny,F,98,1043,23,1066
Casiana,F,100,12,0,12
Jerricka,F,100,217,0,217
Lexsey,F,100,14,0,14
Eberardo,M,100,0,413,413
Yonika,F,100,5,0,5
Niyelle,F,100,13,0,13
Chau,F,77,365,107,472
Katasia,F,100,11,0,11
Haider,M,100,0,493,493
Blaklie,F,100,5,0,5
Shanena,F,100,79,0,79
Kmiya,F,100,5,0,5
Zadquiel,M,100,0,11,11
Kametra,F,100,16,0,16
Zacari,M,67,90,181,271
Aysia,F,100,1912,0,1912
Haowen,M,100,0,6,6
Damarious,M,100,0,282,282
Alban,M,100,0,543,543
Leanni,F,100,14,0,14
Sherese,F,100,940,0,940
Dorrie,F,100,786,0,786
Deslynn,F,100,27,0,27
Carlysha,F,100,5,0,5
Blakelyn,F,100,278,0,278
Patsi,F,100,25,0,25
Rayirth,M,100,0,10,10
Taelyn,F,94,1208,75,1283
Estin,M,100,0,34,34
Ciasia,F,100,11,0,11
Cherylin,F,100,56,0,56
Leangelo,M,100,0,12,12
Keina,F,100,122,0,122
Lynee,F,100,301,0,301
Lenaya,F,100,223,0,223
Detzani,F,100,11,0,11
Nataki,F,100,140,0,140
Caribbean,F,100,5,0,5
Reise,M,55,98,122,220
Khasim,M,100,0,12,12
Brycenn,M,100,0,5,5
Laiyah,F,100,204,0,204
Coopar,M,100,0,14,14
Delya,F,100,5,0,5
Kaitylyn,F,100,41,0,41
Hazelle,F,100,170,0,170
Shauntavious,M,100,0,5,5
Amairani,F,100,1120,0,1120
Janautica,F,100,71,0,71
Marquess,M,100,0,18,18
Karena,F,100,3318,0,3318
Arren,M,93,21,273,294
Hagan,M,91,109,1043,1152
Jontaye,M,100,0,5,5
Sinia,F,100,85,0,85
Leonides,M,98,12,488,500
Darynne,F,100,5,0,5
Jermani,F,79,293,76,369
Keesa,F,100,27,0,27
Timithy,M,100,0,391,391
Demarkas,M,100,0,6,6
Kristle,F,100,892,0,892
Angelicque,F,100,11,0,11
Androniki,F,100,5,0,5
Deeddra,F,100,6,0,6
Kamaehu,M,100,0,12,12
Shemarion,M,100,0,6,6
Malaquias,M,100,0,41,41
Ailsa,F,100,437,0,437
Eian,M,100,0,1608,1608
Kathrynann,F,100,5,0,5
Zilas,M,100,0,5,5
Hasna,F,100,149,0,149
Monick,F,100,80,0,80
Meier,M,100,0,6,6
Daxter,M,100,0,42,42
Trinay,M,100,0,5,5
Jahron,M,100,0,151,151
Gabriel,M,98,6424,299248,305672
Oladipupo,M,100,0,5,5
Jabarrie,M,100,0,5,5
No,F,67,12,6,18
Shiyan,F,100,30,0,30
Jensyn,F,86,381,61,442
Anacleto,M,100,0,63,63
Taylir,F,100,59,0,59
Gwynevere,F,100,93,0,93
Zhanelle,F,100,5,0,5
Bodhin,M,100,0,25,25
Tinley,F,100,1381,0,1381
Quaniece,F,100,27,0,27
Tifni,F,100,5,0,5
Pamilla,F,100,21,0,21
Laihla,F,100,39,0,39
Ashi,F,100,23,0,23
Sevan,M,92,21,227,248
Aquaria,F,100,11,0,11
Hinano,F,100,11,0,11
Makhaila,F,100,26,0,26
Laporschia,F,100,6,0,6
Quirino,M,100,0,122,122
Shawnique,F,100,106,0,106
Ives,M,100,0,21,21
Preciliano,M,100,0,5,5
Nafis,M,100,0,492,492
Camlin,F,50,5,5,10
Taiya,F,100,593,0,593
Julio,M,99,382,53456,53838
Akala,F,100,34,0,34
Sorrel,F,100,56,0,56
Dianelis,F,100,44,0,44
Halimatou,F,100,35,0,35
Timmithy,M,100,0,5,5
Britian,M,89,10,77,87
Denae,F,100,2462,0,2462
Marykaye,F,100,26,0,26
Kais,M,100,0,121,121
Pranil,M,100,0,5,5
Shequanda,F,100,5,0,5
Dusty,M,70,4242,10116,14358
Astella,F,100,38,0,38
Jannie,F,100,4157,0,4157
Iyoni,F,100,5,0,5
Carliana,F,100,19,0,19
Xylie,F,100,31,0,31
Cailyn,F,100,4696,0,4696
Jazzabelle,F,100,6,0,6
Rahil,M,99,6,396,402
Avrion,M,100,0,5,5
Dartanyan,M,100,0,66,66
Sherylyn,F,100,26,0,26
Sequila,F,100,8,0,8
Nzingha,F,100,56,0,56
Saintclair,M,100,0,58,58
Toshio,M,100,0,10,10
Darlenne,F,100,18,0,18
Noelli,F,100,5,0,5
Keondre,M,100,0,1280,1280
Charhonda,F,100,5,0,5
Yireh,F,100,51,0,51
Tama,F,100,1295,6,1301
Julani,M,74,5,14,19
Ortega,M,100,0,6,6
Jerime,M,100,0,281,281
Shareva,F,100,5,0,5
Dquan,M,100,0,219,219
Navjot,F,52,108,98,206
Shankeria,F,100,8,0,8
Burney,M,100,0,248,248
Faryn,F,100,335,0,335
Iden,M,100,0,265,265
Alike,F,100,11,0,11
Ameen,M,100,0,1170,1170
Salissa,F,100,6,0,6
Ankith,M,100,0,89,89
Tesha,F,100,1804,0,1804
Rashee,M,100,0,155,155
Denina,F,100,116,0,116
Korryn,F,100,264,0,264
Shalon,F,90,1180,130,1310
Kallia,F,100,31,0,31
Djimon,M,95,11,227,238
Bonne,F,100,183,0,183
Zekhi,M,100,0,51,51
Alexandria,F,100,91990,214,92204
Cathy,F,100,153682,299,153981
Werner,M,100,0,1108,1108
Denziel,M,100,0,18,18
Macoy,M,100,0,298,298
Jeanni,F,100,134,0,134
Danieljohn,M,100,0,12,12
Burgundy,F,100,276,0,276
Dhillon,M,100,0,61,61
Oluwasegun,M,100,0,17,17
Leilena,F,100,5,0,5
Ghalia,F,100,28,0,28
Amarys,F,100,122,0,122
Ahsia,F,100,12,0,12
Deaundra,F,73,318,120,438
Jameer,M,100,0,1187,1187
Lillykate,F,100,5,0,5
Micheale,F,100,85,0,85
Libra,F,100,218,0,218
Cozetta,F,100,227,0,227
Kayliyah,F,100,21,0,21
Jionna,F,100,17,0,17
Dawood,M,100,0,151,151
Isayana,F,100,5,0,5
Donah,F,100,13,0,13
Yisela,F,100,38,0,38
Khyier,M,100,0,10,10
Camiel,F,100,15,0,15
Icsis,F,100,18,0,18
Lakyna,F,100,7,0,7
Alexicia,F,100,22,0,22
Jarmon,M,100,0,111,111
Emeral,F,91,53,5,58
Koleby,M,100,0,14,14
Javyon,M,100,0,74,74
Zelah,F,100,15,0,15
Nicosia,F,100,13,0,13
Lannis,M,92,6,67,73
Overton,M,100,0,113,113
Kinan,M,100,0,88,88
Traiton,M,100,0,22,22
Anasophia,F,100,173,0,173
Jacob,M,100,2136,839182,841318
Elyshia,F,100,74,0,74
Cely,F,100,5,0,5
Edelin,F,100,58,0,58
Eli,M,99,628,85108,85736
Dushan,M,100,0,12,12
Gyasi,M,100,0,396,396
Abraxas,M,55,5,6,11
Palynn,F,100,39,0,39
Alarice,F,100,16,0,16
Dajaun,M,100,0,303,303
Ephraim,M,100,0,4443,4443
Bryland,M,100,0,38,38
Seqouia,F,100,42,0,42
Ajua,F,100,5,0,5
Ava,F,100,195197,238,195435
Lasunda,F,100,11,0,11
Astasia,F,100,50,0,50
Takirra,F,100,7,0,7
Joevanni,M,100,0,59,59
Ose,M,100,0,5,5
Haislee,F,100,6,0,6
Sohna,F,100,5,0,5
Iretha,F,100,112,0,112
Kallan,M,51,276,283,559
Makaili,F,100,11,0,11
Toriyah,F,100,5,0,5
Stacia,F,100,7948,0,7948
Quantesha,F,100,11,0,11
Asiyah,F,96,796,31,827
Demaryius,M,100,0,39,39
Odett,F,100,11,0,11
Jovita,F,100,1844,0,1844
Liselle,F,100,33,0,33
Tiericka,F,100,5,0,5
Tessanne,F,100,13,0,13
Forrestt,M,100,0,13,13
Amberlie,F,100,214,0,214
Xai,M,84,20,109,129
Mkenzie,F,100,201,0,201
Neita,F,100,112,0,112
Judea,F,79,285,78,363
Yaisha,F,100,7,0,7
Brihanna,F,100,654,0,654
Roselio,M,100,0,12,12
Isana,F,100,11,0,11
Veleria,F,100,83,0,83
Zaiyah,F,100,47,0,47
Haaniya,F,100,6,0,6
Deitre,F,100,15,0,15
Kharla,F,100,6,0,6
Duayne,M,100,0,193,193
Calex,M,100,0,21,21
Isair,M,100,0,48,48
Nariyah,F,100,1030,0,1030
Madalyn,F,100,17280,0,17280
Bohannon,M,100,0,5,5
Addlee,F,100,5,0,5
Sumedh,M,100,0,89,89
Aryiana,F,100,154,0,154
Jerroll,M,100,0,5,5
Basilio,M,100,0,1151,1151
Srivanth,M,100,0,10,10
Janyha,F,100,5,0,5
Branco,M,100,0,10,10
Jamale,M,100,0,466,466
Zyara,F,100,87,0,87
Kingman,M,100,0,6,6
Liliany,F,100,25,0,25
Vice,M,100,0,5,5
Niesa,F,100,21,0,21
Shalin,M,65,172,315,487
Landel,M,100,0,5,5
Afraz,M,100,0,37,37
Chata,F,100,10,0,10
Tangier,F,100,15,0,15
Revae,F,100,31,0,31
Kyjah,F,100,27,0,27
Alayla,F,100,845,0,845
Olivianna,F,100,77,0,77
Sheraine,F,100,16,0,16
Philo,M,100,0,68,68
Myeesha,F,100,89,0,89
Diago,M,100,0,162,162
Dujon,M,100,0,5,5
Ally,F,100,8290,10,8300
Apostolos,M,100,0,221,221
Shiloh,F,67,6533,3259,9792
Richi,M,100,0,22,22
Senika,F,100,28,0,28
Atiyana,F,100,67,0,67
Ariadne,F,100,2037,0,2037
Kenni,F,96,229,10,239
Madella,F,100,5,0,5
Pashance,F,100,25,0,25
Anly,F,100,5,0,5
Tayha,F,100,15,0,15
Heloise,F,100,94,0,94
Jahmi,M,100,0,25,25
Josean,M,100,0,204,204
Thawng,M,100,0,19,19
Rhyne,M,100,0,46,46
Cochise,M,100,0,66,66
Maislyn,F,100,10,0,10
Da,M,62,116,186,302
Tunisa,F,100,17,0,17
Karreem,M,100,0,28,28
Jeremai,M,100,0,34,34
Mashay,F,100,5,0,5
Azoria,F,100,89,0,89
Shashanth,M,100,0,5,5
Cionne,F,100,6,0,6
Malack,F,100,5,0,5
Connar,M,95,31,558,589
Oceanna,F,100,353,0,353
Nathaneal,M,100,0,860,860
Theofanis,M,100,0,10,10
Vinni,F,100,5,0,5
Yemisi,F,100,10,0,10
Michala,F,100,1539,0,1539
Zonda,F,100,49,0,49
Anayjah,F,100,23,0,23
Lingyi,F,100,6,0,6
Britain,M,55,522,628,1150
Talani,F,100,55,0,55
Nicanor,M,100,0,586,586
Saqqara,F,100,27,0,27
Kamyree,F,100,6,0,6
Prinsesa,F,100,7,0,7
Debany,F,100,81,0,81
Ryon,M,99,12,1829,1841
Harmonee,F,100,686,0,686
Ranald,M,100,0,50,50
Rubens,M,100,0,104,104
Shalee,F,100,1073,0,1073
Imaan,F,94,470,32,502
Dekan,M,100,0,18,18
Digby,M,100,0,11,11
Ngone,F,100,6,0,6
Candase,F,100,30,0,30
Emmagrace,F,100,436,0,436
Areya,F,100,173,0,173
Tonielle,F,100,6,0,6
Addylyn,F,100,20,0,20
Ariyha,F,100,5,0,5
Treisha,F,100,5,0,5
Kinzleigh,F,100,123,0,123
Erskin,M,100,0,195,195
Machella,F,100,15,0,15
Shaylon,F,66,166,87,253
Khiree,M,100,0,100,100
Bisleidy,F,100,7,0,7
Alysta,F,100,10,0,10
Tade,M,100,0,33,33
Elimelec,M,100,0,8,8
Ruqayya,F,100,54,0,54
Prysilla,F,100,6,0,6
Ila,F,100,3800,0,3800
Emili,F,100,1700,0,1700
Lakera,F,100,98,0,98
Lonie,M,50,206,208,414
Quiniyah,F,100,33,0,33
Arthell,M,100,0,5,5
Cambelle,F,100,148,0,148
Kamarian,M,100,0,108,108
Darrielle,F,100,319,0,319
Gerolyn,F,100,5,0,5
Elzbieta,F,100,21,0,21
Hidayah,F,100,11,0,11
Chiem,M,100,0,6,6
Khylil,M,100,0,17,17
Happy,F,67,168,83,251
Curtez,M,100,0,76,76
Udonis,M,100,0,5,5
Ramario,M,100,0,6,6
Yuga,M,100,0,5,5
Tanaija,F,100,59,0,59
Nineveh,F,100,22,0,22
Lashawanda,F,100,30,0,30
Ruwayda,F,100,90,0,90
Keyvan,M,100,0,50,50
Azeria,F,100,54,0,54
Adalberto,M,100,0,4010,4010
Zayde,M,83,25,126,151
Samet,M,100,0,5,5
Bethanni,F,100,6,0,6
Shania,F,100,14689,0,14689
Sephanie,F,100,35,0,35
Katarena,F,100,45,0,45
Azmina,F,100,5,0,5
Murna,F,100,22,0,22
Xaniyah,F,100,56,0,56
Jaykin,M,100,0,5,5
Darilyn,F,100,555,0,555
Adinah,F,100,47,0,47
Jessly,F,100,63,0,63
Sydalee,F,100,5,0,5
Kyton,M,100,0,19,19
Tyr,M,100,0,110,110
Marqueeta,F,100,5,0,5
Khalis,F,78,52,15,67
Quatrina,F,100,5,0,5
Rafaela,F,100,1633,0,1633
Corwynn,M,100,0,5,5
Brunetta,F,100,141,0,141
Tasheana,F,100,50,0,50
Sedgwick,M,100,0,44,44
Tralon,M,100,0,10,10
Jessmarie,F,100,11,0,11
Rudie,M,56,52,65,117
Jesusa,F,100,517,0,517
Khamila,F,100,71,0,71
Jaline,F,100,102,0,102
Jibria,F,100,5,0,5
Bernessa,F,100,5,0,5
Nagelly,F,100,8,0,8
Alashia,F,100,234,0,234
Jakiem,M,100,0,38,38
Rosh,M,100,0,5,5
Jorgen,M,100,0,412,412
Valeska,F,100,491,0,491
Mckenleigh,F,100,61,0,61
Devaeh,F,100,69,0,69
Der,F,100,190,0,190
Roderick,M,99,263,39093,39356
Chrissey,F,100,31,0,31
Maykala,F,100,37,0,37
Paschal,M,100,0,117,117
Terricka,F,100,210,0,210
Sidnie,F,100,307,0,307
Llulisa,F,100,13,0,13
Tyshianna,F,100,14,0,14
Calysta,F,100,433,0,433
Jakeitha,F,100,5,0,5
Honour,F,84,109,20,129
Kobie,M,85,238,1304,1542
Zainab,F,100,4038,0,4038
Datavius,M,100,0,5,5
Doraliz,F,100,5,0,5
Prestine,F,100,5,0,5
Dylanthomas,M,100,0,5,5
Dehaven,M,100,0,72,72
Cheenou,M,100,0,26,26
Tannya,F,100,253,0,253
Elleson,F,100,28,0,28
Champane,F,100,10,0,10
Corene,F,100,830,0,830
Bethanya,F,100,6,0,6
Lillyanah,F,100,35,0,35
Caedence,F,100,144,0,144
Reyana,F,100,256,0,256
Sajed,M,100,0,40,40
Keturah,F,100,2873,0,2873
Ellysa,F,100,178,0,178
Madelene,F,100,1230,0,1230
Garrad,M,100,0,5,5
Delcan,M,100,0,5,5
Barbetta,F,100,5,0,5
Lanice,F,100,340,0,340
Sig,M,100,0,12,12
Ellyana,F,100,739,0,739
Charon,F,80,840,215,1055
Angelinamarie,F,100,11,0,11
Tammetha,F,100,5,0,5
Tajion,M,100,0,6,6
Yasmir,F,100,5,0,5
Abigailmarie,F,100,11,0,11
Trace,M,97,343,10127,10470
Miran,M,100,0,35,35
Rosean,M,86,5,32,37
Griff,M,100,0,162,162
Jasyah,M,70,18,43,61
Johnnice,F,100,5,0,5
Llovani,M,100,0,5,5
Micheyla,F,100,14,0,14
Eadyn,F,100,5,0,5
Benas,M,100,0,10,10
Brandyann,F,100,5,0,5
Aliva,F,100,19,0,19
Neshawn,M,86,10,59,69
Tierah,F,100,54,0,54
Keeleigh,F,100,341,0,341
Jye,M,100,0,45,45
Bertrand,M,100,0,1334,1334
Candiance,F,100,6,0,6
Martin,M,100,954,198384,199338
Deepshika,F,100,7,0,7
Kinza,F,100,279,0,279
Ramanda,F,100,204,0,204
Quatisha,F,100,118,0,118
Analaura,F,100,406,0,406
Krystyne,F,100,96,0,96
Reca,F,100,18,0,18
Ayumi,F,100,401,0,401
Daphna,F,100,246,0,246
Kathrynne,F,100,85,0,85
Slaton,M,100,0,100,100
Treka,F,100,18,0,18
Yakub,M,100,0,49,49
Yaretzie,F,100,35,0,35
Abela,F,100,6,0,6
Keynu,F,100,5,0,5
Darolyn,F,100,219,0,219
Jovawn,M,100,0,18,18
Dellanie,F,100,5,0,5
Breneisha,F,100,10,0,10
Lunell,F,100,11,0,11
Fatmire,F,100,5,0,5
Annelie,F,100,147,0,147
Keshunna,F,100,17,0,17
Janda,F,100,242,0,242
Viesha,F,100,5,0,5
Bryndon,M,100,0,197,197
Makalya,F,100,283,0,283
Averiee,F,100,5,0,5
Lella,F,100,63,0,63
Jenille,F,100,69,0,69
Emyia,F,100,31,0,31
Adrith,M,100,0,6,6
Flecia,F,100,221,0,221
Dewin,M,100,0,22,22
Catrinia,F,100,74,0,74
Reagann,F,100,78,0,78
Shanesia,F,100,14,0,14
Mahalia,F,100,1434,0,1434
Kimela,F,100,320,0,320
Eid,M,100,0,10,10
Shavy,F,100,50,0,50
Nathia,F,100,6,0,6
Thadeo,M,100,0,5,5
Hedie,F,100,5,0,5
Raenelle,F,100,32,0,32
Tyeast,F,100,17,0,17
Zarrian,M,100,0,11,11
Latodd,M,100,0,5,5
Vermonica,F,100,5,0,5
Armina,F,100,117,0,117
Derrico,M,100,0,102,102
Nieem,M,100,0,25,25
Darnasia,F,100,27,0,27
Chika,F,92,337,28,365
Fraser,M,100,0,316,316
Copelan,M,100,0,27,27
Myrtle,F,100,4858,0,4858
Cirsten,F,100,42,0,42
Orlinda,F,100,179,0,179
Caysi,F,100,10,0,10
Sudhir,M,100,0,12,12
Anthoney,M,100,0,2508,2508
Caleigh,F,100,4702,0,4702
Dia,F,94,1745,106,1851
Lathena,F,100,5,0,5
Gabrel,M,100,0,29,29
Naydene,F,100,7,0,7
Karonda,F,100,53,0,53
Mikila,F,100,37,0,37
Shemariah,F,100,27,0,27
Rashana,F,100,286,0,286
Laquil,F,100,5,0,5
Darral,M,100,0,316,316
Valesia,F,100,15,0,15
Jozaiah,M,100,0,11,11
Daran,M,99,5,577,582
Chamelle,F,100,5,0,5
Lynia,F,100,139,0,139
Vangie,F,100,409,0,409
Macaylee,F,100,30,0,30
Marnell,F,76,104,32,136
Colesyn,M,100,0,12,12
Marveon,M,100,0,5,5
Juanenrique,M,100,0,5,5
Natacia,F,100,146,0,146
Demarquise,M,100,0,33,33
Geronimo,M,100,0,2073,2073
Thang,M,98,7,413,420
Samajay,M,100,0,18,18
Joelisa,F,100,36,0,36
Emir,M,100,0,1901,1901
Jabrell,M,100,0,35,35
Pema,F,100,110,0,110
Kloe,F,100,2626,0,2626
Jacent,M,100,0,12,12
Sholem,M,100,0,44,44
Anycia,F,100,34,0,34
Raegene,F,100,22,0,22
Shaiyan,F,100,5,0,5
Tyrin,M,99,11,1622,1633
Teralee,F,100,5,0,5
Glee,F,100,195,0,195
Katyln,F,100,5,0,5
Afrin,F,100,24,0,24
Tjuan,M,100,0,24,24
Gabreella,F,100,5,0,5
Gouri,F,100,5,0,5
Almando,M,100,0,93,93
Raemarie,F,100,5,0,5
Jolisha,F,100,54,0,54
Manya,F,100,788,0,788
Berdina,F,100,87,0,87
Lyneah,F,100,23,0,23
Angellique,F,100,6,0,6
Marcele,F,100,16,0,16
Kavika,M,100,0,19,19
Jam,M,100,0,23,23
Manju,F,100,12,0,12
Annalysse,F,100,78,0,78
Deoveon,F,79,22,6,28
Lisiate,M,100,0,5,5
Lovie,F,88,1228,175,1403
Oluwatoniloba,F,55,6,5,11
Tylik,M,100,0,379,379
Arjun,M,100,0,6226,6226
Lawanda,F,100,10225,6,10231
Johnse,M,100,0,20,20
Tacora,F,100,173,0,173
Lealan,M,100,0,12,12
Infiniti,F,100,355,0,355
Symphany,F,100,181,0,181
Rande,M,71,152,380,532
Wong,M,100,0,22,22
Commie,F,55,6,5,11
Majik,M,100,0,5,5
Thomos,M,100,0,24,24
Deronne,M,100,0,6,6
Valeshia,F,100,6,0,6
Enri,M,100,0,12,12
Elias,M,100,144,55467,55611
Rebbeca,F,100,905,0,905
Sevinch,F,100,6,0,6
Delauren,F,100,5,0,5
Trimeka,F,100,36,0,36
Agape,F,83,50,10,60
Yuuki,M,92,16,175,191
Latiyah,F,100,6,0,6
Atasia,F,100,22,0,22
Iretta,F,100,39,0,39
Makaiden,M,100,0,6,6
Jeffray,M,100,0,55,55
Yanellie,F,100,59,0,59
Latissa,F,100,119,0,119
Hydiea,F,100,9,0,9
Clarisa,F,100,2887,0,2887
Jorell,M,100,0,443,443
Jiyaan,M,100,0,6,6
Nanci,F,100,5252,0,5252
Kaique,M,100,0,5,5
Garang,M,100,0,20,20
Ariss,F,100,20,0,20
Burnita,F,100,10,0,10
Raylah,F,100,5,0,5
Shauwn,M,100,0,6,6
Damionna,F,100,5,0,5
Damauni,M,100,0,6,6
Sharnelle,F,100,80,0,80
Tomeaka,F,100,15,0,15
Azarel,M,100,0,64,64
Jassmen,F,100,6,0,6
Eloni,F,100,49,0,49
Etana,F,100,98,0,98
Tamar,F,86,5188,835,6023
Paytyn,F,100,385,0,385
Shaniyla,F,100,15,0,15
Tavis,M,100,6,2103,2109
Sheeba,F,100,38,0,38
Keyasha,F,100,129,0,129
Deborah,F,100,690133,1566,691699
Yesina,F,100,35,0,35
Vaitea,F,100,5,0,5
Chenequa,F,100,42,0,42
Shunsuke,M,100,0,75,75
Bernardo,M,100,0,8248,8248
Peni,F,96,126,5,131
Cherlyn,F,100,1581,0,1581
Jamonta,M,100,0,84,84
Amario,M,100,0,106,106
Dreon,M,100,0,130,130
Avalyne,F,100,11,0,11
Kantrell,M,100,0,54,54
Avantae,M,100,0,132,132
Semarias,M,100,0,5,5
Terenna,F,100,5,0,5
Vondell,M,79,51,193,244
Hermena,F,100,5,0,5
Dezerae,F,100,447,0,447
Kula,F,100,10,0,10
Catrell,M,100,0,204,204
Toru,M,100,0,5,5
Khania,F,100,30,0,30
Dijion,M,100,0,35,35
Tailee,F,100,28,0,28
Mikeshia,F,100,59,0,59
Ottis,M,100,0,959,959
Christobal,M,100,0,640,640
Shantierra,F,100,7,0,7
Dshayla,F,100,5,0,5
Romero,M,100,0,1405,1405
Anyri,F,100,17,0,17
Amonie,F,100,267,0,267
Deiontre,M,100,0,48,48
Jamyn,M,100,0,6,6
Jacynda,F,100,149,0,149
Aileena,F,100,86,0,86
Erianna,F,100,912,0,912
Cristine,F,100,3777,0,3777
Malon,M,74,58,161,219
Amillya,F,100,62,0,62
Sakina,F,100,1150,0,1150
Nathanual,M,100,0,36,36
Ahmed,M,100,0,12022,12022
Trinitey,F,100,86,0,86
Keymora,F,100,120,0,120
Anirvin,M,100,0,21,21
Fushia,F,100,6,0,6
Porchia,F,100,528,0,528
Faruk,M,100,0,34,34
Exie,F,100,147,0,147
Justin,M,100,3775,757958,761733
Emberli,F,100,77,0,77
Kaicey,F,100,6,0,6
Julianno,M,100,0,5,5
Darlee,F,100,10,0,10
Virjean,F,100,9,0,9
Chancey,M,65,469,883,1352
Coralys,F,100,5,0,5
Precious,F,100,17709,82,17791
Williesha,F,100,11,0,11
Uyless,M,100,0,5,5
Aaleeya,F,100,5,0,5
Brighley,F,100,5,0,5
Kadir,M,100,0,240,240
Alexandrah,F,100,6,0,6
Shakena,F,100,387,0,387
Kimathi,M,100,0,15,15
Karent,F,100,16,0,16
Karil,F,100,55,0,55
Ourtney,F,100,5,0,5
Ivelise,F,100,135,0,135
Solyana,F,100,74,0,74
Zamari,M,66,282,536,818
Zykerria,F,100,259,0,259
Shawnic,F,100,16,0,16
Sadeja,F,100,14,0,14
Stanislav,M,100,0,220,220
Kateena,F,100,62,0,62
Jekhi,M,100,0,85,85
Jineen,F,100,31,0,31
Jraya,F,100,5,0,5
Kascha,F,100,23,0,23
Sheily,F,100,382,0,382
Denisha,F,100,4260,0,4260
Annita,F,100,903,0,903
Nectarios,M,100,0,6,6
Guenter,M,100,0,5,5
Lupe,F,72,6250,2396,8646
Graicyn,F,100,5,0,5
Dixy,F,100,5,0,5
Milderd,F,100,11,0,11
Lakela,F,100,65,0,65
Keoria,F,100,5,0,5
Jream,F,86,62,10,72
Jesson,M,100,0,85,85
Daryna,F,100,46,0,46
Denyell,F,100,10,0,10
Dijohn,M,100,0,25,25
Zebra,F,100,5,0,5
Alease,F,100,446,0,446
Nyrobi,F,100,21,0,21
Marvalee,F,100,5,0,5
Joemar,M,100,0,34,34
Karenlee,F,100,5,0,5
Traylor,M,100,0,11,11
Aroon,M,100,0,10,10
Antia,F,100,179,0,179
Nyrissa,F,100,5,0,5
Harita,F,100,5,0,5
Zawadi,F,100,89,0,89
Delborah,F,100,5,0,5
Jamely,F,100,18,0,18
Treneka,F,100,25,0,25
Voula,F,100,62,0,62
Lesta,F,100,115,0,115
Teysean,M,100,0,5,5
Shakinah,F,100,147,0,147
Sofya,F,100,179,0,179
Myrlene,F,100,28,0,28
Arieyonna,F,100,7,0,7
Sheraya,F,100,20,0,20
Tyten,M,100,0,20,20
Qirat,F,100,20,0,20
Guarionex,M,100,0,5,5
Teyana,F,100,628,0,628
Mahlea,F,100,16,0,16
Markiyah,F,100,122,0,122
Quatina,F,100,53,0,53
Ursel,F,100,5,0,5
Navarion,M,100,0,5,5
Shevon,F,97,419,15,434
Devaron,M,100,0,11,11
Lihanna,F,100,58,0,58
Nykole,F,100,228,0,228
Miria,F,100,105,0,105
Lovelynn,F,100,21,0,21
Shamora,F,100,55,0,55
Catrenia,F,100,20,0,20
Kyliana,F,100,117,0,117
Cesilia,F,100,746,0,746
Zyairr,M,100,0,5,5
Aleki,M,100,0,16,16
Emiliya,F,100,39,0,39
Laketa,F,100,629,0,629
Arleene,F,100,140,0,140
Kaytlinn,F,100,22,0,22
Yeimi,F,100,517,0,517
Yle,M,100,0,17,17
Dariusz,M,100,0,130,130
Cheilon,F,100,7,0,7
Martize,M,100,0,25,25
Oaklei,F,100,9,0,9
Avilyn,F,100,46,0,46
Narges,F,100,21,0,21
Miarae,F,100,7,0,7
Jibran,M,100,0,251,251
Nyanza,F,100,46,0,46
Iraj,F,100,11,0,11
Raegen,F,100,649,0,649
Jontrell,M,100,0,186,186
Karalynn,F,100,589,0,589
Kree,F,76,223,72,295
Alyda,F,100,79,0,79
Kindra,F,100,3833,0,3833
Deshonda,F,100,334,0,334
Jarmaris,M,100,0,5,5
Alfreda,F,100,5411,25,5436
Barett,M,100,0,109,109
Tayjah,F,100,104,0,104
Cail,M,100,0,59,59
Caylea,F,100,143,0,143
Dulcy,F,100,78,0,78
Najwa,F,100,467,0,467
Kerstin,F,100,2492,0,2492
Sethaniel,M,100,0,11,11
Hudson,M,98,721,34828,35549
Gearlene,F,100,6,0,6
Aryan,M,90,527,4600,5127
Garan,M,100,0,107,107
Kyliyah,F,100,110,0,110
Santina,F,100,1517,0,1517
Micael,M,100,0,633,633
Lynnmarie,F,100,223,0,223
Rawleigh,M,100,0,56,56
Emersynn,F,100,60,0,60
Singleton,M,100,0,5,5
Selah,F,98,5638,91,5729
Desieree,F,100,6,0,6
Trayse,M,100,0,5,5
Beranda,F,100,10,0,10
Amyya,F,100,5,0,5
Colston,M,100,0,620,620
Kasity,F,100,23,0,23
Ernest,M,99,668,105062,105730
Tiauna,F,100,547,0,547
Tenisha,F,100,3501,0,3501
Rajveer,M,100,0,271,271
Balmore,M,100,0,10,10
Evelin,F,100,6341,5,6346
Audyn,F,88,36,5,41
Anothy,M,100,0,180,180
Datwan,M,100,0,59,59
Mahnaz,F,100,6,0,6
Jeffry,M,100,10,14024,14034
Esmeralda,F,100,41775,180,41955
Paighton,F,100,278,0,278
Arynn,F,100,352,0,352
Mahia,F,100,18,0,18
Yukie,F,100,5,0,5
Paramveer,M,100,0,11,11
Rozena,F,100,148,0,148
Siraya,F,100,5,0,5
Amberlynne,F,100,10,0,10
Takema,F,100,52,0,52
Jezeniah,F,100,5,0,5
Ahsan,M,100,0,476,476
Brentlee,M,81,67,292,359
Javaunte,M,100,0,6,6
Dereion,M,100,0,36,36
Lamech,M,100,0,16,16
Christino,M,100,0,57,57
Paulyna,F,100,5,0,5
Annaleah,F,100,500,0,500
Ndrew,M,100,0,104,104
Daniell,F,72,2048,793,2841
Atilano,M,100,0,104,104
Adelina,F,100,6216,0,6216
Katheran,F,100,15,0,15
Tykel,M,100,0,111,111
Myca,F,89,293,35,328
Rabecka,F,100,67,0,67
Jabryan,M,100,0,18,18
Raea,F,100,48,0,48
Jannelle,F,100,1087,0,1087
Marcille,F,100,111,0,111
Kanishia,F,100,24,0,24
Zacharee,M,95,5,91,96
Daneeka,F,100,11,0,11
Swayzie,F,100,82,0,82
Domynik,M,100,0,11,11
Vermell,F,100,151,0,151
Analese,F,100,172,0,172
Adriauna,F,100,242,0,242
Reham,F,100,234,0,234
Debrianna,F,100,21,0,21
Latyia,F,100,5,0,5
Maelyn,F,100,876,0,876
Zenah,F,100,10,0,10
Leonte,M,100,0,231,231
Nole,M,97,5,157,162
Kendyl,F,98,4196,98,4294
Ajsa,F,100,15,0,15
Kiptin,M,100,0,12,12
Radric,M,100,0,10,10
Kieanna,F,100,189,0,189
Jerone,M,100,0,1049,1049
Jordanalexander,M,100,0,5,5
Amarelys,F,100,11,0,11
Sajan,M,100,0,227,227
Azzareya,F,100,32,0,32
Braleigh,F,100,285,0,285
Imran,M,100,0,2252,2252
Shawonna,F,100,29,0,29
Yina,F,100,60,0,60
Daevaughn,M,100,0,6,6
Naquille,M,100,0,7,7
Denijah,F,100,73,0,73
Farbod,M,100,0,12,12
Elfreida,F,100,27,0,27
Lauryl,F,100,175,0,175
Alliya,F,100,206,0,206
Tiziano,M,100,0,26,26
Thomias,M,100,0,7,7
Frania,F,100,19,0,19
Timmon,M,100,0,6,6
Peggyjo,F,100,6,0,6
Olanda,M,58,80,111,191
Kaleal,M,100,0,49,49
Delore,F,100,5,0,5
Eire,F,100,18,0,18
Domita,F,100,38,0,38
Chauntelle,F,100,202,0,202
Lesa,F,100,11267,12,11279
Amuri,M,100,0,5,5
Chiquta,F,100,12,0,12
Cleto,M,100,0,60,60
Porshae,F,100,30,0,30
Sherryann,F,100,148,0,148
Byrne,M,100,0,39,39
Issaac,M,100,0,163,163
Cassundra,F,100,97,0,97
Antron,M,100,0,1203,1203
Brandy,F,98,105850,2205,108055
Konni,F,100,207,0,207
Ameir,M,100,0,387,387
Aliesa,F,100,17,0,17
Angeline,F,100,11708,0,11708
Salil,M,100,0,78,78
Keivan,M,100,0,50,50
Yared,M,82,87,405,492
Santrell,F,50,10,10,20
Jamarra,F,100,30,0,30
Deaudra,F,100,27,0,27
Jasson,M,100,0,1112,1112
Lyssette,F,100,55,0,55
Britnye,F,100,11,0,11
Keliann,F,100,5,0,5
Tytianna,F,100,994,0,994
Zetha,F,100,5,0,5
Vera,F,100,26318,24,26342
Azura,F,100,316,0,316
Aritzy,F,100,52,0,52
Lakicia,F,100,21,0,21
Hristine,F,100,16,0,16
Emilygrace,F,100,73,0,73
Taylani,F,100,11,0,11
Eiliyah,F,100,125,0,125
Jenely,F,100,30,0,30
Denley,M,100,0,34,34
Ernice,F,100,6,0,6
Chantelle,F,100,6438,8,6446
Perdita,F,100,31,0,31
Jamayiah,F,100,6,0,6
Delicia,F,100,2462,0,2462
Larayah,F,100,49,0,49
Garret,M,100,5,12370,12375
Angeli,F,100,1184,0,1184
Leemichael,M,100,0,11,11
Joris,M,100,0,43,43
Beira,F,100,6,0,6
Jaydann,F,100,5,0,5
Laretta,F,100,287,0,287
Jaylicia,F,100,5,0,5
Cionna,F,100,130,0,130
Emiya,F,100,238,0,238
Letrice,F,100,413,0,413
Laylen,M,100,0,15,15
Raghad,F,100,178,0,178
Liyah,F,100,1475,0,1475
Ahlona,F,100,5,0,5
Takyah,F,100,103,0,103
Savonya,F,100,5,0,5
Coleene,F,100,10,0,10
Tousha,F,100,20,0,20
Esmeraida,F,100,5,0,5
Abdulmohsen,M,100,0,11,11
Adalhi,F,100,5,0,5
Sieda,F,100,20,0,20
Emylee,F,100,594,0,594
Reymond,M,100,0,519,519
Deane,M,66,567,1088,1655
Ayham,M,100,0,194,194
Exael,M,100,0,6,6
Taliyha,F,100,34,0,34
Draden,M,100,0,199,199
Rondelle,F,68,13,6,19
Jalayiah,F,100,69,0,69
Kadeesha,F,100,49,0,49
Pierce,M,99,152,11692,11844
Corynne,F,100,386,0,386
Mizuki,F,96,242,11,253
Jaykob,M,100,0,908,908
Johnthomas,M,100,0,456,456
Nickcola,F,100,5,0,5
Zakeia,F,100,9,0,9
Lakashia,F,100,95,0,95
Dazhon,M,100,0,35,35
Shytavia,F,100,15,0,15
Dasharia,F,100,5,0,5
Yakeem,M,100,0,6,6
Valyre,F,100,5,0,5
Dayshana,F,100,5,0,5
Bruce,M,100,869,263111,263980
Evante,M,100,0,12,12
Shantil,F,100,111,0,111
Cherrish,F,100,498,0,498
Korey,M,89,1278,10613,11891
Skylene,F,100,78,0,78
Tinnie,F,100,97,0,97
Coleeta,F,100,5,0,5
Jalycia,F,100,10,0,10
Jyll,F,100,91,0,91
Brendasia,F,100,5,0,5
Arenda,F,100,26,0,26
Lanieya,F,100,13,0,13
Rashundra,F,100,21,0,21
Maison,M,80,542,2173,2715
Petrita,F,100,19,0,19
Khalimah,F,100,5,0,5
Shade,F,54,836,700,1536
Janayja,F,100,6,0,6
Sophiaisabella,F,100,5,0,5
Jimisha,F,100,26,0,26
Ethelyn,F,100,348,0,348
Ernestina,F,100,2825,0,2825
Traves,M,100,0,306,306
Tyani,F,100,28,0,28
Daijsha,F,100,12,0,12
Rejine,F,100,5,0,5
Kris,M,51,12934,13359,26293
Dysan,M,100,0,5,5
Abdulai,M,100,0,75,75
Shahirah,F,100,5,0,5
Rosellen,F,100,320,0,320
Pavi,F,100,7,0,7
Angeligue,F,100,131,0,131
Annlouise,F,100,36,0,36
Marielly,F,100,40,0,40
Yaire,F,100,506,0,506
Yurivia,F,100,6,0,6
Talajiah,F,100,5,0,5
Amorra,F,100,5,0,5
Chemika,F,100,73,0,73
Safiye,F,100,11,0,11
Kristoper,M,100,0,21,21
Aquiles,M,100,0,351,351
Zyauna,F,100,15,0,15
Gradon,M,100,0,50,50
Rahsaan,M,100,6,1510,1516
Kimaada,F,100,5,0,5
Silas,M,100,34,25605,25639
Izadora,F,100,115,0,115
Adavion,M,100,0,16,16
Rickea,F,100,26,0,26
Keme,F,100,6,0,6
Amariss,F,100,53,0,53
Raqwon,M,100,0,6,6
Norb,M,100,0,5,5
Nevea,F,100,74,0,74
Mariell,F,100,58,0,58
Braydenn,M,100,0,33,33
Kapena,M,100,0,64,64
Teonte,M,100,0,15,15
Kaddie,F,100,37,0,37
Kimani,M,55,1161,1436,2597
Tyniece,F,100,28,0,28
Shavanna,F,100,157,0,157
Kelise,F,100,458,0,458
Dilanjan,M,100,0,13,13
Linora,F,100,12,0,12
Rosaisela,F,100,432,0,432
Tycere,M,100,0,11,11
Lash,M,100,0,67,67
Neziyah,F,100,6,0,6
Lainy,F,100,150,0,150
Telli,F,100,11,0,11
Rosario,F,78,8490,2429,10919
Reyez,M,100,0,10,10
Abdou,M,100,0,193,193
Alyviah,F,100,156,0,156
Kaigen,M,87,5,33,38
Tiera,F,100,4026,6,4032
Marine,F,100,376,0,376
Abimbola,F,94,79,5,84
Ketty,F,100,129,0,129
Jemeka,F,100,73,0,73
Johnethan,M,100,0,16,16
Sajani,F,100,19,0,19
Davonne,M,66,198,381,579
Makailynn,F,100,27,0,27
Shantiqua,F,100,41,0,41
Kirklin,M,100,0,97,97
Maricia,F,100,342,0,342
Laquasia,F,100,162,0,162
Juleanna,F,100,34,0,34
Calyx,M,55,30,36,66
Khalessi,F,100,40,0,40
Joequan,M,100,0,13,13
Angeleen,F,100,241,0,241
Emmamarie,F,100,128,0,128
Juliett,F,100,472,0,472
Lorenso,M,100,0,292,292
Sircharles,M,100,0,85,85
Ariatna,F,100,133,0,133
Magdali,F,100,5,0,5
Gee,M,61,12,19,31
Antoinio,M,100,0,37,37
Chayne,M,90,25,234,259
Elyjiah,M,100,0,29,29
Allice,F,100,20,0,20
Makalyn,F,100,343,0,343
Travarious,M,100,0,41,41
Juwuan,M,100,0,153,153
Emerik,M,100,0,13,13
Dheeraj,M,100,0,60,60
Muslima,F,100,12,0,12
Keiani,F,100,19,0,19
Shykela,F,100,27,0,27
Ikia,F,100,252,0,252
Aarian,M,66,40,76,116
Linsey,F,98,4999,113,5112
Yana,F,100,1673,0,1673
Sussy,F,100,33,0,33
Haruto,M,100,0,135,135
Sophiah,F,100,149,0,149
Sadaf,F,100,491,0,491
Ajanee,F,100,116,0,116
Taneiya,F,100,5,0,5
Julayne,F,100,27,0,27
Hufsa,F,100,5,0,5
Keyauna,F,100,216,0,216
Patience,F,100,9204,17,9221
Zaniyyah,F,100,18,0,18
Shanaia,F,100,77,0,77
Danequa,F,100,25,0,25
Latausha,F,100,285,0,285
Elicio,M,100,0,28,28
Ashdon,M,100,0,170,170
Shequira,F,100,5,0,5
Kerick,M,100,0,6,6
Taliba,F,100,5,0,5
Allysin,F,100,36,0,36
Mathison,M,55,5,6,11
Robbie,M,65,10258,18785,29043
Kayliann,F,100,34,0,34
Deantay,M,100,0,18,18
Rasheida,F,100,68,0,68
Anji,F,100,57,0,57
Annaliya,F,100,5,0,5
Jeccica,F,100,11,0,11
Zaybrien,M,100,0,5,5
Trevier,M,100,0,5,5
Jihoon,M,100,0,13,13
Gracee,F,100,1194,0,1194
Chibueze,M,100,0,112,112
Mikalah,F,100,894,0,894
Banks,M,100,0,664,664
Florentine,F,100,6,0,6
Quillian,M,100,0,10,10
Kristiona,F,100,25,0,25
Gloriane,F,100,17,0,17
Latron,M,100,0,351,351
Breshawn,M,56,35,44,79
Ranylah,F,100,5,0,5
Anquetta,F,100,5,0,5
Cherye,F,100,59,0,59
Ramee,F,54,7,6,13
Tonantzin,F,100,182,0,182
Cheslie,F,100,28,0,28
Greco,M,100,0,106,106
Erial,F,100,176,0,176
Carlana,F,100,5,0,5
Guliana,F,100,137,0,137
Tauni,F,100,296,0,296
Brinisha,F,100,16,0,16
Tyleisha,F,100,32,0,32
Charline,F,100,2199,0,2199
Oluwadunmininu,F,100,5,0,5
Brianca,F,100,550,0,550
Keiston,M,100,0,95,95
Jenasys,F,100,29,0,29
Pricillia,F,100,40,0,40
Prissila,F,100,17,0,17
Azlynne,F,100,5,0,5
Adaliah,F,100,82,0,82
Katona,F,100,52,0,52
Taehyun,M,100,0,5,5
Tyrene,F,100,89,0,89
Corisha,F,100,23,0,23
Suany,F,100,32,0,32
Tannetta,F,100,6,0,6
Ina,F,100,5491,11,5502
Rachelmarie,F,100,23,0,23
Alexiea,F,100,47,0,47
Ashleyrae,F,100,5,0,5
Alazar,M,100,0,94,94
Adrianpaul,M,100,0,7,7
Cashlyn,F,100,103,0,103
Jadarrian,M,100,0,21,21
Damiere,M,100,0,16,16
Taheera,F,100,91,0,91
Alicya,F,100,162,0,162
Fardosa,F,100,5,0,5
Callisto,F,100,28,0,28
Tasiyah,F,100,17,0,17
Darrione,M,100,0,5,5
Laderricka,F,100,46,0,46
Saunya,F,100,55,0,55
Laundyn,F,100,17,0,17
Simeon,M,100,25,6072,6097
Shinell,F,100,17,0,17
Aricella,F,100,18,0,18
Sheylyn,F,100,5,0,5
Bhavik,M,100,0,158,158
Sayali,F,100,10,0,10
Zitlali,F,100,404,0,404
Stedman,M,100,0,316,316
Karelia,F,100,11,0,11
Saesha,F,100,102,0,102
Jemmy,F,100,10,0,10
Gorete,F,100,5,0,5
Kaleil,M,100,0,32,32
Aneysa,F,100,5,0,5
Ceres,F,100,24,0,24
Aidian,M,100,0,146,146
Cherise,F,100,4431,0,4431
Jasmijn,F,100,5,0,5
Jeremiaha,M,100,0,13,13
Marylin,F,100,1999,0,1999
Aubreeana,F,100,18,0,18
Mahi,F,98,803,15,818
Skilee,F,100,5,0,5
Evone,F,98,251,5,256
Bineta,F,100,23,0,23
Darnelle,M,61,223,350,573
Elivia,F,100,215,0,215
Dezon,M,100,0,10,10
Jeanice,F,100,880,0,880
Theta,F,100,61,0,61
Nahim,M,100,0,42,42
Harlem,M,75,320,982,1302
Jodel,F,100,65,0,65
Derk,M,100,0,506,506
Carington,F,100,23,0,23
Rieta,F,100,5,0,5
Sunie,F,100,10,0,10
Stavros,M,100,0,822,822
Travel,M,100,0,5,5
Maeve,F,100,8989,0,8989
Kymier,M,100,0,17,17
Damaris,F,96,10847,498,11345
Sakura,F,100,1142,0,1142
Emmalynn,F,100,2001,0,2001
Komalpreet,F,100,23,0,23
Jeopardy,F,100,6,0,6
Judaea,F,100,72,0,72
Tyissha,F,100,13,0,13
Oaklyn,F,92,103,9,112
Ausar,M,100,0,95,95
Santanya,F,100,5,0,5
Jacoree,M,100,0,5,5
Genece,F,100,23,0,23
Zerick,M,100,0,149,149
Kiralynn,F,100,26,0,26
Keymar,M,100,0,10,10
Shalanda,F,100,1744,0,1744
Adysson,F,100,69,0,69
Dallis,F,55,552,448,1000
Shakel,M,64,16,28,44
Kairee,M,54,105,125,230
Trudie,F,100,1209,0,1209
Briante,F,95,89,5,94
Shirleeta,F,100,5,0,5
Leon,M,99,454,67146,67600
Kaely,F,100,750,0,750
Karim,M,99,58,4283,4341
Lonniesha,F,100,5,0,5
Aaqib,M,100,0,22,22
Vanden,M,100,0,117,117
Eseosa,F,100,17,0,17
Acari,M,100,0,19,19
Lelana,F,100,15,0,15
Darnaja,F,100,5,0,5
Verlyn,M,80,99,403,502
Lesly,F,97,13195,459,13654
Antonius,M,100,0,524,524
Kyon,M,100,0,449,449
Kristeena,F,100,382,0,382
Kelah,F,100,24,0,24
Lathyn,M,100,0,56,56
Kushal,M,100,0,358,358
Constanc,F,100,8,0,8
Keela,F,100,986,0,986
Selecia,F,100,11,0,11
Saanika,F,100,17,0,17
Brendalis,F,100,16,0,16
Adene,F,100,11,0,11
Aleczander,M,100,0,966,966
Zyera,F,100,23,0,23
Briyonna,F,100,191,0,191
Burce,M,100,0,28,28
Venson,M,100,0,422,422
Kirstan,F,100,473,0,473
Nathian,M,100,0,94,94
Jermonica,F,100,7,0,7
Chezney,F,100,150,0,150
Marlei,F,100,205,0,205
Antavion,M,100,0,132,132
Magi,F,100,5,0,5
Jakaela,F,100,17,0,17
Tario,M,100,0,7,7
Leno,M,100,0,156,156
Danea,F,100,489,0,489
Myneisha,F,100,5,0,5
Tashanae,F,100,13,0,13
Adelyna,F,100,58,0,58
Oguz,M,100,0,5,5
Kinneth,M,100,0,48,48
Kaayla,F,100,6,0,6
Janiyha,F,100,124,0,124
Alazea,F,100,15,0,15
Suzann,F,100,2852,0,2852
Tejaun,M,100,0,14,14
Elimar,F,100,7,0,7
Cardell,M,100,0,1795,1795
Omare,M,100,0,77,77
Shreyash,M,100,0,35,35
Moneeka,F,100,23,0,23
Jemal,M,100,0,884,884
Yunalesca,F,100,22,0,22
Kelsyn,F,100,5,0,5
Jarome,M,100,0,211,211
Breazia,F,100,23,0,23
Fher,M,100,0,56,56
Kursten,F,100,281,0,281
Lochlyn,F,91,105,11,116
Lamarquis,M,100,0,49,49
Endre,M,100,0,51,51
Rustan,M,100,0,11,11
Morna,F,100,174,0,174
Elyda,F,100,5,0,5
Ginobili,M,100,0,7,7
Pashen,F,100,22,0,22
Starshema,F,100,12,0,12
Kioni,F,100,108,0,108
Jamon,M,100,6,2498,2504
Romona,F,100,3291,0,3291
Anchor,M,100,0,23,23
Kambra,F,100,74,0,74
Lamone,M,100,0,144,144
Lassie,F,100,44,0,44
Hooria,F,100,29,0,29
Ruta,F,100,305,0,305
Bay,F,69,309,139,448
Santhiago,M,100,0,76,76
Akwete,F,100,6,0,6
Davonna,F,100,910,0,910
Shamoria,F,100,12,0,12
Vontre,M,100,0,14,14
Laymon,M,100,0,242,242
Wilber,M,100,0,1949,1949
Azad,M,100,0,154,154
Arletta,F,100,688,0,688
Shantoria,F,100,351,0,351
Amjad,M,100,0,387,387
Lizabeth,F,100,4830,0,4830
Kaiti,F,100,11,0,11
Almedina,F,100,33,0,33
Clarencia,F,100,5,0,5
Sheanna,F,100,198,0,198
Sunday,F,98,1828,32,1860
Cassarah,F,100,5,0,5
Tawnya,F,100,4943,0,4943
Doye,M,100,0,37,37
Corvyn,M,100,0,11,11
Luchina,F,100,13,0,13
Eziah,M,97,5,154,159
Peja,F,73,61,23,84
Aya,F,100,3815,0,3815
Johnnyangel,M,100,0,10,10
Darien,M,84,1763,9324,11087
Markeya,F,100,383,0,383
Nyle,M,98,25,1036,1061
Nadalee,F,100,126,0,126
Yacouba,M,100,0,5,5
Hazelene,F,100,16,0,16
Pollard,M,100,0,10,10
Secily,F,100,116,0,116
Andreal,F,100,112,0,112
Quentrell,M,100,0,40,40
Lehman,M,100,0,310,310
Loreal,F,100,1518,0,1518
Azel,M,84,22,114,136
Jamion,M,100,0,204,204
Kieonna,F,100,41,0,41
Ladre,M,100,0,32,32
Heydy,F,100,162,0,162
Gearline,F,100,49,0,49
Darshon,M,100,0,7,7
Jannia,F,100,10,0,10
Mariaha,F,100,195,0,195
Ahmya,F,100,480,0,480
Lopez,M,100,0,84,84
Saily,F,100,40,0,40
Bogart,M,100,0,33,33
Sa,F,76,42,13,55
Adai,F,100,17,0,17
Zakarya,M,100,0,34,34
Howell,M,100,0,1156,1156
Javarron,M,100,0,6,6
Tariah,F,100,480,0,480
Suzan,F,100,7053,0,7053
Filmore,M,100,0,16,16
Susi,F,100,341,0,341
Tyrah,F,100,619,0,619
Jaianna,F,100,206,0,206
Jaily,F,100,43,0,43
Tomya,F,100,25,0,25
Danta,M,98,10,398,408
Dolora,F,100,6,0,6
Agastya,M,100,0,291,291
Dnia,F,100,34,0,34
Rodneka,F,100,11,0,11
Shamichael,M,67,5,10,15
Jonavin,M,100,0,100,100
Jakaiyah,F,100,32,0,32
Kassydi,F,100,23,0,23
Adaley,F,100,120,0,120
Susie,F,100,25160,36,25196
Ishiah,M,100,0,6,6
Paiden,F,56,91,72,163
Kwaniqua,F,100,5,0,5
Simonne,F,100,335,0,335
Eliora,F,100,375,0,375
Autymn,F,100,197,0,197
Nigella,F,100,35,0,35
Darieon,M,100,0,53,53
Mitul,M,100,0,95,95
Guilda,F,100,7,0,7
Rori,F,99,1709,17,1726
Airic,M,100,0,32,32
Cretia,F,100,17,0,17
Flame,F,100,5,0,5
Nolawi,M,100,0,64,64
Jonpaul,M,100,0,1484,1484
Carah,F,100,806,0,806
Ridha,F,73,44,16,60
Gesselle,F,100,96,0,96
Brenten,M,100,0,780,780
Shreyas,M,100,0,1040,1040
Tarrod,M,100,0,5,5
Deziya,F,100,66,0,66
Rozalind,F,100,15,0,15
Kwanzaa,F,85,29,5,34
Mathilde,F,100,420,0,420
Aparna,F,100,495,0,495
Monish,M,100,0,60,60
Ruthie,F,100,7371,0,7371
Nyome,F,100,15,0,15
Renica,F,100,32,0,32
Rashiyah,F,100,10,0,10
Fouzia,F,100,5,0,5
Mervyn,M,100,0,414,414
Rosha,F,100,74,0,74
Rohanpreet,M,100,0,14,14
Jamone,M,100,0,266,266
Nyjuan,M,100,0,17,17
Taleek,M,100,0,12,12
Nalley,F,100,31,0,31
Jissell,F,100,73,0,73
Montre,M,100,0,333,333
Angellina,F,100,319,0,319
Tywone,M,100,0,158,158
Krystalmarie,F,100,5,0,5
Kevinisha,F,100,11,0,11
Milliani,F,100,42,0,42
Jordanmarie,F,100,5,0,5
Caisha,F,100,23,0,23
Kerria,F,100,180,0,180
Jeremee,M,100,0,59,59
Samanvi,F,100,160,0,160
Kayleb,M,100,0,1760,1760
Aletta,F,100,432,0,432
Ohemaa,F,100,12,0,12
Dyon,M,97,5,174,179
Nekishia,F,100,10,0,10
Abri,F,100,155,0,155
Harihar,M,100,0,7,7
Woodward,M,100,0,36,36
Chauntell,F,100,34,0,34
Zenayah,F,100,5,0,5
Dnisha,F,100,10,0,10
Amarillis,F,100,10,0,10
Celenia,F,100,197,0,197
Meerah,F,100,6,0,6
Tamajah,F,100,5,0,5
Andrie,M,100,0,39,39
Raaya,F,100,10,0,10
Cydney,F,99,4807,25,4832
Neri,M,79,146,535,681
Naomy,F,100,1376,0,1376
Calub,M,100,0,167,167
Florencia,F,100,919,0,919
Celerino,M,100,0,10,10
Cajuan,M,100,0,11,11
Darthy,F,100,5,0,5
Purav,M,100,0,42,42
Zenen,M,100,0,7,7
Torrianna,F,100,6,0,6
Freidy,F,100,10,0,10
Ilesha,F,100,17,0,17
Childnotnamed,F,100,6,0,6
Chere,F,100,1177,0,1177
Alyka,F,100,6,0,6
Jakaia,F,100,39,0,39
Andin,M,91,5,53,58
Rondell,M,97,67,2399,2466
Yarden,F,58,92,66,158
Kalina,F,100,2705,0,2705
Keldon,M,100,0,503,503
Tijuan,M,100,0,408,408
Zeva,F,100,142,0,142
Adelle,F,100,2491,0,2491
Omnia,F,100,50,0,50
Reinhard,M,100,0,156,156
Denora,F,100,107,0,107
Lajean,F,100,188,0,188
Sharinna,F,100,5,0,5
Yasira,F,100,60,0,60
Engracia,F,100,31,0,31
Jedah,F,100,5,0,5
Emmariah,F,100,10,0,10
Micholas,M,100,0,217,217
Zer,F,100,17,0,17
Adarian,M,100,0,188,188
Merab,F,100,24,0,24
Mathijs,M,100,0,5,5
Nishawn,M,100,0,59,59
Raymont,M,100,0,295,295
Adriona,F,100,290,0,290
Zikee,M,100,0,5,5
Jerald,M,100,60,15460,15520
Maximous,M,100,0,35,35
Jaquelene,F,100,5,0,5
Wyle,M,100,0,5,5
Nafiso,F,100,5,0,5
Christianjoseph,M,100,0,22,22
Valdemar,M,100,0,646,646
Lanija,F,100,59,0,59
Janetzi,F,100,5,0,5
Bernina,F,100,40,0,40
Micaila,F,100,144,0,144
Lilibet,F,100,28,0,28
Sigifredo,M,100,0,486,486
Mykeisha,F,100,81,0,81
Niyoka,F,100,25,0,25
Lexius,F,100,37,0,37
Etrulia,F,100,22,0,22
Jassel,F,100,28,0,28
Ulyssia,F,100,5,0,5
Asonte,M,62,6,10,16
Deavyn,F,100,5,0,5
Nowell,M,100,0,152,152
Barbaraa,F,100,5,0,5
Tyeler,M,91,27,262,289
Dalianna,F,100,5,0,5
Tansi,F,100,5,0,5
Supraja,F,100,5,0,5
Chanea,F,100,58,0,58
Sharenda,F,100,25,0,25
Hampton,M,96,76,1976,2052
Jerme,M,100,0,14,14
Kheng,M,100,0,5,5
Ellasandra,F,100,5,0,5
Gejuan,M,100,0,20,20
Praveen,M,100,0,217,217
Carolina,F,100,34860,109,34969
Jhovan,M,100,0,5,5
Yaphett,M,100,0,5,5
Ayah,F,100,2360,0,2360
Earon,M,97,5,162,167
Ayame,F,100,193,0,193
Danyall,F,100,6,0,6
Alder,M,98,6,305,311
Eagan,M,100,0,256,256
Kyrsha,F,100,13,0,13
Lendora,F,100,54,0,54
Drusilla,F,100,1281,0,1281
Onyekachi,M,84,11,57,68
Ezekeial,M,100,0,12,12
Aaylah,F,100,46,0,46
Juliyanna,F,100,5,0,5
Jasier,M,100,0,83,83
Krystel,F,100,1005,0,1005
Aseret,F,100,47,0,47
Chanele,F,100,167,0,167
Isaura,F,100,1240,0,1240
Zacharry,M,100,0,22,22
Giordan,M,89,14,108,122
Shardonay,F,100,5,0,5
Marget,F,100,36,0,36
Daretha,F,100,5,0,5
Kabree,F,100,5,0,5
Shakeyra,F,100,34,0,34
Bakir,M,100,0,5,5
Deidrea,F,100,126,0,126
Trenaty,F,100,5,0,5
Tayra,F,100,111,0,111
Taelin,M,60,25,38,63
Shanqual,F,100,5,0,5
Seid,M,100,0,5,5
Oded,M,100,0,6,6
Iceis,F,100,71,0,71
Keyonte,M,96,21,481,502
Eliuth,M,100,0,16,16
Dezirea,F,100,68,0,68
Casson,M,100,0,57,57
Cresencio,M,100,0,500,500
Eather,F,100,91,0,91
Hiromi,F,100,213,0,213
Levette,F,100,241,0,241
Panos,M,100,0,22,22
Tamu,F,98,285,5,290
Rani,F,90,1600,173,1773
Dnae,F,100,57,0,57
Eleodoro,M,100,0,11,11
Opal,F,100,5281,0,5281
Marcelis,M,100,0,104,104
Althelia,F,100,5,0,5
Shanley,F,100,438,0,438
Niquita,F,100,119,0,119
Tziah,M,76,12,38,50
Rozella,F,100,385,0,385
Aldina,F,100,59,0,59
Reannen,F,100,15,0,15
Jazmina,F,100,77,0,77
Daegan,M,94,43,701,744
Velkan,M,100,0,7,7
Gaylor,M,100,0,5,5
Manaal,F,100,183,0,183
Amareona,F,100,5,0,5
Caryss,F,100,39,0,39
Yoann,M,100,0,18,18
Yuly,F,100,22,0,22
Challise,F,100,5,0,5
Ramani,F,100,110,0,110
Zienna,F,100,56,0,56
Javeion,M,100,0,214,214
Reide,M,100,0,15,15
Konnar,M,96,5,126,131
Erwin,M,100,13,7310,7323
Yasina,F,100,6,0,6
Marshe,F,100,71,0,71
Jamera,F,100,348,0,348
Laakea,M,93,10,134,144
Markie,F,82,1434,305,1739
Shailin,F,100,16,0,16
Trevail,M,100,0,6,6
Tanish,M,86,66,392,458
Nefeteria,F,100,5,0,5
Emiko,F,99,837,5,842
Tuyetnhung,F,100,5,0,5
Sarahlee,F,100,11,0,11
Kashandra,F,100,5,0,5
Makailyn,F,100,209,0,209
Annayah,F,100,51,0,51
Dashawnda,F,100,10,0,10
Dez,M,100,0,136,136
Onetha,F,100,18,0,18
Jordin,F,65,3924,2100,6024
Micel,F,100,14,0,14
Kanaan,M,100,0,405,405
Jenneh,F,100,12,0,12
Nitsa,F,100,11,0,11
Mariano,M,100,0,6379,6379
Logahn,M,100,0,5,5
Harfateh,M,100,0,6,6
Sami,M,76,1159,3613,4772
Bona,F,78,35,10,45
Quamarion,M,100,0,18,18
Sabah,F,100,434,0,434
Tevaris,M,100,0,12,12
Jennica,F,100,1793,0,1793
Debrisha,F,100,5,0,5
Karilynn,F,100,107,0,107
Alaziah,F,100,29,0,29
Davanta,M,100,0,86,86
Travante,M,100,0,68,68
Pati,F,100,304,0,304
Kaiyah,F,100,564,0,564
Samatha,F,100,4198,0,4198
Caniesha,F,100,16,0,16
Kymarley,M,100,0,5,5
Clarkson,M,100,0,19,19
Zemirah,F,100,246,0,246
Michaelvincent,M,100,0,34,34
Duaa,F,100,418,0,418
Cesareo,M,100,0,71,71
Sannon,F,100,5,0,5
Mckensley,F,100,5,0,5
Terionna,F,100,20,0,20
Euphoria,F,100,6,0,6
Zequan,M,100,0,26,26
Gonzalo,M,100,0,8142,8142
Arvey,M,100,0,6,6
Jacqulyn,F,100,2951,0,2951
Monreaux,F,100,5,0,5
Sondi,F,100,98,0,98
Savage,M,100,0,15,15
Aaryon,M,100,0,10,10
Dontrey,M,100,0,82,82
Gemarion,M,100,0,6,6
Habeeba,F,100,9,0,9
Lavone,F,86,397,67,464
Pecolia,F,100,80,0,80
Leilani,F,100,22959,19,22978
Amariya,F,100,395,0,395
Jefry,M,100,0,228,228
Beautiful,F,100,634,0,634
Zacharius,M,100,0,109,109
Ahmiya,F,100,141,0,141
Nekeidra,F,100,23,0,23
Bristy,F,100,16,0,16
Tamsyn,F,100,89,0,89
Necol,F,100,29,0,29
Drapper,M,100,0,5,5
Gwendylon,F,100,18,0,18
Christopherpaul,M,100,0,5,5
Ashunte,F,100,39,0,39
Roselina,F,100,57,0,57
Kenshawn,M,100,0,75,75
Mahayla,F,100,667,0,667
Elexys,F,100,58,0,58
Nandini,F,100,700,0,700
Gindy,F,100,22,0,22
Kitzia,F,100,321,0,321
Emijah,F,100,13,0,13
Kemauria,F,100,5,0,5
Shilyn,F,100,58,0,58
Lamarus,M,100,0,5,5
Cedrea,F,100,6,0,6
Diyar,M,100,0,18,18
Daisja,F,100,100,0,100
Early,M,92,82,930,1012
Jleigh,F,100,40,0,40
Jillisa,F,100,118,0,118
Kieriana,F,100,6,0,6
Haizley,F,100,52,0,52
Yosan,F,100,11,0,11
Elizah,F,55,368,302,670
Londyn,F,98,10990,246,11236
Kathaline,F,100,20,0,20
Aliysha,F,100,5,0,5
Laddy,M,100,0,16,16
Avalene,F,100,59,0,59
Minica,F,100,28,0,28
Llana,F,100,50,0,50
Kyrston,F,100,20,0,20
Nayib,M,100,0,101,101
Kwane,M,100,0,211,211
Tiffine,F,100,156,0,156
Leliana,F,100,80,0,80
Abbagail,F,100,805,0,805
Almetra,F,100,5,0,5
Caity,F,100,41,0,41
Neeta,F,100,108,0,108
Djuan,M,100,7,1411,1418
Danai,F,98,260,5,265
Layiah,F,100,10,0,10
Ahylin,F,100,13,0,13
Savasia,F,100,12,0,12
Rozita,F,100,18,0,18
Raejean,F,100,334,0,334
Abbiegail,F,100,237,0,237
Amruta,F,100,16,0,16
Mikaylin,F,100,57,0,57
Delexis,F,100,5,0,5
Mykita,F,100,5,0,5
Raymell,M,100,0,10,10
Hydee,F,100,130,0,130
Elizjah,M,100,0,82,82
Sajeda,F,100,5,0,5
Kahlel,M,100,0,66,66
Io,F,93,85,6,91
Dailin,F,76,84,26,110
Njeri,F,100,286,0,286
Dajanee,F,100,69,0,69
Roran,M,100,0,120,120
Sonita,F,100,190,0,190
Roselie,F,100,294,0,294
Ceasia,F,100,117,0,117
Lendell,M,100,0,438,438
Pramod,M,100,0,16,16
Keonda,F,100,87,0,87
Tejveer,M,100,0,11,11
Hailly,F,100,90,0,90
Jawwaad,M,100,0,6,6
Hardy,M,100,0,1899,1899
Taizlee,F,100,6,0,6
Maverick,M,99,63,10473,10536
Curtistine,F,100,60,0,60
Evangelia,F,100,940,0,940
Seaton,M,100,0,91,91
Jair,M,100,11,5008,5019
Tyking,M,100,0,8,8
Srushti,F,100,19,0,19
Boe,M,99,7,692,699
Coolidge,M,100,0,27,27
Abaan,M,100,0,22,22
Woodie,M,97,16,567,583
Makhiya,F,100,168,0,168
Coi,M,69,10,22,32
Zamirah,F,100,200,0,200
Xzayvion,M,100,0,158,158
Fahed,M,100,0,63,63
Cyana,F,100,197,0,197
Alterick,M,100,0,12,12
Nichol,F,99,2895,22,2917
Lachon,F,90,45,5,50
Carabelle,F,100,11,0,11
Aiyona,F,100,58,0,58
Tregan,M,100,0,58,58
Pamalla,F,100,5,0,5
Kevion,M,99,5,911,916
Desmarie,F,100,49,0,49
Kalsey,F,100,85,0,85
Hassiel,M,100,0,5,5
Jadaya,F,100,124,0,124
Jaad,M,100,0,5,5
Ekaterina,F,100,727,0,727
Drewann,F,100,7,0,7
Keyasia,F,100,429,0,429
Eller,F,100,12,0,12
Cortisha,F,100,26,0,26
Anayely,F,100,233,0,233
Akhari,M,100,0,11,11
Coburn,M,100,0,59,59
Kedisha,F,100,8,0,8
Catheline,F,100,65,0,65
Abdurraheem,M,100,0,17,17
Dhaval,M,100,0,94,94
Allesia,F,100,5,0,5
Lionna,F,100,10,0,10
Breelle,F,100,135,0,135
Kaylei,F,100,1704,0,1704
Janyce,F,100,790,0,790
Fiore,M,80,11,44,55
Saiden,M,100,0,5,5
Tranay,F,100,5,0,5
Remus,M,100,0,372,372
Penelopea,F,100,5,0,5
Imyah,F,100,5,0,5
Chyrle,F,100,15,0,15
Randyn,M,100,0,56,56
Gumercindo,M,100,0,16,16
Fitzgerald,M,100,0,1030,1030
Aureon,F,100,10,0,10
Huma,F,100,216,0,216
Brielynn,F,100,91,0,91
Desheila,F,100,18,0,18
Derreck,M,100,0,1321,1321
Orrin,M,100,0,2584,2584
Mondra,M,100,0,5,5
Kisean,M,100,0,63,63
Amirra,F,100,304,0,304
Shulamith,F,100,5,0,5
Christalle,F,100,17,0,17
Colesha,F,100,5,0,5
Evelen,F,100,40,0,40
Milett,F,100,5,0,5
Teliyah,F,100,156,0,156
Yarithza,F,100,99,0,99
Markkus,M,100,0,5,5
Emilymarie,F,100,47,0,47
Tearra,F,100,753,0,753
Deavionne,F,100,19,0,19
Aavyn,M,55,5,6,11
Shelvy,F,80,64,16,80
Om,M,100,0,1493,1493
Rakhia,F,100,37,0,37
Michalann,F,100,6,0,6
Xiclali,F,100,50,0,50
Kyaw,M,100,0,13,13
Saiveon,M,100,0,19,19
Joscelyne,F,100,117,0,117
Hutchinson,M,100,0,64,64
Jaskaran,M,100,0,344,344
Gilliana,F,100,24,0,24
Aveer,M,100,0,37,37
Ledford,M,100,0,15,15
Collen,M,55,471,586,1057
Azaela,F,100,33,0,33
Jaleya,F,100,213,0,213
Garritt,M,100,0,200,200
Brilei,F,100,5,0,5
Romani,M,81,11,46,57
Zsazsa,F,100,273,0,273
Himani,F,100,186,0,186
Brittlyn,F,100,90,0,90
Kwana,F,100,157,0,157
Deonna,F,100,3481,5,3486
Benito,M,100,26,9787,9813
Anjeli,F,100,73,0,73
Lujean,F,100,126,0,126
Chenoah,F,100,64,0,64
Aileny,F,100,5,0,5
Krisette,F,100,45,0,45
Aleighia,F,100,29,0,29
Ebonee,F,100,1662,0,1662
Khairy,M,100,0,5,5
Kyasia,F,100,665,0,665
Roxxi,F,100,11,0,11
Kenterrius,M,100,0,10,10
Tyheed,M,100,0,19,19
Cleatus,M,100,0,222,222
Pashence,F,100,42,0,42
Verniya,F,100,11,0,11
Dajaha,F,100,16,0,16
Aydelis,F,100,5,0,5
Calisse,F,100,22,0,22
Nekea,F,100,20,0,20
Marcile,F,100,22,0,22
Elizabe,F,100,25,0,25
Tinzlee,F,100,37,0,37
Lovenia,F,100,108,0,108
Daelan,M,100,0,248,248
Hasten,M,100,0,47,47
Cadeshia,F,100,18,0,18
Jeryiah,F,100,5,0,5
Yannick,M,100,0,716,716
Oktober,F,100,54,0,54
Nedine,F,100,6,0,6
Shanli,F,100,5,0,5
Etsub,F,100,5,0,5
Bronwen,F,100,728,0,728
Sherina,F,100,797,0,797
Nehorai,M,100,0,21,21
Andrieka,F,100,7,0,7
Marialaina,F,100,7,0,7
Larrisa,F,100,330,0,330
Cavani,M,100,0,13,13
Arysa,F,100,17,0,17
Kiden,F,100,11,0,11
Vanderbilt,M,100,0,5,5
Celia,F,100,24747,15,24762
Haylee,F,100,26198,20,26218
Hezekiel,M,100,0,6,6
Teagann,F,100,10,0,10
Fawzi,M,100,0,47,47
Twala,F,100,109,0,109
Cortnee,F,100,617,0,617
Jennaya,F,100,81,0,81
Rukmini,F,100,12,0,12
Shantaja,F,100,10,0,10
Jeovany,M,100,0,425,425
Donterio,M,100,0,26,26
Oluwafolajimi,M,100,0,5,5
Chazton,M,100,0,15,15
Lilani,F,100,20,0,20
Kaynan,M,100,0,41,41
Remia,F,100,5,0,5
Akilan,M,100,0,22,22
Charro,F,100,18,0,18
Aamna,F,100,190,0,190
Sherreka,F,100,5,0,5
Joni,F,98,27441,501,27942
Adarah,F,100,26,0,26
Erwan,M,100,0,5,5
Adein,M,100,0,35,35
Keiaira,F,100,81,0,81
Heavenly,F,100,2685,0,2685
Raiven,F,100,366,0,366
Dinh,M,100,0,65,65
Bart,M,100,5,14021,14026
Cordera,M,100,0,134,134
Keelynn,F,91,49,5,54
Devvin,M,100,0,50,50
Bexleigh,F,100,5,0,5
Shaquil,M,97,7,206,213
Swade,M,100,0,70,70
Abdulrehman,M,100,0,49,49
Chanta,F,100,861,0,861
Jaycelyn,F,100,172,0,172
Shafina,F,100,7,0,7
Johnscott,M,100,0,5,5
Betta,F,100,13,0,13
Kinder,F,100,10,0,10
Khyler,M,84,50,270,320
Emmerie,F,100,122,0,122
Allyssia,F,100,183,0,183
Emyrson,F,100,19,0,19
Tashawnda,F,100,57,0,57
Angelar,F,100,10,0,10
Kalya,F,100,251,0,251
Adetayo,M,100,0,12,12
Keagan,M,84,1274,6820,8094
Nickey,M,80,311,1255,1566
Shawntee,F,100,207,0,207
Kerian,F,60,24,16,40
Zebulah,M,100,0,7,7
Tarkisha,F,100,5,0,5
Tashma,F,100,6,0,6
Brindin,M,100,0,5,5
Destanee,F,100,825,0,825
Tavyon,M,100,0,31,31
Maryclare,F,100,292,0,292
Ledarion,M,100,0,17,17
Twalla,F,100,47,0,47
Yazlin,F,100,240,0,240
Selita,F,100,87,0,87
Juno,F,75,391,133,524
Mircle,F,100,21,0,21
Anjanett,F,100,5,0,5
Altha,F,100,290,0,290
Heleina,F,100,5,0,5
Tyreeck,M,100,0,5,5
Maurilio,M,100,0,569,569
Delyza,F,100,6,0,6
Alphia,F,100,36,0,36
Tearle,M,100,0,17,17
Chritopher,M,100,0,341,341
Kainyn,M,100,0,6,6
Tyreon,M,100,0,250,250
Jamira,F,100,1001,0,1001
Carisha,F,100,69,0,69
Beyla,F,100,120,0,120
Neelah,F,100,108,0,108
Milay,F,100,10,0,10
Cato,M,100,0,194,194
Anudeep,M,100,0,5,5
Marrah,F,100,80,0,80
Urenna,F,100,5,0,5
Girish,M,100,0,28,28
Ajeet,M,100,0,34,34
Stinson,M,100,0,28,28
Sisi,F,100,25,0,25
Kenaan,M,100,0,14,14
Alexusia,F,100,5,0,5
Kaydan,M,76,125,401,526
Elouise,F,100,1731,0,1731
Kishan,M,100,0,935,935
Asante,M,80,218,886,1104
Ashawn,M,100,0,179,179
Shenise,F,100,467,0,467
Jaliel,M,100,0,138,138
Kanah,F,100,17,0,17
Shaquill,M,90,17,155,172
Luisalfredo,M,100,0,22,22
Bianeth,F,100,11,0,11
Jeret,M,100,0,223,223
Jamaro,M,100,0,5,5
Heidiann,F,100,5,0,5
Kadein,M,100,0,14,14
Rushelle,F,100,44,0,44
Noname,M,69,5,11,16
Kalene,F,100,719,0,719
Alfredo,M,99,275,45168,45443
Nalaiyah,F,100,5,0,5
Quinnita,F,100,5,0,5
Sharini,F,100,5,0,5
Dorla,F,100,232,0,232
Saket,M,100,0,190,190
Valeriya,F,100,28,0,28
Jahmya,F,100,215,0,215
Syvanna,F,100,87,0,87
Adabella,F,100,115,0,115
Subhan,M,100,0,337,337
Michelene,F,100,584,0,584
Allera,F,100,6,0,6
Savit,M,100,0,5,5
Kouper,M,100,0,66,66
Akimi,F,100,10,0,10
Skipp,M,100,0,6,6
Jorgeluis,M,100,0,376,376
Rukayat,F,100,11,0,11
Mimi,F,100,5134,0,5134
Vidale,M,100,0,13,13
Coral,F,99,7241,43,7284
Molette,F,100,5,0,5
Ayati,F,100,6,0,6
Melorie,F,100,10,0,10
Cayvion,M,100,0,12,12
Ebany,F,100,122,0,122
Evangelo,M,100,0,11,11
Adlin,F,100,41,0,41
Jahziya,F,100,8,0,8
Arshaan,M,100,0,28,28
Thaliah,F,100,23,0,23
Marilinda,F,100,5,0,5
Avagrace,F,100,233,0,233
Jasyia,F,100,11,0,11
Raeshelle,F,100,15,0,15
Rileyn,F,100,7,0,7
Adniel,M,100,0,10,10
Yahilin,F,100,13,0,13
Nykeba,F,100,26,0,26
Jovee,F,100,94,0,94
Steel,M,100,0,374,374
Kayedon,M,100,0,6,6
Rudeen,F,100,5,0,5
Mailani,F,100,173,0,173
Izais,M,100,0,25,25
Latroya,F,100,278,0,278
Verlin,M,98,17,1064,1081
Presly,F,100,127,0,127
Javaria,F,100,93,0,93
Renae,F,100,13073,33,13106
Kaysar,M,100,0,18,18
Trenisha,F,100,191,0,191
Kalynn,F,99,3272,33,3305
Cardyn,F,100,12,0,12
Okan,M,100,0,11,11
Jhayda,F,100,37,0,37
Pattianne,F,100,27,0,27
Avana,F,100,165,0,165
Tristana,F,100,25,0,25
Keevis,M,100,0,5,5
Cheska,F,100,11,0,11
Izzie,F,100,102,0,102
Kensley,F,94,3027,188,3215
Maijah,F,100,6,0,6
Francelle,F,100,6,0,6
Aliyonna,F,100,24,0,24
Talib,M,100,0,719,719
Estrelita,F,100,24,0,24
Ronniesha,F,100,116,0,116
Astri,F,100,41,0,41
Donishia,F,100,20,0,20
Vivion,F,100,10,0,10
Shanasha,F,100,5,0,5
Maslyn,F,100,10,0,10
Lavar,M,99,11,1807,1818
Tyshanna,F,100,41,0,41
Walida,F,100,66,0,66
Raygan,F,95,780,40,820
Jaydehn,M,100,0,5,5
Laelynn,F,100,24,0,24
Kadezia,F,100,15,0,15
Jumari,M,100,0,10,10
Biaunca,F,100,5,0,5
Roshae,F,100,8,0,8
Kirstien,F,100,26,0,26
Allis,F,100,97,0,97
Arinola,F,100,5,0,5
Traesean,M,100,0,12,12
Alyese,F,100,27,0,27
Arelie,F,100,96,0,96
Merin,F,100,171,0,171
Lanique,F,100,255,0,255
Juris,M,100,0,46,46
Cithlaly,F,100,41,0,41
Suheib,M,100,0,5,5
Cassondra,F,100,4300,0,4300
Donnajean,F,100,116,0,116
Hemani,F,100,10,0,10
Kyna,F,100,995,0,995
Lucendia,F,100,6,0,6
Augustus,M,100,0,7958,7958
Rowdie,M,100,0,5,5
Saahir,M,100,0,102,102
Mouhamed,M,100,0,448,448
Davinder,M,100,0,29,29
Florenzo,M,100,0,6,6
Cardine,F,100,10,0,10
Abednego,M,100,0,53,53
Norvelle,M,100,0,5,5
Kefentse,M,100,0,5,5
Anjana,F,100,448,0,448
Nasjah,F,100,6,0,6
Jalya,F,100,30,0,30
Gloretta,F,100,18,0,18
Allson,F,100,5,0,5
Brynisha,F,100,7,0,7
Brookelyne,F,100,10,0,10
Zanyyah,F,100,5,0,5
Carlisa,F,100,1001,0,1001
Sumeyye,F,100,7,0,7
Johnye,F,100,5,0,5
Jagar,M,100,0,67,67
Amare,M,95,254,4439,4693
Keasha,F,100,705,0,705
Ambrocio,M,100,0,18,18
Praxedis,M,100,0,5,5
Ezriel,M,100,0,374,374
Licette,F,100,17,0,17
Aricin,M,100,0,48,48
Macall,F,100,88,0,88
Kathyrine,F,100,6,0,6
Ener,M,100,0,5,5
Fiorenza,F,100,5,0,5
Angala,F,100,213,0,213
Reeana,F,100,5,0,5
Anjanette,F,100,2551,0,2551
Merion,M,57,15,20,35
Yakira,F,100,769,0,769
Michaels,M,100,0,5,5
Corianna,F,100,295,0,295
Brenlyn,F,100,51,0,51
Deallen,M,100,0,11,11
Ronnah,F,100,23,0,23
Yann,M,100,0,229,229
Laroyce,M,57,41,55,96
Mayowa,M,100,0,10,10
Babbi,F,100,12,0,12
Evangalene,F,100,5,0,5
Misael,M,100,16,7135,7151
Nazmir,M,100,0,5,5
Keambra,F,100,10,0,10
Leighland,M,100,0,41,41
Shiniya,F,100,10,0,10
Senita,F,100,166,0,166
Tinasia,F,100,5,0,5
Caely,F,100,28,0,28
Ziarah,F,100,28,0,28
Nocholas,M,100,0,103,103
North,M,100,0,193,193
Nebula,F,100,5,0,5
Kashif,M,100,0,828,828
Aaronlee,M,100,0,5,5
Hytham,M,100,0,5,5
Kansas,F,95,937,53,990
Jananne,F,100,5,0,5
Pailynn,F,100,41,0,41
Jashyra,F,100,20,0,20
Golan,M,100,0,12,12
Jiarui,M,100,0,12,12
Sylvan,M,95,48,1007,1055
Sevana,F,100,134,0,134
Keylianis,F,100,5,0,5
Elrick,M,100,0,30,30
Meirav,F,100,21,0,21
Brinli,F,100,6,0,6
Reene,F,100,118,0,118
Taylah,F,100,467,0,467
Teijah,F,100,6,0,6
Avimael,M,100,0,35,35
Jouse,M,100,0,5,5
Ltonya,F,100,34,0,34
Zimbalist,M,100,0,13,13
Bret,M,99,232,29408,29640
Casundra,F,100,30,0,30
Terrilyn,F,100,908,0,908
Amayiah,F,100,123,0,123
Emmon,M,100,0,5,5
Alannie,F,100,53,0,53
Jerami,M,98,6,362,368
Kaniyah,F,100,1569,0,1569
Zakri,M,100,0,5,5
Vonte,M,100,0,129,129
Jalyssa,F,100,1452,0,1452
Gabriellah,F,100,58,0,58
Cardea,M,100,0,6,6
Jahlynn,F,100,5,0,5
Tityanna,F,100,19,0,19
Zona,F,100,798,0,798
Sola,F,95,103,5,108
Dmia,F,100,51,0,51
Issiaka,M,100,0,5,5
Nadira,F,100,864,0,864
Armeen,M,89,5,41,46
Azariea,F,100,10,0,10
Presious,F,100,43,0,43
Areiana,F,100,27,0,27
Hosea,M,100,0,2529,2529
Rumaysa,F,100,130,0,130
Debbye,F,100,47,0,47
Purpose,F,100,5,0,5
Dawni,F,100,21,0,21
Larea,F,100,5,0,5
Ahmirah,F,100,18,0,18
Sharlette,F,100,275,0,275
Jabob,M,100,0,6,6
Jahvaughn,M,100,0,6,6
Zyndall,M,100,0,14,14
Alexiana,F,100,330,0,330
Eshaal,F,100,272,0,272
Dollye,F,100,22,0,22
Jericka,F,100,428,0,428
Rennick,M,100,0,30,30
Zeron,M,100,0,6,6
Platon,M,100,0,66,66
Brendaly,F,100,73,0,73
Lanicka,F,100,6,0,6
Dajua,F,100,6,0,6
Sophilia,F,100,5,0,5
Aastha,F,100,246,0,246
Aceyn,M,100,0,39,39
Marchia,F,100,76,0,76
Bonnielee,F,100,5,0,5
Brayana,F,100,48,0,48
Panfilo,M,100,0,81,81
Ramazan,M,100,0,11,11
Caydan,M,98,5,217,222
Duff,M,100,0,336,336
Valency,F,100,11,0,11
Jefrin,M,100,0,5,5
Sokhom,M,52,12,13,25
Keausha,F,100,17,0,17
Deshonta,F,100,11,0,11
Condol,F,100,5,0,5
Aleksis,F,93,68,5,73
Raycen,M,100,0,17,17
Kywanna,F,100,5,0,5
Benford,M,100,0,110,110
Madielynn,F,100,7,0,7
Maanas,M,100,0,49,49
Sherlon,F,100,67,0,67
Graisen,M,100,0,28,28
Jahaun,M,100,0,46,46
Shain,M,98,26,1161,1187
Terrone,M,100,0,6,6
Fatia,F,100,7,0,7
Geniffer,F,100,5,0,5
Mikinzie,F,100,73,0,73
Wesely,M,100,0,22,22
Haze,M,98,5,267,272
Graidy,M,100,0,11,11
Nicala,F,100,18,0,18
Ashonta,F,100,24,0,24
Nyera,F,100,48,0,48
Shamiyah,F,100,553,0,553
Dewell,M,100,0,27,27
Salayah,F,100,65,0,65
Floyce,F,100,12,0,12
Kimaria,F,100,66,0,66
Gavriella,F,100,291,0,291
Kanish,M,100,0,11,11
Davine,F,75,281,96,377
Lenola,F,100,13,0,13
Kolston,M,100,0,120,120
Yong,M,74,99,284,383
Mareme,F,100,5,0,5
Raynaldo,M,100,0,1255,1255
Catharine,F,100,4918,0,4918
Verlana,F,100,6,0,6
Harloe,F,100,33,0,33
Olen,M,100,0,2053,2053
Aleyna,F,100,1191,0,1191
Taquisa,F,100,5,0,5
Shawnon,F,100,5,0,5
Kendryk,M,100,0,16,16
Darwuin,M,100,0,5,5
Teak,M,100,0,35,35
Aubre,F,98,644,15,659
Zaccariah,M,100,0,10,10
Adriennie,F,100,5,0,5
Quantarius,M,100,0,117,117
Adhrith,M,100,0,19,19
Vaneka,F,100,6,0,6
Krishon,M,100,0,71,71
Azadeh,F,100,139,0,139
Marliss,F,100,60,0,60
Codi,F,63,3119,1816,4935
Keeaira,F,100,10,0,10
Keidy,F,100,256,0,256
Jguadalupe,M,100,0,89,89
Chaquitta,F,100,7,0,7
Yuvan,M,100,0,222,222
Ashja,F,100,6,0,6
Airius,M,100,0,5,5
Zamayah,F,100,37,0,37
Lizethe,F,100,5,0,5
Martial,M,100,0,37,37
Khassidy,F,100,33,0,33
Ashar,M,100,0,216,216
Aleea,F,100,516,0,516
Sannah,F,100,10,0,10
Tanzi,F,100,10,0,10
Marcel,M,94,783,12665,13448
Yeymi,F,100,29,0,29
Lashayna,F,100,22,0,22
Raffiel,M,100,0,5,5
Rayveon,M,100,0,29,29
Krishtian,M,100,0,5,5
Karrick,M,100,0,5,5
Syrie,F,100,10,0,10
Elner,F,100,5,0,5
Delaney,F,97,31675,955,32630
Shalunda,F,100,108,0,108
Elyas,M,100,0,763,763
Jari,F,62,276,169,445
Carmila,F,100,5,0,5
Kendia,F,100,52,0,52
Cashara,F,100,15,0,15
Dagny,F,100,851,0,851
Leverna,F,100,5,0,5
Haniya,F,100,380,0,380
Traesyn,M,100,0,13,13
Ehsan,M,100,0,306,306
Stevani,F,100,5,0,5
Louisia,F,100,5,0,5
Rhion,M,100,0,6,6
Antoneyo,M,100,0,5,5
Gabriala,F,100,5,0,5
Lazavion,M,100,0,17,17
Serine,F,100,51,0,51
Loralee,F,100,1234,0,1234
Ella,F,100,136665,195,136860
Naterra,F,100,5,0,5
Aeshia,F,100,7,0,7
Thabiti,M,100,0,16,16
Asako,F,100,18,0,18
Wydell,M,100,0,50,50
Suhas,M,100,0,307,307
Romi,F,93,506,36,542
Tarzan,M,100,0,5,5
Jaskarn,M,100,0,43,43
Joseroberto,M,100,0,19,19
Illidan,M,100,0,5,5
Nori,F,97,680,22,702
Sybilla,F,100,18,0,18
Nyerere,M,100,0,6,6
Kashae,F,100,130,0,130
Doloris,F,100,204,0,204
Lakiya,F,100,635,0,635
Samauria,F,100,47,0,47
Tamona,F,100,8,0,8
Brilynne,F,100,5,0,5
Ahnna,F,100,183,0,183
Kiaraliz,F,100,79,0,79
Jason,M,100,4998,1010311,1015309
Xiomari,F,100,30,0,30
Donaji,F,100,18,0,18
Chakera,F,100,25,0,25
Yordano,M,100,0,23,23
Octivia,F,100,68,0,68
Donaven,M,100,0,1090,1090
Carly,F,100,60697,160,60857
Curstyn,F,100,5,0,5
Maddex,M,98,19,972,991
Mahkenzie,F,100,29,0,29
Catelaya,F,100,13,0,13
Kamai,M,100,0,33,33
Rennae,F,100,117,0,117
Halee,F,100,2854,0,2854
Kerrilyn,F,100,107,0,107
Jestine,F,100,504,0,504
Shermain,F,50,5,5,10
Tagan,F,52,58,54,112
Shahab,M,100,0,135,135
Emanni,F,100,15,0,15
Genieva,F,100,24,0,24
Aayam,M,100,0,5,5
Lamora,F,100,10,0,10
Dayanne,F,100,140,0,140
Desja,F,100,26,0,26
Cytlaly,F,100,55,0,55
Divany,F,100,18,0,18
Dasael,M,100,0,6,6
Sekura,F,100,5,0,5
Ashawna,F,100,101,0,101
Chubasco,M,100,0,5,5
Daymin,M,100,0,16,16
Korilynn,F,100,5,0,5
Elka,F,100,538,0,538
Dylanjames,M,100,0,27,27
Pamm,F,100,21,0,21
Jesstin,M,100,0,71,71
Laparis,F,96,132,5,137
Estephan,M,100,0,116,116
Takisa,F,100,5,0,5
Kaylem,M,100,0,78,78
Idalie,F,100,38,0,38
Mckynli,F,100,11,0,11
Salonge,F,100,5,0,5
Iory,M,100,0,5,5
Jilene,F,100,64,0,64
Toma,M,75,158,469,627
Afolabi,M,100,0,25,25
Alexix,F,88,37,5,42
Taejohn,M,100,0,7,7
Aamarion,M,100,0,10,10
Laquinton,M,100,0,346,346
Shederick,M,100,0,6,6
Zilynn,F,100,5,0,5
Kenesia,F,100,6,0,6
Lyshon,F,100,5,0,5
Anneliesse,F,100,14,0,14
Kimbree,F,100,57,0,57
Jaynie,F,100,913,0,913
Brutus,M,100,0,6,6
Saamiyah,F,100,6,0,6
Allegra,F,100,3564,0,3564
Yesel,F,100,5,0,5
Arusha,F,100,10,0,10
Talianna,F,100,16,0,16
Randel,M,99,25,2985,3010
Erine,F,88,88,12,100
Ira,M,92,1762,19586,21348
Korayma,F,100,73,0,73
Jaisa,F,100,222,0,222
Barbarann,F,100,151,0,151
Taylianna,F,100,6,0,6
Chylee,F,100,35,0,35
Candid,F,100,62,0,62
Adrain,M,86,558,3399,3957
Nassar,M,100,0,10,10
Clellon,M,100,0,5,5
Jhomar,M,100,0,11,11
Paigelyn,F,100,27,0,27
Asencion,M,100,0,123,123
Daesha,F,100,673,0,673
Marquelle,M,76,84,262,346
Mubina,F,100,11,0,11
Izzaiah,M,100,0,10,10
Pammi,F,100,5,0,5
Aadhya,F,100,639,0,639
Dontray,M,100,0,304,304
Maddox,M,97,767,21187,21954
Reniesha,F,100,6,0,6
Jeanelly,F,100,26,0,26
Persayus,F,100,50,0,50
Doristine,F,100,81,0,81
Trevarious,M,100,0,7,7
Sharlanda,F,100,5,0,5
Valerine,F,100,5,0,5
Achyuth,M,100,0,19,19
Lashounda,F,100,6,0,6
Daelen,M,100,0,241,241
Adabelle,F,100,117,0,117
Jimmey,M,100,0,470,470
Jjames,M,100,0,6,6
Samih,M,100,0,42,42
Joneisha,F,100,164,0,164
Labrenda,F,100,88,0,88
Cynai,F,100,43,0,43
Joeanne,F,100,56,0,56
Sanjuan,M,100,0,134,134
Melia,F,100,4080,0,4080
Eralyn,F,100,17,0,17
Lasundra,F,100,80,0,80
Suah,F,100,22,0,22
Chaviva,F,100,39,0,39
Emelie,F,100,1454,0,1454
Tajah,F,92,838,76,914
Lettice,F,100,10,0,10
Mariahann,F,100,6,0,6
Zyda,F,100,5,0,5
Alasha,F,100,289,0,289
Dlila,F,100,24,0,24
Randon,M,99,10,1653,1663
Birdia,F,100,48,0,48
Sriman,M,100,0,60,60
Kyeshia,F,100,129,0,129
Ellason,F,100,97,0,97
Marcellas,M,100,0,69,69
Keirstin,F,100,529,0,529
Jamaun,M,100,0,17,17
Teigan,F,59,460,321,781
Dalisia,F,100,5,0,5
Zoen,M,100,0,16,16
Preslea,F,100,95,0,95
Zacheri,M,100,0,21,21
Alohna,F,100,5,0,5
Angeleana,F,100,18,0,18
Reo,M,99,5,390,395
Lametrice,F,100,6,0,6
Daziah,F,100,146,0,146
Karoleena,F,100,11,0,11
Jayeden,M,100,0,18,18
Denisia,F,100,183,0,183
Ahman,M,100,0,203,203
Janiaha,F,100,14,0,14
Runnie,M,100,0,12,12
Ofri,F,100,6,0,6
Sharrieff,M,100,0,75,75
Amadeus,M,100,0,779,779
Lanylah,F,100,5,0,5
Daralynn,F,100,21,0,21
Shiyah,F,100,10,0,10
Tulah,F,100,16,0,16
Vincent,M,100,978,235092,236070
Brindi,F,100,11,0,11
Darsha,F,100,83,0,83
Attiyya,F,100,11,0,11
Mackanzie,F,100,11,0,11
Cruiz,M,100,0,33,33
Mauel,M,100,0,15,15
Hermilo,M,100,0,381,381
Ladeja,F,100,279,0,279
Shatasia,F,100,71,0,71
Niyia,F,100,5,0,5
Lincoln,M,99,437,30775,31212
Heavenley,F,100,11,0,11
Jazzalynn,F,100,76,0,76
Makaia,F,100,228,0,228
Sanaria,F,100,25,0,25
Emrys,M,83,42,200,242
Montoyia,F,100,5,0,5
Saketha,F,100,6,0,6
Javale,M,100,0,30,30
Khian,M,100,0,38,38
Emman,F,100,10,0,10
Rutvi,F,100,11,0,11
Cathlin,F,100,116,0,116
Dewetta,F,100,5,0,5
Jamesandrew,M,100,0,21,21
Samiel,M,100,0,48,48
Nsombi,F,100,17,0,17
Talaiya,F,100,25,0,25
Danieljames,M,100,0,28,28
Priyank,M,100,0,5,5
Karlita,F,100,82,0,82
Ambreia,F,100,51,0,51
Bora,M,80,70,287,357
Svea,F,100,371,0,371
Takeshia,F,100,418,0,418
Natiyah,F,100,37,0,37
Reynel,M,100,0,42,42
Toneshia,F,100,91,0,91
Clysta,F,100,7,0,7
Saaliyah,F,100,14,0,14
Brenlee,F,100,303,0,303
Lory,F,95,2123,115,2238
Lyris,F,100,55,0,55
Gerardina,F,100,5,0,5
Dedorah,F,100,36,0,36
Nikkolette,F,100,10,0,10
Koury,M,100,0,62,62
Darriane,F,100,14,0,14
Trenia,F,100,359,0,359
Lemonte,M,100,0,100,100
Duvall,M,100,0,67,67
Yvonnie,F,100,306,0,306
Danesia,F,100,21,0,21
Bellanira,F,100,6,0,6
Sybil,F,100,5226,0,5226
Keyundra,F,100,64,0,64
Avalin,F,100,61,0,61
Gloristine,F,100,33,0,33
Effy,F,100,20,0,20
Lekishia,F,100,6,0,6
Tyjuan,M,100,0,1421,1421
Shavonya,F,100,12,0,12
Mohmmad,M,100,0,110,110
Antone,M,100,10,2748,2758
Yaribel,F,100,51,0,51
Yudit,F,100,62,0,62
Thayden,M,100,0,135,135
Rickki,F,100,5,0,5
Konrad,M,100,0,2937,2937
Quinnel,M,100,0,5,5
Corderro,M,100,0,242,242
Makayleigh,F,100,78,0,78
Rhiann,F,100,131,0,131
Elishah,M,88,27,206,233
Cyntha,F,100,243,0,243
Lachandra,F,100,496,0,496
Tamika,F,100,22689,90,22779
Saje,F,67,76,38,114
Harrold,M,100,0,168,168
Corky,M,93,33,456,489
Enger,F,100,6,0,6
Jaysian,M,100,0,6,6
Bekim,M,100,0,145,145
Wilferd,M,100,0,23,23
Adrein,M,100,0,51,51
Amyriah,F,100,84,0,84
Leahrose,F,100,5,0,5
Angi,F,100,538,0,538
Deshuna,F,100,5,0,5
Elcie,F,100,23,0,23
Wyvetta,F,100,5,0,5
Kairaba,M,100,0,8,8
Josiahs,M,100,0,41,41
Tanuj,M,100,0,65,65
Lelanie,F,100,10,0,10
Abhijeet,M,100,0,45,45
Kaaya,F,100,5,0,5
Antaun,M,100,0,15,15
Stanislaw,M,100,0,197,197
Camran,M,94,18,280,298
Madiyson,F,100,5,0,5
Breigha,F,100,5,0,5
Kavish,M,100,0,131,131
Temera,F,100,31,0,31
Talasha,F,100,11,0,11
Malacai,M,100,0,80,80
Adarryll,M,100,0,29,29
Lequitta,F,100,5,0,5
Burak,M,100,0,255,255
Joslynne,F,100,126,0,126
Tshaka,M,100,0,12,12
Ciprianna,F,100,5,0,5
Phebe,F,100,1261,0,1261
Lannon,M,100,0,5,5
Navon,M,100,0,193,193
Raquon,M,100,0,73,73
Jurline,F,100,24,0,24
Beyza,F,100,111,0,111
Khaiya,F,100,27,0,27
Lakenda,F,100,30,0,30
Emmytt,M,100,0,14,14
Linden,M,62,1122,1837,2959
Adrita,F,100,32,0,32
Zene,F,100,10,0,10
Selamawit,F,100,22,0,22
Jana,F,100,41637,39,41676
Johnrobert,M,100,0,316,316
Marijah,F,100,104,0,104
Kuron,M,100,0,137,137
Fia,F,100,147,0,147
Xarianna,F,100,5,0,5
Shaelee,F,100,423,0,423
Tommya,F,100,5,0,5
Lamariah,F,100,17,0,17
Shemaka,F,100,5,0,5
Preksha,F,100,11,0,11
Khaydence,F,100,5,0,5
Sanquita,F,100,10,0,10
Aethan,M,100,0,37,37
Inderjit,M,100,0,22,22
Avant,M,100,0,507,507
Caylan,F,60,234,154,388
Ryun,M,100,0,181,181
Joeb,M,100,0,41,41
Jodean,F,100,322,0,322
Lish,F,100,7,0,7
Dela,F,98,249,5,254
Zakyra,F,100,266,0,266
Demekia,F,100,31,0,31
Melakhi,M,100,0,5,5
Shaelynn,F,100,1526,0,1526
Deriyah,F,100,61,0,61
Alura,F,100,469,0,469
Caragh,F,100,61,0,61
Asai,M,100,0,12,12
Awna,F,100,5,0,5
Audreauna,F,100,7,0,7
Tiaundra,F,100,7,0,7
Treyquan,M,100,0,43,43
Keelen,M,100,0,151,151
Lanis,M,70,26,60,86
Zymaire,M,100,0,5,5
Brynlyn,F,100,48,0,48
Maze,M,100,0,47,47
Daniyah,F,100,1113,0,1113
Mireida,F,100,12,0,12
Lacelyn,F,100,5,0,5
Annily,F,100,7,0,7
Deivy,M,100,0,30,30
Maecy,F,100,198,0,198
Kaleah,F,100,2465,0,2465
Lelynd,M,100,0,65,65
Jatinder,M,100,0,34,34
Reakwon,M,100,0,73,73
Georgeanna,F,100,824,0,824
Katalaya,F,100,125,0,125
Calvyn,M,100,0,75,75
Kimyatta,F,100,330,0,330
Chip,M,100,0,2989,2989
Awab,M,100,0,103,103
Rodregus,M,100,0,49,49
Lyli,F,100,27,0,27
Terrisa,F,100,287,0,287
Sabatino,M,100,0,45,45
Maryalyce,F,100,19,0,19
Caiyden,M,100,0,11,11
Demaurie,M,100,0,6,6
Akos,M,100,0,5,5
Sotiria,F,100,41,0,41
Troya,F,100,58,0,58
Maecee,F,100,20,0,20
Dyvon,M,100,0,40,40
Massiah,M,83,79,374,453
Jamayla,F,100,46,0,46
Carmell,F,92,142,12,154
Mcalister,M,100,0,5,5
Shaneca,F,100,77,0,77
Kcee,F,100,5,0,5
Krisanna,F,100,32,0,32
Gwenavere,F,100,17,0,17
Tripper,M,100,0,27,27
Demorris,M,100,0,357,357
Oneda,F,100,56,0,56
Galatia,F,100,5,0,5
Tequella,F,100,5,0,5
Lojain,F,100,11,0,11
Moiya,F,100,5,0,5
Anikah,F,100,126,0,126
Ganell,F,100,5,0,5
Shekela,F,100,82,0,82
Jahlyn,M,100,0,10,10
Tonee,F,97,170,5,175
Tevonte,M,100,0,36,36
Onda,F,100,23,0,23
Haileyrose,F,100,6,0,6
Len,M,97,97,2687,2784
Otila,F,100,79,0,79
Adanna,F,100,432,0,432
Legrand,M,100,0,145,145
Marquese,M,100,0,1255,1255
Margrett,F,100,205,0,205
Myrtha,F,100,73,0,73
Hibba,F,100,147,0,147
Caua,M,100,0,6,6
Cortavia,F,100,5,0,5
Prema,F,100,43,0,43
Guilherme,M,100,0,404,404
Lamir,M,100,0,179,179
Ceonna,F,100,63,0,63
Nameer,M,100,0,58,58
Haymond,M,100,0,5,5
Ritik,M,100,0,64,64
Dejonte,M,100,0,55,55
Khadijat,F,100,22,0,22
Janadia,F,100,6,0,6
Shermane,F,100,32,0,32
Anedra,F,100,105,0,105
Medena,F,100,5,0,5
Kendallyn,F,100,145,0,145
Gean,M,62,116,188,304
Noe,M,99,265,18497,18762
Imane,F,100,208,0,208
Michaelann,F,100,201,0,201
Quinterria,F,100,16,0,16
Angle,F,90,1138,125,1263
Defonta,M,100,0,6,6
Ralston,M,100,0,461,461
Chekesha,F,100,151,0,151
Galynn,F,100,10,0,10
Terre,F,89,733,87,820
Kahiau,M,100,0,119,119
Erek,M,100,0,659,659
Adorian,M,100,0,70,70
Dechane,M,100,0,6,6
Leeya,F,100,400,0,400
Sumin,F,100,16,0,16
Brittary,F,100,5,0,5
Rushun,M,100,0,5,5
Alrik,M,100,0,8,8
Ranika,F,100,143,0,143
Malahni,F,100,6,0,6
Skylit,F,100,5,0,5
Vimala,F,100,5,0,5
Rylund,M,100,0,18,18
Marselina,F,100,6,0,6
Cale,M,99,84,7562,7646
Patress,F,100,6,0,6
Mo,M,100,0,7,7
Iyiana,F,100,21,0,21
Thamara,F,100,212,0,212
Nache,F,100,15,0,15
Jaydhen,M,100,0,6,6
Shaneta,F,100,80,0,80
Tiheim,M,100,0,5,5
Anajae,F,100,6,0,6
Janyria,F,100,32,0,32
Ataly,F,100,5,0,5
Cecilla,F,100,24,0,24
Lonnell,M,100,0,1006,1006
Caled,M,100,0,6,6
Quaylon,M,100,0,51,51
Labrisha,F,100,75,0,75
Ameleah,F,100,5,0,5
Desdemona,F,100,24,0,24
Lateashia,F,100,5,0,5
Vaniya,F,100,92,0,92
Revelation,M,100,0,5,5
Ciboney,F,100,5,0,5
Toua,M,100,0,170,170
Taire,F,100,8,0,8
Damondre,M,100,0,71,71
Zaeleigh,F,100,18,0,18
Maleny,F,100,365,0,365
Zailynn,F,100,108,0,108
Leni,F,97,515,15,530
Raidan,M,100,0,26,26
Dontrell,M,99,16,2495,2511
Voshon,M,100,0,80,80
Jakub,M,100,0,2449,2449
Liliahna,F,100,74,0,74
Kaveesh,M,100,0,5,5
Jazzelyn,F,100,21,0,21
Joeisha,F,100,10,0,10
Denelle,F,99,633,6,639
Gelsomina,F,100,5,0,5
Hanish,M,100,0,23,23
Jakin,M,100,0,213,213
Samaria,F,100,3569,0,3569
Hosia,M,100,0,5,5
Latonnia,F,100,10,0,10
Labreeska,F,100,38,0,38
Juanika,F,100,53,0,53
Varner,M,100,0,5,5
Tanger,F,100,20,0,20
Shelvie,F,100,29,0,29
Atreju,M,100,0,6,6
Quanterrious,M,100,0,10,10
Basilios,M,100,0,5,5
Rev,M,100,0,5,5
Jamarreon,M,100,0,23,23
Aubrionna,F,100,100,0,100
Innocence,F,100,71,0,71
Male,M,100,0,1508,1508
Fiera,F,100,28,0,28
Jonatha,M,98,5,311,316
Jaseon,M,100,0,18,18
Dalida,F,100,6,0,6
Beckam,M,100,0,434,434
Heeba,F,100,5,0,5
Lashanay,F,100,10,0,10
Chazaray,M,100,0,6,6
Areana,F,100,418,0,418
Cleopatra,F,100,1060,0,1060
Bobbi,F,100,22701,64,22765
Mahnoor,F,100,596,0,596
Grechen,F,100,5,0,5
Lutrell,M,100,0,15,15
Tramell,M,100,0,620,620
Isay,M,100,0,77,77
Masal,F,100,5,0,5
Jophy,M,100,0,10,10
Tia,F,100,32106,64,32170
Jafari,M,100,0,153,153
Keyin,M,100,0,6,6
Traveion,M,100,0,65,65
Cash,M,100,40,13401,13441
Kehley,F,100,10,0,10
Nikalus,M,100,0,40,40
Bryelle,F,100,309,0,309
Powers,M,100,0,12,12
Johntavis,M,100,0,21,21
Weylyn,M,100,0,27,27
Lali,F,100,35,0,35
Zarihya,F,100,12,0,12
Gaje,M,100,0,137,137
Shaliese,F,100,5,0,5
Jewan,M,100,0,17,17
Abdulhameed,M,100,0,5,5
Latonjia,F,100,10,0,10
Zelene,F,100,83,0,83
Haarika,F,100,23,0,23
Mahana,F,100,30,0,30
Nacoma,M,100,0,27,27
Marckel,M,100,0,5,5
Riggins,M,100,0,147,147
Ruddy,M,99,5,432,437
Raahim,M,100,0,49,49
Loriah,F,100,48,0,48
Kirubel,M,100,0,127,127
Serenitee,F,100,240,0,240
Moraima,F,100,282,0,282
Christ,M,97,47,1730,1777
Lilana,F,100,59,0,59
Emer,F,89,39,5,44
Rameir,M,100,0,11,11
Lanore,F,100,85,0,85
Alejandrina,F,100,1233,0,1233
Jericia,F,100,5,0,5
Linayah,F,100,11,0,11
Carrington,F,60,2237,1494,3731
Lyliann,F,100,5,0,5
Jeniveve,F,100,5,0,5
Lastarr,F,100,39,0,39
Rashaan,M,98,28,1123,1151
Nalee,F,100,71,0,71
Maryangel,F,100,47,0,47
Takota,M,91,33,321,354
Ata,M,100,0,183,183
Natyra,F,100,15,0,15
Zevin,M,100,0,174,174
Shaakirah,F,100,11,0,11
Dvante,M,100,0,201,201
Terrae,F,100,10,0,10
Tinaya,F,100,109,0,109
Avishka,F,100,6,0,6
Willis,M,99,106,14092,14198
Brandel,M,80,13,52,65
Mallery,F,100,481,0,481
Ahad,M,100,0,382,382
Danajia,F,100,32,0,32
Brieana,F,100,973,0,973
Keita,M,68,189,411,600
Jahla,F,100,53,0,53
Amarr,M,100,0,48,48
Aliki,F,100,16,0,16
Amia,F,100,3479,0,3479
Evalen,F,100,5,0,5
Lrey,M,100,0,5,5
Kenari,F,100,6,0,6
Kanton,M,100,0,76,76
Lashanette,F,100,10,0,10
Leverne,M,67,174,353,527
Tenee,F,100,91,0,91
Karter,M,89,989,7779,8768
Tynsley,F,100,18,0,18
Shandrica,F,100,32,0,32
Milady,F,100,98,0,98
Dresean,M,100,0,140,140
Emerzon,M,100,0,23,23
Jaevien,M,100,0,6,6
Tanishq,M,100,0,31,31
Kyvin,M,100,0,16,16
Clarabelle,F,100,181,0,181
Nusayba,F,100,41,0,41
Sehajpreet,F,100,5,0,5
Charniece,F,100,92,0,92
Peyden,F,76,16,5,21
Zeke,M,100,0,3584,3584
Jezebelle,F,100,60,0,60
Damal,M,100,0,5,5
Wasi,M,100,0,5,5
Raahi,F,100,35,0,35
Susanah,F,100,34,0,34
Zyannah,F,100,33,0,33
Yiannis,M,100,0,173,173
Elexia,F,100,535,0,535
Tou,M,100,0,1248,1248
Shrinidhi,F,100,26,0,26
Cathryn,F,100,10918,0,10918
Lachan,F,100,6,0,6
Naitik,M,100,0,34,34
Jerney,F,92,112,10,122
Reinaliz,F,100,5,0,5
Kaliegh,F,100,385,0,385
Aubriana,F,100,2349,0,2349
Channah,F,100,175,0,175
Bellicia,F,100,5,0,5
Yuktha,F,100,55,0,55
Malcomb,M,100,0,63,63
Kelcea,F,100,7,0,7
Kaine,M,100,0,1849,1849
Chaelyn,F,100,75,0,75
Jontaya,F,100,5,0,5
Kurdt,M,100,0,18,18
Bruchy,F,100,238,0,238
Kailanni,F,100,10,0,10
Jodilyn,F,100,76,0,76
Katianna,F,100,171,0,171
Roshani,F,100,40,0,40
Trinia,F,100,316,0,316
Roch,M,100,0,219,219
London,F,79,27229,7200,34429
Shalim,M,100,0,45,45
Ellyson,F,100,284,0,284
Cashea,F,100,18,0,18
Cierre,F,100,26,0,26
Taila,F,100,228,0,228
Cort,M,100,0,1651,1651
Jeannifer,F,100,79,0,79
Steeve,M,100,0,10,10
Bellah,F,100,286,0,286
Ondina,F,100,15,0,15
Hannah,F,100,388986,665,389651
Toniah,F,100,35,0,35
Michelee,F,100,37,0,37
Nykera,F,100,43,0,43
Sheili,F,100,5,0,5
Kadisha,F,100,227,0,227
Myrella,F,100,61,0,61
Daz,M,100,0,16,16
Rutger,M,100,0,252,252
Floresita,F,100,19,0,19
Slevin,M,100,0,67,67
Ieesha,F,100,174,0,174
Brayanna,F,100,59,0,59
Nohelia,F,100,222,0,222
Talitha,F,100,2601,0,2601
Jaeleen,F,100,205,0,205
Savieon,M,100,0,12,12
Terianne,F,100,69,0,69
Atem,M,100,0,5,5
Reginal,M,100,5,2282,2287
Phineas,M,100,0,1366,1366
Fredreick,M,100,0,17,17
Tawain,M,100,0,10,10
Aleshanee,F,100,45,0,45
Ramayah,F,100,6,0,6
Katesha,F,100,177,0,177
Jackielyn,F,100,15,0,15
Gracianna,F,100,114,0,114
Lestat,M,100,0,372,372
Ayveri,F,100,7,0,7
Marleyjane,F,100,5,0,5
Madden,M,84,679,3695,4374
Ashunta,F,100,10,0,10
Anandita,F,100,5,0,5
Corlene,F,100,37,0,37
Juline,F,100,177,0,177
Mychel,F,50,10,10,20
Shayvonne,F,100,25,0,25
Brittley,F,100,103,0,103
Shenouda,M,100,0,50,50
Demar,M,100,0,1036,1036
Garreth,M,100,0,400,400
Itziar,M,100,0,6,6
Marlana,F,100,2672,0,2672
Audree,F,100,2032,0,2032
Sheereen,F,100,11,0,11
Tishana,F,100,233,0,233
Kahlei,F,100,15,0,15
Kawaun,M,100,0,17,17
Gwendola,F,100,6,0,6
Jeaneen,F,100,691,0,691
Franci,F,100,224,0,224
Dayamir,F,100,5,0,5
Orion,M,97,313,10975,11288
Charysse,F,100,16,0,16
Derielle,F,100,13,0,13
Mckelvey,F,100,6,0,6
Sandera,F,100,10,0,10
Yatziel,M,100,0,5,5
Teddy,M,97,601,17975,18576
Cinsere,M,91,5,51,56
Zohe,F,100,5,0,5
Kanette,F,100,5,0,5
Arjanae,F,100,29,0,29
Beuna,F,100,5,0,5
Javontai,M,100,0,9,9
Anna,F,100,374680,1011,375691
Malany,F,100,5,0,5
Hosey,M,100,0,50,50
Tahiri,F,100,45,0,45
Shenia,F,100,359,0,359
Nakara,F,100,18,0,18
Ramik,M,100,0,5,5
Jayion,M,100,0,88,88
Sirenna,F,100,15,0,15
Nassor,M,100,0,5,5
Briayan,M,100,0,5,5
Arnel,M,96,22,597,619
Lamarius,M,100,0,182,182
Tresaun,M,100,0,10,10
Ithalia,F,100,5,0,5
Reginold,M,100,0,460,460
Corday,M,100,0,188,188
Martijn,M,100,0,5,5
Deryle,M,100,0,32,32
Talaya,F,100,1188,0,1188
Mckayden,F,100,6,0,6
Rayshawnda,F,100,5,0,5
Wuilber,M,100,0,5,5
Mann,M,100,0,47,47
Abbaas,M,100,0,5,5
Virna,F,100,183,0,183
Leinani,F,100,55,0,55
Lorinzo,M,100,0,30,30
Trixy,F,100,174,0,174
Naelah,F,100,6,0,6
Pavani,F,100,31,0,31
Daelani,F,100,12,0,12
Caterra,F,100,82,0,82
Lucanus,M,100,0,5,5
Raini,F,89,416,53,469
Maxamis,M,100,0,6,6
Asier,M,100,0,11,11
Finleigh,F,100,263,0,263
Rayce,M,99,11,1085,1096
Dierra,F,100,416,0,416
Tajauna,F,100,18,0,18
Henery,M,100,0,413,413
Jessejames,M,100,0,435,435
Jenesha,F,100,6,0,6
Monita,F,100,364,0,364
Christene,F,100,2018,0,2018
Gedalya,M,100,0,84,84
Miquelle,F,100,21,0,21
Milind,M,100,0,63,63
Koleen,F,100,228,0,228
Abdihafid,M,100,0,9,9
Jessical,F,100,34,0,34
Nikko,M,94,166,2742,2908
Mckynlie,F,100,66,0,66
Sotheary,F,100,20,0,20
Hozie,M,100,0,11,11
Argelia,F,100,782,0,782
Chayse,M,70,743,1698,2441
Anthany,M,100,0,511,511
Lary,M,100,0,901,901
Dominico,M,100,0,314,314
Devontrae,M,100,0,5,5
Nhuy,F,100,8,0,8
Jahseir,M,100,0,6,6
Starley,F,76,16,5,21
Sherrod,M,100,0,1762,1762
Damont,M,100,0,321,321
Delondo,M,100,0,5,5
Justinryan,M,100,0,23,23
Tyyonna,F,100,65,0,65
Nesia,F,100,13,0,13
Shaquin,F,100,5,0,5
Mendell,M,100,0,37,37
Queency,F,100,5,0,5
Janaija,F,100,24,0,24
Gavrielle,F,100,152,0,152
Xaylee,F,100,15,0,15
Chrissa,F,100,650,0,650
Oather,M,100,0,27,27
Zamire,M,100,0,47,47
Selyn,F,100,5,0,5
Nkao,F,100,5,0,5
Chayna,F,100,192,0,192
Christopherjohn,M,100,0,118,118
Kashawn,M,92,78,954,1032
Sudan,M,100,0,10,10
Dimitria,F,100,239,0,239
Lynnel,F,100,101,0,101
Khaydin,M,100,0,11,11
Nasia,F,100,414,0,414
Thena,F,100,63,0,63
Esme,F,100,2665,0,2665
Logan,M,93,21625,279371,300996
Ivanka,F,100,370,0,370
Kahron,M,100,0,147,147
Siany,F,100,44,0,44
Yoshira,F,100,8,0,8
Elishka,F,100,10,0,10
Jajuana,F,100,23,0,23
Rama,F,78,698,193,891
Julivette,F,100,5,0,5
Harryette,F,100,10,0,10
Sheketa,F,100,84,0,84
Seleena,F,100,209,0,209
Glendaliz,F,100,17,0,17
Arella,F,100,286,0,286
Neerav,M,100,0,31,31
Dorina,F,100,747,0,747
Hardie,M,100,0,106,106
Jaycia,F,100,10,0,10
Authur,M,100,0,877,877
Alyosha,M,100,0,6,6
Noralva,F,100,5,0,5
Matrim,M,100,0,26,26
Johnesia,F,100,29,0,29
Leman,M,100,0,185,185
Nitzia,F,100,93,0,93
Omiya,F,100,5,0,5
Tylier,M,100,0,5,5
Josiah,M,100,317,78377,78694
Gunther,M,100,0,738,738
Mireya,F,100,7810,0,7810
Vela,F,100,159,0,159
Montoya,F,82,520,114,634
Shantih,F,100,5,0,5
Betsua,F,100,23,0,23
Garo,M,100,0,157,157
Dicksie,F,100,16,0,16
Antino,M,100,0,126,126
Kayleena,F,100,329,0,329
Anesa,F,100,427,0,427
Vedia,F,100,27,0,27
Crisslyn,F,100,5,0,5
Livija,F,100,5,0,5
Devynne,F,100,110,0,110
Gal,M,51,131,136,267
Airam,F,88,631,82,713
Jarael,M,100,0,16,16
Nihira,F,100,45,0,45
Analize,F,100,28,0,28
Atiya,F,100,1297,0,1297
Cydni,F,100,570,0,570
Nhya,F,100,8,0,8
Tasi,F,69,36,16,52
Tupac,M,100,0,73,73
Kemone,M,100,0,5,5
Arayiah,F,100,16,0,16
Nafissa,F,100,5,0,5
Olasunkanmi,M,100,0,5,5
Serapio,M,100,0,118,118
Ysenia,F,100,378,0,378
Charlyse,F,100,55,0,55
Shantise,F,100,26,0,26
Teresa,F,100,366390,1035,367425
Anayla,F,100,173,0,173
Aithan,M,100,0,80,80
Lucinia,F,100,5,0,5
Jahlia,F,100,180,0,180
Keonya,F,100,16,0,16
Shubhan,M,100,0,16,16
Ayuna,F,100,7,0,7
Shakeidra,F,100,5,0,5
Johnrichard,M,100,0,18,18
Yamini,F,100,50,0,50
Jayvan,M,100,0,90,90
Gustin,M,100,0,170,170
Traylen,M,100,0,89,89
Nicasio,M,100,0,235,235
Lieu,F,100,12,0,12
Pei,F,100,18,0,18
Lynisha,F,100,108,0,108
Maric,M,100,0,5,5
Nia,F,100,19081,10,19091
Symiah,F,100,141,0,141
Jakyren,M,100,0,61,61
Avila,F,100,175,0,175
Haleigh,F,100,13193,9,13202
Tenaya,F,100,881,0,881
Naythen,M,100,0,137,137
Drystal,F,100,24,0,24
Gracelin,F,100,183,0,183
Hervy,M,100,0,5,5
Tramain,M,100,0,141,141
Nicholina,F,100,5,0,5
Pemela,F,100,5,0,5
Lashyra,F,100,37,0,37
Salatiel,M,100,0,33,33
Kylesha,F,100,5,0,5
Derald,M,100,0,879,879
Faybian,M,100,0,16,16
Atrina,F,100,13,0,13
Natelle,F,100,5,0,5
Bernest,M,100,0,7,7
Tasiah,F,100,19,0,19
Hopelyn,F,100,22,0,22
Bristyn,F,100,71,0,71
Brittinee,F,100,56,0,56
Kiyo,F,100,5,0,5
Zyquan,M,100,0,266,266
Afshin,M,100,0,51,51
Shannin,F,100,240,0,240
Shamus,M,100,0,1655,1655
Wryan,M,100,0,12,12
Zanaii,F,100,5,0,5
Chantler,M,100,0,5,5
Obadiah,M,100,0,1217,1217
Elyannah,F,100,14,0,14
Ziarre,F,100,5,0,5
Syire,M,100,0,8,8
Kennyel,M,100,0,6,6
Deprise,F,100,22,0,22
Raemi,F,100,6,0,6
Irha,F,100,6,0,6
Lavontae,M,100,0,342,342
Thomas,M,100,4896,1429111,1434007
Josniel,M,100,0,27,27
Jamantha,F,100,5,0,5
Darisley,F,100,5,0,5
Meleka,F,100,12,0,12
Cari,F,100,12449,55,12504
Donterius,M,100,0,99,99
Hearther,F,100,10,0,10
Ector,M,100,0,692,692
Anapaula,F,100,277,0,277
Deaijah,F,100,16,0,16
Lamayia,F,100,7,0,7
Zephery,M,100,0,5,5
Kavis,M,100,0,13,13
Dezion,M,100,0,22,22
Stephfon,M,100,0,66,66
Sheffield,M,100,0,15,15
Pauljoseph,M,100,0,6,6
Zaydah,F,100,42,0,42
Maxwill,M,100,0,5,5
Corderious,M,100,0,5,5
Void,F,56,9,7,16
Drayvon,M,100,0,13,13
Nekia,F,94,811,50,861
Wrangler,M,100,0,157,157
Jolysa,F,100,5,0,5
Yadhira,F,100,1290,0,1290
Mihai,M,100,0,52,52
Jamica,F,100,801,0,801
Shamariya,F,100,11,0,11
Maciel,F,80,198,51,249
Latiara,F,100,31,0,31
Detrica,F,100,5,0,5
Verinda,F,100,6,0,6
Vladimir,M,100,0,4427,4427
Barbaraann,F,100,338,0,338
Irelynd,F,100,151,0,151
Emanuell,M,100,0,65,65
Quintesha,F,100,12,0,12
Jeromee,M,100,0,10,10
Corrisa,F,100,60,0,60
Lesle,F,100,182,0,182
Garfield,M,100,0,1495,1495
Demitric,M,100,0,6,6
Siegfried,M,100,0,375,375
Mahniya,F,100,45,0,45
Ahlana,F,100,155,0,155
Zareth,F,81,52,12,64
Elyse,F,100,16389,19,16408
Jasyra,F,100,10,0,10
Finessa,F,100,5,0,5
Latrinia,F,100,26,0,26
Rhianne,F,100,216,0,216
Jakavion,M,100,0,90,90
Gabrieljohn,M,100,0,5,5
Obaloluwa,M,100,0,28,28
Meikhi,M,100,0,25,25
Holy,F,100,65,0,65
Lenard,M,100,0,3923,3923
Loganne,F,100,39,0,39
Ransen,M,100,0,5,5
Sushant,M,100,0,40,40
Lovelyn,F,100,43,0,43
Rosea,F,100,40,0,40
Mayur,M,100,0,191,191
Samare,F,100,5,0,5
Keirslyn,F,100,5,0,5
Otoniel,M,100,0,879,879
Cheire,F,100,5,0,5
Meyla,F,100,5,0,5
Abimelec,M,100,0,43,43
Esty,F,100,311,0,311
Leonaldo,M,100,0,5,5
Kioko,F,100,5,0,5
Kimberlyanne,F,100,46,0,46
Cailynn,F,100,821,0,821
Ramelo,M,100,0,65,65
Tyreck,M,100,0,73,73
Bridges,M,100,0,26,26
Kameren,M,86,83,499,582
Straton,M,100,0,37,37
Taurin,M,100,0,29,29
Ciji,F,100,579,0,579
Ixayana,F,100,27,0,27
Katonia,F,100,34,0,34
Areigha,F,100,5,0,5
Eriqua,F,100,10,0,10
Ashlynn,F,100,20537,12,20549
Srihan,M,100,0,152,152
Rubyann,F,100,136,0,136
Josedavid,M,100,0,25,25
Lyndie,F,100,587,0,587
Shaqualla,F,100,41,0,41
Jameisha,F,100,482,0,482
Adalize,F,100,6,0,6
Maebell,F,100,10,0,10
Diviana,F,100,5,0,5
Linsley,M,100,0,5,5
Suellen,F,100,1903,0,1903
Lissbeth,F,100,11,0,11
Zeily,F,100,5,0,5
Janaisa,F,100,73,0,73
Kwanisha,F,100,41,0,41
Camon,M,100,0,33,33
Vasilije,M,100,0,5,5
Leylani,F,100,649,0,649
Anasha,F,100,115,0,115
Kenda,F,100,2234,0,2234
Aiva,F,100,477,0,477
Reaksmey,M,100,0,6,6
Keyshona,F,100,6,0,6
Deronda,F,100,317,0,317
Kynley,F,100,297,0,297
Shanaiya,F,100,90,0,90
Valton,M,100,0,74,74
Parise,F,100,5,0,5
Kylara,F,100,17,0,17
Lumin,F,100,6,0,6
Kataleiya,F,100,6,0,6
Carelyn,F,100,5,0,5
Ranger,M,100,0,453,453
Rachna,F,100,213,0,213
Nwamaka,F,100,5,0,5
Viani,F,100,13,0,13
Cherrisse,F,100,5,0,5
Bentli,F,73,92,34,126
Abdinasir,M,100,0,135,135
Erilyn,F,100,108,0,108
Carlette,F,100,940,0,940
Kiandrea,F,100,18,0,18
Tawn,F,89,252,32,284
Jiliana,F,100,33,0,33
Teghan,F,84,262,49,311
Joneer,F,100,5,0,5
Alesha,F,100,7293,6,7299
Allix,F,100,136,0,136
Chande,M,100,0,5,5
Jahriel,M,100,0,5,5
Mazhar,M,100,0,5,5
Kionia,F,100,5,0,5
Jonnisha,F,100,26,0,26
Alesander,M,100,0,22,22
Falesha,F,100,165,0,165
Natasha,F,100,94024,285,94309
Jahmier,M,100,0,209,209
Zoran,M,100,0,326,326
Bergin,F,100,5,0,5
Cayl,M,100,0,22,22
Kenyae,M,75,6,18,24
Anaaya,F,100,51,0,51
Ronold,M,100,0,450,450
Steffy,F,100,12,0,12
Syden,M,100,0,7,7
Giahna,F,100,27,0,27
Monyka,F,100,5,0,5
Mariques,M,100,0,5,5
Shaneda,F,100,16,0,16
Jocie,F,100,254,0,254
Yasameen,F,100,17,0,17
Owin,M,100,0,133,133
Lydie,F,100,85,0,85
Chayton,M,100,6,1408,1414
Hakeema,F,100,6,0,6
Yacir,M,100,0,10,10
Keiontay,M,100,0,5,5
Tawney,F,100,569,0,569
Yinessa,F,55,6,5,11
Evelette,F,100,78,0,78
Yarima,F,100,66,0,66
Ladora,F,100,321,0,321
Nussen,M,100,0,44,44
Velda,F,100,2145,0,2145
Daejaun,M,100,0,5,5
Carnie,F,100,11,0,11
Omekia,F,100,12,0,12
Spurgeon,M,100,0,307,307
Ravleen,F,100,29,0,29
Ariea,F,100,72,0,72
Hamzeh,M,100,0,111,111
Maddoxx,M,100,0,67,67
Myalee,F,100,51,0,51
Eina,F,100,7,0,7
Dometrius,M,100,0,22,22
Nashawn,M,94,53,827,880
Dayzia,F,100,48,0,48
Maritza,F,100,21835,79,21914
Fiala,F,100,10,0,10
Kamarra,F,100,59,0,59
Brinesha,F,100,29,0,29
Macaila,F,100,151,0,151
Azumi,F,100,50,0,50
Eleasah,F,100,5,0,5
Mohaned,M,100,0,16,16
Rayha,F,100,5,0,5
Nester,M,100,0,27,27
Emmalyne,F,100,209,0,209
Reyaansh,M,100,0,41,41
Aareon,M,77,10,33,43
Limor,F,100,28,0,28
Sharmae,F,100,5,0,5
Tynaisha,F,100,20,0,20
Blaydon,M,100,0,25,25
Efstathios,M,100,0,47,47
Kemari,M,72,344,900,1244
Duskin,M,100,0,5,5
Avangelene,F,100,5,0,5
Alvino,M,100,0,984,984
Anadalay,F,100,103,0,103
Yanelis,F,100,494,0,494
Abdulkareem,M,100,0,155,155
Neveen,F,100,121,0,121
Poorna,F,100,5,0,5
Dajahn,M,100,0,5,5
Christianjacob,M,100,0,22,22
Cyruss,M,100,0,88,88
Crystel,F,100,682,0,682
Sanetta,F,100,6,0,6
Gian,M,100,0,2855,2855
Reanetta,F,100,11,0,11
Lindall,M,100,0,10,10
Nivan,M,100,0,27,27
Daiyon,M,100,0,28,28
Tamichael,M,100,0,16,16
Stephy,F,100,39,0,39
Girl,F,100,365,0,365
Solmayra,F,100,34,0,34
Shaleena,F,100,217,0,217
Layal,F,100,389,0,389
Lakiyah,F,100,268,0,268
Serafima,F,100,5,0,5
Shevonne,F,100,307,0,307
Heaven,F,99,21964,256,22220
Giano,M,100,0,37,37
Jerred,M,100,0,1550,1550
Nouci,F,100,6,0,6
Naeomi,F,100,31,0,31
Mariali,F,100,25,0,25
Korday,M,100,0,13,13
Yamna,F,100,68,0,68
Maelia,F,100,11,0,11
Raylynne,F,100,52,0,52
Odyssey,F,99,438,5,443
Adeolu,M,100,0,10,10
Xandra,F,100,426,0,426
Kashara,F,100,182,0,182
Antrione,M,100,0,5,5
Benedicto,M,100,0,170,170
Ladenna,F,100,10,0,10
Auria,F,100,622,0,622
Trenea,F,100,10,0,10
Makyle,M,100,0,137,137
Zina,F,100,3996,5,4001
Joshika,F,100,5,0,5
Dhane,M,100,0,12,12
Jontay,M,91,15,146,161
Zykiera,F,100,11,0,11
Rajat,M,100,0,108,108
Amoura,F,100,115,0,115
Triva,F,100,97,0,97
Jarvell,M,100,0,29,29
Shemarr,M,100,0,11,11
Shavina,F,100,11,0,11
Arpi,F,100,56,0,56
Shuban,M,100,0,24,24
Lavra,F,100,140,0,140
Naeshaun,M,100,0,6,6
Lenina,F,100,15,0,15
Padee,F,100,22,0,22
Jasani,F,73,230,87,317
Jazabella,F,100,15,0,15
Tatiana,F,100,31843,35,31878
Fortunata,F,100,5,0,5
Yaalini,F,100,5,0,5
Ellivia,F,100,10,0,10
Stevonna,F,100,12,0,12
Mickle,M,100,0,223,223
Elveria,F,100,17,0,17
Shawny,F,100,87,0,87
Deleyza,F,100,23,0,23
Raydan,M,100,0,58,58
Amarea,F,95,118,6,124
Dathon,M,100,0,17,17
Ary,M,61,171,262,433
Aneila,F,100,24,0,24
Paetyn,F,98,683,11,694
Laerica,F,100,34,0,34
Khatia,F,100,5,0,5
Dija,F,100,7,0,7
Shatima,F,100,172,0,172
Dechelle,F,100,75,0,75
Jamelyn,F,100,84,0,84
Miichael,M,100,0,5,5
Jediel,M,100,0,27,27
Dquarius,M,100,0,10,10
Ayooluwa,F,67,10,5,15
Deaaron,M,100,0,202,202
Abdalrhman,M,100,0,5,5
Kevonda,F,100,5,0,5
Falysha,F,100,6,0,6
Michaeldavid,M,100,0,50,50
Malei,F,100,5,0,5
Cobie,M,79,91,340,431
Renardo,M,98,12,762,774
Niaomi,F,100,111,0,111
Daziel,M,100,0,10,10
Tamiia,F,100,30,0,30
Dinisha,F,100,125,0,125
Haygan,M,100,0,5,5
Sabbath,M,100,0,10,10
Yoali,F,100,115,0,115
Daia,F,100,10,0,10
Aadarsh,M,100,0,158,158
Kaleta,F,100,12,0,12
Marcayla,F,100,136,0,136
Joselin,F,100,3712,0,3712
Eydan,M,100,0,65,65
Moyosoreoluwa,F,58,7,5,12
Qiarah,F,100,5,0,5
Daphny,F,100,48,0,48
Bion,M,100,0,41,41
Ameyaa,F,100,10,0,10
Chloris,F,100,6,0,6
Lissett,F,100,607,0,607
Shelbert,M,100,0,5,5
Damorris,M,100,0,11,11
Andjela,F,100,40,0,40
Demetry,M,100,0,95,95
Vidhya,F,100,29,0,29
Cortrell,M,100,0,46,46
Cimberly,F,100,60,0,60
Jalob,M,100,0,6,6
Torina,F,100,212,0,212
Zabriel,M,100,0,35,35
Levis,M,100,0,79,79
Trason,M,100,0,146,146
Derriana,F,100,121,0,121
Mirei,F,100,5,0,5
Fredricka,F,100,920,0,920
Nekayla,F,100,77,0,77
Rinaldo,M,100,0,316,316
Brana,F,100,31,0,31
Harshveer,M,100,0,5,5
Izayah,M,100,0,2828,2828
Ezgi,F,100,17,0,17
Kymberlee,F,100,837,0,837
Ascher,M,100,0,222,222
Shadricka,F,100,16,0,16
Bijou,F,100,202,0,202
Karmia,F,100,7,0,7
Candic,F,100,11,0,11
Giuliani,M,100,0,21,21
Barara,F,100,6,0,6
Winsley,M,100,0,6,6
Heydi,F,100,500,0,500
Summerlin,F,100,33,0,33
Deshone,M,84,51,273,324
Baelie,F,100,11,0,11
Mirai,F,100,123,0,123
Yassir,M,100,0,188,188
Tuesday,F,100,2384,0,2384
Marquice,M,100,0,765,765
Kerion,M,100,0,60,60
Andrick,M,100,0,407,407
Gloryvee,F,100,6,0,6
Yadriel,M,100,0,132,132
Kelisia,F,100,10,0,10
Nisaiah,M,100,0,69,69
Saadiyah,F,100,5,0,5
Isahiah,M,100,0,5,5
Kina,F,100,1273,0,1273
Tija,F,96,114,5,119
Josefina,F,100,8026,13,8039
Jayiah,F,100,6,0,6
Elsye,F,100,7,0,7
Jawhar,M,100,0,6,6
Macayle,F,92,56,5,61
Delanei,F,100,5,0,5
Helan,F,100,5,0,5
Glendale,M,81,69,296,365
Oluwadamilare,M,100,0,63,63
Quashayla,F,100,6,0,6
Mythili,F,100,39,0,39
Zaelynn,F,100,143,0,143
Mazee,F,100,22,0,22
Viera,F,100,73,0,73
Estafani,F,100,45,0,45
Reston,M,100,0,23,23
Mita,F,100,56,0,56
Safeerah,F,100,11,0,11
Starlynn,F,100,346,0,346
Denson,M,100,0,161,161
Malyk,M,100,0,281,281
Alsatia,F,100,17,0,17
Marayna,F,100,7,0,7
Rasika,F,100,13,0,13
Geraldyn,F,100,20,0,20
Charisa,F,100,395,0,395
Cyrene,F,100,121,0,121
Lunabelle,F,100,32,0,32
Jaspyr,M,100,0,5,5
Aminatou,F,100,22,0,22
Altrina,F,100,5,0,5
Martyn,M,100,0,452,452
Larena,F,100,579,0,579
Eligha,M,100,0,121,121
Callin,M,94,7,103,110
Nickki,F,100,38,0,38
Narong,M,100,0,6,6
Shaneah,F,100,16,0,16
Alzena,F,100,6,0,6
Latreka,F,100,5,0,5
Yarexy,F,100,38,0,38
Balery,F,100,10,0,10
Gwydion,M,100,0,5,5
Favian,M,100,0,2452,2452
Blen,F,100,127,0,127
Haliyah,F,100,107,0,107
Corla,F,100,56,0,56
Johnphillip,M,100,0,11,11
Danita,F,100,7329,0,7329
Crystaline,F,100,39,0,39
Jabbaar,M,100,0,5,5
Geanette,F,100,90,0,90
Lasaunda,F,100,5,0,5
Jaqueta,F,100,26,0,26
Damarrius,M,100,0,45,45
Jaquae,M,85,6,34,40
Dynesha,F,100,257,0,257
Vitalina,F,100,27,0,27
Saydie,F,100,463,0,463
Cotton,M,100,0,324,324
Sanaah,F,100,30,0,30
Marleigha,F,100,5,0,5
Lateisha,F,100,1019,0,1019
Tiphanee,F,100,5,0,5
Yaritzel,F,100,203,0,203
Ozaria,F,100,10,0,10
Vinecia,F,100,6,0,6
Vernell,F,52,2176,2033,4209
Camra,F,100,11,0,11
Shanell,F,100,4475,12,4487
Aarabella,F,100,10,0,10
Tyjhon,M,100,0,5,5
Kilah,F,100,354,0,354
Lucienne,F,100,677,0,677
Starshemah,F,100,5,0,5
Payne,M,99,11,1077,1088
Denielle,F,100,980,0,980
Jaziel,M,98,35,1397,1432
Juliamae,F,100,5,0,5
Fryda,F,100,117,0,117
Latari,F,100,5,0,5
Daeshon,M,100,0,178,178
Thaddeaus,M,100,0,128,128
Latres,F,100,22,0,22
Zahar,M,100,0,14,14
Ivory,F,57,6196,4744,10940
Dondee,F,100,20,0,20
Geordie,M,100,0,71,71
Bairon,M,100,0,226,226
Toretto,M,100,0,14,14
Dontrail,M,100,0,136,136
Nakeyia,F,100,76,0,76
Nishtha,F,100,95,0,95
Izaia,M,100,0,89,89
Xeniyah,F,100,5,0,5
Breasya,F,100,6,0,6
Annaston,F,100,123,0,123
Jamesetta,F,100,429,0,429
Rukhsar,F,100,12,0,12
Omer,M,100,5,2452,2457
Anika,F,100,12523,0,12523
Yadieliz,F,100,8,0,8
Amandarose,F,100,15,0,15
Alley,F,100,903,0,903
Xina,F,100,23,0,23
Rheya,F,100,181,0,181
Irandy,F,100,5,0,5
Chyann,F,100,865,0,865
Cordelle,M,100,0,89,89
Tood,M,100,0,54,54
Maveric,M,100,0,171,171
Tjuana,F,100,127,0,127
Jeron,M,100,0,2151,2151
Ashka,F,100,32,0,32
Arata,M,100,0,26,26
Rokhaya,F,100,97,0,97
Lindy,F,91,7446,771,8217
Alexaundrea,F,100,6,0,6
Muslimah,F,100,25,0,25
Jazlin,F,100,913,0,913
Japhet,M,100,0,181,181
Antonin,M,100,0,59,59
Arisai,F,100,12,0,12
Tywain,M,100,0,54,54
Brileigh,F,100,612,0,612
Khmya,F,100,5,0,5
Bretney,F,100,44,0,44
Navia,F,100,344,0,344
Shaqueena,F,100,197,0,197
Anthonio,M,100,0,421,421
Kalijah,M,70,67,154,221
Maigon,F,100,5,0,5
Thristian,M,100,0,17,17
Eimaan,F,100,14,0,14
Paolo,M,100,0,3003,3003
Wilda,F,100,1718,0,1718
Hanad,M,100,0,238,238
Nefeli,F,100,34,0,34
Azaraya,F,100,5,0,5
Dejoun,M,100,0,21,21
Ecequiel,M,100,0,5,5
Corden,M,100,0,19,19
Ikeia,F,100,51,0,51
Ashantee,F,100,128,0,128
Aliliana,F,100,5,0,5
Naetochukwu,M,100,0,6,6
Saavon,M,100,0,5,5
Aikeem,M,100,0,95,95
Jamarah,F,100,42,0,42
Khalique,M,100,0,37,37
Milayna,F,100,142,0,142
Shelea,F,100,32,0,32
Brycyn,M,100,0,5,5
Keyairra,F,100,138,0,138
Tyrhianna,F,100,43,0,43
Amairah,F,100,18,0,18
Yomo,M,100,0,5,5
Vicktoria,F,100,359,0,359
Sedona,F,100,1340,0,1340
Satcha,F,100,49,0,49
Coryell,M,100,0,13,13
Glenny,F,69,25,11,36
Nojus,M,100,0,10,10
Carmyne,M,100,0,36,36
Amneet,F,100,6,0,6
Tiarrah,F,100,68,0,68
Roxxanne,F,100,47,0,47
Laykyn,F,100,6,0,6
Bethie,F,100,5,0,5
Khianna,F,100,137,0,137
Bleona,F,100,18,0,18
Kas,M,100,0,5,5
Hui,F,100,30,0,30
Margurette,F,100,12,0,12
Koty,M,94,30,449,479
Christifer,M,100,0,179,179
Terrineka,F,100,5,0,5
Nanaadwoa,F,100,5,0,5
Mehran,M,100,0,137,137
Joson,M,100,0,74,74
Adylin,F,100,64,0,64
Maysn,M,100,0,16,16
Timara,F,100,608,0,608
Annalaya,F,100,30,0,30
Latoyya,F,100,43,0,43
Ulisses,M,100,0,1128,1128
Rilea,F,100,80,0,80
Talique,M,100,0,17,17
Prathik,M,100,0,75,75
Gailene,F,100,52,0,52
Arrayah,F,100,110,0,110
Judythe,F,100,10,0,10
Pricilla,F,100,3764,0,3764
Shriley,F,100,74,0,74
Posie,F,100,24,0,24
Ayshah,F,100,29,0,29
Tiria,F,100,5,0,5
Markele,M,100,0,7,7
Herby,M,100,0,324,324
Contesa,F,100,7,0,7
Sadey,F,100,289,0,289
Teeana,F,100,5,0,5
Farhiya,F,100,58,0,58
Azure,F,88,1405,185,1590
Molli,F,100,1804,0,1804
Freyah,F,100,6,0,6
Semya,F,100,143,0,143
Toneisha,F,100,176,0,176
Leor,M,90,24,224,248
Pria,F,100,285,0,285
Jazsmin,F,100,108,0,108
Ula,F,100,289,0,289
Icesis,F,100,134,0,134
Cruise,M,100,0,273,273
Dinneen,F,100,5,0,5
Chantily,F,100,5,0,5
Mah,F,100,5,0,5
Anber,F,100,56,0,56
Arnol,M,100,0,86,86
Savanh,F,100,6,0,6
Kabeer,M,100,0,69,69
Graydon,M,100,0,1894,1894
Robertjohn,M,100,0,45,45
Shaylene,F,100,922,0,922
Anaberta,F,100,5,0,5
Keysan,M,100,0,5,5
Antisha,F,100,46,0,46
Emalise,F,100,12,0,12
Toniette,F,100,67,0,67
Yorley,F,100,123,0,123
Vanora,F,100,11,0,11
Astra,F,100,326,0,326
Lorien,F,100,827,0,827
Camera,F,100,106,0,106
Harve,M,100,0,47,47
Krisandra,F,100,267,0,267
Dilma,F,100,10,0,10
Marc,M,100,513,130852,131365
Robertina,F,100,10,0,10
Roxsanne,F,100,16,0,16
Annilee,F,100,14,0,14
Andris,M,100,0,210,210
Reznor,M,100,0,82,82
Ahjanae,F,100,136,0,136
Derlene,F,100,6,0,6
Jayvonni,M,100,0,24,24
Rudhra,M,100,0,6,6
Emeli,F,100,1111,0,1111
Luvinia,F,100,22,0,22
Seyha,M,100,0,5,5
Kavanaugh,M,100,0,5,5
Deagon,M,100,0,43,43
Jamaury,M,100,0,208,208
Caymon,M,100,0,46,46
Sherrard,M,100,0,47,47
Cicely,F,100,2199,0,2199
Javeyon,M,100,0,52,52
Jakyrie,M,100,0,21,21
Tiberius,M,100,0,457,457
Jubal,M,100,0,659,659
Myeshia,F,100,910,0,910
Harald,M,100,0,275,275
Kadijatu,F,100,41,0,41
Glade,M,100,0,337,337
Maclovio,M,100,0,64,64
Walaa,F,100,66,0,66
Rollene,F,100,5,0,5
Yazmyne,F,100,157,0,157
Ajala,F,100,22,0,22
Ferd,M,100,0,48,48
Shadarius,M,100,0,25,25
Babyboy,M,100,0,1942,1942
Youstina,F,100,17,0,17
Corliss,F,96,1864,68,1932
Karlise,F,100,5,0,5
Gladiola,F,100,10,0,10
Breea,F,100,347,0,347
Anhelica,F,100,71,0,71
Osmond,M,100,0,180,180
Argie,F,91,162,16,178
Kaziya,F,100,45,0,45
Junayd,M,100,0,15,15
Deniss,F,94,77,5,82
Geanie,F,100,101,0,101
Annmaria,F,100,5,0,5
Moneak,F,100,13,0,13
Aylia,F,100,28,0,28
Wyndie,F,100,5,0,5
Joyl,F,100,19,0,19
Carland,M,100,0,10,10
Kentrice,F,100,22,0,22
Tempa,F,100,12,0,12
Drakar,M,100,0,6,6
Arayia,F,100,40,0,40
Danieliz,F,100,30,0,30
Ld,M,100,0,5,5
Diquon,M,100,0,5,5
Tyjae,F,52,172,157,329
Schelley,F,100,15,0,15
Rigdon,M,100,0,119,119
Arika,F,100,2179,0,2179
Eriny,F,100,11,0,11
Frimet,F,100,390,0,390
Rhochelle,F,100,5,0,5
Doniven,M,100,0,111,111
Ramzes,M,100,0,5,5
Desman,M,100,0,174,174
Betzy,F,100,874,0,874
Tomicia,F,100,10,0,10
Nalah,F,100,376,0,376
Carmya,F,100,20,0,20
Damaya,F,100,382,0,382
Ravenna,F,100,177,0,177
Tyhessia,F,100,17,0,17
Keymond,M,100,0,13,13
Royd,M,100,0,50,50
Liv,F,100,2520,0,2520
Ateeb,M,100,0,7,7
Berny,M,100,0,45,45
Gyanna,F,100,141,0,141
Laketta,F,100,188,0,188
Saajan,M,100,0,57,57
Bijan,M,97,29,952,981
Ettel,F,100,84,0,84
Lelind,M,100,0,5,5
Luray,F,100,6,0,6
Ziena,F,100,5,0,5
Yarelli,F,100,210,0,210
Cionni,F,100,6,0,6
Emy,F,100,882,0,882
Jazale,F,100,36,0,36
Domunique,M,100,0,5,5
Dor,M,69,5,11,16
Washington,M,100,0,736,736
Sy,M,100,0,804,804
Xiomary,F,100,15,0,15
Seria,F,100,23,0,23
Shimya,F,100,19,0,19
Serenah,F,100,135,0,135
Jaylean,F,100,236,0,236
Mikel,M,91,913,9644,10557
Guerrero,M,100,0,12,12
Calijah,M,100,0,41,41
Dezya,F,100,10,0,10
Sheraldine,F,100,5,0,5
Aleynah,F,100,53,0,53
Nashalie,F,100,76,0,76
Desteny,F,100,1512,0,1512
Hamze,M,100,0,26,26
Macalah,F,100,40,0,40
Alano,M,100,0,92,92
Malazia,F,100,18,0,18
Kamaar,M,100,0,5,5
Johnay,F,100,152,0,152
Ivry,F,90,44,5,49
Ykeisha,F,100,10,0,10
Jefferie,M,100,0,108,108
Kyli,F,100,1921,0,1921
Lacandis,F,100,6,0,6
Tyrekus,M,100,0,5,5
Zyon,M,80,500,1946,2446
Devontavius,M,100,0,5,5
Holston,M,100,0,47,47
Dvir,M,100,0,16,16
Kani,M,75,159,470,629
Quintavius,M,100,0,389,389
Jamiley,F,100,10,0,10
Kindrea,F,100,5,0,5
Khalisi,F,100,7,0,7
Dotti,F,100,152,0,152
Srija,F,100,129,0,129
Kamaia,F,100,32,0,32
Dezmon,M,100,0,743,743
Avianna,F,100,2501,0,2501
Amose,M,100,0,6,6
Shamariona,F,100,12,0,12
Caylen,F,67,525,258,783
Marymae,F,100,6,0,6
Jakyrah,F,100,103,0,103
Addysyn,F,100,96,0,96
Jotavious,M,100,0,6,6
Sibora,F,100,6,0,6
Zamyla,F,100,7,0,7
Teadra,F,100,24,0,24
Janne,F,100,356,0,356
Nixin,M,100,0,12,12
Tyreem,M,100,0,19,19
Paytten,F,100,5,0,5
Jeniel,M,100,0,58,58
Kayliee,F,100,43,0,43
Ramo,M,100,0,11,11
Kiona,F,100,1546,0,1546
Alexzandyr,M,100,0,5,5
Shalawn,F,100,125,0,125
Dartrell,M,100,0,10,10
Shantiana,F,100,16,0,16
Yarelis,F,100,543,0,543
Kyshia,F,100,35,0,35
Avishi,F,100,31,0,31
Namish,M,100,0,55,55
Yamia,F,100,19,0,19
Demarko,M,100,0,635,635
Layce,F,100,189,0,189
Camill,F,100,26,0,26
Kaian,M,100,0,53,53
Lakiska,F,100,38,0,38
Yachi,F,100,23,0,23
Wilkens,M,100,0,30,30
Jarib,M,100,0,15,15
Pryor,M,100,0,115,115
Dontea,M,100,0,98,98
Yusuke,M,100,0,260,260
Dalayna,F,100,278,0,278
Dabria,F,100,191,0,191
Nipun,M,100,0,16,16
Zilah,F,100,58,0,58
Jarit,M,100,0,5,5
Nalisha,F,100,25,0,25
Jonaya,F,100,74,0,74
Eino,M,100,0,6,6
Zabdiel,M,100,0,361,361
Xaviel,M,100,0,47,47
Sacred,F,100,49,0,49
Jaleigha,F,100,292,0,292
Gaylin,F,52,80,73,153
Chiann,F,100,120,0,120
Alber,M,100,0,20,20
Solmon,M,100,0,5,5
Trystin,M,72,276,723,999
Jere,M,75,672,2003,2675
Pride,M,100,0,76,76
Vash,M,100,0,166,166
Katrinna,F,100,88,0,88
Khalyn,F,100,43,0,43
Tar,F,100,5,0,5
Prodigy,M,100,0,12,12
Elianah,F,100,318,0,318
Benardo,M,100,0,5,5
Lawrence,M,100,1020,212488,213508
Navada,F,91,59,6,65
Esterlene,F,100,6,0,6
Zahrea,F,100,10,0,10
Dynesti,F,100,5,0,5
Jabriyah,F,100,13,0,13
Maleko,M,100,0,29,29
Yoshani,F,100,6,0,6
Quinnlyn,F,100,156,0,156
Aretina,F,100,34,0,34
Selenna,F,100,36,0,36
Seaira,F,100,438,0,438
Alek,M,98,68,3423,3491
Bliss,F,98,1086,27,1113
Donate,M,100,0,15,15
Torrye,F,100,18,0,18
Emileo,M,100,0,70,70
Renado,M,100,0,5,5
Khalial,M,100,0,5,5
Shaqueeta,F,100,5,0,5
Aailiyah,F,100,10,0,10
Kaylub,M,100,0,174,174
Kestin,M,100,0,44,44
Riah,F,100,283,0,283
Ousman,M,100,0,230,230
Myliana,F,100,13,0,13
Laylonnie,F,100,30,0,30
Eymy,F,100,6,0,6
Dawnell,F,100,369,0,369
Ashaunie,F,100,5,0,5
Kimie,F,100,154,0,154
Deshauna,F,100,293,0,293
Obdulio,M,100,0,68,68
Amaura,F,100,81,0,81
Loyce,F,83,677,143,820
Tessia,F,100,371,0,371
Adamary,F,100,588,0,588
Sumiko,F,100,112,0,112
Kobin,M,100,0,47,47
Jamius,M,100,0,19,19
Omolara,F,100,101,0,101
Mashanda,F,100,89,0,89
Mekea,F,100,5,0,5
Demicah,M,100,0,5,5
Rozalyn,F,100,582,0,582
Esabella,F,100,458,0,458
Carliss,F,80,243,61,304
Jaben,M,100,0,69,69
Keyannah,F,100,39,0,39
Tracey,F,91,86059,8380,94439
Alexandrer,M,100,0,7,7
Bohdi,M,100,0,110,110
Jeremy,M,99,2261,426808,429069
Kiyomi,F,100,654,0,654
Raneen,F,100,153,0,153
Seylah,F,100,42,0,42
Dorelia,F,100,6,0,6
Caree,F,100,134,0,134
Bwana,M,100,0,5,5
Jeeya,F,100,40,0,40
Rodarius,M,100,0,145,145
Rigby,M,83,30,144,174
Yulizza,F,100,8,0,8
Claiborne,M,97,17,543,560
Ernad,M,100,0,12,12
Dniyah,F,100,127,0,127
Jarin,M,97,33,957,990
Mikaylen,F,100,5,0,5
Tran,F,82,549,123,672
Monye,F,100,26,0,26
Karessa,F,100,452,0,452
Bradd,M,100,0,626,626
Alohi,F,100,11,0,11
Eleny,F,100,207,0,207
Remedios,F,100,28,0,28
Kaniel,M,100,0,117,117
Ayaina,F,100,5,0,5
Lashond,F,100,10,0,10
Eular,F,100,5,0,5
Sybrina,F,100,98,0,98
Carlin,M,55,1567,1914,3481
Macolm,M,100,0,18,18
Edword,M,100,0,29,29
Jack,M,100,790,307294,308084
Jalisia,F,100,145,0,145
Daegen,M,100,0,61,61
Whitman,M,100,0,431,431
Lizmarie,F,100,430,0,430
Khristian,M,81,458,1989,2447
Rheyanna,F,100,5,0,5
Dshun,M,100,0,5,5
Arreon,F,60,24,16,40
Marcello,M,100,10,4451,4461
Dianely,F,100,92,0,92
Neven,M,98,6,310,316
Audrionna,F,100,87,0,87
Astrin,F,100,8,0,8
Kandance,F,100,91,0,91
Christineanne,F,100,5,0,5
Wei,M,78,78,275,353
Lamarqus,M,100,0,5,5
Coriana,F,100,232,0,232
Jyquavious,M,100,0,5,5
Jhaziel,M,100,0,12,12
Izeyah,M,100,0,189,189
Sarda,F,100,7,0,7
Teonia,F,100,104,0,104
Voncile,F,100,301,0,301
Janeise,F,100,5,0,5
Aalim,M,100,0,27,27
Mirel,F,100,463,0,463
Kabria,F,100,251,0,251
Harun,M,100,0,475,475
Mykeal,M,90,13,118,131
Janalle,F,100,5,0,5
Racquel,F,100,4665,5,4670
Demariya,F,100,11,0,11
Rivan,M,100,0,58,58
Tanglia,F,100,5,0,5
Mylah,F,100,1620,0,1620
Domino,F,94,75,5,80
Sharine,F,100,110,0,110
Trevi,F,100,22,0,22
Renata,F,100,7523,6,7529
Lisbet,F,100,954,0,954
Lissie,F,100,50,0,50
Yaricsa,F,100,13,0,13
Calyssa,F,100,266,0,266
Deanesha,F,100,5,0,5
Takeena,F,100,27,0,27
Sera,F,100,1402,0,1402
Rakhee,F,100,22,0,22
Kiano,M,100,0,75,75
Zsophia,F,100,5,0,5
Bobbielee,F,100,6,0,6
Shanequea,F,100,5,0,5
Kevinkhang,M,100,0,6,6
Molissa,F,100,5,0,5
Trecie,F,100,10,0,10
Zulimar,F,100,11,0,11
Jewl,F,100,10,0,10
Lauralie,F,100,85,0,85
Sausha,F,100,150,0,150
Ziannah,F,100,6,0,6
Aalyvia,F,100,5,0,5
Nema,F,82,81,18,99
Jaedah,F,100,128,0,128
Marandia,F,100,5,0,5
Jadison,M,100,0,6,6
Alyeska,F,100,26,0,26
Onyedikachi,M,100,0,6,6
Merrilu,F,100,5,0,5
Purvi,F,100,252,0,252
Kahanuola,M,100,0,5,5
Vidula,F,100,6,0,6
Sandye,F,100,5,0,5
Linita,F,100,34,0,34
Alycea,F,100,241,0,241
Nygia,F,100,6,0,6
Ceslie,F,100,48,0,48
Clide,M,100,0,69,69
Anhuar,M,100,0,12,12
Kahlynn,F,100,26,0,26
Maude,F,100,1440,0,1440
Tareena,F,100,6,0,6
Linna,F,100,438,0,438
Seneque,F,100,5,0,5
Kharmen,F,100,18,0,18
Caela,F,100,425,0,425
Zakkiyah,F,100,16,0,16
Raenae,F,100,5,0,5
Alexamarie,F,100,34,0,34
Keviyon,M,100,0,11,11
Mayley,F,100,92,0,92
Demontae,M,100,0,594,594
Anupam,M,100,0,16,16
Tyla,F,100,2660,7,2667
Carmille,F,100,6,0,6
Ramisha,F,100,36,0,36
Emil,M,100,5,7336,7341
Nacona,F,100,34,0,34
Carletta,F,100,2417,0,2417
Shaundreka,F,100,5,0,5
Ladarris,M,100,0,34,34
Tonnica,F,100,9,0,9
Tyrion,M,98,7,307,314
Raneshia,F,100,96,0,96
Hiroto,M,100,0,129,129
Yosselin,F,100,424,0,424
Adree,F,100,21,0,21
Stanson,M,100,0,5,5
Shinelle,F,100,12,0,12
Latacia,F,100,38,0,38
Randolfo,M,100,0,5,5
Estellar,F,100,5,0,5
Jeren,M,100,0,383,383
Omeshia,F,100,12,0,12
Nesean,M,100,0,12,12
Unk,M,69,17,37,54
Lilea,F,100,17,0,17
Quinnlynn,F,100,6,0,6
Jermecia,F,100,52,0,52
Shaelie,F,100,47,0,47
Peighten,F,100,11,0,11
Zeel,F,100,5,0,5
Marcelius,M,100,0,25,25
Nyonna,F,100,98,0,98
Ramir,M,100,0,480,480
Wade,M,100,129,51617,51746
Harmani,F,100,120,0,120
Lavin,M,100,0,61,61
Ulyana,F,100,59,0,59
Matlin,F,100,7,0,7
Alyxia,F,100,25,0,25
Jakailyn,F,100,18,0,18
Sahiry,F,100,8,0,8
Evonie,F,100,10,0,10
Jeidy,F,100,266,0,266
Aaronjames,M,100,0,95,95
Hardin,M,100,0,189,189
Jacee,F,98,1383,28,1411
Tressia,F,100,300,0,300
Laqueisha,F,100,128,0,128
Sophi,F,100,412,0,412
Zuriyah,F,100,37,0,37
Antwanette,F,100,601,0,601
Aeriella,F,100,13,0,13
Tyan,M,75,68,203,271
Ravindra,M,100,0,113,113
Erical,F,100,13,0,13
Infant,M,52,3764,4072,7836
Jayanah,F,100,43,0,43
Nariah,F,100,2137,0,2137
Roylee,M,100,0,63,63
Ramonia,F,100,270,0,270
Teenia,F,100,5,0,5
Abdiel,M,100,0,3193,3193
Dennell,F,74,28,10,38
Kahmyah,F,100,5,0,5
Demetruis,M,99,5,799,804
Zarea,F,100,84,0,84
Elsey,F,100,53,0,53
Amram,M,100,0,43,43
Tron,M,99,7,514,521
Sherrilee,F,100,44,0,44
Trint,M,100,0,16,16
Diamondnique,F,100,34,0,34
Chevala,F,100,6,0,6
Vyvyan,F,100,5,0,5
Sequita,F,100,200,0,200
Aalana,F,100,43,0,43
Dareus,M,100,0,52,52
Senai,F,57,97,74,171
Kristianne,F,100,323,0,323
Christinea,F,100,92,0,92
Kaile,F,97,681,22,703
Aneri,F,100,141,0,141
Dianalys,F,100,5,0,5
Avriana,F,100,145,0,145
Yanexi,F,100,16,0,16
Shatika,F,100,273,0,273
Rhylinn,F,100,11,0,11
Jiair,M,100,0,23,23
Kohner,M,100,0,104,104
Jerica,F,100,3805,0,3805
Hazy,F,100,5,0,5
Doneva,F,100,30,0,30
Theoplis,M,100,0,76,76
Jensy,M,58,39,54,93
Dell,M,71,784,1928,2712
Koh,M,100,0,29,29
Tierney,F,99,3531,23,3554
Jodeane,F,100,14,0,14
Jasye,M,100,0,5,5
Shilat,F,100,6,0,6
Naiah,F,100,74,0,74
Charolett,F,100,178,0,178
Doree,F,100,430,0,430
Tryone,M,100,0,253,253
Mcchael,M,100,0,5,5
Steffenie,F,100,11,0,11
Letina,F,100,89,0,89
Iovanna,F,100,5,0,5
Isley,F,76,457,145,602
Alexandera,F,100,351,0,351
Akon,M,86,10,61,71
Raeford,M,100,0,184,184
Nysa,F,100,184,0,184
Amija,F,100,29,0,29
Caytlin,F,100,277,0,277
Kainin,M,100,0,32,32
Molik,M,100,0,5,5
Cabria,F,100,108,0,108
Alpa,F,100,76,0,76
Mariss,F,100,10,0,10
Jonatthan,M,100,0,10,10
Martrell,M,100,0,465,465
Amdrea,F,100,16,0,16
Zebulin,M,100,0,77,77
Aerabella,F,100,170,0,170
Cashus,M,100,0,142,142
Julicia,F,100,111,0,111
Kemel,M,100,0,10,10
Dusitn,M,100,0,16,16
Armonee,F,92,68,6,74
Anchal,F,100,34,0,34
Jayvis,M,100,0,14,14
Calamity,F,100,19,0,19
Marche,F,98,411,7,418
Sir,M,100,0,1228,1228
Hannabella,F,100,5,0,5
Hannalise,F,100,5,0,5
Kayleeonna,F,100,5,0,5
Shaunece,F,100,11,0,11
Andreita,F,100,5,0,5
Calleigh,F,100,1734,0,1734
Jazzalyn,F,100,197,0,197
Antonique,F,100,359,0,359
Kialani,F,100,5,0,5
Helem,F,100,62,0,62
Daan,M,100,0,15,15
Zaviyon,M,100,0,10,10
Cipriana,F,100,172,0,172
Achillies,M,100,0,60,60
Khiyah,F,100,40,0,40
Broly,M,100,0,41,41
Jaylyn,F,76,4689,1498,6187
Dawlton,M,100,0,19,19
Zikia,F,100,39,0,39
Anthoine,M,100,0,5,5
Malikiah,M,100,0,59,59
Biance,F,100,86,0,86
Havannah,F,100,274,0,274
Darris,M,99,19,1674,1693
Rashmi,F,100,302,0,302
Zandalee,F,100,33,0,33
Winfrey,M,100,0,14,14
Xjavier,M,100,0,5,5
Randoll,M,100,0,30,30
Mahveen,F,100,17,0,17
Sheradyn,F,100,18,0,18
Tahni,F,100,45,0,45
Curtrina,F,100,22,0,22
Rittany,F,100,44,0,44
Maiki,M,100,0,5,5
Clemetine,F,100,36,0,36
Aydin,M,96,184,3940,4124
Benjermen,M,100,0,5,5
Marney,F,100,421,0,421
Lailyn,F,100,101,0,101
Leanza,F,100,91,0,91
Garey,M,100,0,973,973
Mccray,M,100,0,25,25
Emelinda,F,100,38,0,38
Davarious,M,100,0,101,101
Haelynn,F,100,9,0,9
Demarie,F,67,104,52,156
Ayrianna,F,100,306,0,306
Shevi,F,100,5,0,5
Shanyel,F,100,5,0,5
Lamaj,M,100,0,63,63
Fajar,F,100,10,0,10
Jabare,M,100,0,15,15
Laiton,M,100,0,13,13
Estrella,F,100,12417,0,12417
Ivette,F,100,10263,10,10273
Oshae,M,100,0,146,146
Shyma,F,100,5,0,5
Teauna,F,100,128,0,128
Mahreen,F,100,93,0,93
Trica,F,100,200,0,200
Lauralye,F,100,48,0,48
Aaryn,F,61,926,592,1518
Jahziel,M,95,15,262,277
Keyli,F,100,804,0,804
Rielley,F,100,5,0,5
Nykira,F,100,207,0,207
Rhyan,F,61,1861,1212,3073
Rayleigh,F,100,1163,0,1163
Adale,F,100,5,0,5
Devaughn,M,100,0,2252,2252
Yovanny,M,100,0,338,338
Wraith,M,100,0,23,23
Tambria,F,100,236,0,236
Maomi,F,100,5,0,5
Signora,F,100,15,0,15
Annahbella,F,100,5,0,5
Yonis,M,100,0,249,249
Dejahnique,F,100,5,0,5
Gizem,F,100,19,0,19
Martarius,M,100,0,12,12
Taevion,M,100,0,367,367
Devika,F,100,488,0,488
Sunil,M,100,0,970,970
Nathasha,F,100,319,0,319
Syrena,F,100,537,0,537
Jaionna,F,100,226,0,226
Elga,F,100,35,0,35
Derico,M,100,0,332,332
Soreya,F,100,5,0,5
Timari,F,65,50,27,77
Meshack,M,100,0,15,15
Cidney,F,98,849,17,866
Hadeed,M,100,0,8,8
Diamani,F,100,21,0,21
Antonese,F,100,5,0,5
Traevin,M,100,0,12,12
Analucia,F,100,382,0,382
Charistopher,M,100,0,97,97
Robynne,F,100,353,0,353
Kalista,F,100,1962,0,1962
Annisha,F,100,169,0,169
Swayzee,F,100,78,0,78
Jahleah,F,100,67,0,67
Jevion,M,100,0,40,40
Jazzell,F,100,58,0,58
Erasto,M,100,0,140,140
Harutyun,M,100,0,70,70
Devang,M,100,0,36,36
Cyanne,F,100,252,0,252
Saffiyah,F,100,33,0,33
Tareek,M,100,0,85,85
Gaven,M,100,0,3568,3568
Janssen,M,100,0,174,174
Kadie,F,100,2450,0,2450
Daidrian,M,100,0,6,6
Delesha,F,100,83,0,83
Kemarcus,M,100,0,7,7
Ariamarie,F,100,5,0,5
Nalan,M,100,0,11,11
Rickyah,F,100,16,0,16
Laury,F,97,823,28,851
Aladdin,M,100,0,127,127
Axtin,M,100,0,24,24
Erlan,M,100,0,5,5
Ahnyah,F,100,56,0,56
Nikala,F,100,113,0,113
Jayvn,M,100,0,20,20
Scarlotte,F,100,10,0,10
Kymoni,M,68,50,108,158
Mase,M,100,0,40,40
Tomecca,F,100,12,0,12
Dejarae,F,100,16,0,16
Amishi,F,100,45,0,45
Kyelar,M,100,0,5,5
Darie,F,100,23,0,23
Jamea,F,100,448,0,448
Danaejah,F,100,32,0,32
Jennelyn,F,100,15,0,15
Levyn,M,100,0,11,11
Garner,M,99,13,1053,1066
Ibrohim,M,100,0,15,15
Sahithi,F,100,200,0,200
Neaveh,F,100,138,0,138
Jessice,F,100,151,0,151
Sacha,F,82,1862,402,2264
Jonica,F,100,622,0,622
Tamana,F,100,86,0,86
Detrick,M,98,25,1447,1472
Latavious,M,100,0,178,178
Frankel,M,100,0,6,6
Antroy,M,100,0,5,5
Myer,M,98,5,201,206
Zeth,M,100,0,1058,1058
Katora,F,100,118,0,118
Jini,F,100,47,0,47
Anshel,M,100,0,10,10
Kliyah,F,100,37,0,37
Kiylan,M,100,0,5,5
Cyonna,F,100,23,0,23
Talyiah,F,100,55,0,55
Chelssie,F,100,6,0,6
Deviontae,M,100,0,5,5
Ofek,M,100,0,17,17
Aarion,M,76,133,431,564
Jenaya,F,100,864,0,864
Mellie,F,100,148,0,148
Madiline,F,100,47,0,47
Sheetal,F,100,251,0,251
Kyre,M,93,35,451,486
Airian,F,100,5,0,5
Lukeus,M,100,0,12,12
Ammy,F,100,998,0,998
Kacy,F,84,4778,918,5696
Dietrich,M,91,149,1559,1708
Dario,M,100,0,7640,7640
Cessna,F,100,6,0,6
Deantwon,M,100,0,5,5
Dezi,M,62,126,202,328
Bessy,F,100,225,0,225
Leshanda,F,100,38,0,38
Penley,F,100,13,0,13
Dannett,F,100,38,0,38
Lenalee,F,100,6,0,6
Jhonas,M,100,0,11,11
Ruzgar,M,100,0,21,21
Ireana,F,100,53,0,53
Demitri,M,99,23,1707,1730
Tarkeshia,F,100,5,0,5
Ellsie,F,100,120,0,120
Treivon,M,100,0,12,12
Jaken,M,100,0,90,90
Tykenya,F,100,6,0,6
Topaz,F,98,282,6,288
Khael,M,100,0,40,40
Dariean,F,100,5,0,5
Jeiry,F,100,61,0,61
Tanera,F,100,23,0,23
Juel,M,68,200,418,618
Giovanny,M,99,30,5571,5601
Neesha,F,100,276,0,276
Harkaran,M,100,0,17,17
Raechelle,F,100,589,0,589
Nkiyah,F,100,5,0,5
Machenzie,F,86,32,5,37
Rowana,F,100,10,0,10
Chyan,F,100,128,0,128
Milas,M,100,0,103,103
Jibril,M,100,0,868,868
Laberta,F,100,15,0,15
Sabit,M,100,0,5,5
Alailah,F,100,51,0,51
Luanda,F,100,25,0,25
Toniyah,F,100,87,0,87
Lyndan,F,71,12,5,17
Phoebee,F,100,19,0,19
Saloni,F,100,388,0,388
Antrez,M,100,0,5,5
Locklin,M,100,0,6,6
Kinson,M,100,0,10,10
Tirell,M,100,0,55,55
Kaithlin,F,100,5,0,5
Noga,F,100,138,0,138
Mirian,F,100,2777,0,2777
Ryzen,M,100,0,60,60
Kirianna,F,100,19,0,19
Kenra,F,100,30,0,30
Leeor,M,52,15,16,31
Desirae,F,100,12289,0,12289
Janyssa,F,100,33,0,33
Mariateresa,F,100,271,0,271
Marquieta,F,100,16,0,16
Yaresly,F,100,67,0,67
Kersey,F,73,52,19,71
Torunn,F,100,39,0,39
Gianmarcos,M,100,0,11,11
Shazia,F,100,463,0,463
Imiya,F,100,6,0,6
Xoie,F,100,94,0,94
Kwan,M,95,27,480,507
Nahiara,F,100,44,0,44
Priscella,F,100,851,0,851
Jaheen,M,100,0,5,5
Jeffries,M,100,0,10,10
Syliva,F,100,425,0,425
Garrik,M,100,0,34,34
Bensen,M,100,0,131,131
Priseis,F,100,113,0,113
Clif,M,100,0,188,188
Oaken,M,100,0,10,10
Socheata,F,100,12,0,12
Darnay,M,100,0,24,24
Lendel,M,100,0,15,15
Sanskriti,F,100,78,0,78
Mahati,F,100,76,0,76
Johnanthan,M,100,0,10,10
Tzivia,F,100,446,0,446
Azeriah,F,89,39,5,44
Aerika,F,100,80,0,80
Jerlisha,F,100,7,0,7
Leiha,F,100,23,0,23
Tysun,M,100,0,34,34
Sherrion,F,100,17,0,17
Veleka,F,100,146,0,146
Lynus,M,100,0,15,15
Khale,M,100,0,157,157
Pepsi,F,100,44,0,44
Samiah,F,100,1167,0,1167
Meztli,F,100,193,0,193
Jeliah,F,100,15,0,15
Timm,M,100,0,549,549
Sargun,F,100,21,0,21
Jahcari,M,100,0,18,18
Raequan,M,100,0,476,476
Lakema,F,100,36,0,36
Daleysa,F,100,186,0,186
Deniel,M,100,0,81,81
Araf,M,100,0,69,69
Annis,F,100,328,0,328
Armann,M,100,0,5,5
Kemmy,M,100,0,12,12
Katenia,F,100,25,0,25
Kyser,M,100,0,132,132
Sanny,M,100,0,7,7
Amiyra,F,100,31,0,31
Loutricia,F,100,5,0,5
Zyiere,M,100,0,44,44
Maille,F,100,189,0,189
Etoshia,F,100,7,0,7
Ezequel,M,100,0,23,23
Aishi,F,100,53,0,53
Fritzy,F,100,10,0,10
Illa,F,100,216,0,216
Andrewjohn,M,100,0,42,42
Baruc,M,100,0,60,60
Maecyn,F,100,42,0,42
Heavynn,F,100,33,0,33
Letta,F,100,198,0,198
Brandal,M,100,0,20,20
Jasera,F,100,5,0,5
Shadarria,F,100,10,0,10
Lynneah,F,100,34,0,34
Lajoya,F,100,91,0,91
Mirage,F,96,127,5,132
Lorena,F,99,29926,219,30145
Zakyrah,F,100,41,0,41
Trenise,F,100,475,0,475
Lauraanne,F,100,24,0,24
Lainah,F,100,10,0,10
Dajona,F,100,12,0,12
Daliya,F,100,69,0,69
Amruth,M,100,0,5,5
Tyrece,M,100,0,698,698
Traeson,M,100,0,61,61
Aciano,M,100,0,5,5
Finneas,M,100,0,314,314
Quantashia,F,100,6,0,6
Savannahrose,F,100,28,0,28
Kazden,M,100,0,32,32
Independence,F,100,5,0,5
Destinea,F,100,10,0,10
Thaddaus,M,100,0,11,11
Treanna,F,100,277,0,277
Chubbie,M,100,0,5,5
Neiba,F,100,22,0,22
Kemariyah,F,100,6,0,6
Dellena,F,100,21,0,21
Latraya,F,100,10,0,10
Adalynd,F,100,19,0,19
Ahmad,M,100,18,15449,15467
Masson,M,100,0,233,233
Joslin,F,99,1221,10,1231
Addan,M,100,0,21,21
Gurnie,M,100,0,7,7
Marylon,F,100,60,0,60
Charmia,F,100,5,0,5
Polixeni,F,100,5,0,5
Maleeah,F,100,151,0,151
Gessel,F,100,23,0,23
Jahmeer,M,100,0,158,158
Almas,F,100,38,0,38
Jagur,M,100,0,40,40
Janathean,M,100,0,5,5
Elbert,M,100,24,8712,8736
Viyan,M,100,0,44,44
Lejoyce,F,100,5,0,5
Carlosjr,M,100,0,5,5
Kyler,M,94,1522,25539,27061
Rachelleann,F,100,5,0,5
Zhanel,F,100,5,0,5
Diabolique,F,67,14,7,21
Aavin,M,100,0,10,10
Samuelle,M,87,6,39,45
Myrtie,F,100,107,0,107
Paulanthony,M,100,0,136,136
Darrlyn,M,100,0,22,22
Morry,M,100,0,30,30
Aeyden,M,100,0,8,8
Doncella,F,100,36,0,36
Corah,F,100,231,0,231
Eleigh,F,100,5,0,5
Ishak,M,100,0,17,17
Aleeka,F,100,5,0,5
Nyzae,M,100,0,10,10
Jewelle,F,100,170,0,170
Shonie,F,100,29,0,29
Philene,F,100,11,0,11
Jamaah,M,100,0,5,5
Julyen,M,100,0,23,23
Kaynen,M,100,0,128,128
Tammylee,F,100,5,0,5
Evdokia,F,100,10,0,10
Dionza,F,100,11,0,11
Donterious,M,100,0,45,45
Keann,F,100,10,0,10
Shalissa,F,100,89,0,89
Carilyn,F,100,302,0,302
Anjolaoluwa,F,96,136,5,141
Jushua,M,100,0,260,260
Mirina,F,100,12,0,12
Ajahnae,F,100,111,0,111
Trejan,M,100,0,90,90
Seriena,F,100,5,0,5
Anelyse,F,100,19,0,19
Stazia,F,100,5,0,5
Meital,F,100,87,0,87
Paulin,M,100,0,15,15
Wakeel,M,100,0,5,5
Idalia,F,100,2430,0,2430
Nico,M,93,641,8379,9020
Deanah,F,100,15,0,15
Lavaya,F,100,89,0,89
Brodin,M,100,0,112,112
Carlene,F,100,8591,0,8591
Malakia,M,84,8,42,50
Jacqualyne,F,100,5,0,5
Blayre,F,100,83,0,83
Gloribel,F,100,45,0,45
Hristos,M,100,0,28,28
Kimble,M,66,226,446,672
Feroz,M,100,0,10,10
Rogel,M,100,0,10,10
Zarela,F,100,39,0,39
Lashannon,F,100,291,0,291
Chinou,M,100,0,11,11
Tish,F,100,754,0,754
Donld,M,100,0,23,23
Marihanna,F,100,36,0,36
Curley,M,88,124,947,1071
Wyvette,F,100,11,0,11
Steelie,F,100,5,0,5
Braelinn,F,100,5,0,5
Wilberth,M,100,0,64,64
Kaoir,F,100,9,0,9
Corvetta,F,100,11,0,11
Avalina,F,100,192,0,192
Alyze,F,100,133,0,133
Poppi,F,100,46,0,46
Graisyn,F,76,32,10,42
Gaspar,M,100,0,1336,1336
Lanita,F,100,3058,0,3058
Armand,M,100,0,6127,6127
Jeilyn,F,100,253,0,253
Graeme,M,100,0,2154,2154
Kashika,F,100,16,0,16
Lakendra,F,100,2278,0,2278
Jaidalyn,F,100,64,0,64
Gaspard,M,100,0,27,27
Korie,F,82,1865,416,2281
Miquan,M,100,0,129,129
Chrisopher,M,100,0,750,750
Evalyse,F,100,50,0,50
Johnnisha,F,100,63,0,63
Caide,M,100,0,46,46
Zamyrah,F,100,45,0,45
Chelsee,F,100,1706,0,1706
Packard,M,100,0,5,5
Adah,F,100,1030,0,1030
Brazos,M,100,0,139,139
Aicen,M,100,0,5,5
Sebron,M,100,0,95,95
Lakeyda,F,100,21,0,21
Ayria,F,100,10,0,10
Shareika,F,100,37,0,37
Cabell,M,100,0,17,17
Jonene,F,100,5,0,5
Maylei,F,100,44,0,44
Aralynn,F,100,435,0,435
Ivona,F,100,46,0,46
Cavell,M,100,0,34,34
Ehlana,F,100,51,0,51
Charleene,F,100,38,0,38
Carlissa,F,100,650,0,650
Atia,F,100,360,0,360
Shirletta,F,100,28,0,28
Ciona,F,100,36,0,36
Roseland,F,100,51,0,51
Nikky,F,100,112,0,112
Marissa,F,100,117620,270,117890
Ondraya,F,100,6,0,6
Armelinda,F,100,17,0,17
Aleigh,F,100,542,0,542
Momar,M,100,0,22,22
Breighlyn,F,100,12,0,12
Janira,F,100,719,0,719
Mahdia,F,100,10,0,10
Siler,M,100,0,102,102
Gelsey,F,100,225,0,225
Geretha,F,100,7,0,7
Teneca,F,100,5,0,5
Jahyden,M,100,0,16,16
Arnika,F,100,34,0,34
Kimyia,F,100,6,0,6
Avanah,F,100,5,0,5
Nikai,M,94,5,85,90
Hannon,M,69,10,22,32
Bryn,F,84,6035,1159,7194
Darsh,M,100,0,464,464
Lameshia,F,100,161,0,161
Mckaylie,F,100,84,0,84
Tieesha,F,100,24,0,24
Deterrion,M,100,0,16,16
Lyllia,F,100,6,0,6
Khea,F,100,5,0,5
Nicolene,F,100,6,0,6
Kitrina,F,100,259,0,259
Renold,M,100,0,34,34
Lirije,F,100,5,0,5
Daisia,F,100,435,0,435
Yalimar,F,100,9,0,9
Danikah,F,100,88,0,88
Leyni,F,100,12,0,12
Marquian,M,100,0,5,5
Mahriah,F,100,11,0,11
Timera,F,100,211,0,211
Avacyn,F,100,45,0,45
Julliet,F,100,22,0,22
Zeyah,F,100,11,0,11
Temya,F,100,38,0,38
Frak,M,100,0,46,46
Jarald,M,100,0,5,5
Letrina,F,100,5,0,5
Lasheta,F,100,5,0,5
Drevaughn,M,100,0,7,7
Maryfer,F,100,159,0,159
Christi,F,100,20601,22,20623
Jatyler,M,100,0,5,5
Kessia,F,100,16,0,16
Hailiey,F,100,5,0,5
Azarion,M,100,0,125,125
Dausen,M,100,0,15,15
Caressa,F,100,1217,0,1217
Khaniyah,F,100,76,0,76
Kirthana,F,100,6,0,6
Delaylah,F,100,18,0,18
Adelynn,F,100,4783,0,4783
Jillia,F,100,12,0,12
Yazziel,M,100,0,5,5
Orva,M,69,5,11,16
Sule,F,100,5,0,5
Yosuke,M,100,0,28,28
Delephine,F,100,5,0,5
Marcisha,F,100,11,0,11
Emmy,F,100,5558,0,5558
Temilola,F,100,31,0,31
Leonard,M,99,563,110195,110758
Lucine,F,100,159,0,159
Rushie,F,100,12,0,12
Xinrui,F,100,5,0,5
Blaire,F,98,2935,54,2989
Brecca,F,100,30,0,30
Alam,M,100,0,222,222
Ailanie,F,100,33,0,33
Sarri,F,100,5,0,5
Kushtrim,M,100,0,7,7
Shanicqua,F,100,75,0,75
Jashae,F,100,84,0,84
Huberta,F,100,29,0,29
Jaffer,M,100,0,41,41
Timoteo,M,100,0,790,790
Danyra,F,100,11,0,11
Kionte,M,93,16,200,216
Quamain,M,100,0,23,23
Quevon,M,100,0,40,40
Luce,F,100,5,0,5
Yasmyne,F,100,48,0,48
Jillayne,F,100,137,0,137
Sheali,F,100,5,0,5
Vala,F,100,124,0,124
Shrivas,M,100,0,5,5
Rozelle,F,69,48,22,70
Dyontae,M,100,0,5,5
Dadra,F,100,5,0,5
Shamont,M,100,0,21,21
Jaddiel,M,100,0,5,5
Thel,M,100,0,5,5
Tylil,M,100,0,34,34
Naome,F,100,94,0,94
Kimmori,F,100,6,0,6
Lowanda,F,100,333,0,333
Brennda,F,100,5,0,5
Delphia,F,100,737,0,737
Samyriah,F,100,12,0,12
Andan,M,100,0,25,25
Kenleigh,F,100,1165,0,1165
Colsten,M,100,0,26,26
Natahlia,F,100,55,0,55
Mikya,F,100,191,0,191
Jessicia,F,100,348,0,348
Kimmesha,F,100,5,0,5
Gorge,M,100,0,2043,2043
Ryeli,F,100,5,0,5
Davesha,F,100,40,0,40
Mihit,M,100,0,6,6
Chandee,F,100,5,0,5
Abriel,F,67,573,283,856
Cianan,M,100,0,30,30
Celton,M,100,0,17,17
Zacary,M,100,0,1118,1118
Ashantae,F,100,104,0,104
Cyanthia,F,100,5,0,5
Randalyn,F,100,74,0,74
Aily,F,100,109,0,109
Larenz,M,100,0,421,421
Asira,F,100,7,0,7
Emylia,F,100,135,0,135
Niciah,F,100,5,0,5
Melakai,M,100,0,27,27
Maesa,F,100,26,0,26
Arwynn,F,100,11,0,11
Akshith,M,100,0,44,44
Tajane,F,100,29,0,29
Stephvon,M,100,0,5,5
Alaijah,F,99,544,5,549
Sherrilynn,F,100,210,0,210
Geannine,F,100,21,0,21
Shawntey,F,100,5,0,5
Gennesis,F,100,505,0,505
Marleen,F,100,2730,0,2730
Matson,M,100,0,154,154
Shaylynn,F,100,1967,0,1967
Jessicarose,F,100,24,0,24
Keannah,F,100,22,0,22
Zydarius,M,100,0,31,31
Varenya,F,100,33,0,33
Chaynee,F,100,5,0,5
Dacorey,M,100,0,11,11
Selina,F,100,15726,0,15726
Yakirah,F,100,5,0,5
Safeya,F,100,6,0,6
Elizza,F,100,28,0,28
Ziporah,F,100,21,0,21
Jalonte,M,100,0,19,19
Esa,M,83,46,219,265
Mariacamila,F,100,23,0,23
Shadiamon,F,100,26,0,26
Amandeep,M,56,183,237,420
Ivyon,M,100,0,12,12
Caliah,F,100,200,0,200
Tahany,F,100,10,0,10
Shafer,M,100,0,114,114
Mukil,M,100,0,5,5
Shapree,F,100,10,0,10
Demas,M,100,0,5,5
Shadijah,F,100,6,0,6
Dehlia,F,100,169,0,169
Jhana,F,100,96,0,96
Blane,M,100,11,3914,3925
Yasmina,F,100,840,0,840
Selman,M,100,0,20,20
Mannat,F,100,249,0,249
Lorenzo,M,99,273,48715,48988
Sherlly,F,100,5,0,5
Capitola,F,100,6,0,6
Lequisha,F,100,141,0,141
Naruto,M,100,0,5,5
Destene,F,100,23,0,23
Jaimir,M,100,0,42,42
Josip,M,100,0,103,103
Dyanne,F,100,711,0,711
Delania,F,100,228,0,228
Shatha,F,100,112,0,112
Tatiauna,F,100,18,0,18
Keyoni,F,95,97,5,102
Xoey,F,100,167,0,167
Tevion,M,100,0,176,176
Dayla,F,100,1430,0,1430
Aneek,M,100,0,8,8
Maysie,F,100,185,0,185
Shentell,F,100,6,0,6
Kaymoni,F,100,5,0,5
Logic,M,100,0,7,7
Shanyia,F,100,472,0,472
Jiacheng,M,100,0,5,5
Mariposa,F,100,184,0,184
Orvetta,F,100,5,0,5
Yitzchok,M,100,0,3282,3282
Baani,F,100,45,0,45
Klarisa,F,100,235,0,235
Arjay,M,100,0,209,209
Mckenzey,F,100,166,0,166
Franne,F,100,5,0,5
Kenny,M,99,436,43175,43611
Rosabella,F,100,432,0,432
Audreyann,F,100,14,0,14
Ulyses,M,100,0,761,761
Darrein,M,80,7,28,35
Chiedu,M,100,0,5,5
Latiea,F,100,5,0,5
Maclane,M,100,0,128,128
Aidar,M,100,0,5,5
Anslem,M,100,0,10,10
Danelis,F,100,15,0,15
Jannina,F,100,16,0,16
Tiawna,F,100,22,0,22
Jaterria,F,100,25,0,25
Rebelle,F,100,14,0,14
Orvel,M,100,0,118,118
Sheryn,F,100,168,0,168
Coreyon,M,100,0,145,145
Soumil,M,100,0,59,59
Rabih,M,100,0,30,30
Leoma,F,100,90,0,90
Eveny,F,100,143,0,143
Ajamu,M,100,0,116,116
Natsuko,F,100,15,0,15
Eleanore,F,100,1788,0,1788
Meribeth,F,100,382,0,382
Ryhanna,F,100,144,0,144
Aunesty,F,100,175,0,175
Kortni,F,100,1156,0,1156
Jameria,F,100,790,0,790
Parnell,M,100,0,901,901
Esiah,M,100,0,151,151
Chanaya,F,100,54,0,54
Jennine,F,100,1205,0,1205
Emonie,F,98,848,14,862
Kata,F,100,53,0,53
Nasteha,F,100,17,0,17
Fifi,F,100,52,0,52
Latarsia,F,100,5,0,5
Flordemaria,F,100,5,0,5
Maelle,F,100,225,0,225
Mavrik,M,100,0,182,182
Divan,M,100,0,5,5
Haiylee,F,100,5,0,5
Zelle,F,100,5,0,5
Luann,F,100,14025,6,14031
Markee,M,86,110,675,785
Yosimar,M,100,0,11,11
Jeriel,M,100,0,681,681
Mariyanna,F,100,47,0,47
Alizabella,F,100,7,0,7
Gerise,F,100,17,0,17
Benner,M,100,0,5,5
Cathren,F,100,22,0,22
Kylie,F,100,96903,427,97330
Fonta,F,52,12,11,23
Athea,F,100,158,0,158
Tenesha,F,100,1438,0,1438
Ember,F,99,5564,66,5630
Kiearra,F,100,244,0,244
Phelps,M,100,0,15,15
Rayhaan,M,100,0,68,68
Arriah,F,100,65,0,65
Devrim,M,100,0,11,11
Slyvester,M,100,0,123,123
Arohi,F,100,76,0,76
Aakanksha,F,100,5,0,5
Morgen,F,76,1768,547,2315
Jeneil,F,100,17,0,17
Terena,F,100,565,0,565
Dillyn,M,73,139,371,510
Tishay,F,100,5,0,5
Donza,F,100,21,0,21
Juergen,M,100,0,88,88
Coriann,F,100,119,0,119
Deterrio,M,100,0,5,5
Asaad,M,100,0,340,340
Jabreel,M,100,0,89,89
Bryssia,F,100,5,0,5
Araina,F,100,366,0,366
Conda,F,97,164,5,169
Latayia,F,100,5,0,5
Rodriques,M,100,0,226,226
Malcolm,M,100,74,37107,37181
Jagmeet,M,100,0,10,10
Keiland,M,100,0,84,84
Naedelyn,F,100,6,0,6
Akeela,F,100,165,0,165
Ariannah,F,100,675,0,675
Kumail,M,100,0,37,37
Aquila,F,92,665,57,722
Charisha,F,100,5,0,5
Areah,F,100,6,0,6
Kolbie,F,68,738,340,1078
Adekemi,F,100,5,0,5
Anelah,F,100,6,0,6
Jaylin,M,57,6800,8918,15718
Ansumana,M,100,0,10,10
Ayomide,M,59,249,364,613
Juliam,M,100,0,5,5
Rapheal,M,100,0,1252,1252
Zhariah,F,100,32,0,32
Shunashi,F,100,5,0,5
Enma,F,100,85,0,85
Alexandre,M,97,145,4373,4518
Reet,F,100,140,0,140
Sennett,M,100,0,6,6
Lashondia,F,100,17,0,17
Kemontez,M,100,0,5,5
Falecia,F,100,218,0,218
Laurier,M,100,0,41,41
Neveah,F,100,3113,0,3113
Killashandra,F,100,11,0,11
Nael,M,98,6,312,318
Harshith,M,100,0,78,78
Cena,F,98,249,6,255
Shaqueria,F,100,33,0,33
Corleone,M,100,0,96,96
Lasheia,F,100,5,0,5
Capp,M,100,0,5,5
Tiyanni,F,100,5,0,5
Merica,F,100,208,0,208
Cristee,F,100,11,0,11
Akshita,F,100,239,0,239
Aimara,F,100,12,0,12
Chadman,M,100,0,5,5
Jayceon,M,100,16,4385,4401
Tomoyuki,M,100,0,7,7
Nitosha,F,100,48,0,48
Cove,M,97,6,170,176
Shamika,F,100,5047,6,5053
Zuzanna,F,100,486,0,486
Pesach,M,100,0,70,70
Amillie,F,100,9,0,9
Tavarian,M,100,0,5,5
Justiss,F,88,136,18,154
Ericson,M,100,0,570,570
Kutler,M,100,0,32,32
Carmalena,F,100,5,0,5
Zyrihanna,F,100,45,0,45
Jayley,F,100,208,0,208
Farisa,F,100,11,0,11
Arra,F,100,27,0,27
Bronti,F,100,14,0,14
Arik,M,100,0,2110,2110
Kelijah,M,90,12,107,119
Algin,M,100,0,23,23
Temica,F,100,150,0,150
Arlethia,F,100,131,0,131
Kenaria,F,100,10,0,10
Keadon,M,100,0,6,6
Keandria,F,100,147,0,147
Deonn,F,100,13,0,13
Nabor,M,100,0,302,302
Empris,F,100,6,0,6
Dorry,F,100,11,0,11
Zatoria,F,100,27,0,27
Riloh,F,100,5,0,5
Shaqville,M,100,0,21,21
Izzac,M,100,0,152,152
Mel,M,88,307,2255,2562
Pedrum,M,100,0,5,5
Theodoric,M,100,0,49,49
Kyiah,F,100,258,0,258
Kathey,F,100,1330,0,1330
Adeleine,F,100,177,0,177
Cashala,F,100,11,0,11
Marcheta,F,100,177,0,177
Kirah,F,100,806,0,806
Rosarie,F,100,5,0,5
Christoper,M,100,0,3112,3112
Maire,F,100,646,0,646
Nekoda,M,88,15,107,122
Yeraldy,F,100,73,0,73
Ametra,F,100,16,0,16
Maeliyah,F,100,5,0,5
Dazmine,F,100,18,0,18
Kemani,F,54,406,349,755
Vedder,M,100,0,60,60
Ladarrian,M,100,0,101,101
Ahmaad,M,100,0,346,346
Margulia,F,100,5,0,5
Luscious,F,100,6,0,6
Erka,F,100,6,0,6
Jamylah,F,100,113,0,113
Iselle,F,100,19,0,19
Deontrae,M,100,0,175,175
Mikelia,F,100,5,0,5
Markeon,M,100,0,6,6
Luseane,F,100,13,0,13
Ewa,F,100,260,0,260
Yahav,F,50,5,5,10
Widline,F,100,9,0,9
Teola,F,100,5,0,5
Sanjiv,M,100,0,124,124
Demya,F,100,626,0,626
Jayonni,F,67,10,5,15
Richella,F,100,23,0,23
Gabria,F,100,5,0,5
Seneka,F,100,12,0,12
Liette,F,100,5,0,5
Taige,M,77,24,79,103
Idaya,F,100,5,0,5
Saahas,M,100,0,51,51
Juliahnna,F,100,5,0,5
Raymarion,M,100,0,12,12
Darianny,F,100,56,0,56
Aaiyana,F,100,5,0,5
Ketina,F,100,63,0,63
Loveda,F,100,5,0,5
Gwendel,F,100,7,0,7
Ayelen,F,100,467,0,467
Aviyanna,F,100,58,0,58
Giovonnie,M,100,0,76,76
Mathiew,M,100,0,5,5
Milicent,F,100,96,0,96
Ryanna,F,100,1112,0,1112
Daishun,M,100,0,15,15
Oyindamola,F,93,62,5,67
Aletra,F,100,11,0,11
Ishawn,M,100,0,33,33
Lalaina,F,100,54,0,54
Raymond,M,100,1681,340830,342511
Centrell,M,100,0,11,11
Reme,M,100,0,17,17
Quetzaly,F,100,206,0,206
Danice,F,100,558,0,558
Randye,F,100,110,0,110
Zoeygrace,F,100,5,0,5
Jathan,M,100,0,1273,1273
Louiza,F,100,30,0,30
Yumira,F,100,5,0,5
Shaolin,F,93,62,5,67
Suchit,M,100,0,10,10
Adali,F,93,342,24,366
Tenayah,F,100,5,0,5
Marris,M,65,6,11,17
Zmari,M,100,0,10,10
Saurya,M,100,0,7,7
Zema,F,100,19,0,19
Rahkeem,M,100,0,233,233
Nellwyn,F,100,5,0,5
Roxianne,F,100,27,0,27
Shabrika,F,100,10,0,10
Ravien,F,100,5,0,5
Evelynn,F,100,5073,0,5073
Nylan,M,82,49,224,273
Prestan,M,100,0,45,45
Mathius,M,100,0,129,129
Tanza,F,100,168,0,168
Rashidat,F,100,12,0,12
Quian,M,52,10,11,21
Leanne,F,100,27138,0,27138
Patrich,M,100,0,76,76
Archita,F,100,59,0,59
Deno,M,100,0,433,433
Soon,F,100,18,0,18
Palin,F,100,133,0,133
Jezell,F,100,34,0,34
Urika,F,100,5,0,5
Khodi,F,57,8,6,14
Tyreace,M,100,0,9,9
Markiea,F,100,11,0,11
Vanice,F,100,92,0,92
Gabbie,F,100,135,0,135
Sherilee,F,100,123,0,123
Marqueta,F,100,248,0,248
Tasheen,F,100,45,0,45
Adithri,F,100,12,0,12
Henrietta,F,100,7194,0,7194
Birydiana,F,100,5,0,5
Rajdeep,M,79,11,41,52
Santrez,M,100,0,5,5
Willett,F,50,5,5,10
Morenike,F,100,115,0,115
Abedallah,M,100,0,16,16
Serious,M,100,0,12,12
Glenroy,M,100,0,79,79
Drina,F,100,211,0,211
Daniana,F,100,5,0,5
Tresa,F,100,4118,0,4118
Joesiyah,M,100,0,6,6
Ikran,F,100,137,0,137
Surina,F,100,403,0,403
Eastyn,M,60,245,364,609
Shanina,F,100,216,0,216
Adelita,F,100,1372,0,1372
Aliceyn,F,100,7,0,7
Kaella,F,100,12,0,12
Philis,F,100,106,0,106
Kameon,M,100,0,5,5
Ksha,F,100,9,0,9
Cesario,M,100,0,707,707
Zeynab,F,100,63,0,63
Tyrann,M,100,0,40,40
Rosselyn,F,100,217,0,217
Shamek,M,100,0,5,5
Baileigh,F,100,1823,0,1823
Austa,F,100,5,0,5
Akeira,F,100,223,0,223
Mauna,F,100,14,0,14
Nin,F,100,6,0,6
Memphis,M,82,816,3743,4559
Saryah,F,100,356,0,356
Ermon,M,100,0,5,5
Angelmarie,F,100,217,0,217
Chrisel,F,100,5,0,5
Luzia,F,100,17,0,17
Lakendria,F,100,259,0,259
Derby,M,85,5,29,34
Kwinton,M,100,0,55,55
Floye,F,100,5,0,5
Bacarri,M,100,0,5,5
Aribeth,F,100,10,0,10
Antwone,M,100,0,1950,1950
Dennies,M,100,0,59,59
Shakesha,F,100,138,0,138
Kellsy,F,100,14,0,14
Tromaine,M,100,0,17,17
Shanaka,F,100,16,0,16
Albieris,M,100,0,5,5
Lelon,M,100,0,69,69
Ayda,F,100,639,0,639
Milosz,M,100,0,6,6
Lajasmine,F,100,27,0,27
Rayssa,F,100,77,0,77
Kveon,M,100,0,79,79
Wilburt,M,100,0,307,307
Landrie,F,100,523,0,523
Jaasir,M,100,0,14,14
Jeydon,M,100,0,28,28
Mithcell,M,100,0,215,215
Amarey,F,50,5,5,10
Emmer,F,100,105,0,105
Garon,M,100,0,920,920
Tymar,M,100,0,63,63
Chauntee,F,100,28,0,28
Annetha,F,100,5,0,5
Dylian,M,100,0,10,10
Christabelle,F,100,230,0,230
Julyssa,F,100,840,0,840
Godwill,M,100,0,6,6
Syble,F,100,486,0,486
Donnella,F,100,296,0,296
Kameko,F,97,184,5,189
Nashwa,F,100,10,0,10
Garyon,M,100,0,12,12
Myona,F,100,33,0,33
Derex,M,100,0,21,21
Galdino,M,100,0,115,115
Temecka,F,100,7,0,7
Kristana,F,100,41,0,41
Allysa,F,100,2509,0,2509
Karrigan,F,100,407,0,407
Borys,M,100,0,22,22
Terryion,M,100,0,23,23
Drezden,M,100,0,85,85
Tavania,F,100,14,0,14
Jotham,M,100,0,427,427
Tykara,F,100,18,0,18
Raiqa,F,100,5,0,5
Cardon,M,100,0,46,46
Avanthika,F,100,27,0,27
Latrinity,F,100,30,0,30
Zaydn,M,100,0,57,57
Donjanae,F,100,5,0,5
Amiriya,F,100,10,0,10
Nasaria,F,100,10,0,10
Keyonia,F,100,366,0,366
Zondra,F,100,401,0,401
Marlina,F,100,1088,0,1088
Johnnye,F,95,97,5,102
Christela,F,100,6,0,6
Gwyn,F,96,1659,74,1733
Mahkaylah,F,100,13,0,13
Clarann,F,100,8,0,8
Kamyle,F,100,5,0,5
Pretty,F,100,51,0,51
Guisel,F,100,5,0,5
Marolyn,F,100,391,0,391
Mckenah,F,100,53,0,53
Xiomy,F,100,5,0,5
Darleni,F,100,5,0,5
Vesta,F,100,981,0,981
Alaena,F,100,198,0,198
Jaqualen,M,100,0,12,12
Chrisanthony,M,100,0,17,17
Cristie,F,100,2059,0,2059
Makyna,F,100,60,0,60
Karliah,F,100,50,0,50
Koushik,M,100,0,11,11
Dmarkus,M,100,0,54,54
Lilymae,F,100,76,0,76
Tawnee,F,100,778,0,778
Azyon,M,100,0,10,10
Codera,M,100,0,5,5
Dessie,F,97,1538,50,1588
Onesimo,M,100,0,370,370
Yeudiel,M,100,0,39,39
Venie,F,100,5,0,5
Charlan,F,100,10,0,10
Zyleah,F,100,13,0,13
Keanah,F,100,43,0,43
Tarrie,F,95,104,5,109
Avienne,F,100,7,0,7
Jenielle,F,100,47,0,47
Calinda,F,100,71,0,71
Pranshi,F,100,11,0,11
Kerr,M,100,0,17,17
Rejina,F,100,61,0,61
Leshan,F,59,16,11,27
Zuleyca,F,100,13,0,13
Mikio,M,100,0,10,10
Shaherah,F,100,24,0,24
Boneta,F,100,25,0,25
Adriyana,F,100,160,0,160
Laneise,F,100,5,0,5
Mylinh,F,100,264,0,264
Vasanti,F,100,5,0,5
Clayton,M,100,372,93540,93912
Sanaya,F,100,931,0,931
Khira,F,100,269,0,269
Davontay,M,100,0,504,504
Zinn,M,100,0,12,12
Essynce,F,100,193,0,193
Deyja,F,100,63,0,63
Odies,M,100,0,11,11
Veya,F,100,8,0,8
Aubriyana,F,100,5,0,5
Kaliyanei,F,100,7,0,7
Shandiin,F,100,143,0,143
Natajia,F,100,27,0,27
Yilia,F,100,6,0,6
Amoy,F,100,65,0,65
Nykeem,M,100,0,48,48
Rickeem,M,100,0,5,5
Rebekan,F,100,30,0,30
Janequa,F,100,104,0,104
Badia,F,100,40,0,40
Lexton,M,100,0,228,228
Deaun,F,100,66,0,66
Edilia,F,100,63,0,63
Ezael,M,100,0,5,5
Nolin,M,100,0,302,302
Milina,F,100,58,0,58
Sparkel,F,100,6,0,6
Caprice,F,95,3218,164,3382
Zuleymi,F,100,5,0,5
Tydrick,M,100,0,60,60
Sorayah,F,100,108,0,108
Kaiyen,M,100,0,26,26
Rosalynne,F,100,30,0,30
Edriana,F,100,31,0,31
Ezmae,F,100,59,0,59
Dshawn,M,100,0,554,554
Dymin,F,100,73,0,73
Spivey,M,100,0,5,5
Temuulen,M,100,0,7,7
Sanskruti,F,100,5,0,5
Daniela,F,100,53486,163,53649
Uniya,F,100,5,0,5
Pasqua,F,100,5,0,5
Zahida,F,100,5,0,5
Maradith,F,100,5,0,5
Odarius,M,100,0,82,82
Lachaka,F,100,24,0,24
Denija,F,100,31,0,31
Dontai,M,100,0,168,168
Chanze,M,100,0,223,223
Anushri,F,100,76,0,76
Shakeerah,F,100,94,0,94
Bernado,M,100,0,15,15
Tanyah,F,100,291,0,291
Jillane,F,100,119,0,119
Youa,F,100,175,0,175
Anaeli,F,100,134,0,134
Tarius,M,100,0,226,226
Deerica,F,100,151,0,151
Donashia,F,100,5,0,5
Naytasha,F,100,5,0,5
Elisabetta,F,100,224,0,224
Lluvia,F,100,2778,0,2778
Alila,F,100,57,0,57
Tylerjohn,M,100,0,5,5
Seresa,F,100,40,0,40
Donovyn,M,100,0,203,203
Hydiah,F,100,9,0,9
Melissamarie,F,100,10,0,10
Avy,F,94,251,16,267
Brelyn,F,92,443,38,481
Delilia,F,100,10,0,10
Ashara,F,100,177,0,177
Emberlie,F,100,39,0,39
Armenia,F,100,5,0,5
Catera,F,100,397,0,397
Shayan,M,96,58,1467,1525
Enson,M,100,0,37,37
Dasianae,F,100,10,0,10
Noni,F,100,499,0,499
Keierra,F,100,61,0,61
Daveisha,F,100,6,0,6
Lorean,F,100,233,0,233
Jaeyon,M,100,0,5,5
Demire,M,100,0,7,7
Sheyenne,F,100,1401,0,1401
Azairah,F,100,6,0,6
Dafny,F,100,54,0,54
Nanea,F,100,154,0,154
Sharisse,F,100,621,0,621
Nakaia,F,100,38,0,38
Liticia,F,100,121,0,121
Lonzo,M,100,0,1288,1288
Azarael,M,100,0,5,5
Kerith,F,100,189,0,189
Ziva,F,100,1042,0,1042
Ciomara,F,100,29,0,29
Aarionna,F,100,133,0,133
Yakyra,F,100,5,0,5
Luie,M,100,0,12,12
Jezel,F,100,152,0,152
Yobany,M,100,0,209,209
Jeseka,F,100,7,0,7
Noema,F,100,5,0,5
Miamore,F,100,6,0,6
Xiya,F,100,11,0,11
Hedda,F,100,87,0,87
Soorya,M,100,0,11,11
Emirah,F,100,18,0,18
Kodah,M,100,0,96,96
Lilac,F,100,110,0,110
Balvina,F,100,10,0,10
Wesly,M,100,0,1106,1106
Deakin,M,100,0,159,159
Dayvid,M,100,0,29,29
Megna,F,100,16,0,16
Ranisha,F,100,584,0,584
Maryanne,F,100,8749,0,8749
Etzio,M,100,0,23,23
Abreana,F,100,39,0,39
Sehej,F,62,8,5,13
Jameka,F,100,1626,0,1626
Kyja,F,100,12,0,12
Brick,M,100,0,341,341
Lashundia,F,100,5,0,5
Jeshon,M,100,0,10,10
Eithan,M,100,0,719,719
Fabio,M,100,0,2271,2271
Holder,M,100,0,5,5
Annistin,F,100,6,0,6
Eashaan,M,100,0,5,5
Peggyann,F,100,121,0,121
Elizia,F,100,24,0,24
Anashe,F,100,5,0,5
Delvis,M,100,0,90,90
Shyannah,F,100,27,0,27
River,M,74,3810,10618,14428
Benen,M,100,0,61,61
Allexys,F,100,10,0,10
Lany,F,100,41,0,41
Adeel,M,100,0,283,283
Annakiya,F,100,5,0,5
Tynashia,F,100,19,0,19
Altheia,F,100,72,0,72
Elvi,M,100,0,16,16
Jazirah,F,100,25,0,25
Diquan,M,100,0,372,372
Armetta,F,100,35,0,35
Marshal,M,98,74,3524,3598
Kenith,M,100,0,1086,1086
Ddnald,M,100,0,11,11
Iba,F,100,5,0,5
Kaevon,M,100,0,198,198
Inetha,F,100,50,0,50
Tavorris,M,100,0,12,12
Watasha,F,100,11,0,11
Mikalyn,F,100,227,0,227
Irelynn,F,100,886,0,886
Kawan,M,97,15,507,522
Lulani,F,100,40,0,40
Tamarr,M,71,5,12,17
Cherylyn,F,100,331,0,331
Jennaliz,F,100,5,0,5
Bree,F,100,7893,17,7910
Berita,F,100,5,0,5
Geidi,F,100,5,0,5
Jacalynn,F,100,100,0,100
Montea,F,50,5,5,10
Nickolai,M,100,0,332,332
Loranne,F,100,11,0,11
Kwon,M,100,0,34,34
Haelyn,F,100,128,0,128
Joshiah,M,100,0,80,80
Kashonda,F,100,148,0,148
Nethra,F,100,203,0,203
Keerra,F,100,11,0,11
Janiyia,F,100,46,0,46
Braian,M,100,0,179,179
Polk,M,100,0,5,5
Debrann,F,100,20,0,20
Heyden,M,100,0,140,140
Marnina,F,100,6,0,6
Jenalynn,F,100,16,0,16
Miosoty,F,100,6,0,6
Kailen,F,52,638,597,1235
Canya,F,100,23,0,23
Kassaundra,F,100,400,0,400
Tazhane,F,100,46,0,46
Annie,F,100,68790,231,69021
Shay,F,59,5789,4070,9859
Alisson,F,100,3116,0,3116
Kattaleya,F,100,60,0,60
Donyel,F,55,96,79,175
Chantae,F,100,510,0,510
Marguerite,F,100,15730,5,15735
Shammah,M,87,6,39,45
Moksha,F,100,105,0,105
Johncharles,M,100,0,84,84
Ociel,M,100,0,390,390
Marcys,M,100,0,10,10
Jequita,F,100,16,0,16
Raigen,F,100,244,0,244
Gwendolyne,F,100,108,0,108
Bentlie,F,65,108,57,165
Ravenne,F,100,61,0,61
Ranaa,F,100,5,0,5
Mustaf,M,100,0,77,77
Shannice,F,100,48,0,48
Larsen,M,77,109,372,481
Azzure,F,94,75,5,80
Deniecia,F,100,5,0,5
Kayme,F,100,5,0,5
Funda,F,100,6,0,6
Shaquna,F,100,57,0,57
Alaida,F,100,5,0,5
Alyvia,F,100,3703,0,3703
Jaquail,M,100,0,93,93
Meganelizabeth,F,100,12,0,12
Curlie,F,57,39,30,69
Salahudin,M,100,0,12,12
Tephanie,F,100,135,0,135
Sylvester,M,99,113,16590,16703
Kedzie,F,100,12,0,12
Jiaire,M,100,0,72,72
Samana,F,100,5,0,5
Iyeisha,F,100,5,0,5
Jalexy,F,100,27,0,27
Emmie,F,100,2938,0,2938
Bowdrie,M,100,0,6,6
Shakeyla,F,100,189,0,189
Jayle,F,100,82,0,82
Donivon,M,100,0,28,28
Dafnee,F,100,34,0,34
Metzli,F,100,206,0,206
Denia,F,100,1101,0,1101
Javon,M,95,755,15504,16259
Kevondre,M,100,0,21,21
Vedansh,M,100,0,43,43
Tazanna,F,100,10,0,10
Teonna,F,100,1067,0,1067
Demitrie,M,100,0,16,16
Sarriyah,F,100,5,0,5
Ponce,M,100,0,91,91
Taegyn,F,100,5,0,5
Tiliyah,F,100,17,0,17
Shalone,F,100,17,0,17
Shalita,F,100,405,0,405
Jolon,M,100,0,91,91
Sepideh,F,100,25,0,25
Ashelynn,F,100,69,0,69
Vincient,M,100,0,212,212
Jaeger,M,100,0,575,575
Seinna,F,100,16,0,16
Aubriee,F,100,139,0,139
Saliym,M,100,0,5,5
Tawnni,F,100,22,0,22
Ahyan,M,100,0,97,97
Onetta,F,100,32,0,32
Creeden,M,100,0,18,18
Eversyn,F,100,5,0,5
Braylea,F,100,69,0,69
Gradys,F,100,5,0,5
Naesha,F,100,87,0,87
Drayke,M,100,0,282,282
Shalexis,F,100,16,0,16
Bradin,M,100,0,391,391
Ladaryl,M,100,0,14,14
Marialuiza,F,100,60,0,60
Moniqua,F,100,409,0,409
Madesen,F,100,12,0,12
Joncarlos,M,100,0,194,194
Shaketra,F,100,6,0,6
Particia,F,100,111,0,111
Pryscilla,F,100,16,0,16
Atheena,F,100,164,0,164
Keoisha,F,100,15,0,15
Aerin,F,98,681,16,697
Shamill,F,100,5,0,5
Kearia,F,100,286,0,286
Laniyha,F,100,11,0,11
Zaidee,F,100,145,0,145
Esmaralda,F,100,11,0,11
Bralyn,M,61,251,386,637
Lashonna,F,100,429,0,429
Milano,M,100,0,43,43
Madicyn,F,100,107,0,107
Timofei,M,100,0,13,13
Luci,F,100,2085,0,2085
Dariyana,F,100,27,0,27
Laurenann,F,100,6,0,6
Agena,F,100,15,0,15
Roque,M,100,0,1925,1925
Brezlin,M,55,5,6,11
Kimako,F,100,6,0,6
Osamu,M,100,0,15,15
Myajah,F,100,5,0,5
Gillette,M,100,0,5,5
Christiandaniel,M,100,0,7,7
Trasi,F,100,6,0,6
Mukund,M,100,0,122,122
Hayes,M,95,197,4114,4311
Persephony,F,100,12,0,12
Iline,F,100,22,0,22
Divante,M,100,0,159,159
Somaria,F,100,11,0,11
Skilyn,F,100,42,0,42
Khysen,M,100,0,6,6
Raygen,F,90,405,47,452
Kadren,M,100,0,5,5
Getzemani,F,100,23,0,23
Nica,F,100,208,0,208
Elieser,M,100,0,237,237
Jhenae,F,100,6,0,6
Faige,F,100,185,0,185
Kiarah,F,100,1082,0,1082
Bricelynn,F,100,10,0,10
Rean,F,100,5,0,5
Jedrick,M,100,0,85,85
Lafayette,M,100,11,2216,2227
Sheel,M,100,0,25,25
Makaily,F,100,5,0,5
Eithyn,M,100,0,11,11
Samyiah,F,100,191,0,191
Quintana,F,100,201,0,201
Kristepher,M,100,0,5,5
Averlee,F,100,17,0,17
Remii,F,100,11,0,11
Ozric,M,100,0,8,8
Nycia,F,100,5,0,5
Rahjon,M,100,0,24,24
Shermia,F,100,16,0,16
Naiyanna,F,100,5,0,5
Greyer,M,100,0,34,34
Yenty,F,100,46,0,46
Amed,M,100,0,77,77
Yanelli,F,100,372,0,372
Damarius,M,100,0,1274,1274
Tessalee,F,100,6,0,6
Aalyha,F,100,19,0,19
Kymora,F,100,605,0,605
Sanaii,F,100,268,0,268
Brazil,F,91,329,33,362
Shamuel,M,100,0,5,5
Lexin,M,100,0,16,16
Earlin,M,100,0,5,5
Bo,M,94,572,8743,9315
Eesa,M,100,0,194,194
Shameera,F,100,6,0,6
Eaen,M,100,0,5,5
Sila,F,100,173,0,173
Lerome,M,100,0,5,5
Kishina,F,100,19,0,19
Tywin,M,100,0,5,5
Ayten,F,100,10,0,10
Alonta,M,100,0,18,18
Isabelah,F,100,13,0,13
Luley,F,100,5,0,5
Tryphena,F,100,93,0,93
Taquana,F,100,310,0,310
Derna,F,100,5,0,5
Eimaj,M,100,0,6,6
Aveya,F,100,112,0,112
Durrel,M,100,0,55,55
Malcom,M,100,0,3706,3706
Izibella,F,100,28,0,28
Ayriah,F,100,5,0,5
Anusri,F,100,5,0,5
Tiquita,F,100,11,0,11
Edwuin,M,100,0,18,18
Chambre,F,100,7,0,7
Nichollas,M,100,0,79,79
Warwick,M,100,0,15,15
Pj,M,100,0,179,179
Isain,M,100,0,11,11
Wilesha,F,100,5,0,5
Jernard,M,100,0,109,109
Domnik,M,100,0,19,19
Krishn,M,100,0,16,16
Nakya,F,100,569,0,569
Zakory,M,100,0,28,28
Breyah,F,100,139,0,139
Ellisyn,F,100,269,0,269
Chinmay,M,100,0,136,136
Drayson,M,100,0,284,284
Alyssha,F,100,75,0,75
Yaelle,F,100,18,0,18
Oakly,M,100,0,11,11
Alexondria,F,100,24,0,24
Lisann,F,100,23,0,23
Skylon,M,100,0,27,27
Eme,F,100,34,0,34
Richenda,F,100,16,0,16
Keanda,F,100,17,0,17
Rollin,M,100,0,1774,1774
Sheniah,F,100,71,0,71
Chilyn,F,100,5,0,5
Jakia,F,100,1136,0,1136
Rahjae,F,100,5,0,5
Jamisen,M,62,162,266,428
Jolayne,F,100,136,0,136
Joyful,F,100,14,0,14
Citlalic,F,100,127,0,127
Nonie,F,100,282,0,282
Rasia,F,100,8,0,8
Tyriah,F,100,33,0,33
Qamar,M,66,62,118,180
Tyequan,M,100,0,6,6
Jonquavious,M,100,0,12,12
Jinal,F,100,19,0,19
Aashay,M,100,0,24,24
Chyane,F,100,95,0,95
Jessa,F,100,3947,0,3947
Shantanique,F,100,61,0,61
Gicell,F,100,12,0,12
Camrion,M,100,0,5,5
Symia,F,100,151,0,151
Takuma,M,100,0,142,142
Eshaan,M,100,0,645,645
Delina,F,100,1240,0,1240
Leyli,F,100,78,0,78
Hattan,M,100,0,13,13
Emmagene,F,100,5,0,5
Dontae,M,100,17,5245,5262
Chrissandra,F,100,52,0,52
Brynlin,F,100,6,0,6
Jerusha,F,100,924,0,924
Courtny,F,99,500,5,505
Zyariah,F,100,6,0,6
Tayonia,F,100,5,0,5
Janell,F,100,13410,23,13433
Harrisson,M,100,0,5,5
Yahayra,F,100,199,0,199
Haskel,M,100,0,221,221
Requel,F,100,53,0,53
Yaselin,F,100,16,0,16
Vantasia,F,100,65,0,65
Karre,F,100,6,0,6
Rozell,M,90,32,283,315
Mirsha,F,100,10,0,10
Rehaan,M,100,0,166,166
Tifanni,F,100,11,0,11
Ceaser,M,100,0,500,500
Lerae,F,100,68,0,68
Kaelyb,M,100,0,6,6
Tarron,M,95,20,402,422
Starri,F,100,5,0,5
Montarius,M,100,0,117,117
Ermilo,M,100,0,5,5
Laurella,F,100,5,0,5
Allon,M,100,0,180,180
Mariam,F,100,10769,5,10774
Joshitha,F,100,6,0,6
Marvon,M,100,0,92,92
Zyliah,F,100,34,0,34
Latise,F,100,78,0,78
Eyuel,M,100,0,17,17
Saintjohn,M,100,0,5,5
Hilda,F,100,16799,40,16839
Zemira,F,100,197,0,197
Ammie,F,100,1437,0,1437
Edeline,F,100,135,0,135
Honorae,F,100,5,0,5
Miracal,F,100,5,0,5
Laraib,F,100,46,0,46
Abiud,M,100,0,6,6
Jonathen,M,100,0,1466,1466
Tilisa,F,100,23,0,23
Myunique,F,100,5,0,5
Drayven,M,100,0,252,252
Teija,F,100,19,0,19
Campion,M,100,0,5,5
Brandia,F,100,19,0,19
Tamike,F,100,43,0,43
Darleny,F,100,118,0,118
Kathrene,F,100,101,0,101
Maytte,F,100,63,0,63
Samuil,M,100,0,5,5
Kaylab,M,100,0,5,5
Loryanna,F,100,5,0,5
Randelle,F,100,22,0,22
Biko,M,100,0,30,30
Taren,F,73,1154,437,1591
Thaniel,M,100,0,56,56
Sumiya,F,100,53,0,53
Nikalas,M,100,0,98,98
Smokey,M,100,0,113,113
Siohban,F,100,5,0,5
Traveyon,M,100,0,6,6
Tanzila,F,100,10,0,10
Shequita,F,100,602,0,602
Montiera,F,100,5,0,5
Rodena,F,100,12,0,12
Ahslee,F,100,31,0,31
Jozephine,F,100,11,0,11
Jaivan,M,100,0,46,46
Blasa,F,100,5,0,5
Evany,F,100,448,0,448
Dakari,M,94,90,1468,1558
Sheliah,F,100,396,0,396
Nicquan,M,100,0,11,11
Cassietta,F,100,7,0,7
Knoxton,M,100,0,19,19
Uswa,F,100,5,0,5
Sherhonda,F,100,145,0,145
Fahren,F,100,23,0,23
Charlen,F,100,52,0,52
Deshira,F,100,22,0,22
Savino,M,100,0,277,277
Kimbley,F,100,573,0,573
Judieth,F,100,85,0,85
Eyonna,F,100,78,0,78
Yessi,F,100,6,0,6
Demacio,M,100,0,17,17
Tiffeney,F,100,53,0,53
Reinhart,M,100,0,10,10
Venetta,F,100,556,0,556
Marchelo,M,100,0,6,6
Letroy,M,100,0,161,161
Harlo,F,77,120,35,155
Meladie,F,100,47,0,47
Kaidence,F,93,2140,169,2309
Casady,F,100,61,0,61
Andreonna,F,100,6,0,6
Themis,M,100,0,5,5
Nena,F,100,3453,0,3453
Aaronjoshua,M,100,0,10,10
Reveca,F,100,102,0,102
Timia,F,100,1010,0,1010
Mara,F,100,18185,16,18201
Tashona,F,100,188,0,188
Iyonna,F,100,1458,0,1458
Arayla,F,100,53,0,53
Keza,F,100,6,0,6
Temetria,F,100,5,0,5
Tammora,F,100,5,0,5
Amerie,F,100,1713,0,1713
Zykiah,F,100,18,0,18
Kanica,F,100,6,0,6
Chadlee,M,100,0,5,5
Guylene,F,100,13,0,13
Savreen,F,100,8,0,8
Chera,F,100,468,0,468
Chrisanna,F,100,80,0,80
Rakeria,F,100,6,0,6
Jamarea,M,71,34,82,116
Maveryk,M,100,0,26,26
Correen,F,100,165,0,165
Suvilla,F,100,5,0,5
Amii,F,100,42,0,42
Kaeden,M,96,152,3666,3818
Daleyza,F,100,1988,0,1988
Khelsea,F,100,58,0,58
Kevian,M,100,0,47,47
Makiko,F,100,13,0,13
Whitaker,M,98,5,261,266
Elleana,F,100,281,0,281
Noraida,F,100,21,0,21
Salik,M,100,0,73,73
Izah,M,100,0,5,5
Amonta,M,100,0,5,5
Mohamud,M,100,0,150,150
Xavious,M,100,0,94,94
Roozbeh,M,100,0,16,16
Reida,F,100,144,0,144
Shatonya,F,100,220,0,220
Quanicia,F,100,5,0,5
Rehmat,F,100,5,0,5
Synnove,F,100,6,0,6
Avionce,F,100,17,0,17
Emmanual,M,100,0,423,423
Kany,F,100,12,0,12
Jasibe,F,100,5,0,5
Shamyia,F,100,345,0,345
Talhia,F,100,18,0,18
Enzlee,F,100,6,0,6
Maizee,F,100,114,0,114
Srinitya,F,100,8,0,8
Amanda,F,100,760241,2133,762374
Jenniger,F,100,47,0,47
Treyor,M,100,0,13,13
Angelisha,F,100,6,0,6
Emilyna,F,100,5,0,5
Jemia,F,100,176,0,176
Jamaya,F,100,1893,0,1893
Ylani,F,100,5,0,5
Edinson,M,100,0,115,115
Alienna,F,100,5,0,5
Mahadi,M,100,0,10,10
Daden,M,100,0,93,93
Adalicia,F,100,15,0,15
Shaneqa,F,100,10,0,10
Breeahna,F,100,6,0,6
Adahli,F,100,23,0,23
Zamonte,M,100,0,11,11
Bobbiesue,F,100,26,0,26
Niyah,F,100,2024,0,2024
Johnisha,F,100,464,0,464
Morena,F,100,247,0,247
Prisha,F,100,1136,0,1136
Slater,M,100,0,1269,1269
Lil,F,100,94,0,94
Syrene,F,100,5,0,5
Queenie,F,100,1128,0,1128
Aujah,F,100,10,0,10
Jamele,M,100,0,49,49
Marlaena,F,100,10,0,10
Chirstine,F,100,117,0,117
Corye,M,100,0,49,49
Maurey,M,100,0,5,5
Michaeel,M,100,0,33,33
Ssirley,F,100,5,0,5
Zaelon,M,100,0,7,7
Hageo,M,100,0,5,5
Aariah,F,100,163,0,163
Elnoria,F,100,14,0,14
Carllene,F,100,6,0,6
Luna,F,100,13078,7,13085
Dereon,M,76,345,1104,1449
Wysteria,F,100,11,0,11
Jamille,F,63,438,260,698
Curtisa,F,100,30,0,30
Jesselin,F,100,45,0,45
Symphony,F,100,1615,0,1615
Karalee,F,100,1042,0,1042
Zoheb,M,100,0,5,5
Ahyanna,F,100,53,0,53
Yalina,F,100,26,0,26
Jakiylah,F,100,5,0,5
Yuseff,M,100,0,11,11
Arnice,F,100,53,0,53
Name,M,68,11,23,34
Oziel,M,100,0,1473,1473
Semajay,M,100,0,57,57
Virdell,F,100,5,0,5
Yahshua,M,100,0,148,148
Kaitlynd,F,100,99,0,99
Huie,M,100,0,13,13
Glenys,F,100,154,0,154
Jaquann,M,100,0,114,114
Deonie,F,100,5,0,5
Hoku,M,100,0,5,5
Nemesio,M,100,0,58,58
Arim,F,100,5,0,5
Oakli,F,100,13,0,13
Zilphia,F,100,6,0,6
Ries,M,100,0,39,39
Kainan,M,100,0,412,412
Briannica,F,100,6,0,6
Zalaiyah,F,100,11,0,11
Daryll,M,99,11,1459,1470
Joeline,F,100,72,0,72
Andea,F,100,5,0,5
Romey,M,52,84,92,176
Jerriel,M,100,0,29,29
Mattan,M,100,0,44,44
Byrdie,F,100,5,0,5
Kalaina,F,100,23,0,23
Shelonda,F,100,279,0,279
Nealey,F,100,15,0,15
Oved,M,100,0,55,55
Millette,F,100,86,0,86
Kianta,F,100,5,0,5
Carion,M,100,0,17,17
Ronke,F,100,5,0,5
Sanyah,F,100,301,0,301
Jencie,F,100,11,0,11
Latrica,F,100,503,0,503
Khobe,M,100,0,19,19
Manzie,M,100,0,5,5
Treniece,F,100,185,0,185
Gregor,M,100,0,822,822
Erikk,M,100,0,12,12
Ariyannah,F,100,79,0,79
Wyvonnia,F,100,11,0,11
Yariel,M,99,10,1074,1084
Kendry,M,87,22,148,170
Valissa,F,100,214,0,214
Jamilliah,F,100,6,0,6
Yaxaira,F,100,7,0,7
Alyjah,M,83,45,219,264
Finnlay,M,100,0,5,5
Omotola,F,100,11,0,11
Sherlene,F,100,696,0,696
Cheryse,F,100,21,0,21
Capucine,F,100,107,0,107
Baretta,M,72,20,52,72
Gabrelle,F,100,235,0,235
Amaury,M,100,5,1117,1122
Laloni,F,100,78,0,78
Essance,F,100,169,0,169
Ayanle,M,100,0,11,11
Nianna,F,100,79,0,79
Kween,F,100,7,0,7
Maresa,F,100,581,0,581
Zipora,F,100,40,0,40
Sebastyn,M,100,0,20,20
Railey,F,92,543,48,591
Quatavious,M,100,0,66,66
Oluwabukunmi,F,100,6,0,6
Nolton,M,100,0,5,5
Cedrica,F,100,69,0,69
Cedeno,M,100,0,7,7
Libi,F,100,42,0,42
Gatsby,M,100,0,24,24
Ileane,F,100,30,0,30
Devida,F,100,43,0,43
Yanire,F,100,11,0,11
Tiniya,F,100,50,0,50
Elithia,F,100,5,0,5
Assaf,M,100,0,6,6
Tavonne,M,76,5,16,21
Aiedan,M,100,0,5,5
Rhylon,M,100,0,5,5
Yuvansh,M,100,0,6,6
Judiann,F,100,70,0,70
Jillan,F,100,10,0,10
Ryatt,M,98,7,292,299
Adrik,M,100,0,340,340
Shaphan,M,100,0,53,53
Paytynn,F,100,6,0,6
Torriyah,F,100,5,0,5
Kai,M,84,5034,27083,32117
Cailee,F,100,1344,0,1344
Nouh,M,100,0,28,28
Mylii,F,100,5,0,5
Jilliann,F,100,326,0,326
Quianna,F,100,865,0,865
Joshusa,M,100,0,10,10
Chessa,F,100,386,0,386
Siedah,F,100,271,0,271
Ariadny,F,100,6,0,6
Keydren,M,100,0,11,11
Areesha,F,100,110,0,110
Miquel,M,95,92,1905,1997
Kunj,M,100,0,45,45
Lennex,M,72,10,26,36
Krystofer,M,100,0,163,163
Shekina,F,100,176,0,176
Brinlynn,F,100,31,0,31
Columba,F,100,37,0,37
Zared,M,100,0,106,106
Shyreeta,F,100,8,0,8
Xena,F,100,1529,0,1529
Kiernan,M,73,511,1355,1866
Angelene,F,100,1345,0,1345
Cindyann,F,100,15,0,15
Maithe,F,100,14,0,14
Jdin,M,100,0,6,6
Cartina,F,100,104,0,104
Siryah,F,100,5,0,5
Joanette,F,100,294,0,294
Kourtnie,F,100,657,0,657
Elvira,F,100,8476,0,8476
Eilam,M,100,0,35,35
Kyriee,M,100,0,6,6
Razia,F,100,57,0,57
Datwon,M,100,0,10,10
Patches,F,100,151,0,151
Illianna,F,100,253,0,253
Aynara,F,100,7,0,7
Alonah,F,100,230,0,230
Forbes,M,100,0,46,46
Rayniel,M,100,0,30,30
Lancy,M,100,0,26,26
Maxence,M,100,0,35,35
Dachelle,F,100,107,0,107
Pietro,M,100,0,1584,1584
Alpheus,M,100,0,135,135
Charlottle,F,100,5,0,5
Tyrona,F,100,10,0,10
Zaven,M,100,0,288,288
Schafer,M,100,0,42,42
Diamoni,F,100,5,0,5
Kasheem,M,100,0,107,107
Alixa,F,100,10,0,10
Shonika,F,100,112,0,112
Banning,M,100,0,45,45
Ezaan,M,100,0,6,6
Rayquon,M,100,0,70,70
Dasany,F,100,25,0,25
Debarah,F,100,231,0,231
Yonny,M,100,0,26,26
Patreece,F,100,42,0,42
Jakisha,F,100,48,0,48
Patirica,F,100,80,0,80
Kahl,M,100,0,17,17
Bernetta,F,100,1140,0,1140
Lasonya,F,100,1700,0,1700
Braxlee,M,100,0,7,7
Annastazia,F,100,55,0,55
Rimi,F,100,6,0,6
Maryfrances,F,100,691,0,691
Nahome,M,100,0,66,66
Kenzel,M,100,0,120,120
Abu,M,100,0,360,360
Deamontae,M,100,0,21,21
Kaavya,F,100,277,0,277
Safeer,M,100,0,22,22
Mickinley,F,100,5,0,5
Gladiz,F,100,10,0,10
Serah,F,100,546,0,546
Monzeratt,F,100,7,0,7
Henri,M,94,181,2892,3073
Erling,M,100,0,148,148
Lilli,F,100,2706,0,2706
Dasha,F,100,3200,0,3200
Taurean,M,98,45,2097,2142
Kalasia,F,100,79,0,79
Neeley,F,100,370,0,370
Chaylin,F,100,33,0,33
Asyra,F,100,6,0,6
Caitlynd,F,100,22,0,22
Chante,F,99,3928,33,3961
Farjana,F,100,6,0,6
Ramy,M,100,0,811,811
Zymya,F,100,6,0,6
Lillyana,F,100,2187,0,2187
Choyce,F,57,33,25,58
Takumi,M,100,0,380,380
Hermila,F,100,148,0,148
Sandler,M,100,0,43,43
Shivali,F,100,203,0,203
Shameia,F,100,36,0,36
Gurinder,M,100,0,26,26
Evlin,F,100,23,0,23
Loribeth,F,100,130,0,130
Janeane,F,100,373,0,373
Joray,M,100,0,5,5
Samuael,M,100,0,5,5
Mithran,M,100,0,20,20
Simao,M,100,0,24,24
Anihya,F,100,89,0,89
Alivn,M,100,0,15,15
Vinnie,M,56,519,657,1176
Constence,F,100,5,0,5
Sok,M,78,8,28,36
Plutarco,M,100,0,5,5
Vayla,F,100,80,0,80
Rujuta,F,100,5,0,5
Abdulazeem,M,100,0,5,5
Wondra,F,100,33,0,33
Analeigha,F,100,112,0,112
Cordellia,F,100,35,0,35
Rochanda,F,100,62,0,62
Kyle,M,98,8358,467991,476349
Ninette,F,100,695,0,695
Dree,F,100,7,0,7
Nicoel,F,100,5,0,5
Latoni,F,100,31,0,31
Aundraya,F,100,81,0,81
Madysin,F,100,250,0,250
Missie,F,100,498,0,498
Maral,F,100,281,0,281
Jennilynn,F,100,11,0,11
Haizen,M,100,0,6,6
Kasadee,F,100,6,0,6
Terresa,F,100,1499,0,1499
Letonia,F,100,86,0,86
Ellieann,F,100,17,0,17
Jacon,M,100,0,90,90
Kynsley,F,100,269,0,269
Daezon,M,100,0,10,10
Zaileigh,F,100,22,0,22
Makhai,M,100,0,473,473
Davidpaul,M,100,0,5,5
Kamdin,M,98,5,214,219
Madelyne,F,100,2369,0,2369
Fouad,M,100,0,324,324
Ronise,F,100,24,0,24
Doniece,F,100,39,0,39
Amannda,F,100,23,0,23
Shekila,F,100,44,0,44
Anferney,M,100,0,5,5
Glenne,F,100,5,0,5
Keeanna,F,100,69,0,69
Murl,M,97,11,324,335
Alzora,F,100,12,0,12
Kymon,M,100,0,37,37
Maronda,F,100,100,0,100
Connee,F,100,98,0,98
Masion,M,100,0,10,10
Aanika,F,100,214,0,214
Dason,M,100,0,486,486
Asta,F,100,112,0,112
Clois,M,100,0,102,102
Tyanthony,M,100,0,52,52
Joannie,F,100,1431,0,1431
Riddic,M,100,0,5,5
Kathyria,F,100,21,0,21
Adamo,M,100,0,11,11
Eleina,F,100,170,0,170
Salayna,F,100,5,0,5
Karrin,F,100,367,0,367
Nekko,M,100,0,29,29
Lapatrick,M,100,0,57,57
Tybriana,F,100,5,0,5
Robeto,M,100,0,10,10
Marchello,M,100,0,500,500
Caseyann,F,100,20,0,20
Aireal,F,100,252,0,252
Qusay,M,100,0,46,46
Nechemya,M,100,0,11,11
Leilannie,F,100,11,0,11
Miral,F,100,92,0,92
Kewon,M,100,0,253,253
Zhyaire,M,100,0,25,25
Zichen,M,100,0,5,5
Jyon,M,100,0,15,15
Perrine,F,100,12,0,12
Wynnston,M,100,0,5,5
Brittne,F,100,263,0,263
Skylin,F,95,462,24,486
Joniell,M,100,0,5,5
Odeth,F,100,63,0,63
Azira,F,100,10,0,10
Dharmik,M,100,0,12,12
Carla,F,100,134874,415,135289
Rhylie,F,100,322,0,322
Jawanda,F,100,257,0,257
Rowin,M,91,7,67,74
Daneisy,F,100,10,0,10
Sabriyya,F,100,17,0,17
Juleimy,F,100,5,0,5
Aili,F,100,637,0,637
Caoimhe,F,100,217,0,217
Reon,M,100,0,96,96
Marcuz,M,100,0,19,19
Shylin,F,100,115,0,115
Branoon,M,100,0,11,11
Willisha,F,100,95,0,95
Ionia,F,100,18,0,18
Marqavious,M,100,0,30,30
Joleene,F,100,83,0,83
Jeilani,F,100,39,0,39
Braylynn,F,90,668,74,742
Laylanna,F,100,5,0,5
Zurisaday,F,100,41,0,41
Lamija,F,100,54,0,54
Jondra,F,100,5,0,5
Zamera,F,100,12,0,12
Yeidan,M,100,0,5,5
Shou,M,100,0,10,10
Thearon,M,100,0,10,10
Thadius,M,100,0,456,456
Desmona,F,100,27,0,27
Ricketa,F,100,12,0,12
Delailah,F,100,101,0,101
Mekenna,F,100,365,0,365
Zaedyn,M,98,5,280,285
Gatha,F,100,100,0,100
Tremar,M,100,0,65,65
Zentavious,M,100,0,5,5
Saajid,M,100,0,11,11
Vanja,F,100,5,0,5
Leighlah,F,100,16,0,16
Kyante,M,77,5,17,22
Pollux,M,100,0,16,16
Takwon,M,100,0,11,11
Ilham,F,96,137,5,142
Amaurys,M,100,0,10,10
Shataura,F,100,5,0,5
Husnain,M,100,0,18,18
Keighly,F,100,58,0,58
Numan,M,100,0,58,58
Homer,M,100,21,9838,9859
Kyriana,F,100,114,0,114
Mikaiah,F,85,56,10,66
Jhasir,M,100,0,5,5
Madelayne,F,100,11,0,11
Malic,M,100,0,121,121
Shawntea,F,100,29,0,29
Tavleen,F,100,6,0,6
Camiya,F,100,376,0,376
Chandy,F,100,91,0,91
Kennyetta,F,100,15,0,15
Avynn,F,100,44,0,44
Jhourni,F,100,17,0,17
January,F,100,1976,0,1976
Edrian,M,100,0,188,188
Thelonious,M,100,0,272,272
Charade,F,100,11,0,11
Elea,F,100,150,0,150
Keniel,M,100,0,142,142
Estevon,M,100,0,89,89
Toure,M,100,0,381,381
Makinsley,F,100,44,0,44
Arvo,M,100,0,11,11
Yukon,M,100,0,5,5
Amilian,F,100,29,0,29
Shamise,F,100,5,0,5
Karlotta,F,100,47,0,47
Cassiday,F,100,11,0,11
Shatell,F,100,5,0,5
Rajane,F,100,9,0,9
Yorleny,F,100,34,0,34
Khelen,M,100,0,5,5
Xavius,M,100,0,174,174
Faleisha,F,100,5,0,5
Darnel,M,95,50,958,1008
Melvern,M,100,0,7,7
Johna,F,100,2240,6,2246
Nakeria,F,100,52,0,52
Zachaery,M,100,0,10,10
Kysha,F,100,411,0,411
Meeyah,F,100,46,0,46
Selisa,F,100,83,0,83
Jamara,F,95,852,45,897
Deysha,F,100,107,0,107
Ishia,F,100,147,0,147
Yeraldo,M,100,0,23,23
Yaniz,F,100,10,0,10
Asmahan,F,100,15,0,15
Daneshia,F,100,258,0,258
Renona,F,100,36,0,36
Kevious,M,100,0,5,5
Caydince,F,100,40,0,40
Margart,F,100,162,0,162
Dairra,F,100,10,0,10
Tashani,F,100,16,0,16
Cadesha,F,100,40,0,40
Cortney,F,85,16850,3051,19901
Wanda,F,100,138048,491,138539
Keosha,F,100,1884,0,1884
Damarria,F,100,19,0,19
Brandii,F,100,189,0,189
Arlys,F,100,206,0,206
Tex,M,100,0,745,745
Shadwick,M,100,0,18,18
Ishaanvi,F,100,6,0,6
Kenndra,F,100,114,0,114
Calvon,M,100,0,53,53
Esrom,M,100,0,29,29
Devin,M,90,16546,146363,162909
Makell,M,63,148,255,403
Alissondra,F,100,5,0,5
Amberley,F,100,586,0,586
Autum,F,100,3113,0,3113
Tamsin,F,100,240,0,240
Gaberial,M,96,16,420,436
Parin,M,100,0,36,36
Biviana,F,100,240,0,240
Ejay,M,100,0,95,95
Shataria,F,100,78,0,78
Ithan,M,100,0,94,94
Cresenciano,M,100,0,6,6
Anival,M,100,0,278,278
Annaley,F,100,25,0,25
Loyd,M,100,0,4668,4668
Kasha,F,100,1488,0,1488
Lavoria,F,100,12,0,12
Arlean,F,100,422,0,422
Kiry,M,100,0,20,20
Tonyna,F,100,6,0,6
Mayline,F,100,95,0,95
Daejohn,M,100,0,29,29
Chidumebi,F,100,5,0,5
Semantha,F,100,19,0,19
Felise,F,100,63,0,63
Hydeia,F,100,214,0,214
Alexxus,F,100,416,0,416
Mally,F,100,127,0,127
Vibiana,F,100,12,0,12
Nicson,M,100,0,6,6
Laci,F,100,8869,0,8869
Daquawn,M,100,0,158,158
Fenway,M,100,0,34,34
Marique,M,100,0,6,6
Elliemarie,F,100,8,0,8
Talesa,F,100,37,0,37
Hartleigh,F,100,39,0,39
Aurelio,M,100,6,4623,4629
Jonni,F,100,1122,5,1127
Jeiny,F,100,6,0,6
Roshanta,F,100,5,0,5
Odaly,F,100,77,0,77
Jenevieve,F,100,925,0,925
Alandria,F,100,453,0,453
Apasra,F,100,5,0,5
Saeeda,F,100,40,0,40
Nahom,M,100,0,605,605
Jazzmyn,F,100,1048,0,1048
Ilayda,F,100,105,0,105
Catinia,F,100,17,0,17
Shamala,F,100,11,0,11
Ekow,M,100,0,5,5
Sianni,F,100,207,0,207
Coraly,F,100,6,0,6
Laquetta,F,100,939,0,939
Sabarin,F,100,5,0,5
Janessa,F,100,12151,0,12151
Ayrika,F,100,47,0,47
Franciso,M,100,0,453,453
Nelia,F,100,663,0,663
Jacia,F,100,92,0,92
Annalis,F,100,149,0,149
Makenzee,F,100,829,0,829
Juanpablo,M,100,0,1478,1478
Curtice,M,100,0,27,27
Becker,M,100,0,249,249
Jerrianne,F,100,55,0,55
Dequon,M,100,0,172,172
Damontae,M,100,0,500,500
Lequentin,M,100,0,10,10
Joyal,F,100,19,0,19
Gabrionna,F,100,5,0,5
Seumas,M,100,0,5,5
Jonluke,M,100,0,121,121
Aryes,M,100,0,6,6
Khamel,M,100,0,5,5
Brielyn,F,100,107,0,107
Braxx,M,100,0,5,5
Urmi,F,100,45,0,45
Keethan,M,100,0,5,5
Draelyn,M,100,0,16,16
Adaiah,F,84,167,33,200
Tequesta,F,100,17,0,17
Chaye,F,100,50,0,50
Tahmina,F,100,48,0,48
Serrah,F,100,10,0,10
Aleanah,F,100,18,0,18
Rhyker,M,100,0,106,106
Anwen,F,100,127,0,127
Kristol,F,100,255,0,255
Chanyia,F,100,13,0,13
Dorise,F,100,205,0,205
Jadell,M,100,0,17,17
Vahan,M,100,0,98,98
Couy,M,100,0,6,6
Laasia,F,100,236,0,236
Yeritza,F,100,6,0,6
Ganiyah,F,100,50,0,50
Kiniyah,F,100,18,0,18
Quindon,M,100,0,114,114
Ankush,M,100,0,151,151
Kaizen,M,100,0,200,200
Vendetta,F,100,178,0,178
Yariza,F,100,60,0,60
Ladainian,M,100,0,424,424
Yoscar,M,100,0,31,31
Laconda,F,100,123,0,123
Adrea,F,100,698,0,698
Ovida,F,100,21,0,21
Carianne,F,100,496,0,496
Quaheem,M,100,0,5,5
Kylla,F,100,47,0,47
Lasean,M,71,155,384,539
Sarie,F,100,90,0,90
Loanna,F,100,7,0,7
Chavaughn,F,100,10,0,10
Dainna,F,100,5,0,5
Tyerra,F,100,176,0,176
Maddielynn,F,100,24,0,24
Domineque,F,63,26,15,41
Urhonda,F,100,5,0,5
Jennefer,F,100,1497,0,1497
Cedar,M,56,750,951,1701
Kaena,F,76,58,18,76
Shawnte,F,93,1383,102,1485
Kristia,F,100,417,0,417
Vritika,F,100,10,0,10
Khemari,M,100,0,5,5
Krysteena,F,100,79,0,79
Leightyn,F,100,89,0,89
Kieryn,F,94,177,11,188
Parminder,M,52,15,16,31
Aryion,M,100,0,12,12
Tayviona,F,100,5,0,5
Jessten,M,100,0,5,5
Nazr,M,100,0,5,5
Temeika,F,100,54,0,54
Kenan,M,99,30,3084,3114
Aairah,F,100,24,0,24
Kennidi,F,100,231,0,231
Fawnda,F,100,70,0,70
Lakersha,F,100,5,0,5
Tylecia,F,100,21,0,21
Soriah,F,100,240,0,240
Layanah,F,100,14,0,14
Rolisha,F,100,18,0,18
Callissa,F,100,5,0,5
Aleyiah,F,100,45,0,45
Daveontae,M,100,0,8,8
Shavia,F,100,10,0,10
Jasy,F,100,5,0,5
Jaryel,M,100,0,5,5
Mikolaj,M,100,0,159,159
Kalayshia,F,100,17,0,17
Maximillion,M,100,0,463,463
Malajah,F,100,205,0,205
Ailah,F,100,98,0,98
Annalysa,F,100,166,0,166
Tristynn,F,100,52,0,52
Erabella,F,100,96,0,96
Matea,F,100,622,0,622
Zidan,M,100,0,143,143
Leilanni,F,100,171,0,171
Ishmeal,M,100,0,212,212
Ribaldo,M,100,0,13,13
Shalese,F,100,209,0,209
Kymberly,F,100,2960,0,2960
Nichoel,F,100,131,0,131
Jailon,M,100,0,252,252
Nydia,F,100,3384,0,3384
Ayrin,F,100,12,0,12
Frasier,M,100,0,30,30
Alycen,F,100,53,0,53
Zuhra,F,100,10,0,10
Anakaren,F,100,985,0,985
Chibuike,M,100,0,94,94
Dokota,M,100,0,55,55
Kristifer,M,100,0,28,28
Hollyn,F,100,726,0,726
Xophia,F,100,16,0,16
Velna,F,100,18,0,18
Biancamarie,F,100,10,0,10
Laverta,F,100,61,0,61
Breckynn,F,100,6,0,6
Kalirose,F,100,15,0,15
Brenham,M,100,0,19,19
Sinahi,F,100,88,0,88
Souad,F,100,16,0,16
Jvonte,M,100,0,45,45
Slade,M,100,0,3993,3993
Jyrell,M,100,0,56,56
Mickiel,M,100,0,5,5
Filomena,F,100,1070,0,1070
Jaydden,M,100,0,45,45
Taryah,F,100,47,0,47
Mextli,F,100,5,0,5
Arreana,F,100,6,0,6
Angeleca,F,100,5,0,5
Tatyona,F,100,36,0,36
Ashlii,F,100,6,0,6
Erbin,M,100,0,5,5
Bradlee,M,95,157,2996,3153
Saylem,F,100,11,0,11
Bernie,M,90,510,4523,5033
Gregori,M,100,0,78,78
Aleca,F,100,5,0,5
Benzel,M,100,0,5,5
Amone,F,100,5,0,5
Abdiwali,M,100,0,5,5
Jliyah,F,100,11,0,11
Aubreonna,F,100,21,0,21
Salathia,F,100,10,0,10
Barbarba,F,100,5,0,5
Aliannie,F,100,5,0,5
Yazuri,F,100,13,0,13
Chara,F,100,925,0,925
Michaeleen,F,100,187,0,187
Andrey,M,95,100,2013,2113
Rossie,F,54,253,212,465
Kaceton,M,100,0,7,7
Geremias,M,100,0,21,21
Alane,F,100,1551,0,1551
Selema,F,100,6,0,6
Andrelle,F,100,11,0,11
Takia,F,100,1957,0,1957
Magally,F,100,110,0,110
Blakesley,F,100,11,0,11
Waynetta,F,100,148,0,148
Shaniesha,F,100,22,0,22
Brieanne,F,100,662,0,662
Marilia,F,100,28,0,28
Amaal,F,100,80,0,80
Keiran,M,84,136,737,873
Vartan,M,100,0,157,157
Isaihas,M,100,0,6,6
Limuel,M,100,0,8,8
Franchessca,F,100,8,0,8
Euphemia,F,100,86,0,86
Jannine,F,100,660,0,660
Kynidee,F,100,6,0,6
Shakim,M,100,0,428,428
Antonieta,F,100,156,0,156
Calicia,F,100,27,0,27
Teng,M,100,0,354,354
Sharitza,F,100,6,0,6
Amontae,M,100,0,159,159
Ajuni,F,100,16,0,16
Suetta,F,100,60,0,60
Traquan,M,100,0,317,317
Mohamad,M,100,0,2869,2869
Vija,F,100,5,0,5
Alaney,F,100,69,0,69
Dorean,F,67,182,90,272
Shaquel,F,52,78,73,151
Aubreyelle,F,100,5,0,5
Kawon,M,100,0,154,154
Kaylianne,F,100,5,0,5
Celsi,F,100,5,0,5
Jesabel,F,100,26,0,26
Cataleena,F,100,5,0,5
Kiaya,F,100,729,0,729
Mitchum,M,100,0,44,44
Lashunda,F,100,2270,0,2270
Jaiyanna,F,100,51,0,51
Ayrton,M,100,0,522,522
Sanita,F,100,248,0,248
Quentine,M,100,0,35,35
Jessuly,F,100,18,0,18
Chinda,F,100,39,0,39
Jaisean,M,100,0,158,158
Oceane,F,100,76,0,76
Belle,F,100,3525,0,3525
Abhijay,M,100,0,90,90
Eliseo,M,100,0,6928,6928
Hadasha,F,100,16,0,16
Aveonna,F,100,21,0,21
Abinadab,M,100,0,5,5
Chylar,F,100,7,0,7
Hiro,M,100,0,234,234
Keeyana,F,100,32,0,32
Shalea,F,100,389,0,389
Jamesia,F,100,651,0,651
Avash,M,100,0,6,6
Wake,M,100,0,56,56
Mayly,F,100,5,0,5
Ronisue,F,100,13,0,13
Kaiel,M,100,0,65,65
Agustine,M,100,0,441,441
Kyrion,M,100,0,31,31
Aristedes,M,100,0,5,5
Naail,M,100,0,18,18
Nooria,F,100,5,0,5
Jakolby,M,100,0,128,128
Karicia,F,100,45,0,45
Nasyah,F,100,27,0,27
Leiani,F,100,123,0,123
Satonya,F,100,89,0,89
Yermi,M,100,0,6,6
Kayliegh,F,100,341,0,341
Jayciana,F,100,17,0,17
Yvon,M,78,47,162,209
Thalia,F,100,10773,0,10773
Sharrona,F,100,6,0,6
Tomorrow,F,100,254,0,254
Leshun,M,75,7,21,28
Kentoria,F,100,39,0,39
Leeara,F,100,5,0,5
Ambree,F,100,381,0,381
Jenaro,M,100,0,544,544
Tylo,M,68,13,27,40
Danye,M,77,12,41,53
Leamber,F,100,19,0,19
Olatunde,M,100,0,19,19
Vi,F,87,813,125,938
Jondarius,M,100,0,20,20
Jomari,M,81,59,244,303
Abdulmajid,M,100,0,15,15
Saviel,M,100,0,16,16
Kinnon,M,100,0,7,7
Marinell,F,100,58,0,58
Rito,M,100,0,1002,1002
Arhum,M,100,0,101,101
Terrel,M,98,49,2442,2491
Tineke,F,100,23,0,23
Bowen,M,98,61,3996,4057
Jehlani,M,100,0,5,5
Violeta,F,100,4972,5,4977
Finesse,F,95,189,10,199
Eljay,M,100,0,69,69
Kyleigh,F,100,15853,6,15859
Olita,F,100,32,0,32
Keilyn,F,81,716,163,879
Kyondra,F,100,6,0,6
Rhylee,F,89,1025,129,1154
Clifton,M,99,189,36851,37040
Jabrina,F,100,13,0,13
Weslynn,F,100,41,0,41
Zayven,M,100,0,65,65
Quamisha,F,100,6,0,6
Nichola,F,86,794,127,921
Treytin,M,100,0,10,10
Shye,F,94,72,5,77
Shanyiah,F,100,86,0,86
Jeter,M,100,0,413,413
Jon,M,99,915,138741,139656
Lindajo,F,100,13,0,13
Kyjaun,M,100,0,6,6
Andjoua,F,100,6,0,6
Onan,M,100,0,12,12
Armida,F,100,1516,0,1516
Justinia,F,100,5,0,5
Anvit,M,100,0,22,22
Desiya,F,100,12,0,12
Shalene,F,100,848,0,848
Deserie,F,100,922,0,922
Khalani,F,90,138,15,153
Manuell,M,100,0,5,5
Maiyah,F,100,374,0,374
Jocelynmarie,F,100,5,0,5
Monek,F,100,6,0,6
Keayra,F,100,72,0,72
Valari,F,100,88,0,88
Lagarius,M,100,0,7,7
Harseerat,F,100,13,0,13
Tyronne,M,100,0,1113,1113
Corieon,M,100,0,10,10
Nikayia,F,100,6,0,6
Wayneisha,F,100,50,0,50
Chyrstal,F,100,28,0,28
Lanequa,F,100,10,0,10
Emad,M,100,0,567,567
Maritere,F,100,56,0,56
Namiah,F,100,111,0,111
Venda,F,100,99,0,99
Adlar,M,100,0,5,5
Gamal,M,100,0,417,417
Cadance,F,99,843,5,848
Lashella,F,100,11,0,11
Dequinn,M,100,0,20,20
Haidin,M,81,5,21,26
Oladele,M,100,0,5,5
Itzy,F,100,95,0,95
Kamen,M,100,0,344,344
Kymori,F,100,10,0,10
Romania,F,100,15,0,15
Kolben,M,100,0,47,47
Teres,F,100,45,0,45
Leva,F,100,34,0,34
Rhamel,M,100,0,26,26
Debrina,F,100,95,0,95
Caylor,M,52,77,83,160
Alden,M,92,711,7997,8708
Davarrio,M,100,0,5,5
Jashandeep,M,100,0,11,11
Siyuan,M,100,0,14,14
Tyshia,F,100,192,0,192
Staysha,F,100,92,0,92
Malecia,F,100,10,0,10
Angeliqua,F,100,32,0,32
Xania,F,100,41,0,41
Marthena,F,100,5,0,5
Ronney,M,100,0,1143,1143
Carelle,F,100,5,0,5
Cartrell,M,100,0,141,141
Kaylib,M,100,0,114,114
Montiara,F,100,5,0,5
Jaley,F,100,348,0,348
Jasmyne,F,100,3882,0,3882
Bonell,M,100,0,5,5
Parag,M,100,0,199,199
Kortlyn,F,100,180,0,180
Vannetta,F,100,15,0,15
Jacore,M,100,0,5,5
Ibn,M,100,0,828,828
Anora,F,100,295,0,295
Ryshaun,M,100,0,6,6
Emori,F,87,292,45,337
Quaran,M,100,0,81,81
Cataldo,M,100,0,5,5
Kariah,F,100,333,0,333
Chelsia,F,100,386,0,386
Jlan,M,100,0,6,6
November,F,100,526,0,526
Victorene,F,100,5,0,5
Veida,F,100,44,0,44
Jessinia,F,100,33,0,33
Shontelle,F,100,257,0,257
Hudsyn,F,57,178,133,311
Zacharay,M,100,0,27,27
Melena,F,100,1128,0,1128
Eliab,M,100,0,350,350
Seoyoon,F,100,5,0,5
Alithea,F,100,57,0,57
Xaiver,M,100,0,963,963
Karmello,M,100,0,301,301
Zarin,M,53,92,105,197
Jenniya,F,100,16,0,16
Jhamilet,F,100,5,0,5
Anae,F,100,80,0,80
Catrinna,F,100,5,0,5
Evalett,F,100,13,0,13
Ruqayah,F,100,23,0,23
Preetam,M,100,0,5,5
Somi,F,100,11,0,11
Gantt,M,100,0,5,5
Cirilo,M,100,0,767,767
Zissy,F,100,485,0,485
Marquavius,M,100,0,322,322
Zaneb,F,100,15,0,15
Ennio,M,100,0,43,43
Martena,F,100,17,0,17
Zyianna,F,100,16,0,16
Jaeson,M,100,0,502,502
Kilynn,F,100,233,0,233
Viney,F,100,18,0,18
Marck,M,100,0,561,561
Belynda,F,100,755,0,755
Amedee,M,100,0,10,10
Aremy,F,100,17,0,17
Shaquirra,F,100,5,0,5
Laini,F,100,300,0,300
Cephus,M,100,0,381,381
Lanell,F,77,1171,349,1520
Andra,F,65,4732,2530,7262
Miosotis,F,100,76,0,76
Koreem,M,100,0,5,5
Imanee,F,100,47,0,47
Jemon,M,100,0,5,5
Jadelyn,F,100,1639,0,1639
Jamarley,M,100,0,7,7
Breandrea,F,100,6,0,6
Rahna,F,100,5,0,5
Saro,M,100,0,16,16
Kriti,F,100,270,0,270
Kataliyah,F,100,22,0,22
Leif,M,100,5,6857,6862
Ahtziry,F,100,273,0,273
Tarlisha,F,100,11,0,11
Tysaun,M,100,0,8,8
Alondrea,F,100,11,0,11
Temple,F,76,1083,340,1423
Vincy,F,100,60,0,60
Marialaura,F,100,7,0,7
Raeqwon,M,100,0,74,74
Laquaysha,F,100,19,0,19
Jazelyn,F,100,157,0,157
Aboubakar,M,100,0,30,30
Matthewdavid,M,100,0,5,5
Karcynn,F,100,7,0,7
Kingelijah,M,100,0,12,12
Trence,M,100,0,25,25
Zyiah,F,100,113,0,113
Romale,M,100,0,27,27
Sharidan,F,100,11,0,11
Jacklen,F,100,5,0,5
Sharece,F,100,217,0,217
Aarren,M,100,0,5,5
Wylan,M,100,0,177,177
Shonette,F,100,160,0,160
Cardae,M,100,0,46,46
Dentrell,M,100,0,29,29
Breze,F,100,5,0,5
Merrie,F,100,1811,0,1811
Hannabelle,F,100,11,0,11
Hossein,M,100,0,40,40
Meilin,F,100,220,0,220
Brigitt,F,100,120,0,120
Sarahgrace,F,100,161,0,161
Ellory,F,100,326,0,326
Thanos,M,100,0,28,28
Demia,F,100,554,0,554
Avey,F,100,91,0,91
Zy,M,85,6,34,40
Pranita,F,100,30,0,30
Kuuipo,F,100,172,0,172
Larica,F,100,53,0,53
Thesha,F,100,6,0,6
Johnnae,F,100,182,0,182
Dainen,M,100,0,17,17
Charnee,F,100,83,0,83
Vernadean,F,100,6,0,6
Dellaney,F,100,16,0,16
Marcianna,F,100,63,0,63
Toriah,F,100,31,0,31
Aayra,F,100,5,0,5
Demerrick,M,100,0,5,5
Eldrige,M,100,0,5,5
Leighann,F,100,3241,0,3241
Kiyan,M,97,28,819,847
Kenslee,F,100,472,0,472
Karagen,F,100,12,0,12
Quinnell,M,100,0,5,5
Dayrin,F,100,146,0,146
Zhanea,F,100,5,0,5
Danterius,M,100,0,6,6
Shantesha,F,100,5,0,5
Zanaya,F,100,437,0,437
Tampatha,F,100,27,0,27
Merridy,F,100,19,0,19
Soukaina,F,100,5,0,5
Kaaden,M,100,0,16,16
Arelle,F,100,12,0,12
Londan,F,100,113,0,113
Ebb,M,100,0,18,18
Latiffany,F,100,223,0,223
Davyn,M,88,68,478,546
Courtlynn,F,100,248,0,248
Quetin,M,100,0,31,31
Aariyana,F,100,74,0,74
Alonzo,M,99,139,26455,26594
Keyaun,M,100,0,43,43
Enslee,F,100,34,0,34
Neidra,F,100,60,0,60
Moyinoluwa,F,100,61,0,61
Amerius,F,100,5,0,5
Arshanti,F,100,5,0,5
Julen,M,100,0,101,101
Jalanna,F,100,5,0,5
Nyrah,F,100,57,0,57
Pranathi,F,100,120,0,120
Kassidie,F,100,303,0,303
Zacherey,M,100,0,16,16
Esmie,F,100,33,0,33
Tamishia,F,100,29,0,29
Jenis,F,100,5,0,5
Shaqula,F,100,6,0,6
Tondrea,F,100,6,0,6
Dub,M,100,0,76,76
Phelecia,F,100,6,0,6
Kaiston,M,100,0,5,5
Shundria,F,100,10,0,10
Sheretta,F,100,355,0,355
Oriel,M,55,104,127,231
Meilich,M,100,0,12,12
Armella,F,100,18,0,18
Fateen,M,100,0,15,15
Willisa,F,100,11,0,11
Alecxander,M,100,0,126,126
Ryuki,M,100,0,5,5
Christol,F,100,243,0,243
Temeeka,F,100,5,0,5
Maytee,F,100,33,0,33
Ketan,M,100,0,341,341
Adilynn,F,100,1110,0,1110
Josselyne,F,100,165,0,165
Jazleene,F,100,15,0,15
Yasmim,F,100,22,0,22
Jaiyon,M,100,0,49,49
Gracia,F,100,993,0,993
Ajenae,F,100,8,0,8
Treshaun,M,99,5,731,736
Abdelaziz,M,100,0,87,87
Jacquise,M,61,47,73,120
Uliana,F,100,34,0,34
Tyeka,F,100,6,0,6
Daynna,F,100,12,0,12
Matin,M,100,0,188,188
Ambri,F,100,71,0,71
Shakib,M,100,0,17,17
Sharlett,F,100,80,0,80
Aajon,M,100,0,8,8
Yance,M,100,0,29,29
Anezka,F,100,45,0,45
Sharonica,F,100,246,0,246
Rafat,M,100,0,35,35
Maymouna,F,100,5,0,5
Harmanie,F,100,32,0,32
Morghyn,F,100,6,0,6
Kendahl,F,93,609,49,658
Aliina,F,100,11,0,11
Daryle,M,95,104,2076,2180
Lydiann,F,100,262,0,262
Kamylah,F,100,137,0,137
Toland,M,100,0,25,25
Jonithan,M,100,0,22,22
Sanieya,F,100,20,0,20
Jiten,M,100,0,20,20
Caidenn,M,100,0,6,6
Janace,F,100,55,0,55
Ademar,M,100,0,6,6
Cerrone,M,100,0,73,73
Neneh,F,100,29,0,29
Azleigh,F,100,6,0,6
Kerryanne,F,100,28,0,28
Callianne,F,100,23,0,23
Zamaiyah,F,100,5,0,5
Partick,M,100,0,208,208
Milissa,F,100,3003,0,3003
Aryelle,F,100,373,0,373
Agueda,F,100,186,0,186
Ansa,F,100,21,0,21
Melat,F,100,180,0,180
Lucinda,F,100,24868,11,24879
Ra,M,76,20,64,84
Christorpher,M,100,0,176,176
Wahid,M,100,0,88,88
Travious,M,100,0,309,309
Ainzlee,F,100,23,0,23
Paul,M,100,3248,836366,839614
Jacion,M,100,0,161,161
Candler,M,89,5,40,45
Sinai,F,90,1475,157,1632
Cristaly,F,100,5,0,5
Yuneisy,F,100,21,0,21
Gizzelle,F,100,112,0,112
Haliee,F,100,31,0,31
Azriel,M,74,397,1150,1547
Lucely,F,100,78,0,78
Delianna,F,100,5,0,5
Neomy,F,100,6,0,6
Vernett,F,100,37,0,37
Nihitha,F,100,17,0,17
Regionald,M,100,0,46,46
Amine,M,100,0,323,323
Jetty,F,100,47,0,47
Tequila,F,100,2130,0,2130
Jyquez,M,100,0,45,45
Naylene,F,100,90,0,90
Kristna,F,100,10,0,10
Richaud,M,100,0,6,6
Elfago,M,100,0,5,5
Vasco,M,100,0,155,155
Kalpana,F,100,31,0,31
Yolaine,F,100,8,0,8
Zayah,F,94,269,16,285
Zella,F,100,1852,0,1852
Nayvie,F,100,17,0,17
Eroz,M,100,0,6,6
Brekia,F,100,5,0,5
Hanoch,M,100,0,6,6
Radonna,F,100,329,0,329
Jansyn,F,100,25,0,25
Ehan,M,100,0,185,185
Jaimie,F,91,9390,899,10289
Shriram,M,100,0,18,18
Patryck,M,100,0,69,69
Pharez,M,100,0,17,17
Keiten,M,100,0,6,6
Lenny,M,95,306,6308,6614
Mayreni,F,100,5,0,5
Luvina,F,100,26,0,26
Yuri,F,60,2380,1575,3955
Genevy,F,100,35,0,35
Drayah,F,100,29,0,29
Crisann,F,100,5,0,5
Wiam,F,100,5,0,5
Creek,M,100,0,141,141
Soria,F,100,5,0,5
Heshy,M,100,0,24,24
Brieann,F,100,708,0,708
Kefira,F,100,5,0,5
Haxton,M,100,0,5,5
Yrania,F,100,5,0,5
Josilynn,F,100,212,0,212
Taraji,F,97,1879,50,1929
Ondria,F,100,85,0,85
Edan,M,88,148,1059,1207
Thorsten,M,100,0,81,81
Jacbo,M,100,0,5,5
Izzybella,F,100,5,0,5
Athony,M,100,0,516,516
Faizal,M,100,0,5,5
Tiburcio,M,100,0,99,99
Johnica,F,100,87,0,87
Brayln,M,100,0,86,86
Lilton,M,100,0,96,96
Maryonna,F,100,54,0,54
Rikyah,F,100,5,0,5
Deontaye,M,100,0,157,157
Danijah,F,100,183,0,183
Juwell,M,100,0,5,5
Lando,M,100,0,194,194
Kyannah,F,100,57,0,57
Daryiah,F,100,6,0,6
Jadalyse,F,100,16,0,16
Tiffane,F,100,200,0,200
Madilen,F,100,10,0,10
Morsal,F,100,6,0,6
Kehaulani,F,100,294,0,294
Issic,M,100,0,20,20
Manesha,F,100,28,0,28
Pota,F,100,5,0,5
Delsey,F,100,32,0,32
Sylena,F,100,340,0,340
Crystian,M,100,0,325,325
Schnell,F,100,25,0,25
Dontrel,M,100,0,247,247
Benjiman,M,100,0,1804,1804
Brinden,M,100,0,97,97
Suleiman,M,100,0,316,316
Unity,F,100,396,0,396
Darchell,F,100,8,0,8
Genovevo,M,100,0,5,5
Shakiem,M,100,0,37,37
Charlett,F,100,163,0,163
Aurore,F,100,25,0,25
Labaron,M,100,0,170,170
Jordinn,F,100,6,0,6
Syla,F,100,47,0,47
Shyann,F,100,5892,0,5892
Gwinn,F,100,5,0,5
Mackenzi,F,99,1843,11,1854
Kue,M,100,0,81,81
Subira,F,100,6,0,6
Sway,F,82,158,34,192
Harmany,F,100,29,0,29
Markeita,F,100,233,0,233
Mynor,M,100,0,567,567
Dayra,F,100,819,0,819
Skyah,F,100,38,0,38
Jarika,F,100,63,0,63
Mohamed,M,100,0,12828,12828
Jerelin,F,100,6,0,6
Laurn,F,100,21,0,21
Jaymien,M,100,0,61,61
Geisha,F,100,113,0,113
Bryella,F,100,45,0,45
Zaidy,F,100,67,0,67
Ledaniel,M,100,0,5,5
Aleighna,F,100,52,0,52
Taveres,M,100,0,10,10
Wendylee,F,100,5,0,5
Claudette,F,100,9116,5,9121
Katerria,F,100,54,0,54
Maeda,F,100,5,0,5
Addylen,F,100,6,0,6
Scarlett,F,100,35839,13,35852
Prabin,M,100,0,5,5
Alexyia,F,100,63,0,63
Anjellica,F,100,44,0,44
Lynese,F,100,46,0,46
Jazavian,M,100,0,5,5
Angelray,M,100,0,6,6
Julessa,F,100,10,0,10
Tremesha,F,100,5,0,5
Kamiko,F,100,36,0,36
Hollister,M,73,25,66,91
Jebreel,M,100,0,5,5
Stace,M,85,33,184,217
Khiley,F,100,128,0,128
Brookelynn,F,100,2781,0,2781
Khyara,F,100,17,0,17
Corissa,F,100,2016,0,2016
Makanna,F,100,5,0,5
Karmina,F,100,101,0,101
Uneeda,F,100,17,0,17
Boun,M,100,0,5,5
Jazette,F,100,5,0,5
Jaymond,M,100,0,103,103
Alessa,F,100,1457,0,1457
Kaylana,F,100,461,0,461
Fairyn,F,100,5,0,5
Devantae,M,100,0,160,160
Carsandra,F,100,17,0,17
Jakhia,F,100,436,0,436
Brannon,M,97,116,4437,4553
Rondre,M,100,0,40,40
Yarel,F,76,530,163,693
Srika,F,100,5,0,5
Lyndsey,F,100,14072,32,14104
Feodor,M,100,0,5,5
Benhur,M,100,0,8,8
Martyna,F,100,260,0,260
Johnita,F,100,491,0,491
Arienne,F,100,384,0,384
Zong,M,81,22,95,117
Melis,F,100,224,0,224
Ellard,M,100,0,17,17
Braijon,M,100,0,21,21
Keyna,F,100,429,0,429
Merri,F,100,2891,0,2891
Welton,M,100,0,934,934
Natelege,F,100,5,0,5
Naasir,M,100,0,247,247
Sarrah,F,100,1154,0,1154
Callasandra,F,100,5,0,5
Aharon,M,100,0,1685,1685
Cianna,F,100,2224,0,2224
Zakaira,F,100,6,0,6
Kyndi,F,100,5,0,5
Maximo,M,100,0,4716,4716
Lucina,F,100,825,0,825
Jancarlo,M,100,0,539,539
Jewel,F,92,14099,1295,15394
Kelen,M,87,25,174,199
Elli,F,99,1967,17,1984
Samanthalee,F,100,14,0,14
Advitha,F,100,10,0,10
Alvenia,F,100,130,0,130
Ishara,F,100,49,0,49
Alexanna,F,100,27,0,27
Deena,F,100,12358,5,12363
Melek,F,77,135,40,175
Yaritzza,F,100,5,0,5
Bryshawn,M,100,0,31,31
Mashea,F,100,5,0,5
Lecil,M,100,0,26,26
Luc,M,100,0,2956,2956
Jaderian,M,100,0,10,10
Yeleini,F,100,6,0,6
Assan,M,100,0,10,10
Crissa,F,100,420,0,420
Emmaly,F,100,506,0,506
Dariely,F,100,5,0,5
Darnishia,F,100,7,0,7
Nikeshia,F,100,109,0,109
Raha,F,100,116,0,116
Jacaranda,F,100,5,0,5
Bilan,F,100,61,0,61
Nakida,F,100,37,0,37
Desai,M,100,0,12,12
Garylee,M,100,0,12,12
Miyoko,F,100,89,0,89
Treg,M,100,0,292,292
Hinako,F,100,29,0,29
Rafel,M,100,0,119,119
Janece,F,100,544,0,544
Niranjan,M,100,0,71,71
Nohea,F,70,57,24,81
Kouta,M,100,0,22,22
Nataliyah,F,100,95,0,95
Deantoine,M,100,0,10,10
Lauralyn,F,100,355,0,355
Omani,M,55,30,36,66
Fidelina,F,100,11,0,11
Keonte,M,96,55,1358,1413
Kini,F,100,5,0,5
Shareena,F,100,201,0,201
Jacqueli,F,100,157,0,157
Krynn,F,100,7,0,7
Tae,M,78,102,367,469
Lexie,F,99,11865,135,12000
Tejay,M,100,0,150,150
Jhoseph,M,100,0,12,12
Ewelina,F,100,108,0,108
Avery,F,68,90945,43032,133977
Petro,M,100,0,101,101
Brookelyn,F,100,2965,0,2965
Gracye,F,100,27,0,27
Kardin,M,100,0,29,29
Everlynn,F,100,36,0,36
Vivianna,F,100,2611,0,2611
Doraelia,F,100,7,0,7
Khileigh,F,100,16,0,16
Xadyn,M,100,0,13,13
Amun,M,100,0,29,29
Shaborn,M,100,0,16,16
Libertie,F,100,74,0,74
Daiva,F,100,48,0,48
Maxxim,M,100,0,21,21
Keontae,M,97,27,959,986
Sherelene,F,100,5,0,5
Cherilyn,F,100,2139,0,2139
Wilhelmena,F,100,95,0,95
Djamila,F,100,5,0,5
Willey,M,100,0,51,51
Easton,M,98,497,28846,29343
Maclaine,F,82,85,19,104
Charlesjoseph,M,100,0,5,5
Tedra,F,100,799,0,799
Taysha,F,100,682,0,682
Dylane,F,100,5,0,5
Lorynn,F,100,100,0,100
Tamy,F,100,623,0,623
Karan,F,66,2617,1340,3957
Brevon,M,100,0,96,96
Kandis,F,100,2617,0,2617
Tamzen,F,100,6,0,6
Yaima,F,100,17,0,17
Avichai,M,100,0,5,5
Briannan,F,100,10,0,10
Riahnna,F,100,20,0,20
Simarpreet,F,100,15,0,15
Kamora,F,100,2026,0,2026
Antiana,F,100,38,0,38
Masaru,M,100,0,5,5
Monah,F,100,5,0,5
Taralee,F,100,202,0,202
Shamakia,F,100,5,0,5
Maleak,M,100,0,189,189
Millenium,F,100,7,0,7
Princetta,F,100,108,0,108
Lavell,M,96,99,2285,2384
Rheanon,F,100,5,0,5
Osa,F,100,19,0,19
Khotan,M,100,0,9,9
Elanore,F,100,23,0,23
Dawnielle,F,100,401,0,401
Myliah,F,100,138,0,138
Miami,F,100,189,0,189
Jaman,M,100,0,94,94
Keriah,F,100,6,0,6
Aybree,F,100,69,0,69
Loden,M,100,0,87,87
Willamina,F,100,124,0,124
Jaidelyn,F,100,12,0,12
Sammiyah,F,100,5,0,5
Keaten,M,98,5,323,328
Anyiah,F,100,543,0,543
Arrihanna,F,100,20,0,20
Hli,F,100,33,0,33
Audraya,F,100,8,0,8
Tymeria,F,100,24,0,24
Sorah,F,100,160,0,160
Aaralyn,F,100,1023,0,1023
Chevella,F,100,67,0,67
Terrace,M,86,107,679,786
Kazuo,M,100,0,24,24
Santangela,F,100,6,0,6
Malie,F,100,260,0,260
Lavarious,M,100,0,24,24
Sulie,F,100,10,0,10
Bronagh,F,100,5,0,5
Ronneka,F,100,22,0,22
Marleena,F,100,175,0,175
Draper,M,100,0,340,340
Tracyann,F,100,181,0,181
Brystin,M,100,0,19,19
Gervon,M,100,0,21,21
Rhanada,F,100,5,0,5
Terrie,F,98,17892,309,18201
Tyski,M,100,0,5,5
Malaijah,F,100,87,0,87
Jacqulina,F,100,6,0,6
Gihanna,F,100,39,0,39
Jury,F,95,106,6,112
Jesaias,M,100,0,5,5
Hrishi,M,100,0,40,40
Ab,M,100,0,286,286
Sheema,F,100,29,0,29
Dezree,F,100,7,0,7
Reaghan,F,100,835,0,835
Charielle,F,100,17,0,17
Amayha,F,100,6,0,6
Mirela,F,100,91,0,91
Reinette,F,100,57,0,57
Tyzhane,F,100,20,0,20
Ellenor,F,100,140,0,140
Ameiah,F,100,22,0,22
Lyon,M,100,0,351,351
Maxus,M,100,0,12,12
Koreyon,M,100,0,11,11
Jenner,M,97,15,468,483
Aaryona,F,100,5,0,5
Elisheba,F,100,137,0,137
Layanie,F,100,5,0,5
Wyett,M,100,0,241,241
Aimy,F,100,229,0,229
Folashade,F,100,174,0,174
Karolyn,F,100,3741,0,3741
Nandan,M,100,0,94,94
Letrell,M,100,0,206,206
Joplin,F,97,155,5,160
Rondella,F,100,6,0,6
Branae,F,100,69,0,69
Kevianna,F,100,39,0,39
Rogene,F,100,190,0,190
Dylenn,M,100,0,5,5
Leneka,F,100,6,0,6
Jihyun,F,100,5,0,5
Shaquira,F,100,246,0,246
Parvaneh,F,100,12,0,12
Takela,F,100,269,0,269
Laurenne,F,100,15,0,15
Maritsa,F,100,925,0,925
Torika,F,100,5,0,5
Graicen,M,100,0,5,5
Adea,F,100,83,0,83
Ron,M,100,70,29515,29585
Kolbin,M,100,0,11,11
Unika,F,100,123,0,123
Toshima,F,100,11,0,11
Lange,M,100,0,5,5
Xya,F,100,19,0,19
Heladio,M,100,0,22,22
Sarbjot,M,100,0,5,5
Colbey,M,95,28,510,538
Izzik,M,100,0,5,5
Kayman,M,86,21,125,146
Jwaun,M,100,0,23,23
Chardee,F,100,18,0,18
Mattox,M,94,24,389,413
Ciin,F,100,29,0,29
Markese,M,100,0,1025,1025
Marnika,F,100,13,0,13
Emmarae,F,100,265,0,265
Alakay,M,100,0,13,13
Kyley,F,95,1490,76,1566
Calie,F,100,1265,0,1265
Fatma,F,100,647,0,647
Yma,F,100,29,0,29
Jesalynn,F,100,32,0,32
Mery,F,100,360,0,360
Carene,F,100,27,0,27
Debb,F,100,13,0,13
Jamariona,F,100,25,0,25
Miella,F,100,11,0,11
Lutie,F,100,6,0,6
Zyanah,F,100,26,0,26
Madhavi,F,100,83,0,83
Lizania,F,100,85,0,85
Layli,F,100,68,0,68
Anaclara,F,100,108,0,108
Antonetta,F,100,261,0,261
Delena,F,100,1624,0,1624
Yosalin,F,100,10,0,10
Azaria,F,98,4235,87,4322
Derri,F,100,51,0,51
Nazaya,F,100,5,0,5
Dayvian,M,100,0,81,81
Jenett,F,100,6,0,6
Monteria,F,100,27,0,27
Jaydenalexander,M,100,0,5,5
Timesha,F,100,498,0,498
Arlon,M,100,0,526,526
Georgeen,F,100,30,0,30
Rubby,F,100,107,0,107
Katessa,F,100,64,0,64
Leonardo,M,100,124,48938,49062
Jacari,M,96,68,1537,1605
Terrolyn,F,100,5,0,5
Parisa,F,100,811,0,811
Keyala,F,100,33,0,33
Tanzie,F,100,68,0,68
Oluwanifemi,F,56,118,94,212
Genessee,F,100,11,0,11
Haroon,M,100,0,759,759
Iah,F,100,5,0,5
Djuanna,F,100,12,0,12
Shahin,M,100,0,260,260
Lennon,M,72,1395,3583,4978
Quanise,F,100,5,0,5
Taymon,M,100,0,16,16
Vikky,F,100,5,0,5
Liliuokalani,F,100,6,0,6
Dreylon,M,100,0,16,16
Teniya,F,100,220,0,220
Anisjon,M,100,0,6,6
Jaydence,F,58,131,94,225
Shelah,F,100,436,0,436
Curstin,F,100,77,0,77
Andwele,M,100,0,28,28
Sears,M,100,0,10,10
Laconya,F,100,97,0,97
Jheri,F,100,148,0,148
Aleiza,F,100,10,0,10
Qualiyah,F,100,6,0,6
Aila,F,100,1237,0,1237
Aoibheann,F,100,11,0,11
Tianca,F,100,29,0,29
Jamonie,M,87,6,41,47
Lais,F,100,9,0,9
Ezana,M,100,0,255,255
Julita,F,100,146,0,146
Richardjames,M,100,0,5,5
Enry,M,100,0,17,17
Sanilah,F,100,10,0,10
Takhia,F,100,107,0,107
Pressley,F,80,387,97,484
Robinho,M,100,0,5,5
Greylynn,F,100,5,0,5
Neli,F,100,244,0,244
Tooba,F,100,40,0,40
Endsley,F,100,10,0,10
Claudine,F,100,4935,0,4935
Resha,F,100,257,0,257
Paulo,M,100,0,3604,3604
Karynna,F,100,51,0,51
Tomeko,F,100,156,0,156
Mortimer,M,100,0,110,110
Tysheed,M,100,0,5,5
Zyeir,M,100,0,73,73
Javette,F,100,54,0,54
Diajah,F,100,29,0,29
Viha,F,100,55,0,55
Dorothea,F,100,7192,6,7198
Lakiara,F,100,6,0,6
Xaine,M,100,0,39,39
Abdisamad,M,100,0,18,18
Zayveon,M,100,0,240,240
Sutton,M,53,1673,1853,3526
Lyubov,F,100,26,0,26
Nissan,M,92,5,60,65
Zaiana,F,100,5,0,5
Nareh,F,100,61,0,61
Aryani,F,100,35,0,35
Jahray,M,100,0,5,5
Tijwana,F,100,18,0,18
Stratton,M,99,11,858,869
Sarenity,F,100,420,0,420
Jahfari,M,100,0,55,55
Naomia,F,100,97,0,97
Nevyn,M,95,5,106,111
Suja,F,100,11,0,11
Deano,M,100,0,204,204
Porcia,F,100,167,0,167
Quynhanh,F,100,10,0,10
Oliviaann,F,100,10,0,10
Janeal,F,100,266,0,266
Galylea,F,100,34,0,34
Jahad,M,100,0,371,371
Elgie,M,100,0,183,183
Sadeen,F,100,122,0,122
Kaylinn,F,100,480,0,480
Lerena,F,100,5,0,5
Britanya,F,100,37,0,37
Nazia,F,100,346,0,346
Breton,M,100,0,398,398
Merriann,F,100,31,0,31
Ayvion,M,100,0,39,39
Kano,M,100,0,65,65
Tod,M,100,0,7279,7279
Osiah,M,100,0,32,32
Shylar,F,100,38,0,38
Katishia,F,100,5,0,5
Dlorah,F,100,29,0,29
Zera,F,100,106,0,106
Priscilla,F,100,76887,182,77069
Meldrick,M,100,0,50,50
Valeree,F,100,96,0,96
Saivon,M,100,0,168,168
Ian,M,100,711,205193,205904
Canyon,M,95,128,2422,2550
Shoniqua,F,100,41,0,41
Angeliana,F,100,6,0,6
Okeith,M,100,0,12,12
Janilyn,F,100,21,0,21
Doane,M,100,0,41,41
Marish,F,100,5,0,5
Emyleigh,F,100,6,0,6
Daxson,M,100,0,61,61
Amador,M,100,0,2227,2227
Tajanique,F,100,59,0,59
Adajah,F,100,72,0,72
Isamarie,F,100,16,0,16
Delisa,F,100,3215,0,3215
Roselynne,F,100,43,0,43
Tome,M,100,0,5,5
Kholette,F,100,5,0,5
Tiffanni,F,100,110,0,110
Argenys,M,100,0,10,10
Senaiya,F,100,5,0,5
Sada,F,100,823,0,823
Alexzandra,F,100,1284,0,1284
Tishon,M,100,0,35,35
Gyla,F,100,19,0,19
Kevante,M,100,0,93,93
Lessa,F,100,148,0,148
Dayanara,F,100,5939,0,5939
Kishen,M,100,0,16,16
Ezabella,F,100,263,0,263
Mikequan,M,100,0,5,5
Keyion,M,100,0,104,104
Quest,M,98,9,387,396
Jaliea,F,100,6,0,6
Gemar,M,100,0,5,5
Tyniyah,F,100,11,0,11
Spike,M,100,0,100,100
Zyhier,M,100,0,10,10
Raushaun,M,100,0,5,5
Calina,F,100,432,0,432
Diocelina,F,100,10,0,10
Yardena,F,100,6,0,6
Aalimah,F,100,11,0,11
Aishlyn,F,100,5,0,5
Maury,M,88,240,1732,1972
Mesiah,M,97,5,190,195
Trypp,M,100,0,70,70
Alegna,F,100,41,0,41
Truly,F,100,449,0,449
Katara,F,100,966,0,966
Stevenmichael,M,100,0,23,23
Jashona,F,100,10,0,10
Theo,M,95,270,5252,5522
Deziyah,F,100,211,0,211
Jessicka,F,100,38,0,38
Noureddine,M,100,0,6,6
Casimira,F,100,32,0,32
Koharu,F,100,34,0,34
Krystl,F,100,150,0,150
Jerrime,M,100,0,5,5
Jervonte,M,100,0,56,56
Aarshiya,F,100,5,0,5
Meloni,F,100,326,0,326
Charkita,F,100,5,0,5
Stevan,M,100,0,3466,3466
Halye,F,100,5,0,5
Arione,F,100,6,0,6
Jodonna,F,100,13,0,13
Jackob,M,100,0,101,101
Tanjala,F,100,25,0,25
Sheria,F,100,643,0,643
Summers,F,100,65,0,65
Ziyear,M,100,0,5,5
Gerhart,M,100,0,16,16
Coralynne,F,100,5,0,5
Jadarrius,M,100,0,317,317
Nayana,F,100,456,0,456
Aken,M,100,0,5,5
Keymonie,M,100,0,5,5
Hubert,M,100,0,12537,12537
Lul,F,100,15,0,15
Emiree,F,100,24,0,24
Kayala,F,100,23,0,23
Nicolette,F,100,15414,5,15419
Agnessa,F,100,6,0,6
Rohun,M,100,0,37,37
Kahila,F,100,5,0,5
Eliasz,M,100,0,14,14
Xeniah,F,100,10,0,10
Libbie,F,100,932,0,932
Arshaun,M,100,0,35,35
Mandre,M,100,0,5,5
Shally,F,100,27,0,27
Anaylah,F,100,8,0,8
Kyonia,F,100,10,0,10
Mehtab,M,100,0,69,69
Ziham,F,100,29,0,29
Naz,F,100,58,0,58
Knixon,M,100,0,17,17
Kandiss,F,100,123,0,123
Laurianne,F,100,224,0,224
Aleita,F,100,5,0,5
Jouanna,F,100,6,0,6
Psalm,F,58,69,50,119
Zhyir,M,100,0,5,5
Devionne,M,100,0,18,18
Ibrahima,M,100,0,698,698
Sharyah,F,100,55,0,55
Vihas,M,100,0,15,15
Christerfer,M,100,0,30,30
Elijahray,M,100,0,5,5
Jadarien,M,100,0,52,52
Dezariyah,F,100,11,0,11
Chardon,F,100,20,0,20
Shabazz,M,100,0,259,259
Rhawnie,F,100,40,0,40
Calebe,M,100,0,12,12
Neha,F,100,4026,0,4026
Milaan,F,100,24,0,24
Louden,M,100,0,417,417
Joahua,M,100,0,5,5
Feynman,M,100,0,15,15
Darionte,M,100,0,20,20
Tyreike,M,100,0,5,5
Sharlotte,F,100,663,0,663
Paulmichael,M,100,0,182,182
Kurie,F,100,5,0,5
Caelin,F,57,386,296,682
Cashtyn,M,100,0,30,30
Mariamawit,F,100,32,0,32
Zaccaria,M,100,0,10,10
Princessa,F,100,167,0,167
Casten,M,100,0,78,78
Ezeriah,M,100,0,31,31
Lyndale,M,83,5,25,30
Jefferi,M,100,0,6,6
Rainee,F,100,523,0,523
Tenniel,F,100,11,0,11
Muammar,M,100,0,5,5
Saisha,F,100,533,0,533
Reshay,F,100,14,0,14
Kuol,M,100,0,10,10
Shaneise,F,100,15,0,15
Simran,F,95,2385,133,2518
Shauntasia,F,100,12,0,12
Sherilynn,F,100,299,0,299
Yudith,F,100,407,0,407
Alleisha,F,100,5,0,5
Stone,M,100,17,4372,4389
Febie,F,100,5,0,5
Rhiauna,F,100,11,0,11
Tomaya,F,100,5,0,5
Teretha,F,100,417,0,417
Marrianna,F,100,20,0,20
Seena,F,72,259,99,358
Cambria,F,100,4213,0,4213
Juddson,M,100,0,138,138
Jahsire,M,100,0,6,6
Codee,M,58,185,251,436
Bane,M,100,0,446,446
Kawai,M,100,0,10,10
Lyneisha,F,100,45,0,45
Paylan,F,100,6,0,6
Kately,F,100,80,0,80
Karaya,F,100,5,0,5
Safari,F,97,186,5,191
Armya,F,100,76,0,76
Ziyonna,F,100,165,0,165
Silpa,F,100,24,0,24
Tavia,F,100,2313,0,2313
Citlally,F,100,544,0,544
Tremika,F,100,34,0,34
Eulises,M,100,0,291,291
Amarley,F,100,6,0,6
Yosmely,F,100,10,0,10
Jenelly,F,100,24,0,24
Tomie,F,67,170,85,255
Aretzy,F,100,39,0,39
Ewell,M,100,0,369,369
Trineka,F,100,14,0,14
Peterson,M,100,0,713,713
Edilberto,M,100,0,724,724
Shyneka,F,100,5,0,5
Lorey,F,100,260,0,260
Lidell,M,100,0,10,10
Karder,M,96,7,166,173
Shyasia,F,100,225,0,225
Londynne,F,100,9,0,9
Monda,F,100,185,0,185
Lemarcus,M,100,0,380,380
Paizli,F,100,21,0,21
Zianya,F,100,17,0,17
Braydee,F,92,56,5,61
Raquane,M,100,0,5,5
Phylisia,F,100,5,0,5
Aero,M,85,17,96,113
Amarya,F,100,95,0,95
Tameah,F,100,59,0,59
Zaniah,F,100,1182,0,1182
Letticia,F,100,567,0,567
Cleighton,M,100,0,11,11
Kroix,M,100,0,14,14
Sedonia,F,100,87,0,87
Jeneffer,F,100,42,0,42
Dayli,F,100,48,0,48
Kriztian,M,100,0,5,5
Brhett,M,100,0,5,5
Tayva,F,100,59,0,59
Eliberto,M,100,0,300,300
Jylisa,F,100,7,0,7
Kruze,M,100,0,161,161
Esbeydy,F,100,13,0,13
Yaw,M,100,0,308,308
Katura,F,100,194,0,194
Anttwan,M,100,0,5,5
Blinda,F,100,200,0,200
Zamien,M,100,0,11,11
Chee,M,53,209,236,445
Audryana,F,100,85,0,85
Jakyria,F,100,90,0,90
Damieon,M,100,0,194,194
Jaede,F,100,5,0,5
Yamika,F,100,50,0,50
Khaidyn,M,100,0,97,97
Dorota,F,100,49,0,49
Jayvein,M,100,0,5,5
Marieanna,F,100,11,0,11
Bhargav,M,100,0,187,187
Rendi,F,100,135,0,135
Saniya,F,100,5623,0,5623
Dezarai,F,100,93,0,93
Redell,M,84,29,152,181
Sekia,F,100,5,0,5
Josuah,M,100,0,36,36
Lazarus,M,100,0,2099,2099
Jamario,M,100,0,1292,1292
Reus,M,100,0,5,5
Teiya,F,100,16,0,16
Brad,M,100,233,81091,81324
Blessn,F,100,5,0,5
Demarquez,M,100,0,138,138
Joylynne,F,100,5,0,5
Marniqua,F,100,5,0,5
Shamella,F,100,20,0,20
Real,M,80,26,103,129
Carold,M,100,0,11,11
Khilan,M,100,0,21,21
Miia,F,100,105,0,105
Sheka,F,100,37,0,37
Nyjeria,F,100,13,0,13
Kupaa,M,100,0,5,5
Cardarius,M,100,0,133,133
Nasaya,F,100,10,0,10
Chevell,F,100,21,0,21
Jazya,F,100,30,0,30
Jernya,F,100,10,0,10
Kosisochi,F,100,5,0,5
Zayannah,F,100,5,0,5
Shantee,F,100,489,0,489
Eliyanah,F,100,25,0,25
Jolyssa,F,100,119,0,119
Brando,M,100,0,1811,1811
Kazu,M,100,0,5,5
Graidys,F,100,6,0,6
Nazar,M,100,0,320,320
Leahmarie,F,100,126,0,126
Kenne,M,100,0,12,12
Strauss,M,100,0,5,5
Quionna,F,100,17,0,17
Jonise,F,100,76,0,76
Lyrick,F,51,108,105,213
Alasiah,F,100,26,0,26
Kinslei,F,100,26,0,26
Tiawanna,F,100,95,0,95
Syeisha,F,100,5,0,5
Shrika,F,100,124,0,124
Presilla,F,100,5,0,5
Ixareli,F,100,6,0,6
Melani,F,100,3595,0,3595
Lourene,F,100,36,0,36
Imanni,F,100,93,0,93
Jennette,F,100,2242,0,2242
Toribio,M,100,0,521,521
Keyonna,F,100,3340,0,3340
Caycie,F,100,34,0,34
Jenita,F,100,440,0,440
Leann,F,100,22736,7,22743
Keishara,F,100,19,0,19
Taylinn,F,100,119,0,119
Devrie,F,100,11,0,11
Alirah,F,100,5,0,5
Demaury,M,100,0,26,26
Chrishona,F,100,5,0,5
Tamarion,M,100,0,529,529
Roy,M,99,912,155003,155915
Aitor,M,100,0,23,23
Tayllor,F,100,131,0,131
Kojiro,M,100,0,6,6
Hellon,F,100,10,0,10
Mayana,F,100,133,0,133
Kaen,M,100,0,5,5
Gerica,F,100,132,0,132
Trela,F,100,33,0,33
Dontreal,M,100,0,74,74
Julyanna,F,100,111,0,111
Corian,M,93,21,265,286
Elexsis,F,100,24,0,24
Nemya,F,100,6,0,6
Cenaida,F,100,13,0,13
Amarria,F,100,116,0,116
Treven,M,100,0,1000,1000
Hikari,F,100,116,0,116
Nargis,F,100,62,0,62
Bearl,M,100,0,17,17
Juvon,M,100,0,141,141
Tyshone,M,100,0,11,11
Maidson,F,100,5,0,5
Stevieray,M,100,0,20,20
Sulai,F,100,5,0,5
Otilia,F,100,684,0,684
Alazia,F,100,222,0,222
Lugman,M,100,0,5,5
Shailynn,F,100,361,0,361
Faye,F,100,20093,71,20164
Annaleya,F,100,10,0,10
Karrisa,F,100,245,0,245
Aureliana,F,100,20,0,20
Aalya,F,100,32,0,32
Brisna,F,100,6,0,6
Ashli,F,100,5639,0,5639
Brydan,M,100,0,135,135
Myiah,F,100,672,0,672
Calvin,M,99,787,124668,125455
Destinni,F,100,10,0,10
Forever,F,97,232,6,238
Parys,F,98,229,5,234
Zahire,M,100,0,6,6
Arvia,F,100,5,0,5
Senetta,F,100,6,0,6
Mariajulia,F,100,18,0,18
Abhijit,M,100,0,42,42
Islarose,F,100,5,0,5
Treyten,M,100,0,118,118
Deveney,F,100,102,0,102
Khaloni,F,100,10,0,10
Tavish,M,99,5,558,563
Dasiyah,F,100,42,0,42
Furlon,M,100,0,6,6
Rosheka,F,100,11,0,11
Laguan,M,100,0,26,26
Marca,F,100,228,0,228
Wyconda,F,100,10,0,10
Sethe,M,100,0,32,32
Jaseer,M,100,0,5,5
Eliason,M,100,0,11,11
Kizzie,F,100,910,0,910
Jeneanne,F,100,12,0,12
Esekiel,M,100,0,5,5
Royle,M,100,0,10,10
Hooman,M,100,0,29,29
Nancye,F,100,310,0,310
Edsel,M,100,0,1237,1237
Tere,F,98,362,6,368
Zamaya,F,100,369,0,369
Jiaxin,F,100,6,0,6
Jamaca,F,100,18,0,18
Ginna,F,100,727,0,727
Wynde,F,100,23,0,23
Sarala,F,100,6,0,6
Makar,M,100,0,35,35
Jeanna,F,100,8458,0,8458
Santasha,F,100,34,0,34
Berney,M,100,0,35,35
Myriah,F,100,1849,0,1849
Kirian,F,50,5,5,10
Ryaan,M,100,0,98,98
Percy,M,99,107,9762,9869
Margueritte,F,100,112,0,112
Axcell,M,100,0,5,5
Azaya,F,100,74,0,74
Amoni,F,87,892,128,1020
Anselm,M,100,0,104,104
Jerrame,M,100,0,12,12
Shanijah,F,100,18,0,18
Josefernando,M,100,0,10,10
Rithik,M,100,0,263,263
Natalyn,F,100,476,0,476
Glyndon,M,100,0,16,16
Dylanger,M,100,0,26,26
Jozsef,M,100,0,123,123
Oluwalonimi,F,100,5,0,5
Latonda,F,100,252,0,252
Cedrik,M,100,0,122,122
Byrce,M,100,0,17,17
Derry,M,93,87,1085,1172
Shakeda,F,100,82,0,82
Amman,M,100,0,87,87
Lateela,F,100,5,0,5
Tyriel,F,100,33,0,33
Arcenio,M,100,0,165,165
Mareily,F,100,5,0,5
Giavonna,F,100,878,0,878
Tydarrius,M,100,0,24,24
Owan,M,100,0,7,7
Randeep,M,100,0,50,50
Jorryn,M,51,75,77,152
Ronie,M,52,182,201,383
Larson,M,97,37,1046,1083
Kearsten,F,100,529,0,529
Janel,F,100,11443,32,11475
Saron,F,82,595,133,728
Ahmadou,M,100,0,85,85
Estefany,F,100,4323,5,4328
Mishaela,F,100,28,0,28
Mekala,F,100,181,0,181
Tynieka,F,100,5,0,5
Kamariona,F,100,29,0,29
Shaghayegh,F,100,19,0,19
Qassam,M,100,0,7,7
Dashanay,F,100,41,0,41
Idean,M,100,0,5,5
Sharmar,M,100,0,7,7
Marinus,M,100,0,5,5
Malyha,F,100,10,0,10
Gelacio,M,100,0,27,27
Tasnia,F,100,181,0,181
Aichatou,F,100,21,0,21
Jeaniyah,F,100,5,0,5
Ryzer,M,100,0,6,6
Jazmarie,F,100,206,0,206
Jolaine,F,100,208,0,208
Jerez,M,100,0,12,12
Chantle,F,100,11,0,11
Raequon,M,100,0,67,67
Kynden,M,100,0,6,6
Nariana,F,100,14,0,14
Nissen,M,100,0,7,7
Bryley,F,79,215,56,271
Makina,F,100,85,0,85
Jobi,F,88,42,6,48
Schelby,F,100,32,0,32
Akul,M,100,0,188,188
Celestina,F,100,1534,0,1534
Adilynne,F,100,67,0,67
Alethea,F,100,3639,0,3639
Makaylah,F,100,2665,0,2665
Jonisha,F,100,437,0,437
Gideon,M,100,11,9762,9773
Anousone,M,100,0,5,5
Roscoe,M,100,0,5424,5424
Amayia,F,100,179,0,179
Arlesha,F,100,51,0,51
Gerrilyn,F,100,32,0,32
Shauntrell,F,100,29,0,29
Obera,F,100,6,0,6
Demetrian,M,100,0,10,10
Mattthew,M,100,0,70,70
Dovey,F,100,20,0,20
Lakiah,F,100,120,0,120
Minori,F,100,49,0,49
Kalix,M,100,0,60,60
Alontae,M,100,0,166,166
Quinta,F,82,191,41,232
Crockett,M,100,0,114,114
Amunet,F,100,25,0,25
Gio,M,98,5,292,297
Roc,M,100,0,214,214
Olivera,F,100,13,0,13
Jahleya,F,100,7,0,7
Oksana,F,100,865,0,865
Kirston,F,100,228,0,228
Carlicia,F,100,118,0,118
Bezaleel,M,100,0,5,5
Elyjah,M,100,0,1268,1268
Laquante,M,100,0,12,12
Dreylin,M,100,0,5,5
Teeanna,F,100,11,0,11
Tyshai,F,100,25,0,25
Shanikia,F,100,87,0,87
Shola,F,84,27,5,32
Keresa,F,100,17,0,17
Kentasia,F,100,25,0,25
Zhion,M,100,0,45,45
Glendoria,F,100,30,0,30
Lakeska,F,100,10,0,10
Gianni,M,83,1658,8071,9729
Lashonte,F,100,36,0,36
Tehron,M,100,0,33,33
Dyamond,F,99,1146,10,1156
Arrah,F,100,10,0,10
Teshaun,M,100,0,202,202
Carleon,M,100,0,12,12
Bryniah,F,100,5,0,5
Breven,M,100,0,134,134
Laim,M,100,0,45,45
Joseramon,M,100,0,55,55
Nakiyha,F,100,5,0,5
Jataun,F,100,17,0,17
Nakaya,F,100,248,0,248
Chiquetta,F,100,71,0,71
Annecia,F,100,26,0,26
Daphine,F,100,840,0,840
Jhia,F,100,11,0,11
Justun,M,100,0,129,129
Mckylie,F,100,5,0,5
Manvitha,F,100,12,0,12
Cooper,M,98,1355,65514,66869
Jarrin,M,100,0,395,395
Josalin,F,100,138,0,138
Gurkamal,M,100,0,5,5
Clothilda,F,100,5,0,5
Vaanya,F,100,41,0,41
Raileen,F,100,5,0,5
Lomant,M,100,0,5,5
Erla,F,100,102,0,102
Shontia,F,100,330,0,330
Maureena,F,100,75,0,75
Hawo,F,100,43,0,43
Dim,F,100,45,0,45
Noahh,M,100,0,11,11
Govind,M,100,0,103,103
Devanae,F,100,5,0,5
Jennessa,F,100,570,0,570
Alaisia,F,100,44,0,44
Javaya,F,100,45,0,45
Zechariah,M,100,13,8162,8175
Talullah,F,100,33,0,33
Quinnesha,F,100,47,0,47
Dymond,F,96,1781,71,1852
Anzel,M,100,0,31,31
Ramell,M,100,0,350,350
Enjoli,F,100,859,0,859
Azeem,M,100,0,404,404
Josphua,M,100,0,5,5
Charmel,F,100,214,0,214
Keiri,F,100,176,0,176
Shuntina,F,100,5,0,5
Alham,F,100,5,0,5
Jazarian,M,100,0,5,5
Dainette,F,100,14,0,14
Payce,M,100,0,32,32
Wahab,M,100,0,39,39
Rickardo,M,100,0,79,79
Cornelio,M,100,0,1097,1097
Abdelkarim,M,100,0,27,27
Reynell,F,100,6,0,6
Fedor,M,100,0,54,54
Burach,M,100,0,16,16
Mckee,M,100,0,5,5
Weaver,M,100,0,23,23
Giavanni,F,68,186,88,274
Trygg,M,100,0,74,74
Lochlin,M,100,0,53,53
Atthew,M,100,0,194,194
Vladislav,M,100,0,456,456
Sherelle,F,100,1014,0,1014
Madel,F,100,6,0,6
Arvydas,M,100,0,5,5
Angy,F,100,360,0,360
Falanda,F,100,11,0,11
Quentez,M,100,0,76,76
Yovan,M,100,0,105,105
Chelsey,F,100,30843,65,30908
Ethne,F,100,95,0,95
Lachrisha,F,100,143,0,143
Avyon,M,100,0,77,77
Deaunta,M,100,0,34,34
Fiona,F,100,21211,5,21216
Jakiyah,F,100,1075,0,1075
Chikamso,F,52,14,13,27
Mahdy,M,100,0,47,47
Gracelan,F,100,5,0,5
Vishnu,M,100,0,866,866
Taylor,F,75,308130,103785,411915
Kelse,F,100,91,0,91
Malosi,M,100,0,53,53
Takeya,F,100,640,0,640
Nyheem,M,100,0,92,92
Kaivon,M,100,0,199,199
Aseante,M,100,0,5,5
Romario,M,100,0,886,886
Marquise,M,96,392,9522,9914
Kayri,F,100,19,0,19
Jyrin,M,100,0,26,26
Hafid,M,100,0,6,6
Harin,M,100,0,11,11
Antalya,F,100,11,0,11
Carless,M,100,0,25,25
Bhoomika,F,100,5,0,5
Haya,F,100,721,0,721
Prinston,M,100,0,44,44
Madyson,F,100,11540,0,11540
Taynia,F,100,10,0,10
Albiona,F,100,10,0,10
Dewey,M,100,11,9937,9948
Jakaden,M,100,0,172,172
Dannely,F,100,18,0,18
Fontilla,F,100,5,0,5
Quincella,F,100,5,0,5
Ronzel,M,100,0,11,11
Carna,F,100,5,0,5
Wilene,F,100,37,0,37
Alexondra,F,100,54,0,54
Kyia,F,100,879,0,879
Orvilla,F,100,10,0,10
Jaevian,M,100,0,87,87
Nakishia,F,100,38,0,38
Bejamin,M,100,0,441,441
Scherry,F,100,363,0,363
Sarabi,F,100,93,0,93
Darnise,F,100,116,0,116
Abou,M,100,0,63,63
Nathaiel,M,100,0,49,49
Jelicia,F,100,131,0,131
Kelaia,F,100,11,0,11
Chastidy,F,100,542,0,542
Brinson,M,98,6,272,278
Nyaisa,F,100,47,0,47
Natile,F,100,39,0,39
Adrinne,F,100,66,0,66
Ladona,F,100,495,0,495
Hobert,M,100,0,1190,1190
Sophan,M,100,0,8,8
Brynlee,F,100,6657,10,6667
Anabeli,F,100,7,0,7
Jesper,M,100,0,94,94
Bryttanie,F,100,19,0,19
Shreenidhi,F,100,6,0,6
Lilliani,F,100,11,0,11
Dekwon,M,100,0,11,11
Vannara,M,100,0,16,16
Lyan,M,62,50,80,130
Aniessa,F,100,50,0,50
Mohmed,M,100,0,84,84
Kilmer,M,100,0,6,6
Aslam,M,100,0,5,5
Samrawit,F,100,42,0,42
Jamia,F,100,3809,6,3815
Merenda,F,100,10,0,10
Zeena,F,100,367,0,367
Mckynna,F,100,114,0,114
Yamiley,F,100,17,0,17
Avaneesh,M,100,0,169,169
Gracyn,F,97,2768,83,2851
Janaih,F,100,14,0,14
Idus,M,100,0,6,6
Tavianna,F,100,52,0,52
Jazlean,F,100,6,0,6
Dazion,M,100,0,39,39
Alisiana,F,100,18,0,18
Gelinda,F,100,35,0,35
Doritha,F,100,28,0,28
Buffey,F,100,96,0,96
Syonna,F,100,6,0,6
Bekki,F,100,164,0,164
Annelizabeth,F,100,15,0,15
Brittay,F,100,69,0,69
Lurean,F,100,7,0,7
Jasmire,F,100,5,0,5
Aariel,F,100,159,0,159
Mat,M,100,0,234,234
Advika,F,100,260,0,260
Samina,F,100,494,0,494
Gennett,F,100,22,0,22
Tonisha,F,100,2224,0,2224
Dakar,M,100,0,28,28
Tineisha,F,100,26,0,26
Afra,F,100,132,0,132
Amiyha,F,100,45,0,45
August,M,84,3017,16145,19162
Shamauria,F,100,6,0,6
Addieson,F,100,5,0,5
Angelenia,F,100,6,0,6
Oluwaseyi,M,67,80,166,246
Angelique,F,100,26789,6,26795
Nazaneen,F,100,17,0,17
Jelana,F,100,12,0,12
Sherrese,F,100,18,0,18
Asuncion,M,53,48,55,103
Rayona,F,100,335,0,335
Lilymay,F,100,5,0,5
Jakius,M,100,0,5,5
Doniqua,F,100,78,0,78
Lynton,M,100,0,10,10
Pallavi,F,100,340,0,340
Johnavin,M,100,0,17,17
Joene,F,100,41,0,41
Emilyrose,F,100,196,0,196
Keaisha,F,100,66,0,66
Scottland,M,100,0,13,13
Daisha,F,100,4410,0,4410
Wanye,M,100,0,22,22
Ryelle,F,100,113,0,113
Kayli,F,100,6400,0,6400
Romarion,M,100,0,39,39
Anglina,F,100,41,0,41
Derenda,F,100,316,0,316
Shylla,F,100,5,0,5
Annajo,F,100,24,0,24
Ashantie,F,100,52,0,52
Izekiel,M,100,0,40,40
Brix,M,100,0,71,71
Abreonna,F,100,15,0,15
Keondric,M,100,0,8,8
Elizbeth,F,100,679,0,679
Fernande,F,100,5,0,5
Markail,M,100,0,57,57
Ranajah,F,100,6,0,6
Josilyne,F,100,5,0,5
Nyaziah,F,100,5,0,5
Cathye,F,100,95,0,95
Cree,F,70,704,302,1006
Creigh,M,100,0,5,5
Daliza,F,100,48,0,48
Trisa,F,100,475,0,475
Kadience,F,100,263,0,263
Natiley,F,100,22,0,22
Bradley,M,100,1368,288996,290364
Severine,F,100,11,0,11
Gwynneth,F,100,212,0,212
Tasmine,F,100,69,0,69
Annexie,F,100,9,0,9
Krislyn,F,100,1135,0,1135
Gila,F,100,489,0,489
Naquisha,F,100,145,0,145
Donelda,F,100,128,0,128
Adhrit,M,100,0,134,134
Antowine,M,100,0,10,10
Yves,M,97,26,995,1021
Cavonte,M,100,0,11,11
Arpit,M,100,0,40,40
Maebrie,F,100,10,0,10
Katlain,F,100,5,0,5
Elayshia,F,100,11,0,11
Angielina,F,100,30,0,30
Annalea,F,100,475,0,475
Jenness,F,100,68,0,68
Krystalin,F,100,33,0,33
Stanley,M,100,583,121516,122099
Masaki,M,100,0,203,203
Shaneria,F,100,35,0,35
Tiko,M,100,0,40,40
Shaneka,F,100,2686,0,2686
Henessy,F,100,149,0,149
Hortencia,F,100,1754,0,1754
Gitty,F,100,2095,0,2095
Suelyn,F,100,5,0,5
Bucky,M,100,0,779,779
Donevin,M,100,0,81,81
Dajahnay,F,100,5,0,5
Wilkie,M,100,0,79,79
Suniyah,F,100,42,0,42
Deguan,M,100,0,12,12
Dejahna,F,100,10,0,10
Terone,M,100,0,40,40
Laurina,F,100,181,0,181
Marithza,F,100,82,0,82
Meahan,F,100,7,0,7
Shawnti,F,100,11,0,11
Chonda,F,100,189,0,189
Donie,F,54,78,66,144
Rem,M,100,0,5,5
Margarette,F,100,1235,0,1235
Lessley,F,90,54,6,60
Rylenn,F,100,17,0,17
Chaise,M,74,318,924,1242
Gurdeep,M,100,0,22,22
Tinamaria,F,100,10,0,10
Shaniqua,F,100,5117,0,5117
Jeweleah,F,100,5,0,5
Enchantra,F,100,8,0,8
Monyae,F,92,57,5,62
Jakki,F,100,140,0,140
Bethsaida,F,100,290,0,290
Linzie,F,85,545,94,639
Retonya,F,100,5,0,5
Leala,F,100,580,0,580
Maliak,M,100,0,11,11
Jeslene,F,100,18,0,18
Anastacio,M,100,0,1227,1227
Ahmaud,M,100,0,181,181
Tashema,F,100,255,0,255
Clorice,F,100,14,0,14
Ronnica,F,100,134,0,134
Alleshia,F,100,14,0,14
Caelee,F,100,59,0,59
Kamrie,F,100,440,0,440
Nebeyu,M,100,0,5,5
Timi,F,99,649,5,654
Shakita,F,100,1202,0,1202
Mykaila,F,100,414,0,414
Kamauri,M,69,235,514,749
Surbhi,F,100,22,0,22
Skyela,F,100,25,0,25
Menal,F,100,5,0,5
Oluwatomilola,F,100,5,0,5
Avyay,M,100,0,85,85
Kharter,M,81,24,105,129
Dayshawn,M,100,5,1211,1216
Lizmari,F,100,31,0,31
Shatanna,F,100,16,0,16
Imajean,F,100,5,0,5
Jasimine,F,100,382,0,382
Tarna,F,100,29,0,29
Luzclarita,F,100,41,0,41
Trevel,M,100,0,84,84
Kenara,F,100,11,0,11
Vaniecia,F,100,5,0,5
Faizon,M,100,0,233,233
Kentre,M,100,0,21,21
Advaith,M,100,0,402,402
Shawnie,F,100,552,0,552
Findley,M,69,47,107,154
Kynzee,F,100,150,0,150
Mallerie,F,100,78,0,78
Shaneen,F,100,321,0,321
Rochard,M,100,0,5,5
Ason,M,100,0,274,274
Lakeyah,F,100,8,0,8
Bevon,M,100,0,17,17
Hasanat,F,100,5,0,5
Josellyn,F,100,19,0,19
Dianelly,F,100,73,0,73
Kelden,M,100,0,184,184
Ladereon,M,100,0,7,7
Aijahlon,M,100,0,5,5
Lastarza,M,100,0,6,6
Pagen,F,100,5,0,5
Cozell,M,100,0,6,6
Isam,M,100,0,170,170
Denel,F,100,10,0,10
Deaton,M,100,0,26,26
Tamber,F,100,215,0,215
Yamilka,F,100,79,0,79
Martia,F,100,383,0,383
Miyesha,F,100,5,0,5
Berina,F,100,20,0,20
Palma,F,100,732,0,732
Jakale,M,100,0,17,17
Marichal,M,100,0,8,8
Bhavini,F,100,23,0,23
Aidin,M,98,12,591,603
Diep,F,78,21,6,27
Tawana,F,100,6441,0,6441
Lanise,F,100,581,0,581
Tionni,F,100,38,0,38
Hadiah,F,100,5,0,5
Imagene,F,100,22,0,22
Delight,F,100,350,0,350
Tavin,M,99,23,1547,1570
Drennen,M,100,0,5,5
Rhory,M,100,0,6,6
Demara,F,100,128,0,128
Esha,F,100,1541,0,1541
Kyson,M,100,0,2833,2833
Architha,F,100,6,0,6
Zuheyla,F,100,5,0,5
Helius,M,100,0,5,5
Mavin,M,100,0,44,44
Tytrell,M,100,0,10,10
Aledra,F,100,5,0,5
Jasavion,M,100,0,15,15
Jamarian,M,99,6,780,786
Tyira,F,100,5,0,5
Garrod,M,100,0,45,45
Braily,F,100,43,0,43
Yonnie,F,100,20,0,20
Amythest,F,100,24,0,24
Draeson,M,100,0,18,18
Marcellos,M,100,0,10,10
Biankah,F,100,5,0,5
Cherelle,F,100,1669,0,1669
Pacie,F,100,28,0,28
Daija,F,100,2874,0,2874
Aylet,F,100,9,0,9
Meilah,F,100,44,0,44
Fitzhugh,M,100,0,37,37
Tamarrah,F,100,5,0,5
Aeisha,F,100,264,0,264
Marinez,F,100,5,0,5
Sakiyah,F,100,148,0,148
Bridan,M,100,0,5,5
Afua,F,100,200,0,200
Jadriel,M,100,0,115,115
Darshaun,M,100,0,37,37
Gent,M,100,0,24,24
Malen,M,55,5,6,11
Shantese,F,100,59,0,59
Kaveah,F,100,20,0,20
Xochitl,F,100,4491,0,4491
Farrad,M,100,0,7,7
Atalanta,F,100,5,0,5
Sharicka,F,100,159,0,159
Crishon,M,100,0,10,10
Nikoli,M,100,0,441,441
Aisling,F,100,1111,0,1111
Octayvia,F,100,38,0,38
Laquiesha,F,100,94,0,94
Latischa,F,100,16,0,16
Elya,M,57,141,184,325
Styles,M,100,0,387,387
Nyimah,F,100,62,0,62
Adelicia,F,100,49,0,49
Cissie,F,100,5,0,5
Helmuth,M,100,0,25,25
Mehvish,F,100,17,0,17
Karne,F,100,135,0,135
Jesusjr,M,100,0,19,19
Jewelyn,F,100,5,0,5
Lajaune,M,100,0,10,10
Sante,M,100,0,58,58
Taleyah,F,100,245,0,245
Aarvi,F,100,40,0,40
Kassandre,F,100,30,0,30
Zakyria,F,100,59,0,59
Shanice,F,100,9401,5,9406
Joannah,F,100,335,0,335
Shiana,F,100,369,0,369
Mahkya,F,100,12,0,12
Sherrin,F,100,207,0,207
Jalik,M,100,0,222,222
Sally,F,100,94238,235,94473
Marijana,F,100,5,0,5
Kelda,F,100,209,0,209
Heidy,F,100,4784,0,4784
Kacey,F,84,9910,1914,11824
Lynlea,F,100,12,0,12
Yerli,F,100,6,0,6
Leanore,F,100,41,0,41
Dorinne,F,100,45,0,45
Jahnyah,F,100,49,0,49
Eyleen,F,100,170,0,170
Blessed,F,71,138,56,194
Nouvelle,F,100,5,0,5
Domini,F,100,157,0,157
Lanadia,F,100,25,0,25
Jaciyon,M,100,0,5,5
Donyelle,F,96,372,15,387
Odeh,M,100,0,11,11
Lachana,F,100,39,0,39
Abbie,F,100,14620,41,14661
Shawona,F,100,43,0,43
Osmel,M,100,0,111,111
Arson,M,100,0,17,17
Isabellasophia,F,100,5,0,5
Mikelann,F,100,6,0,6
Aunye,F,100,27,0,27
Aerilyn,F,100,145,0,145
Derontae,M,100,0,6,6
Catrisha,F,100,6,0,6
Corydon,M,100,0,136,136
Seleyna,F,100,6,0,6
Keigo,M,100,0,66,66
Carlethia,F,100,64,0,64
Bruin,M,100,0,188,188
Graecyn,F,100,36,0,36
Mohid,M,100,0,127,127
Yarieli,F,100,11,0,11
Dairy,F,100,36,0,36
Simona,F,100,2463,0,2463
Shallen,F,100,57,0,57
Gannon,M,100,0,4258,4258
Juliete,F,100,53,0,53
Adasha,F,100,89,0,89
Karliee,F,100,11,0,11
Jeffri,M,100,0,45,45
Gracian,M,100,0,5,5
Maileen,F,100,37,0,37
Charger,M,100,0,6,6
Nohealani,F,100,151,0,151
Yigit,M,100,0,35,35
Brecker,M,100,0,14,14
Afeni,F,100,26,0,26
Emmalani,F,100,6,0,6
Revon,M,100,0,22,22
Jaine,F,100,227,0,227
Dinara,F,100,55,0,55
Mariafernanda,F,100,872,0,872
Adalisa,F,100,6,0,6
Adalaide,F,100,143,0,143
Amiel,M,93,51,702,753
Tyquail,M,100,0,16,16
Jerdean,F,100,5,0,5
Abdourahman,M,100,0,5,5
Lydya,F,100,5,0,5
Andreq,M,100,0,17,17
Dakotajames,M,100,0,5,5
Josecarlos,M,100,0,274,274
Glenesha,F,100,6,0,6
Maddon,M,100,0,168,168
Angelith,F,100,5,0,5
Gwennetta,F,100,5,0,5
Jatavia,F,100,403,0,403
Javair,M,100,0,10,10
Chessie,F,100,181,0,181
Kanav,M,100,0,78,78
Tykeria,F,100,638,0,638
Aileigh,F,100,5,0,5
Nayonika,F,100,6,0,6
Toyce,F,100,6,0,6
Mikeia,F,100,54,0,54
Reileigh,F,100,26,0,26
Dalaylah,F,100,5,0,5
Kysen,M,100,0,416,416
Reah,F,100,146,0,146
Rayland,M,100,0,259,259
Stetson,M,100,0,3606,3606
Marvette,F,100,320,0,320
Semico,F,100,7,0,7
Acelyn,F,98,314,5,319
Alphea,F,100,5,0,5
Wydia,F,100,10,0,10
Leelyn,M,100,0,77,77
Ying,F,65,260,140,400
Deundray,M,100,0,8,8
Paricia,F,100,18,0,18
Dupre,M,100,0,11,11
Elizabella,F,100,211,0,211
Yacqueline,F,100,18,0,18
Nabila,F,100,542,0,542
Telsha,F,100,5,0,5
Tyreik,M,100,0,522,522
Kyann,F,98,301,5,306
Nirvi,F,100,50,0,50
Jakaya,F,100,189,0,189
Ciera,F,100,11145,5,11150
Scharron,F,100,6,0,6
Deven,M,88,1294,9953,11247
Mach,M,100,0,5,5
Sebastiana,F,100,96,0,96
Steva,F,100,34,0,34
Asyana,F,100,5,0,5
Rahem,M,100,0,33,33
Icelyn,F,100,19,0,19
Addiley,F,100,24,0,24
Toriano,M,100,0,1149,1149
Shereca,F,100,10,0,10
Kiro,M,100,0,12,12
Moses,M,100,25,22526,22551
Camara,F,89,670,81,751
Paeten,F,100,5,0,5
Mariana,F,100,31299,84,31383
Jasmine,F,99,236267,1253,237520
Seiko,F,100,6,0,6
Keisi,F,100,113,0,113
Taysir,M,100,0,17,17
Pablito,M,100,0,21,21
Jaleesa,F,100,3028,6,3034
Rudy,M,98,686,33727,34413
Levani,F,100,5,0,5
Jasiri,M,93,7,92,99
Kengi,M,100,0,5,5
Kailany,F,100,70,0,70
Yarianna,F,100,67,0,67
Eduviges,F,100,6,0,6
Kaylyn,F,100,10880,32,10912
Makoto,M,100,0,298,298
Sherayne,F,100,6,0,6
Jakylin,M,100,0,27,27
Gagan,M,85,6,35,41
Jarquavious,M,100,0,73,73
Laika,F,100,10,0,10
Marizza,F,100,39,0,39
Tecumseh,M,100,0,58,58
Henlie,F,100,21,0,21
Chaske,M,100,0,50,50
Keneesha,F,100,37,0,37
Deandrea,F,76,2188,710,2898
Areen,F,95,102,5,107
Fadeelah,F,100,5,0,5
Alexiel,F,50,5,5,10
Nabile,F,100,5,0,5
Antwann,M,100,0,557,557
Nathnael,M,100,0,43,43
Westen,M,100,0,800,800
Colyer,M,100,0,19,19
Gianluka,M,100,0,13,13
Amaly,F,100,41,0,41
Jayston,M,100,0,142,142
Duran,M,100,0,1404,1404
Jacory,M,100,0,1096,1096
Mariaelizabeth,F,100,34,0,34
Towana,F,100,785,0,785
Lilikoi,F,100,24,0,24
Juwahn,M,100,0,5,5
Faithlynn,F,100,285,0,285
Aaiza,F,100,16,0,16
Menelek,M,100,0,6,6
Dristy,F,100,6,0,6
Cemya,F,100,5,0,5
Randalynn,F,100,5,0,5
Jarai,M,100,0,5,5
Lajoia,F,100,6,0,6
Zackry,M,100,0,369,369
Mailk,M,100,0,6,6
Thailer,M,85,6,33,39
Gil,M,100,0,3977,3977
Keileen,F,100,20,0,20
Osceola,M,100,0,31,31
Vernest,M,100,0,22,22
Vianka,F,100,424,0,424
Orris,M,100,0,66,66
Jerril,M,100,0,17,17
Keetan,M,100,0,10,10
Yvianna,F,100,6,0,6
Jerah,F,100,96,0,96
Chabely,F,100,63,0,63
Ellisen,F,100,32,0,32
Kalum,M,100,0,231,231
Evrett,M,100,0,108,108
Prashanth,M,100,0,6,6
Kereem,M,100,0,11,11
Arleigh,F,82,359,80,439
Blakleigh,F,100,43,0,43
Demonte,M,100,0,2201,2201
Mykal,M,76,326,1032,1358
Zanthony,M,100,0,17,17
Caidy,F,100,5,0,5
Alayjia,F,100,6,0,6
Muhammed,M,100,0,1718,1718
Maxxton,M,100,0,6,6
Keiann,F,100,5,0,5
Trenace,F,100,100,0,100
Sierria,F,100,225,0,225
Rece,M,99,5,441,446
Jasmin,F,99,42791,584,43375
Keiyanna,F,100,48,0,48
Addielynn,F,100,11,0,11
Kenedra,F,100,13,0,13
Retonia,F,100,6,0,6
Leeman,M,100,0,51,51
Haylyn,F,100,84,0,84
Teeara,F,100,11,0,11
Jymon,M,100,0,5,5
Stephani,F,100,5159,0,5159
Chezkel,M,100,0,11,11
Maged,M,100,0,17,17
Patrician,F,100,5,0,5
Khaley,F,100,17,0,17
Elis,F,63,148,88,236
Wimberley,F,100,5,0,5
Dezmin,M,100,0,207,207
Sumayo,F,100,43,0,43
Lakevia,F,100,257,0,257
Vaneza,F,100,399,0,399
Arjit,M,100,0,18,18
Luxie,F,100,34,0,34
Taiwanna,F,100,22,0,22
Merav,F,100,18,0,18
Yuliette,F,100,5,0,5
Ruweyda,F,100,75,0,75
Nicte,F,100,5,0,5
Roula,F,100,41,0,41
Levetta,F,100,79,0,79
Kinser,M,100,0,82,82
Jahmez,M,100,0,60,60
Prophet,M,100,0,132,132
Eury,M,100,0,6,6
Tigra,F,100,10,0,10
Taion,M,100,0,18,18
Daveigh,F,100,124,0,124
Suzie,F,100,2980,0,2980
Fayha,F,100,10,0,10
Linard,M,100,0,46,46
Steph,F,100,66,0,66
Yasmaine,F,100,20,0,20
Jamarris,M,100,0,5,5
Allsion,F,100,63,0,63
Laquavion,M,100,0,5,5
Briselda,F,100,134,0,134
Duska,F,100,36,0,36
Shamair,F,76,16,5,21
Jenalyn,F,100,253,0,253
Keylon,M,100,0,382,382
Ravena,F,100,10,0,10
Keltin,M,100,0,79,79
Tiany,F,100,5,0,5
Maxten,M,100,0,59,59
Dominiq,M,98,5,250,255
Andrenae,F,100,5,0,5
Patt,F,85,57,10,67
Jahmir,M,100,0,1547,1547
Seville,F,61,78,50,128
Malaz,F,100,6,0,6
Cirra,F,100,5,0,5
Freida,F,100,3469,0,3469
Lelita,F,100,5,0,5
Lacei,F,100,10,0,10
Leeandrea,F,100,12,0,12
Kemorah,F,100,47,0,47
Dorthy,F,100,3417,0,3417
Zakeea,F,100,9,0,9
Sancha,F,100,12,0,12
Chass,M,100,0,10,10
Nikiki,F,100,10,0,10
Lacee,F,100,2415,0,2415
Favio,M,100,0,508,508
Esco,M,100,0,40,40
Mahra,F,100,16,0,16
Ademola,M,100,0,116,116
Korinne,F,100,1124,0,1124
Jag,M,100,0,94,94
Tekeisha,F,100,149,0,149
Maebh,F,100,28,0,28
Jessiana,F,100,18,0,18
Merric,M,100,0,110,110
Nashali,F,100,132,0,132
Saachi,F,100,311,0,311
Oji,M,100,0,29,29
Conagher,M,100,0,41,41
Nili,F,100,145,0,145
Kidata,F,100,5,0,5
Tevante,M,100,0,18,18
Sjana,F,100,5,0,5
Sabir,M,100,0,421,421
Vernoica,F,100,11,0,11
Minwoo,M,100,0,17,17
Kimball,M,92,140,1539,1679
Arjuna,M,100,0,225,225
Coraliz,F,100,6,0,6
Tashawn,M,83,273,1381,1654
Araiza,F,100,15,0,15
Denham,M,100,0,52,52
Hanz,M,100,0,68,68
Lilo,F,100,82,0,82
Shaunel,F,100,5,0,5
Jabon,M,100,0,6,6
Paytan,F,96,158,7,165
Moriyah,F,100,188,0,188
Kaydenze,F,100,11,0,11
Issai,M,100,0,85,85
Mardee,F,100,158,0,158
Tuyetnhi,F,100,10,0,10
Yost,M,100,0,10,10
Aleny,F,100,29,0,29
Zohal,F,100,72,0,72
Vedhika,F,100,5,0,5
Myangel,F,100,329,0,329
Kaigan,F,67,12,6,18
Asim,M,100,0,842,842
Kaliyanna,F,100,5,0,5
Myrlande,F,100,5,0,5
Kaveona,F,100,5,0,5
Tovaris,M,100,0,5,5
Maresha,F,100,226,0,226
Jermey,M,100,0,2651,2651
Jayvean,M,100,0,6,6
Nickolie,M,100,0,5,5
Jontavis,M,100,0,36,36
Jamarion,M,100,0,5990,5990
Charleston,M,86,274,1755,2029
Dallas,M,82,9241,41143,50384
Osheanna,F,100,22,0,22
Raylie,F,100,221,0,221
Brender,F,100,24,0,24
Shareeda,F,100,10,0,10
Brynsley,F,100,5,0,5
Lyani,F,100,27,0,27
Carmeline,F,100,5,0,5
Nila,F,100,2824,0,2824
Kyleia,F,100,10,0,10
Aleksandre,M,100,0,5,5
Izear,M,100,0,17,17
Rhandy,M,100,0,25,25
Tanny,F,97,171,5,176
Ijnanya,F,100,10,0,10
Anjelyka,F,100,5,0,5
Kadynce,F,99,757,6,763
Hazyn,M,100,0,5,5
Tamarind,F,100,10,0,10
Tevon,M,100,0,981,981
Aayush,M,100,0,948,948
Keimani,F,78,102,29,131
Desere,F,100,193,0,193
Tahna,F,100,5,0,5
Geneal,F,100,18,0,18
Samuel,M,100,2010,539939,541949
Sheil,F,100,5,0,5
Staphany,F,100,178,0,178
Ura,F,50,5,5,10
Nazneen,F,100,5,0,5
Lalenia,F,100,5,0,5
Kingslee,M,55,29,36,65
Kalanie,F,100,73,0,73
Aislyn,F,100,1202,0,1202
Yerenia,F,100,5,0,5
Dierdre,F,100,1032,0,1032
Lakira,F,100,448,0,448
Rayhan,M,100,0,558,558
Daleen,F,100,200,0,200
Tawnja,F,100,10,0,10
Adalisse,F,100,5,0,5
Coleigh,F,100,10,0,10
Eaden,M,62,44,72,116
Danieljr,M,100,0,13,13
Jacaleb,M,100,0,32,32
Carlaysia,F,100,25,0,25
Tashenna,F,100,27,0,27
Mhairi,F,100,5,0,5
Summa,F,100,5,0,5
Kathleenmary,F,100,6,0,6
Markita,F,100,2483,0,2483
Naheed,F,100,11,0,11
Anahla,F,100,61,0,61
Turhan,M,100,0,208,208
Damell,M,100,0,5,5
Lashundria,F,100,24,0,24
Tyere,M,100,0,5,5
Sameem,M,100,0,5,5
Joseandres,M,100,0,65,65
Tess,F,100,12511,0,12511
Ariha,F,100,10,0,10
Jaremiah,M,100,0,32,32
Kaysean,M,100,0,58,58
Sallyann,F,100,498,0,498
Jamarri,M,100,0,490,490
Caitlen,F,100,383,0,383
Keyshun,M,100,0,140,140
Shar,F,100,212,0,212
Ashaley,F,100,49,0,49
Andalucia,F,100,5,0,5
Johnnyray,M,100,0,42,42
Unita,F,100,54,0,54
Kanae,F,100,107,0,107
Tushar,M,100,0,240,240
Kaylee,F,100,112670,169,112839
Alanea,F,100,103,0,103
Kalen,M,73,1404,3846,5250
Yochanon,M,100,0,34,34
Asantae,M,100,0,11,11
Shadra,F,100,6,0,6
Cadense,F,100,11,0,11
Jaculine,F,100,5,0,5
Joelaine,F,100,5,0,5
Danaria,F,100,59,0,59
Avra,F,100,28,0,28
Sheonta,F,100,6,0,6
Jaidynn,F,89,242,30,272
Mayha,F,100,5,0,5
Saraina,F,100,5,0,5
Dasheena,F,100,11,0,11
Jasleene,F,100,24,0,24
Sadena,F,100,6,0,6
Dwone,M,100,0,16,16
Jawdat,M,100,0,5,5
Merlina,F,100,121,0,121
Flerida,F,100,5,0,5
Kaytlen,F,100,206,0,206
Jamarrian,M,100,0,20,20
Ronzell,M,100,0,87,87
Abrille,F,100,10,0,10
Kenzington,F,100,381,0,381
Kirill,M,100,0,276,276
Bente,F,100,10,0,10
Kennley,F,100,93,0,93
Allyah,F,100,299,0,299
Dante,M,99,453,37683,38136
Scotlynn,F,100,142,0,142
Jesue,M,100,0,8,8
Marchae,F,100,41,0,41
Kevonta,M,100,0,170,170
Canuto,M,100,0,7,7
Arij,F,100,26,0,26
Nashua,M,100,0,61,61
Ajasia,F,100,10,0,10
Markiese,M,100,0,40,40
Caid,M,100,0,146,146
Laylannie,F,100,6,0,6
Amron,M,100,0,55,55
Abdifatah,M,100,0,168,168
Nohl,M,100,0,18,18
Tommylee,M,100,0,46,46
Kelab,M,100,0,5,5
Yeriel,M,100,0,214,214
Ollie,M,51,3758,3886,7644
Vallerie,F,100,991,0,991
Jarma,F,100,12,0,12
Braylen,M,94,408,6804,7212
Dakia,F,100,102,0,102
Seerat,F,100,138,0,138
Axavier,M,100,0,101,101
Ishi,F,89,58,7,65
Zayani,F,100,5,0,5
Estellise,F,100,5,0,5
Kimorah,F,100,255,0,255
Natrell,M,100,0,34,34
Sharia,F,100,648,0,648
Erlene,F,100,462,0,462
Chardey,F,100,5,0,5
Vareck,M,100,0,13,13
Safaa,F,100,246,0,246
Arneda,F,100,24,0,24
Mekelle,F,100,5,0,5
Raychelle,F,100,603,0,603
Mahee,F,100,19,0,19
Axton,M,100,0,1355,1355
Khaniya,F,100,129,0,129
Aamoni,F,100,10,0,10
Kitti,F,100,130,0,130
Neenah,F,100,221,0,221
Deangello,M,100,0,11,11
Ajiyah,F,100,16,0,16
Vonzetta,F,100,17,0,17
Markeshia,F,100,408,0,408
Isaih,M,100,0,1255,1255
Gibran,M,100,0,860,860
Linus,M,100,0,2343,2343
Shatice,F,100,11,0,11
Braydyn,M,100,0,369,369
Aldis,M,100,0,6,6
Ratisha,F,100,36,0,36
Carlo,M,99,80,9910,9990
Zadaya,F,100,18,0,18
Yacoub,M,100,0,104,104
Clara,F,100,56680,82,56762
Xavien,M,100,0,656,656
Ky,M,91,111,1180,1291
Raizo,M,100,0,37,37
Jemarius,M,100,0,13,13
Rowrenia,F,100,7,0,7
Izaria,F,100,28,0,28
Revan,M,100,0,171,171
Jaidden,M,100,0,7,7
Malke,F,100,30,0,30
Dreena,F,100,36,0,36
Ivor,M,100,0,304,304
Yameen,M,100,0,12,12
Gobind,M,100,0,10,10
Aniylah,F,100,338,0,338
Amari,M,52,11469,12562,24031
Levion,M,100,0,5,5
Ashot,M,100,0,27,27
Tynayah,F,100,5,0,5
Ulises,M,100,15,9331,9346
Padrick,M,100,0,5,5
Catisha,F,100,45,0,45
Halo,F,87,906,133,1039
Lonita,F,100,262,0,262
Janifer,F,100,266,0,266
Rosangelica,F,100,150,0,150
Kaleigh,F,100,14793,6,14799
Trelan,M,100,0,10,10
Lenea,F,100,192,0,192
Lovel,M,100,0,5,5
Jaraad,M,100,0,29,29
Christinna,F,100,75,0,75
Abigal,F,100,724,0,724
Deilyn,F,100,23,0,23
Maray,F,100,11,0,11
Theory,F,73,30,11,41
Dimitriy,M,100,0,71,71
Jennylynn,F,100,19,0,19
Thienan,M,63,29,50,79
Milca,F,100,507,0,507
Tilor,M,100,0,10,10
Tajhanae,F,100,5,0,5
Millena,F,100,119,0,119
Latwana,F,100,42,0,42
Estarlin,M,100,0,5,5
Taiwo,M,69,57,128,185
Juelle,F,73,43,16,59
Carrina,F,100,157,0,157
Shavawn,F,100,55,0,55
Rashayla,F,100,18,0,18
Terrianna,F,100,346,0,346
Mari,F,100,13542,10,13552
Shafonda,F,100,19,0,19
Antoneo,M,100,0,64,64
Deleno,M,100,0,5,5
Annaira,F,100,5,0,5
Dillan,M,96,270,6288,6558
Anarose,F,100,25,0,25
Tinker,F,50,10,10,20
Kylierose,F,100,6,0,6
Emelee,F,100,68,0,68
Lafawn,F,100,83,0,83
Chitina,F,100,5,0,5
Zay,M,100,0,41,41
Emmilia,F,100,59,0,59
Josen,M,100,0,15,15
Verina,F,100,100,0,100
Rakin,M,100,0,112,112
Joshton,M,100,0,16,16
Avajane,F,100,6,0,6
Delvaughn,M,100,0,6,6
Kassan,M,100,0,15,15
Angler,M,100,0,5,5
Shanaja,F,100,6,0,6
Dinnis,M,100,0,60,60
Rader,M,100,0,5,5
Jerlisa,F,100,116,0,116
Charisma,F,100,3310,0,3310
Marquida,F,100,29,0,29
Aliciamarie,F,100,12,0,12
Timmya,F,100,67,0,67
Beckham,M,99,22,3230,3252
Ishamel,M,100,0,11,11
Taquoya,F,100,5,0,5
Farheen,F,100,122,0,122
Amanjit,M,100,0,5,5
Kenna,F,99,8691,126,8817
Jayliannie,F,100,11,0,11
Shanike,F,100,17,0,17
Waymond,M,100,0,829,829
Markeece,M,100,0,43,43
Iksha,F,100,12,0,12
Donnett,F,100,26,0,26
Stedmen,M,100,0,6,6
Tyshiem,M,100,0,5,5
Ghael,M,100,0,7,7
Lallie,F,100,15,0,15
Huntleigh,F,100,36,0,36
Phuc,M,97,7,272,279
Lalena,F,100,291,0,291
Bertis,M,100,0,73,73
Luisgabriel,M,100,0,6,6
Bronwyn,F,100,3041,0,3041
Jamila,F,100,6915,0,6915
Ashaki,F,100,252,0,252
Jywon,M,100,0,5,5
Temprynce,F,100,10,0,10
Aleona,F,100,5,0,5
Tyeisha,F,100,1553,0,1553
Oluwafunmilayo,F,100,18,0,18
Taunya,F,100,1464,0,1464
Ohaji,M,100,0,7,7
Grayton,M,100,0,90,90
Karey,F,80,2148,548,2696
Torynn,F,100,5,0,5
Eilynn,F,100,6,0,6
Kedarrius,M,100,0,35,35
Khadisah,F,100,5,0,5
Carshena,F,100,30,0,30
Moraya,F,100,7,0,7
Samari,F,68,967,465,1432
Mofiyinfoluwa,F,100,5,0,5
Sharlin,F,100,49,0,49
Azzie,F,100,70,0,70
Kevondra,F,100,5,0,5
Eules,M,100,0,5,5
Daiyana,F,100,44,0,44
Ju,F,67,24,12,36
Louann,F,100,3818,0,3818
Aliyana,F,100,1112,0,1112
Kanylah,F,100,39,0,39
Shalina,F,100,542,0,542
Anousha,F,100,20,0,20
Ahkil,M,100,0,5,5
Ramla,F,100,150,0,150
Remya,F,100,29,0,29
Kristoph,M,100,0,50,50
Valree,F,100,37,0,37
Sonakshi,F,100,60,0,60
Oreana,F,100,23,0,23
Kirya,F,100,11,0,11
Teisa,F,100,22,0,22
Nakaiyah,F,100,28,0,28
Nychole,F,100,12,0,12
Para,F,100,44,0,44
Farihah,F,100,11,0,11
Jabbar,M,100,0,683,683
Ahreanna,F,100,5,0,5
Maleni,F,100,203,0,203
Yandier,M,100,0,5,5
Jervis,M,100,0,197,197
Lacreta,F,100,12,0,12
Vandetta,F,100,38,0,38
Emare,M,100,0,13,13
Elveta,F,100,6,0,6
Abbot,M,100,0,12,12
Sayli,F,100,15,0,15
Queenester,F,100,10,0,10
Eilley,F,100,52,0,52
Zendaya,F,100,625,0,625
Aymie,F,100,5,0,5
Cervante,M,100,0,10,10
Akeilah,F,100,29,0,29
Keagon,M,100,0,193,193
Daniellemarie,F,100,16,0,16
Ahlexis,F,100,24,0,24
Koraima,F,100,231,0,231
Pegan,F,100,12,0,12
Dejhana,F,100,5,0,5
Deareon,M,100,0,5,5
Nikoletta,F,100,110,0,110
Annise,F,100,156,0,156
Llinda,F,100,6,0,6
Cynii,F,100,5,0,5
Adair,M,57,905,1208,2113
Josericardo,M,100,0,6,6
Nicholai,M,100,0,747,747
Andilynn,F,100,36,0,36
Teeka,F,100,15,0,15
Reneda,F,100,8,0,8
Leaha,F,100,553,0,553
Khamiya,F,100,123,0,123
Aulelei,F,100,18,0,18
Anu,F,95,212,10,222
Dannia,F,100,303,0,303
Shuntell,F,100,64,0,64
Robinson,M,100,0,2069,2069
Tabbytha,F,100,5,0,5
Adagio,M,100,0,9,9
Beija,F,100,40,0,40
Amel,F,52,317,296,613
Nigil,M,100,0,91,91
Lorra,F,100,425,0,425
Liyanna,F,100,51,0,51
Tyley,F,100,13,0,13
Rahmi,M,100,0,5,5
Yamir,M,100,0,442,442
Taelynne,F,100,7,0,7
Thierno,M,100,0,238,238
Khaliyl,M,100,0,18,18
Adaia,F,100,51,0,51
Mariyani,F,100,11,0,11
Manton,M,100,0,5,5
Morgandy,F,100,25,0,25
Saaphyri,F,100,11,0,11
Manavi,F,100,5,0,5
Mirriah,F,100,5,0,5
Neemah,F,100,5,0,5
Seth,M,100,489,153269,153758
Baler,M,100,0,6,6
Abaigeal,F,100,307,0,307
Meridith,F,100,2508,5,2513
Anatasia,F,100,123,0,123
Yasin,M,100,0,1487,1487
Sanaz,F,100,135,0,135
Joesef,M,100,0,10,10
Christabell,F,100,13,0,13
Jaresha,F,100,5,0,5
Darlah,F,100,37,0,37
Joneen,F,100,21,0,21
Kievon,M,100,0,11,11
Rasheka,F,100,117,0,117
Shafeqah,F,100,14,0,14
Hinson,M,100,0,5,5
Cheng,M,94,38,611,649
Hansen,M,100,0,572,572
Marny,F,100,210,0,210
Brookyln,F,100,5,0,5
Lot,M,100,0,10,10
Rannah,F,100,21,0,21
Den,M,100,0,5,5
Vella,F,100,358,0,358
Pheonix,M,57,262,351,613
Daryah,F,100,28,0,28
Geneveive,F,100,21,0,21
Maudeen,F,100,5,0,5
Latash,F,100,92,0,92
Wen,M,57,65,87,152
Jazzmine,F,100,2321,0,2321
Rael,M,52,143,153,296
Sherie,F,100,4630,0,4630
Dekker,M,100,0,114,114
Akio,M,100,0,253,253
Havan,F,100,21,0,21
Copper,M,75,43,131,174
Roshan,M,92,118,1409,1527
Georgiana,F,100,2970,0,2970
Laur,F,100,10,0,10
Yasminda,F,100,6,0,6
Aasha,F,100,252,0,252
Aaro,M,100,0,16,16
Broderik,M,100,0,11,11
Quaniyah,F,100,87,0,87
Yero,M,100,0,19,19
Ialiyah,F,100,24,0,24
Falicity,F,100,150,0,150
Lacrissa,F,100,12,0,12
Wyette,M,100,0,20,20
Jyair,M,100,0,141,141
Minhtri,M,100,0,5,5
Yutaro,M,100,0,44,44
Gabiela,F,100,6,0,6
Cambre,F,100,93,0,93
Albion,M,100,0,220,220
Anetria,F,100,61,0,61
Braidon,M,100,0,417,417
Eliezer,M,100,0,5768,5768
Linzy,F,81,892,212,1104
Jociah,M,100,0,6,6
Shareem,M,100,0,5,5
Kenzy,F,95,584,32,616
Nicandro,M,100,0,129,129
Breanah,F,100,216,0,216
Jaydus,M,100,0,24,24
Annora,F,100,200,0,200
Jeriah,M,80,236,932,1168
Matheau,M,100,0,67,67
Alixandria,F,100,539,0,539
Traeh,F,71,71,29,100
Sriyansh,M,100,0,5,5
Dionis,M,100,0,95,95
Petyon,F,100,5,0,5
Markay,F,100,27,0,27
Kahmiya,F,100,24,0,24
Mitchal,M,100,0,40,40
Tyell,M,100,0,5,5
Azden,M,100,0,11,11
Robina,F,100,393,0,393
Neyra,F,100,80,0,80
Bronx,M,99,5,671,676
Nickole,F,100,2481,0,2481
Aliciana,F,100,292,0,292
Deora,F,100,10,0,10
Abundio,M,100,0,87,87
Laiana,F,100,82,0,82
Kalaiyah,F,100,15,0,15
Camreon,M,100,0,17,17
Ayla,F,100,14526,0,14526
Reata,F,100,45,0,45
Marquarious,M,100,0,10,10
Kenyota,F,84,26,5,31
Jaci,F,100,4325,0,4325
Shakuria,F,100,15,0,15
Maralynn,F,100,16,0,16
Ananshi,F,100,6,0,6
Danyle,F,100,161,0,161
Aahna,F,100,72,0,72
Malakie,M,100,0,64,64
Sammael,M,100,0,5,5
Chemane,F,100,5,0,5
Jaycian,M,100,0,7,7
Brentten,M,100,0,5,5
Yissel,F,100,317,0,317
Lashonya,F,100,52,0,52
Terrlyn,F,100,12,0,12
Aeryal,F,100,24,0,24
Kauan,M,100,0,267,267
Aric,M,100,5,7141,7146
Jaylyne,F,95,89,5,94
Kalev,M,100,0,105,105
Leesly,F,100,17,0,17
Ladarion,M,100,0,320,320
Qunisha,F,100,85,0,85
Jennalyn,F,100,399,0,399
Earleen,F,100,405,0,405
Ameri,F,94,98,6,104
Layona,F,100,24,0,24
Quillie,M,100,0,10,10
Lam,M,90,53,478,531
Bobbetta,F,100,10,0,10
Motley,M,100,0,10,10
Rurik,M,100,0,5,5
Exton,M,100,0,29,29
Mccai,M,100,0,6,6
Tyionna,F,100,49,0,49
Kevon,M,99,56,4855,4911
Anka,F,100,7,0,7
Inda,F,100,223,0,223
Sama,F,100,599,0,599
Josine,F,100,5,0,5
Kurtlin,M,100,0,5,5
Jalaine,F,100,141,0,141
Supreme,M,100,0,202,202
Jaimeson,M,93,16,215,231
Canyen,M,100,0,5,5
Rubyjane,F,100,8,0,8
Ryden,M,96,32,844,876
Maryagnes,F,100,25,0,25
Johnea,F,100,20,0,20
Rutherford,M,100,0,130,130
Cauan,M,100,0,10,10
Juanjr,M,100,0,5,5
Namarion,M,100,0,9,9
Jallen,M,100,0,59,59
Giani,M,59,161,227,388
Lalinda,F,100,34,0,34
Brogyn,M,100,0,5,5
Lilburn,M,100,0,33,33
Hydi,F,100,26,0,26
Brentton,M,100,0,182,182
Marckos,M,100,0,5,5
Mattelynn,F,100,10,0,10
Kaius,M,100,0,255,255
Jesleen,F,100,10,0,10
Camrey,F,100,49,0,49
Kristinia,F,100,244,0,244
Lynaya,F,100,13,0,13
Keiyona,F,100,5,0,5
Kimiya,F,100,277,0,277
Elziabeth,F,100,12,0,12
Skyelee,F,100,5,0,5
Metro,M,100,0,30,30
Jelanie,F,100,5,0,5
Sabriel,F,71,82,34,116
Trayonna,F,100,64,0,64
Marylinn,F,100,5,0,5
Niasha,F,100,180,0,180
Krysia,F,100,75,0,75
Kynsli,F,100,50,0,50
Felichia,F,100,35,0,35
Vu,M,100,0,764,764
Tracine,F,100,28,0,28
Rafer,M,100,0,34,34
Shontella,F,100,17,0,17
Natthew,M,100,0,49,49
Ramsey,M,80,1207,4810,6017
Elyzah,F,100,19,0,19
Raushanah,F,100,164,0,164
Zoee,F,100,1559,0,1559
Yanira,F,100,3017,0,3017
Jadyn,F,78,11189,3189,14378
Sritha,F,100,50,0,50
Latitia,F,100,490,0,490
Nanett,F,100,17,0,17
Alliyah,F,100,2673,0,2673
Kitara,F,100,146,0,146
Acadia,F,100,676,0,676
Kaylar,F,100,10,0,10
Janara,F,100,64,0,64
Samaa,F,100,78,0,78
Cadhla,F,100,13,0,13
Kelani,F,96,345,14,359
Kaiza,F,100,5,0,5
Shardai,F,100,293,0,293
Kaylien,F,100,5,0,5
Monty,M,99,155,11840,11995
Rayvan,F,100,18,0,18
Sanjeev,M,100,0,415,415
Volare,F,100,5,0,5
Gavynn,M,100,0,200,200
Mauriceo,M,100,0,16,16
Lailanee,F,100,18,0,18
Maclay,F,100,11,0,11
Tomea,F,100,5,0,5
Traison,M,100,0,5,5
Charnette,F,100,192,0,192
Benett,M,100,0,210,210
Jensine,F,100,328,0,328
Ikechi,M,100,0,41,41
Jakela,F,100,54,0,54
Richel,F,100,104,0,104
Elynore,F,100,5,0,5
Aronde,M,100,0,37,37
Aliyaha,F,100,23,0,23
Tayln,F,100,12,0,12
Tristyn,F,52,1846,1677,3523
Cyrenna,F,100,6,0,6
Abdallah,M,100,0,1070,1070
Shevetta,F,100,5,0,5
Marva,F,100,4912,0,4912
Derwin,M,100,0,3423,3423
Edisson,M,100,0,27,27
Tomacina,F,100,5,0,5
Kenshia,F,100,5,0,5
Jamyre,M,100,0,15,15
Akelah,F,100,49,0,49
Dreyon,M,100,0,40,40
Kambrey,F,100,73,0,73
Byntlee,M,84,5,27,32
Audrienna,F,100,19,0,19
Shanavia,F,100,220,0,220
Nikith,M,100,0,11,11
Dimetri,M,100,0,114,114
Chy,F,100,11,0,11
Alyzae,F,100,98,0,98
Zakk,M,100,0,442,442
Ethanjohn,M,100,0,15,15
Crusita,F,100,21,0,21
Rajab,M,100,0,7,7
Greta,F,100,16847,0,16847
Jonny,M,98,52,2466,2518
Storm,M,64,1495,2643,4138
Nylajah,F,100,5,0,5
Maryelle,F,100,11,0,11
Paizly,F,100,14,0,14
Nichlos,M,100,0,188,188
Deiadra,F,100,6,0,6
Graeson,M,97,15,425,440
Oladipo,M,100,0,5,5
Lambros,M,100,0,47,47
Giannie,F,100,86,0,86
Darbee,F,100,5,0,5
Dannee,F,100,5,0,5
Chanon,F,70,62,26,88
Terasa,F,100,367,0,367
Sunasia,F,100,5,0,5
Raykwon,M,100,0,93,93
Luiscarlos,M,100,0,111,111
Jakzenny,F,100,11,0,11
Tomy,M,100,0,332,332
Dezhaun,M,100,0,5,5
Osciel,M,100,0,5,5
Rajanae,F,100,153,0,153
Nyarah,F,100,32,0,32
Markquise,M,100,0,10,10
Argene,M,100,0,5,5
Milini,F,100,16,0,16
Emirra,F,100,5,0,5
Janera,F,100,56,0,56
Miliani,F,100,342,0,342
Antonya,F,100,209,0,209
Ilyan,M,100,0,13,13
Laquinta,F,98,1209,27,1236
Mckeyla,F,100,12,0,12
Yaquelin,F,100,1293,0,1293
Darrisha,F,100,20,0,20
Montrae,M,100,0,76,76
Martisha,F,100,406,0,406
Delmond,M,100,0,5,5
Camariyah,F,100,11,0,11
Neron,M,100,0,5,5
Trillion,M,100,0,33,33
Dirrick,M,100,0,40,40
Aye,F,100,25,0,25
Eunita,F,100,13,0,13
Itzelle,F,100,74,0,74
Nakeita,F,100,73,0,73
Kassie,F,100,6425,0,6425
Moziah,M,100,0,24,24
Kelyse,F,100,79,0,79
Paesyn,F,100,16,0,16
Daijaun,M,100,0,5,5
Kynnady,F,100,5,0,5
Laia,F,100,215,0,215
Annaya,F,100,228,0,228
Ilany,F,100,33,0,33
Jontez,M,100,0,117,117
Valaree,F,100,225,0,225
Omelia,F,100,18,0,18
Laquavia,F,100,13,0,13
Zyahna,F,100,6,0,6
Dekendrick,M,100,0,182,182
Tribeca,F,100,6,0,6
Khani,M,87,17,114,131
Sharrod,M,100,0,543,543
Lyana,F,100,463,0,463
Luisandres,M,100,0,11,11
Emorie,F,100,326,0,326
Canin,M,100,0,6,6
Ivani,F,100,5,0,5
Truc,F,93,226,17,243
Danilah,F,100,29,0,29
Yadira,F,100,12187,23,12210
Axsel,M,100,0,47,47
Mcneil,M,100,0,21,21
Geremia,M,100,0,10,10
Giulia,F,100,2036,0,2036
Kasson,M,100,0,72,72
Saddiq,M,100,0,20,20
Lamarianna,F,100,8,0,8
Tradd,M,100,0,41,41
Gianah,F,100,93,0,93
Breaja,F,100,36,0,36
Carneal,M,100,0,5,5
Damaine,M,100,0,33,33
Aveon,M,94,20,342,362
Shaunna,F,100,2921,0,2921
Mahbeer,M,100,0,6,6
Andoni,M,100,0,124,124
Anirud,M,100,0,5,5
Enyla,F,100,52,0,52
Kan,M,100,0,6,6
Castro,M,100,0,6,6
Janasia,F,100,1062,0,1062
Yetziel,M,100,0,6,6
Marialy,F,100,86,0,86
Koriann,F,100,27,0,27
Terrencia,F,100,25,0,25
Keyashia,F,100,24,0,24
Hawthorne,M,100,0,87,87
Mayco,M,100,0,176,176
Daion,M,100,0,212,212
Tedros,M,100,0,5,5
Shiye,M,100,0,5,5
Dessiree,F,100,137,0,137
Tymarion,M,100,0,123,123
Deantonio,M,100,0,39,39
Tychelle,F,100,90,0,90
Eyosias,M,100,0,31,31
Asbury,M,100,0,41,41
Sonta,F,100,15,0,15
Griffith,M,100,0,890,890
Arrow,M,79,84,317,401
Seianna,F,100,5,0,5
Boubacar,M,100,0,283,283
Semone,F,100,247,0,247
Jasandra,F,100,9,0,9
Obet,M,100,0,26,26
Rayonda,F,100,5,0,5
Analiyah,F,100,560,0,560
Morina,F,100,7,0,7
Tyvaeh,F,100,5,0,5
Louna,F,100,5,0,5
Skyleigh,F,100,397,0,397
Jaelynn,F,99,6253,94,6347
Zyanna,F,100,373,0,373
Rececca,F,100,26,0,26
Tavishi,F,100,18,0,18
Cepeda,M,100,0,24,24
Alix,F,78,3066,848,3914
Kwayera,F,100,5,0,5
Ambreal,F,100,30,0,30
Carman,F,83,1999,407,2406
Dakiyah,F,100,81,0,81
Robecca,F,100,163,0,163
Dory,F,88,893,119,1012
Lanisa,F,100,75,0,75
Dristen,M,90,5,44,49
Grafton,M,100,0,452,452
Shelsey,F,100,214,0,214
Ladaijah,F,100,45,0,45
Kaleiya,F,100,33,0,33
Xabi,M,100,0,58,58
Karolynn,F,100,201,0,201
Zubair,M,100,0,386,386
Taianna,F,100,23,0,23
Burma,F,100,142,0,142
Troyanne,F,100,6,0,6
Aldrena,F,100,10,0,10
Slone,M,82,7,33,40
Aengus,M,100,0,117,117
Wezley,M,100,0,15,15
Timaj,M,100,0,5,5
Faran,F,80,24,6,30
Mckensy,F,100,11,0,11
Atzi,F,100,48,0,48
Latorie,F,100,74,0,74
Harland,M,100,0,1374,1374
Rozalee,F,100,5,0,5
Johanthan,M,100,0,111,111
Johathon,M,100,0,114,114
Besnik,M,100,0,96,96
Halla,F,100,293,0,293
Garison,M,100,0,124,124
Romane,M,100,0,26,26
Lacey,F,98,48672,846,49518
Lliam,M,100,0,299,299
Purab,M,100,0,5,5
Narek,M,100,0,357,357
Ilette,F,100,6,0,6
Arkadian,M,100,0,5,5
Davonia,F,100,16,0,16
Madysan,F,100,18,0,18
Eygpt,F,100,5,0,5
Zea,F,100,204,0,204
Mekiya,F,100,50,0,50
Daidre,F,100,5,0,5
Jadelynne,F,100,11,0,11
Lailana,F,100,50,0,50
Riahna,F,100,30,0,30
Lavett,F,100,22,0,22
Madelena,F,100,146,0,146
Joanne,F,100,109419,220,109639
Floretta,F,100,550,0,550
Maleigha,F,100,951,0,951
Aula,F,100,5,0,5
Dovan,M,100,0,6,6
Natani,F,100,10,0,10
Aneida,F,100,10,0,10
Einin,F,100,6,0,6
Graylan,M,100,0,28,28
Tairon,M,100,0,17,17
Jaila,F,100,2133,0,2133
Anjalina,F,100,59,0,59
Joshuadavid,M,100,0,57,57
Hazir,M,100,0,5,5
Kahlia,F,100,764,0,764
Kerlin,F,100,7,0,7
Chelsae,F,100,386,0,386
Taylorrae,F,100,22,0,22
Alexzandrea,F,100,358,0,358
Mariyam,F,100,183,0,183
Ysela,F,100,137,0,137
Sruti,F,100,110,0,110
Corbon,M,100,0,5,5
Shohjahon,M,100,0,6,6
Shunta,F,96,732,29,761
Makiylah,F,100,18,0,18
Taiylor,F,100,272,0,272
Nakenya,F,100,67,0,67
Tannar,M,93,10,141,151
Yaritzi,F,100,226,0,226
Yairet,F,100,6,0,6
Rochel,F,100,2766,0,2766
Alesso,M,100,0,6,6
Adeliz,F,100,69,0,69
Krisztina,F,100,27,0,27
Kenley,F,84,4710,876,5586
Leigh,F,92,38650,3163,41813
Ittai,M,100,0,13,13
Davin,M,97,335,9420,9755
Keeler,M,100,0,33,33
Myrtice,F,100,373,0,373
Marceline,F,100,803,0,803
Kirtan,M,100,0,129,129
Michaael,M,100,0,7,7
Kimbrely,F,100,78,0,78
Neeve,F,100,29,0,29
Jaelanie,F,100,5,0,5
Jemaine,M,100,0,169,169
Timber,F,68,804,386,1190
Fode,M,100,0,27,27
Senait,F,100,38,0,38
Sabeena,F,100,7,0,7
Husayn,M,100,0,38,38
Danilla,F,100,5,0,5
Kamdynn,F,100,12,0,12
Gaston,M,100,0,1791,1791
Haylie,F,100,9220,0,9220
Yosselyn,F,100,163,0,163
Charlianne,F,100,20,0,20
Niurka,F,100,260,0,260
Macallister,M,100,0,196,196
Cadillac,M,100,0,6,6
Shanedra,F,100,59,0,59
Tamyria,F,100,5,0,5
Ailena,F,100,15,0,15
Davier,M,100,0,187,187
Shakima,F,100,627,0,627
Zyairah,F,100,123,0,123
Merilynn,F,100,36,0,36
Rayford,M,100,0,2364,2364
Laithen,M,100,0,33,33
Rynisha,F,100,11,0,11
Kewanna,F,100,256,0,256
Larae,F,100,2386,0,2386
Kendar,F,100,5,0,5
Tykerria,F,100,176,0,176
Brodix,M,100,0,12,12
Breara,F,100,5,0,5
Branton,M,100,0,772,772
Irvan,M,100,0,22,22
Anhar,F,100,35,0,35
Tyreeq,M,100,0,11,11
Maveryck,M,100,0,12,12
Ceeanna,F,100,10,0,10
Tijanae,F,100,6,0,6
Ayannia,F,100,10,0,10
Jeanie,F,100,11401,0,11401
Kemonie,F,84,91,17,108
Jvontae,M,100,0,7,7
Shebria,F,100,5,0,5
Shivanshi,F,100,11,0,11
Sonna,F,100,229,0,229
Jenika,F,100,739,0,739
Takenya,F,100,286,0,286
Elsbeth,F,100,342,0,342
Leeshaun,M,100,0,5,5
Ream,F,100,23,0,23
Daevion,M,100,0,418,418
Larance,M,100,0,76,76
Janeidy,F,100,5,0,5
Rajeeyah,F,100,10,0,10
Rawley,M,100,0,290,290
Evaleigh,F,100,79,0,79
Satoru,M,100,0,6,6
Mckinzee,F,100,192,0,192
Tansha,F,100,12,0,12
Johnchristian,M,100,0,45,45
Arianys,F,100,12,0,12
Zalen,M,100,0,276,276
Dolphine,F,100,5,0,5
Lacoria,F,100,27,0,27
Brannock,M,100,0,7,7
Leeann,F,100,13309,0,13309
Sherena,F,100,446,0,446
Aubreyonna,F,100,17,0,17
Maida,F,100,1015,0,1015
Miklos,M,100,0,204,204
Kamelia,F,100,248,0,248
Kadedria,F,100,12,0,12
Kanari,F,50,23,23,46
Misgana,F,100,5,0,5
Raesha,F,100,78,0,78
Febbie,F,100,5,0,5
Aleata,F,100,17,0,17
Jerwan,M,100,0,7,7
Idona,F,100,12,0,12
Kimala,F,100,326,0,326
Arness,M,100,0,11,11
Danovan,M,100,0,6,6
Yayoi,F,100,5,0,5
Treaven,M,100,0,5,5
Emilin,F,100,23,0,23
Caleal,M,100,0,5,5
Ndrea,F,100,10,0,10
Juanell,F,100,36,0,36
Lilyanne,F,100,1047,0,1047
Nijha,F,100,43,0,43
Tima,F,100,139,0,139
Audrene,F,100,16,0,16
Katie,F,100,187967,369,188336
Texas,M,90,21,189,210
Stefana,F,100,49,0,49
Jamilet,F,100,738,0,738
Damisi,M,100,0,6,6
Chanz,M,100,0,230,230
Moeisha,F,100,48,0,48
Avangelia,F,100,6,0,6
Jacianna,F,100,13,0,13
Amarah,F,100,897,0,897
Reut,F,100,5,0,5
Krishonda,F,100,27,0,27
Caidance,F,100,177,0,177
Pearce,M,99,12,819,831
Milon,M,100,0,61,61
Danikka,F,100,44,0,44
Ayari,F,100,279,0,279
Gissela,F,100,208,0,208
Tue,M,100,0,11,11
Hermine,F,100,112,0,112
Briana,F,100,90621,201,90822
Eldridge,M,100,0,1847,1847
Dejonnae,F,100,6,0,6
Varen,M,100,0,32,32
Simranpreet,F,100,29,0,29
Kanasha,F,100,30,0,30
Daijour,M,100,0,5,5
Kewuan,M,100,0,19,19
Jaevier,M,100,0,5,5
Brehan,F,100,27,0,27
Myla,F,100,7889,0,7889
Shaquitta,F,100,238,0,238
Keianna,F,100,963,0,963
Ramsha,F,100,120,0,120
Lakedrick,M,100,0,5,5
Shaylonda,F,100,5,0,5
Ahan,M,100,0,143,143
Syndee,F,100,57,0,57
Lorisha,F,100,10,0,10
Kelian,M,100,0,20,20
Kataleya,F,100,675,0,675
Tegan,F,73,4718,1776,6494
Soheila,F,100,10,0,10
Kylik,M,100,0,20,20
Deionta,M,100,0,57,57
Monyca,F,100,12,0,12
Marcos,M,100,156,44599,44755
Halsey,F,70,202,85,287
Shakiyah,F,100,266,0,266
Trevira,F,100,5,0,5
Tula,F,100,438,0,438
Geriann,F,100,206,0,206
Nashia,F,100,183,0,183
Syiere,M,100,0,5,5
Sandricka,F,100,5,0,5
Mihran,M,100,0,71,71
Suban,F,100,7,0,7
Draedon,M,100,0,6,6
Ishanth,M,100,0,27,27
Sojourner,F,100,133,0,133
Absidy,F,100,17,0,17
Amberle,F,100,198,0,198
Tyniya,F,100,71,0,71
Jadus,M,100,0,27,27
Donterrio,M,100,0,28,28
Taahir,M,100,0,44,44
Larrica,F,100,5,0,5
Heisy,F,100,11,0,11
Timeisha,F,100,16,0,16
Omaira,F,100,362,0,362
Maybel,F,100,60,0,60
Inikki,F,100,5,0,5
Malakai,M,100,16,4853,4869
Atyanna,F,100,13,0,13
Contrell,M,100,0,214,214
Gurshaan,M,100,0,135,135
Jisoo,F,100,11,0,11
Mastin,M,100,0,11,11
Ileah,F,100,254,0,254
Joss,M,66,136,260,396
Mickalla,F,100,5,0,5
Carlester,M,100,0,74,74
Zynah,F,100,36,0,36
Lashaundria,F,100,17,0,17
Sheryel,F,100,11,0,11
Talayla,F,100,56,0,56
Elle,F,100,10515,0,10515
Giankarlo,M,100,0,50,50
Marybella,F,100,51,0,51
Jernice,F,100,5,0,5
Renatta,F,100,372,0,372
Jaekob,M,100,0,54,54
Camille,F,99,51448,408,51856
Latrena,F,100,261,0,261
Jaece,M,100,0,54,54
Jyssica,F,100,109,0,109
Majel,F,100,30,0,30
Savanah,F,100,8916,0,8916
Kyion,M,100,0,100,100
Fatimata,F,100,184,0,184
Janeily,F,100,6,0,6
Senora,F,100,500,0,500
Dandrea,F,84,910,174,1084
Kennith,M,100,5,6526,6531
Jourden,M,68,84,177,261
Jhaylen,M,100,0,21,21
Onesimus,M,100,0,33,33
Tywania,F,100,5,0,5
Yahli,M,100,0,11,11
Asuka,F,100,92,0,92
Brittiney,F,100,339,0,339
Yeleina,F,100,15,0,15
Jonathin,M,100,0,101,101
Regnia,F,100,56,0,56
Addiline,F,100,5,0,5
Deariah,F,100,5,0,5
Jheremy,M,100,0,52,52
Sharita,F,100,2637,0,2637
Jojuan,M,100,0,123,123
Sadora,F,100,11,0,11
Coletha,F,100,28,0,28
Aarib,M,100,0,39,39
Antavis,M,100,0,15,15
Leila,F,100,26137,0,26137
Umar,M,100,0,1701,1701
Derotha,F,100,42,0,42
Raziya,F,100,235,0,235
Nikil,M,100,0,30,30
Jakaylen,M,100,0,33,33
Nekisha,F,100,410,0,410
Curissa,F,100,28,0,28
Jaquelin,F,100,3578,0,3578
Mahirah,F,100,5,0,5
Shanitra,F,100,273,0,273
Regene,F,100,63,0,63
Dilshan,M,100,0,10,10
Nakasia,F,100,7,0,7
Alevia,F,100,33,0,33
Jonasia,F,100,192,0,192
Quintine,M,100,0,5,5
Leondria,F,100,45,0,45
Terenia,F,100,15,0,15
Julenny,F,100,5,0,5
Lurie,F,67,12,6,18
Sidy,M,100,0,17,17
Laqueshia,F,100,141,0,141
Heiley,F,100,98,0,98
Yeray,M,97,5,169,174
Daiza,F,100,58,0,58
Jadeon,M,100,0,49,49
Denyel,F,100,32,0,32
Miliyah,F,100,61,0,61
Lamberto,M,100,0,298,298
Jaxin,M,100,0,535,535
Mahasin,F,100,87,0,87
Mayara,F,100,70,0,70
Leighlani,F,100,7,0,7
Basma,F,100,238,0,238
Jahda,F,100,28,0,28
Dace,M,95,18,370,388
Dominike,M,100,0,15,15
Liamgabriel,M,100,0,7,7
Wisin,M,100,0,27,27
Thoren,M,100,0,72,72
Paulie,M,56,11,14,25
Eleftherios,M,100,0,156,156
Weslee,M,88,98,751,849
Sheraton,M,100,0,5,5
Camaria,F,100,181,0,181
Taslin,F,100,5,0,5
Irene,F,100,70914,246,71160
Conlin,M,100,0,219,219
Caidyn,M,59,354,500,854
Marlem,F,100,36,0,36
Caysen,M,96,34,749,783
Alga,F,100,5,0,5
Demare,M,100,0,19,19
Gaelan,M,100,0,125,125
Luzmila,F,100,5,0,5
Mikhayla,F,100,357,0,357
Shanise,F,100,1459,0,1459
Tarris,M,100,0,92,92
Tam,M,53,805,893,1698
Nishith,M,100,0,5,5
Evalisa,F,100,5,0,5
Ramsen,M,100,0,5,5
Srimedha,F,100,5,0,5
Chimaobim,M,100,0,5,5
Shequitta,F,100,15,0,15
Amila,F,100,235,0,235
Apolo,M,100,0,97,97
Hinley,F,100,43,0,43
Rondey,M,100,0,233,233
Audriauna,F,100,42,0,42
Williamrobert,M,100,0,6,6
Margaretjo,F,100,5,0,5
Stephnie,F,100,530,0,530
Narvis,F,100,6,0,6
Kemet,M,100,0,38,38
Shauntelle,F,100,195,0,195
Nicohlas,M,100,0,40,40
Elyon,M,100,0,61,61
Nathania,F,100,455,0,455
Marcellino,M,100,0,210,210
Shawntice,F,100,10,0,10
Terricia,F,100,5,0,5
Eiley,F,100,206,0,206
Ashea,F,100,69,0,69
Lushonda,F,100,5,0,5
Leianne,F,100,117,0,117
Trevonte,M,100,0,545,545
Jennis,F,100,20,0,20
Zaleyah,F,100,16,0,16
Lourena,F,100,11,0,11
Goshen,M,100,0,5,5
Temeshia,F,100,38,0,38
Admir,M,100,0,184,184
Nakitia,F,100,6,0,6
Shaddrick,M,100,0,10,10
Shaker,M,100,0,22,22
Elenis,F,100,6,0,6
Brionnah,F,100,35,0,35
Kanesha,F,100,1752,0,1752
Luken,M,100,0,141,141
Kinnick,M,98,5,300,305
Gennette,F,100,94,0,94
Jeromey,M,100,0,416,416
Malikhai,M,100,0,15,15
Mareena,F,100,289,0,289
Romita,F,100,6,0,6
Raeyanna,F,100,5,0,5
Sindhu,F,100,189,0,189
Markavion,M,100,0,45,45
Gyana,F,100,17,0,17
Willliam,M,100,0,233,233
Karielys,F,100,5,0,5
Xanti,M,100,0,13,13
Willetta,F,100,587,0,587
Hadriel,M,100,0,46,46
Ariyeh,M,100,0,6,6
Rachad,M,100,0,38,38
Cresha,F,100,46,0,46
Candus,F,100,223,0,223
Phyliss,F,100,964,0,964
Zalman,M,100,0,452,452
Mercy,F,100,5310,20,5330
Avelinn,F,100,5,0,5
Kendo,M,100,0,6,6
Barnett,M,100,0,386,386
Angelleigh,F,100,5,0,5
Wini,F,100,5,0,5
Janlucas,M,100,0,25,25
Jamyla,F,100,421,0,421
Kahaan,M,100,0,14,14
Corinda,F,100,266,0,266
Joji,M,100,0,10,10
Ryelynn,F,100,79,0,79
Jerrall,M,100,0,11,11
Era,F,100,782,0,782
Davarous,M,100,0,5,5
Varney,M,100,0,6,6
Tytiyana,F,100,51,0,51
Gabryella,F,100,607,0,607
Jalena,F,100,895,0,895
Emonii,F,100,50,0,50
Velecia,F,100,77,0,77
Milaniya,F,100,5,0,5
Roberick,M,100,0,5,5
Romin,M,100,0,81,81
Idhant,M,100,0,19,19
Dacota,M,73,177,475,652
Aarshi,F,100,16,0,16
Cadee,F,100,382,0,382
Lunetta,F,100,5,0,5
Andreyna,F,100,13,0,13
Cordarian,M,100,0,12,12
Akena,F,100,10,0,10
Demon,M,100,0,821,821
Tyde,M,100,0,82,82
Caysin,M,100,0,25,25
Chinasa,F,100,36,0,36
Sharran,F,100,31,0,31
Oris,M,94,20,339,359
Zamia,F,100,199,0,199
Ardella,F,100,535,0,535
Ulrik,M,100,0,6,6
Rally,M,100,0,50,50
Binnie,F,91,48,5,53
Jassie,F,100,5,0,5
Joaquina,F,100,236,0,236
Revanth,M,100,0,61,61
Mayarose,F,100,6,0,6
Lenzy,M,74,54,153,207
Blair,F,52,12372,11312,23684
Keyarie,F,100,12,0,12
Alxavier,M,100,0,5,5
Bayne,M,100,0,282,282
Jimon,M,100,0,8,8
Merritt,M,57,1428,1930,3358
Lakishia,F,100,397,0,397
Lal,M,78,5,18,23
Skylarr,F,100,52,0,52
Gurshan,M,100,0,160,160
Jamard,M,100,0,32,32
Samarah,F,100,1247,0,1247
Ugonna,M,71,47,117,164
Geramiah,M,100,0,52,52
Estelita,F,100,69,0,69
Siba,F,100,6,0,6
Tanek,M,100,0,5,5
Brytnie,F,100,23,0,23
Kamraan,M,100,0,5,5
Nishta,F,100,15,0,15
Viaan,M,100,0,225,225
Jerrico,M,100,0,181,181
Domenic,M,100,0,6855,6855
Linkon,M,100,0,124,124
Jadaan,M,100,0,22,22
Nyliyah,F,100,38,0,38
Delenna,F,100,5,0,5
Symara,F,100,47,0,47
Xaviona,F,100,5,0,5
Bellaann,F,100,20,0,20
Brodee,M,97,15,525,540
Mileyshka,F,100,5,0,5
Kerionna,F,100,24,0,24
Kishawn,M,97,10,306,316
Kalliopi,F,100,215,0,215
Macarius,M,100,0,73,73
Dezere,F,100,5,0,5
Geannie,F,100,39,0,39
Chinemerem,M,86,5,30,35
Moya,F,100,540,0,540
Myyah,F,100,5,0,5
Lekai,M,100,0,5,5
Nisi,F,100,29,0,29
Dimitrious,M,100,0,63,63
Joelia,F,100,10,0,10
Larin,F,54,68,58,126
Ayrial,F,100,5,0,5
Deucalion,M,100,0,7,7
Marileysis,F,100,8,0,8
Joslyn,F,100,9110,28,9138
Jamileh,F,100,17,0,17
Dekiya,F,100,24,0,24
Broden,M,100,0,1313,1313
Nooh,M,100,0,35,35
Robiya,F,100,6,0,6
Aviella,F,100,102,0,102
Aarolyn,F,100,6,0,6
Makada,F,100,5,0,5
Finus,M,100,0,5,5
Temur,M,100,0,25,25
Jeania,F,100,366,0,366
Torr,M,100,0,13,13
Kaitlyne,F,100,318,0,318
Jakierra,F,100,12,0,12
Killian,M,92,419,4728,5147
Terrah,F,100,640,0,640
Anjanie,F,100,6,0,6
Andrico,M,100,0,13,13
Rosemari,F,100,23,0,23
Jamariun,M,100,0,5,5
Elissabeth,F,100,6,0,6
Wakely,F,100,19,0,19
Jordell,M,100,0,61,61
Talithia,F,100,39,0,39
Arnesto,M,100,0,5,5
Haania,F,100,5,0,5
Nerissa,F,100,1867,0,1867
Verdon,M,100,0,16,16
Charlain,F,100,5,0,5
Nala,F,100,2159,0,2159
Shawntay,F,95,694,35,729
Murissa,F,100,10,0,10
Maddysen,F,100,51,0,51
Cheyeene,F,100,5,0,5
Chalonda,F,100,128,0,128
Tecoa,F,100,6,0,6
Lamarian,M,100,0,58,58
Arlandria,F,100,12,0,12
Sufyaan,M,100,0,85,85
Vladyslav,M,100,0,11,11
Heidee,F,100,66,0,66
Rosselin,F,100,22,0,22
Yetzaly,F,100,5,0,5
Riddhi,F,100,438,0,438
Zykerion,M,100,0,16,16
Kawaski,M,100,0,37,37
Ghia,F,100,38,0,38
Elonna,F,100,46,0,46
Jacquanna,F,100,5,0,5
Shayleigh,F,100,604,0,604
Jamicia,F,100,91,0,91
Daveena,F,100,90,0,90
Joeangel,M,100,0,287,287
Herma,F,100,50,0,50
Deangalo,M,100,0,7,7
Barren,M,100,0,38,38
Quanterious,M,100,0,12,12
Maryclaire,F,100,462,0,462
Karesa,F,100,64,0,64
Cataleyah,F,100,48,0,48
Khaden,M,100,0,219,219
Tyrese,M,98,148,8135,8283
Gerrin,M,100,0,11,11
Adylina,F,100,5,0,5
Dylen,M,98,16,864,880
Joliene,F,100,55,0,55
Brenson,M,100,0,166,166
Tyricka,F,100,12,0,12
Jansel,M,100,0,63,63
Tahnisha,F,100,5,0,5
Lenwood,M,100,0,946,946
Amilliana,F,100,108,0,108
Aous,M,100,0,5,5
Shaban,M,100,0,22,22
Merecedes,F,100,41,0,41
Sicilee,F,100,6,0,6
Ralf,M,100,0,199,199
Sundi,F,100,182,0,182
Byrl,M,100,0,31,31
Tunde,M,100,0,6,6
Darlynn,F,100,423,0,423
Cheryel,F,100,65,0,65
Taviana,F,100,113,0,113
Kashtian,M,100,0,5,5
Nahdia,F,100,82,0,82
Emmalynne,F,100,159,0,159
Mellony,F,100,141,0,141
Karleah,F,100,16,0,16
Casaundra,F,100,772,0,772
Suliana,F,100,28,0,28
Dorrion,M,100,0,22,22
Kennedi,F,100,8807,15,8822
Germon,M,100,0,6,6
Jataiya,F,100,5,0,5
Dyanni,F,100,24,0,24
Abaigail,F,100,10,0,10
Baden,M,100,0,334,334
Anyce,F,100,22,0,22
Kyrei,M,100,0,12,12
Naveed,M,100,0,549,549
Cashis,M,100,0,112,112
Jearldine,F,100,75,0,75
Santonio,M,100,0,801,801
Marcopolo,M,100,0,5,5
Aleasia,F,100,38,0,38
Shaydin,M,100,0,5,5
Heidemarie,F,100,95,0,95
Kannyn,F,100,11,0,11
Takeia,F,100,277,0,277
Mykera,F,100,11,0,11
Quenita,F,100,16,0,16
Messi,M,100,0,86,86
Juniya,F,100,41,0,41
Rollan,M,100,0,44,44
Caillou,M,100,0,225,225
Sklyer,M,84,5,27,32
Chrisha,F,100,119,0,119
Jonathn,M,100,0,25,25
Infboy,M,100,0,5,5
Loys,F,50,5,5,10
Emyr,M,100,0,11,11
Kalanii,F,100,5,0,5
Nayarit,F,100,14,0,14
Emilina,F,100,51,0,51
Shanin,F,100,317,0,317
Lovett,M,100,0,81,81
Yanabah,F,100,5,0,5
Antonine,M,100,0,53,53
Dayzah,F,100,11,0,11
Lakay,F,100,11,0,11
Khadarius,M,100,0,5,5
Ashia,F,100,2324,0,2324
Armaad,M,100,0,5,5
Luchana,F,100,35,0,35
Derrich,M,100,0,64,64
Kt,F,100,12,0,12
Maren,F,100,6763,0,6763
Avishai,M,100,0,135,135
Maysa,F,100,612,0,612
Seldon,M,100,0,260,260
Aleysia,F,100,121,0,121
Ahliyah,F,100,211,0,211
Jarmen,M,100,0,5,5
Kahlaya,F,100,5,0,5
Khade,M,100,0,13,13
Donelle,F,77,1065,316,1381
Samariah,F,100,248,0,248
Breshey,F,100,20,0,20
Yazlyn,F,100,181,0,181
Eastynn,F,100,15,0,15
Soniqua,F,100,5,0,5
Erien,F,100,5,0,5
Raulin,M,100,0,11,11
Jayven,M,100,0,1281,1281
Bulah,F,100,81,0,81
Nikoma,F,100,5,0,5
Zevion,M,100,0,24,24
Krisily,F,100,11,0,11
Keischa,F,100,5,0,5
Atrick,M,100,0,13,13
Lean,F,91,597,60,657
Veeraj,M,100,0,6,6
Irini,F,100,58,0,58
Kalaila,F,100,10,0,10
Rechell,F,100,43,0,43
Mikylie,F,100,5,0,5
Denarious,M,100,0,6,6
Decedric,M,100,0,16,16
Selestina,F,100,6,0,6
Garland,M,97,303,8532,8835
Tranette,F,100,17,0,17
Krischan,M,100,0,43,43
Mariadelrosario,F,100,16,0,16
Jhalia,F,100,5,0,5
Syerra,F,100,404,0,404
Gesell,F,100,6,0,6
Cordey,M,100,0,11,11
Tmyra,F,100,5,0,5
Abdurrahim,M,100,0,27,27
Lorainne,F,100,24,0,24
Haldrin,M,100,0,5,5
Jady,F,97,188,5,193
Arrabelle,F,100,5,0,5
Jenniefer,F,100,309,0,309
Avaya,F,100,545,0,545
Lanesia,F,100,25,0,25
Tauhid,M,100,0,5,5
Delainah,F,100,5,0,5
Devan,M,72,5015,12752,17767
Genie,F,100,1580,6,1586
Tamesha,F,100,1883,0,1883
Mikayli,F,100,40,0,40
Trakelia,F,100,6,0,6
Dezariah,F,100,36,0,36
Zihanna,F,100,5,0,5
Lastasha,F,100,11,0,11
Malenie,F,100,32,0,32
Shaqueal,M,100,0,44,44
Cheyney,F,85,28,5,33
Jaelyn,F,92,11097,1029,12126
Geniva,F,100,52,0,52
Tashauna,F,100,563,0,563
Charmin,F,100,621,0,621
Normen,M,100,0,5,5
Fredericka,F,100,952,0,952
Zuriya,F,100,27,0,27
Kayelee,F,100,316,0,316
Shaqwanna,F,100,5,0,5
Ajan,M,100,0,17,17
Meron,F,97,348,12,360
Dabne,F,100,10,0,10
Balam,M,100,0,28,28
Vinette,F,100,40,0,40
Shevelle,F,100,146,0,146
Trayvin,M,100,0,23,23
Decklin,M,100,0,83,83
Aashvi,F,100,138,0,138
Michoel,M,100,0,106,106
Azriella,F,100,73,0,73
Kanda,F,100,166,0,166
Jaslynne,F,100,100,0,100
Dream,F,93,1029,81,1110
Adain,M,100,0,291,291
Travarius,M,100,0,103,103
Katrenna,F,100,5,0,5
Sedalia,F,100,29,0,29
Deeneen,F,100,12,0,12
Miko,F,51,465,444,909
Analina,F,100,120,0,120
Alleana,F,100,12,0,12
Janney,F,100,409,0,409
Terrelle,M,94,34,554,588
Sherol,F,100,51,0,51
Franchelle,F,100,102,0,102
Delise,F,100,318,0,318
Rustam,M,100,0,14,14
Stig,M,100,0,17,17
Araba,F,100,10,0,10
Fadila,F,100,6,0,6
Timorthy,M,100,0,12,12
Baldomero,M,100,0,751,751
Suzonne,F,100,35,0,35
Akyria,F,100,6,0,6
Tomako,F,100,5,0,5
Jesslynn,F,100,422,0,422
Shadeja,F,100,50,0,50
Keefer,M,100,0,296,296
Azarea,F,100,31,0,31
Artrell,M,100,0,163,163
Inarah,F,100,5,0,5
Calene,F,100,60,0,60
Leiara,F,100,15,0,15
Lennel,M,100,0,5,5
Rhyson,M,100,0,5,5
Xamir,M,100,0,5,5
Arijah,F,100,18,0,18
Lizzy,F,100,469,0,469
Seleta,F,100,100,0,100
Arionah,F,100,22,0,22
Soroya,F,100,5,0,5
Jovonte,M,100,0,298,298
Payzlee,F,100,105,0,105
Stephanni,F,100,5,0,5
Lovely,F,100,1368,0,1368
Candan,M,100,0,5,5
Arbrianna,F,100,5,0,5
Syeira,F,100,29,0,29
Aneesah,F,100,668,0,668
Dalai,F,100,5,0,5
Jayme,F,79,13542,3652,17194
Nadaya,F,100,10,0,10
Tramale,M,100,0,10,10
Solaine,F,100,5,0,5
Kristella,F,100,21,0,21
Alecsa,F,100,11,0,11
Shenique,F,100,266,0,266
Tosh,M,100,0,519,519
Ceion,M,100,0,5,5
Tyandre,M,100,0,8,8
Owen,M,100,314,128416,128730
Violetrose,F,100,5,0,5
Jaynae,F,100,42,0,42
Bensyn,M,100,0,44,44
Givonna,F,100,5,0,5
Audon,M,100,0,41,41
Garold,M,100,0,1112,1112
Shanayah,F,100,56,0,56
Rahsheen,M,100,0,16,16
Britzel,F,100,30,0,30
Rebekah,F,100,70110,119,70229
Jerwin,M,100,0,11,11
Aijalon,M,52,95,102,197
Zaundra,F,100,10,0,10
Christyl,F,100,142,0,142
Vitaly,M,100,0,128,128
Pascal,M,100,6,1380,1386
Arionna,F,100,2014,0,2014
Lakiesha,F,100,1897,0,1897
Jeyko,M,100,0,6,6
Yuleidy,F,100,65,0,65
Justinjames,M,100,0,11,11
Zoilo,M,100,0,15,15
Gurbir,M,100,0,7,7
Karyme,F,100,1877,0,1877
Odette,F,100,1658,0,1658
Jalayna,F,100,202,0,202
Yosvani,M,100,0,22,22
Cynteria,F,100,17,0,17
Estiben,M,100,0,66,66
Austen,M,92,611,7189,7800
Tannisha,F,100,66,0,66
Rorrie,F,100,6,0,6
Nytasia,F,100,22,0,22
Dondie,F,100,5,0,5
Finnegan,M,99,37,5087,5124
Bryttnie,F,100,11,0,11
Lyth,M,100,0,6,6
Briamarie,F,100,6,0,6
Dredan,M,100,0,35,35
Aashita,F,100,6,0,6
Tarrik,M,100,0,6,6
Reico,M,100,0,10,10
Taric,M,100,0,5,5
Areonna,F,100,211,0,211
Latichia,F,100,13,0,13
Aallyah,F,100,5,0,5
Maximili,M,100,0,5,5
Jovel,M,100,0,28,28
Dorothyann,F,100,22,0,22
Tryell,M,100,0,5,5
Monchell,F,100,23,0,23
Thedra,F,100,10,0,10
Mazzie,F,100,143,0,143
Kamishia,F,100,6,0,6
Juliamarie,F,100,31,0,31
Deasiah,F,100,89,0,89
Muhab,M,100,0,6,6
Josina,F,100,16,0,16
Saurish,M,100,0,12,12
Avaiah,F,100,55,0,55
Atong,F,100,5,0,5
Jartavius,M,100,0,12,12
Alanmichael,M,100,0,221,221
Clive,M,100,0,1414,1414
Ajith,M,100,0,27,27
Tywand,M,100,0,5,5
Teirra,F,100,389,0,389
Keishawn,M,92,63,683,746
Trennen,M,100,0,30,30
Crecencio,M,100,0,65,65
Aldayr,M,100,0,5,5
Olivya,F,100,281,0,281
Shadd,M,100,0,243,243
Kealy,F,100,415,0,415
Yavonne,F,100,216,0,216
Sudha,F,100,15,0,15
Ervina,F,100,17,0,17
Taden,M,100,0,281,281
Leronda,F,100,64,0,64
Anaika,F,100,76,0,76
Kareme,M,100,0,5,5
Anzio,M,100,0,29,29
Tavare,M,100,0,38,38
Keishun,M,100,0,35,35
Illene,F,100,79,0,79
Serj,M,100,0,16,16
Madilin,F,100,35,0,35
Jabrielle,F,100,11,0,11
Linet,F,100,69,0,69
Anastasha,F,100,233,0,233
Kristalyn,F,100,573,0,573
Myreon,M,100,0,105,105
Marilina,F,100,5,0,5
Jazabel,F,100,19,0,19
Ibraaheem,M,100,0,5,5
Tomme,M,100,0,5,5
Latalya,F,100,13,0,13
Naily,F,100,13,0,13
Tameeka,F,100,937,0,937
Atrell,M,100,0,6,6
Dedrian,M,100,0,11,11
Perel,F,100,474,0,474
Sahitya,F,100,5,0,5
Elizabith,F,100,5,0,5
Santeria,F,100,40,0,40
Cornelis,M,100,0,20,20
Kimberli,F,100,3840,0,3840
Juanitta,F,100,34,0,34
Morrissey,M,77,5,17,22
Ezel,M,100,0,54,54
Rashauna,F,100,190,0,190
Judell,F,100,5,0,5
Harrison,M,100,203,50540,50743
Hardwick,M,100,0,5,5
Kaymin,F,100,9,0,9
Peityn,F,100,82,0,82
Anaias,M,100,0,11,11
Titilayo,F,100,101,0,101
Ashita,F,100,26,0,26
Jadasha,F,100,13,0,13
Parissa,F,100,87,0,87
Tailen,M,100,0,5,5
Charney,F,100,11,0,11
Lachaun,F,100,6,0,6
Constantinos,M,100,0,629,629
Shanija,F,100,38,0,38
Abdurrahmaan,M,100,0,5,5
Kiylah,F,100,62,0,62
Audriel,F,100,6,0,6
Maricka,F,100,12,0,12
Kruise,M,100,0,11,11
Rocklyn,F,68,51,24,75
Imothy,M,100,0,15,15
Madalynn,F,100,6395,0,6395
Lauire,F,100,6,0,6
Abtin,M,100,0,6,6
Ronon,M,100,0,41,41
Kahyla,F,100,11,0,11
Darryus,M,100,0,22,22
Angelita,F,100,7364,5,7369
Kierrah,F,100,211,0,211
Zishe,M,100,0,5,5
Roselena,F,100,28,0,28
Oshia,F,100,11,0,11
Michole,F,100,142,0,142
Beah,F,100,5,0,5
Stracy,F,100,11,0,11
Samario,M,100,0,18,18
Kinsler,M,88,25,183,208
Amerra,F,100,32,0,32
Akela,F,100,531,0,531
Sabrea,F,100,142,0,142
Quayshon,M,100,0,10,10
Kelei,F,100,6,0,6
Adelee,F,100,59,0,59
Samanthaann,F,100,13,0,13
Mateo,M,100,14,27275,27289
Gezelle,F,100,45,0,45
Keiandra,F,100,125,0,125
Cyree,M,100,0,45,45
Eurijah,M,100,0,6,6
Jaysiah,M,100,0,70,70
Radcliffe,M,100,0,11,11
Gilma,F,100,112,0,112
Kyira,F,100,109,0,109
Neako,M,100,0,11,11
Mati,F,73,46,17,63
Yume,F,100,19,0,19
Christalyn,F,100,272,0,272
Magdaline,F,100,507,0,507
Pamlea,F,100,97,0,97
Caiman,M,100,0,42,42
Caroleen,F,100,91,0,91
Makylie,F,100,101,0,101
Rashanti,F,100,26,0,26
Quentella,F,100,23,0,23
Hollynd,F,100,14,0,14
Laurrie,F,100,102,0,102
Angenette,F,100,377,0,377
Jatava,F,100,7,0,7
Jisha,F,100,11,0,11
Strella,F,100,11,0,11
Damiano,M,100,0,355,355
Diontay,M,100,0,152,152
Kendred,M,100,0,16,16
Saalihah,F,100,7,0,7
Krishnan,M,100,0,16,16
Laynie,F,100,1093,0,1093
Avianah,F,100,84,0,84
Tycho,M,100,0,154,154
Areial,F,100,46,0,46
Sarvia,F,100,5,0,5
Estie,F,100,13,0,13
Keithin,M,100,0,5,5
Angilina,F,100,5,0,5
Kaloyan,M,100,0,19,19
Alekhya,F,100,139,0,139
Laritha,F,100,5,0,5
Jaquavion,M,100,0,396,396
Johntez,M,100,0,17,17
Gustaf,M,100,0,214,214
Adriyan,M,100,0,32,32
Darby,F,74,7176,2511,9687
Eddye,F,90,56,6,62
Sirica,M,100,0,8,8
Kathyjo,F,100,129,0,129
Keylyn,F,100,35,0,35
Dearious,M,100,0,5,5
Caleigha,F,100,86,0,86
Sidora,F,100,5,0,5
Dazavion,M,100,0,5,5
Shaundell,M,89,5,42,47
Precilla,F,100,500,0,500
Jerrald,M,100,0,564,564
Smitha,F,100,51,0,51
Skyylar,F,88,38,5,43
Kevinchristophe,M,100,0,5,5
Zaylon,M,100,0,245,245
Morocco,M,100,0,30,30
Dennita,F,100,6,0,6
Niah,F,100,1113,0,1113
Brenai,F,100,5,0,5
Kyana,F,100,1949,0,1949
Keryn,F,100,320,0,320
Maurene,F,100,212,0,212
Olivier,M,100,5,1320,1325
Abegale,F,100,5,0,5
Naava,F,100,108,0,108
Clynton,M,100,0,10,10
Quinnton,M,100,0,340,340
Devraj,M,100,0,17,17
Annebelle,F,100,102,0,102
Edier,M,100,0,5,5
Ladejah,F,100,25,0,25
Jahseim,M,100,0,5,5
Tameko,F,100,270,0,270
Wanisha,F,100,74,0,74
Dharius,M,100,0,21,21
Charnisha,F,100,30,0,30
Illiyana,F,100,7,0,7
Roldan,M,100,0,259,259
Nirvana,F,100,642,0,642
Meral,F,100,77,0,77
Katalyn,F,100,62,0,62
Elexander,M,100,0,15,15
Tamare,M,55,10,12,22
Areatha,F,100,195,0,195
Brylan,M,92,67,804,871
Yaslene,F,100,81,0,81
Magalli,F,100,7,0,7
Shabana,F,100,159,0,159
Austi,F,100,20,0,20
Azlyn,F,100,542,0,542
Lisbed,F,100,24,0,24
Talaisha,F,100,8,0,8
Alecxia,F,100,5,0,5
Darelys,F,100,11,0,11
Melayna,F,100,424,0,424
Nayonna,F,100,52,0,52
Annabeth,F,100,1287,0,1287
Malikia,F,90,45,5,50
Amarious,M,100,0,39,39
Naishaun,M,100,0,5,5
Jonda,F,100,497,0,497
Winn,M,100,0,164,164
Wyn,M,78,17,59,76
Dkaiden,M,100,0,5,5
Jasielle,F,100,6,0,6
Jernika,F,100,5,0,5
Mannan,M,100,0,24,24
Geogory,M,100,0,10,10
Sarh,F,100,52,0,52
Shawndrika,F,100,22,0,22
Phabian,M,100,0,49,49
Dejane,F,100,161,0,161
Maleana,F,100,16,0,16
Tram,F,100,455,0,455
Sakima,M,67,5,10,15
Zuriah,F,96,138,6,144
Adrieanne,F,100,16,0,16
Vannessa,F,100,3166,0,3166
Trinna,F,100,134,0,134
Dipti,F,100,11,0,11
Kerstine,F,100,11,0,11
Lariza,F,100,187,0,187
Chazten,M,100,0,5,5
Stefanos,M,100,0,370,370
Johanna,F,100,35328,129,35457
Reyann,F,100,86,0,86
Saheim,M,100,0,29,29
Joannamarie,F,100,58,0,58
Kross,M,100,0,270,270
Tammis,F,100,6,0,6
Shulamite,F,100,5,0,5
Clarivel,F,100,80,0,80
Josuel,M,100,0,113,113
Nahjee,M,100,0,38,38
Timoth,M,100,0,113,113
Ayhem,M,100,0,34,34
Ramzy,M,100,0,314,314
Ashlyn,F,100,42313,54,42367
Domonic,M,97,67,2579,2646
Adysen,F,100,694,0,694
Jessi,F,82,5911,1265,7176
Guadalupe,F,75,49612,16291,65903
Raidel,M,100,0,12,12
Jurnei,F,100,46,0,46
Livia,F,100,5679,0,5679
Daschle,M,100,0,11,11
Deangel,F,100,33,0,33
Law,M,100,0,62,62
Shadayah,F,100,5,0,5
Zeline,F,100,12,0,12
Ibin,M,100,0,21,21
Meghin,F,100,193,0,193
Chrisitan,M,100,0,8,8
Rafeef,F,100,47,0,47
Allijah,M,100,0,24,24
Tanielle,F,100,134,0,134
Richardean,F,100,22,0,22
Sapan,M,100,0,24,24
Nikela,F,100,27,0,27
Inman,M,100,0,49,49
Rishon,M,100,0,192,192
Leone,F,71,365,150,515
Fantaysia,F,100,5,0,5
Elray,M,100,0,102,102
Merary,F,100,398,0,398
Alexanderjames,M,100,0,68,68
Ronelle,F,89,532,69,601
Mardie,F,83,25,5,30
Geena,F,100,1531,0,1531
Lakeithia,F,100,193,0,193
Lorrisa,F,100,5,0,5
Jazalle,F,100,13,0,13
Kameriah,F,100,6,0,6
Tyon,M,100,0,561,561
Anonda,F,100,45,0,45
Aleemah,F,100,13,0,13
Cabrini,F,100,63,0,63
Melaku,M,100,0,5,5
Levontae,M,100,0,26,26
Laqusha,F,100,5,0,5
Daffie,F,100,13,0,13
Bernasia,F,100,5,0,5
Mallorey,F,100,64,0,64
Aundreah,F,100,6,0,6
Marrio,M,100,0,368,368
Kohyn,M,100,0,11,11
Dorothey,F,100,139,0,139
Savan,M,100,0,97,97
Neydelin,F,100,20,0,20
Ciarrah,F,100,81,0,81
Duuana,F,100,6,0,6
Vaishali,F,100,194,0,194
Lloyd,M,100,225,50314,50539
Havah,F,100,70,0,70
Yvannia,F,100,5,0,5
Deveny,F,100,55,0,55
Claytin,M,100,0,45,45
Jaggyr,M,100,0,5,5
Tierza,F,100,47,0,47
Lotaya,F,100,5,0,5
Mersedes,F,100,75,0,75
Ziann,F,100,38,0,38
Panayotis,M,100,0,5,5
Queenasia,F,100,16,0,16
Ravene,F,100,13,0,13
Nayyirah,F,100,5,0,5
Keirrah,F,100,28,0,28
Breidyn,M,100,0,5,5
Landenn,M,100,0,5,5
Rubit,F,100,19,0,19
Aaliyaa,F,100,5,0,5
Mollee,F,100,676,0,676
Maloni,F,100,85,0,85
Dajonna,F,100,25,0,25
Shelbylynn,F,100,134,0,134
Twylla,F,100,172,0,172
Robt,M,100,0,5,5
Semhal,F,100,10,0,10
Patrisio,M,100,0,5,5
Weena,F,100,26,0,26
Danaia,F,100,5,0,5
Wareef,F,100,5,0,5
Memarie,F,100,17,0,17
Nykeshia,F,100,13,0,13
Malyssa,F,100,381,0,381
Mauriana,F,100,162,0,162
Marcie,F,100,14228,8,14236
Harliee,F,100,5,0,5
Norville,M,100,0,40,40
Yuliya,F,100,44,0,44
Jelah,F,100,11,0,11
Natavious,M,100,0,20,20
Jaydenmatthew,M,100,0,5,5
Rianon,F,100,5,0,5
Janashia,F,100,83,0,83
Kateland,F,100,659,0,659
Tremayne,M,99,39,3712,3751
Taliesin,M,100,0,117,117
Trayveon,M,100,0,350,350
Luzelena,F,100,314,0,314
Jevone,M,100,0,8,8
Torrey,M,80,1183,4806,5989
Finest,M,100,0,5,5
Franchon,F,100,91,0,91
Kyndra,F,100,2326,0,2326
Tyquon,M,100,0,182,182
Jewellia,F,100,6,0,6
Me,F,100,5,0,5
Deashley,F,100,24,0,24
Jassen,M,100,0,261,261
Mateah,F,100,22,0,22
Merrily,F,100,376,0,376
Yolonde,F,100,5,0,5
Danialle,F,100,155,0,155
Evelie,F,100,10,0,10
Ajiah,F,100,67,0,67
Erisha,F,100,28,0,28
Gustas,M,100,0,11,11
Somaya,F,100,694,0,694
Kwadjo,M,100,0,11,11
Jeanea,F,100,24,0,24
Tejal,F,100,299,0,299
Kenyette,F,100,100,0,100
Laiyla,F,100,159,0,159
Mikhai,M,100,0,111,111
Dakyrah,F,100,5,0,5
Kamaurion,M,100,0,28,28
Quaniesha,F,100,50,0,50
Yuta,M,100,0,346,346
Kiahnna,F,100,14,0,14
Lavan,M,100,0,216,216
Mele,F,100,744,0,744
Fara,F,100,929,0,929
Juliyan,M,100,0,30,30
Elliemay,F,100,19,0,19
Giorgio,M,100,0,1328,1328
Jeveon,M,100,0,11,11
Zierra,F,100,133,0,133
Tacorian,M,100,0,11,11
Anielka,F,100,21,0,21
Tramaine,M,75,561,1717,2278
Amadita,F,100,5,0,5
Ashe,M,72,52,137,189
Toprak,M,100,0,22,22
Cherub,F,100,29,0,29
Laterian,M,100,0,5,5
Keiosha,F,100,224,0,224
Hayyan,M,100,0,14,14
Lavi,M,100,0,47,47
Kaleeb,M,100,0,21,21
Markanthony,M,100,0,1690,1690
Elizabth,F,100,100,0,100
Martaja,F,100,5,0,5
Alvaro,M,100,5,13293,13298
Sabrinamarie,F,100,11,0,11
Lisandra,F,100,1553,0,1553
Jete,F,100,5,0,5
Janek,M,100,0,11,11
Glendine,F,100,16,0,16
Taneysha,F,100,5,0,5
Elysian,F,100,5,0,5
Carmisha,F,100,77,0,77
Ghana,F,100,12,0,12
Mey,F,100,39,0,39
Demarkio,M,100,0,5,5
Subhaan,M,100,0,37,37
Isamar,F,96,2065,91,2156
Shriyans,M,100,0,84,84
Larz,M,100,0,171,171
Shonae,F,100,10,0,10
Rhayna,F,100,14,0,14
Jadia,F,100,271,0,271
Laurana,F,100,155,0,155
Davd,M,100,0,29,29
Lecresha,F,100,20,0,20
Markey,M,98,5,271,276
Jeylen,F,71,12,5,17
Shataka,F,100,5,0,5
Bradli,F,100,5,0,5
Macray,M,100,0,8,8
Minela,F,100,54,0,54
Ahmond,M,100,0,20,20
Urias,M,100,0,158,158
Zakhai,M,100,0,42,42
Meyer,M,96,45,1157,1202
Matraca,F,100,85,0,85
Amsey,F,100,5,0,5
Janisse,F,100,85,0,85
Antaneisha,F,100,15,0,15
Veronika,F,100,2792,0,2792
Rhiannah,F,100,18,0,18
Briann,F,99,1512,20,1532
Pennye,F,100,185,0,185
Mickela,F,100,38,0,38
Riyann,F,100,5,0,5
Eiko,F,100,5,0,5
Hezron,M,100,0,18,18
Maslin,F,100,5,0,5
Krystn,F,100,110,0,110
Hedwig,F,100,107,0,107
Trejean,M,100,0,18,18
Tayveion,M,100,0,11,11
Charish,F,100,401,0,401
Nellene,F,100,44,0,44
Kytalin,F,100,5,0,5
Braxxton,M,100,0,57,57
Denyah,F,100,5,0,5
Jakauri,M,100,0,6,6
Samik,M,100,0,92,92
Monquez,M,100,0,17,17
Davant,M,100,0,14,14
Shandell,F,89,526,68,594
Omaria,F,100,152,0,152
Trevius,M,100,0,34,34
Kenenth,M,100,0,5,5
Kirina,F,100,5,0,5
Mily,F,100,347,0,347
Bernalee,F,100,5,0,5
Kingdon,M,100,0,5,5
Terree,F,100,90,0,90
Birttany,F,100,51,0,51
Delfino,M,100,0,1513,1513
Kealee,F,100,55,0,55
Vineta,F,100,45,0,45
Lavenna,F,100,5,0,5
Devontae,M,100,0,2502,2502
Niralya,F,100,23,0,23
Cheyan,F,100,132,0,132
Sohini,F,100,46,0,46
Alela,F,100,5,0,5
Maximillian,M,100,0,5043,5043
Yelizaveta,F,100,5,0,5
Sonrisa,F,100,38,0,38
Ronal,M,100,0,875,875
Isabelo,M,100,0,16,16
Kindalyn,F,100,6,0,6
Meli,F,100,82,0,82
Talen,M,97,44,1564,1608
Jashon,M,99,6,818,824
Bienvenida,F,100,8,0,8
Aizah,F,100,169,0,169
Saiah,F,100,10,0,10
Maydelin,F,100,82,0,82
Lutz,M,100,0,5,5
Kenlei,F,100,70,0,70
Vinn,M,100,0,5,5
Therone,M,100,0,5,5
Andreous,M,100,0,10,10
Qunesha,F,100,26,0,26
Taavi,M,100,0,61,61
Sariaha,F,100,5,0,5
Meagann,F,100,10,0,10
Rittney,F,100,15,0,15
Lauralea,F,100,23,0,23
Honoria,F,100,16,0,16
Emjay,F,55,28,23,51
Cherlene,F,100,50,0,50
Leamarie,F,100,13,0,13
Imaria,F,100,26,0,26
Yabdiel,M,100,0,25,25
Danute,F,100,11,0,11
Angeles,F,98,2940,59,2999
Denay,F,100,510,0,510
Aginah,F,100,6,0,6
Troyvon,M,100,0,10,10
Zaharah,F,100,71,0,71
Asani,F,77,306,93,399
Simiya,F,100,30,0,30
Remonia,F,100,251,0,251
Angelynna,F,100,7,0,7
Kelaiah,F,100,156,0,156
Kemar,M,100,0,445,445
Noorjahan,F,100,5,0,5
Cabral,M,100,0,5,5
Shariyah,F,100,355,0,355
Apurva,F,78,101,28,129
Deadre,F,100,51,0,51
Adryon,M,100,0,15,15
Abisag,F,100,16,0,16
Maxym,M,100,0,13,13
Tymara,F,100,64,0,64
Kristl,F,100,95,0,95
Lagena,F,100,134,0,134
Clary,F,64,119,66,185
Miketa,F,100,11,0,11
Aydn,M,100,0,136,136
Kaliyan,F,100,50,0,50
Rilen,M,100,0,90,90
Conya,F,100,65,0,65
Genghis,M,100,0,6,6
Asuzena,F,100,85,0,85
Harlequinn,F,100,10,0,10
Shauri,F,100,48,0,48
Brandun,M,100,0,99,99
Jeremie,M,98,70,4082,4152
Crews,M,100,0,44,44
Valaysia,F,100,5,0,5
Mersaydes,F,100,39,0,39
Reionna,F,100,10,0,10
Kiki,F,97,896,25,921
Wetzel,M,100,0,58,58
Denton,M,100,0,3146,3146
Brookston,M,100,0,17,17
Mykenzie,F,100,1021,0,1021
Shep,M,100,0,12,12
Briajah,F,100,12,0,12
Jaryia,F,100,11,0,11
Kadenze,F,100,5,0,5
Kenzia,F,100,5,0,5
Dmoni,M,100,0,39,39
Kevondrick,M,100,0,8,8
Teleshia,F,100,54,0,54
Breyana,F,100,1077,0,1077
Florita,F,100,210,0,210
Daejon,M,100,0,340,340
Benson,M,100,0,5880,5880
Keyshone,M,100,0,7,7
Hartlie,F,100,7,0,7
Kiayanna,F,100,5,0,5
Kamelo,M,100,0,5,5
Noami,F,100,547,0,547
Jaxlynn,F,100,8,0,8
Edmound,M,100,0,5,5
Chaplin,M,100,0,11,11
Shahrzad,F,100,124,0,124
Antwinette,F,100,13,0,13
Areisy,F,100,21,0,21
Yena,F,100,162,0,162
Kieli,F,100,66,0,66
Ranesha,F,100,464,0,464
Lexah,F,100,6,0,6
Kayelle,F,100,5,0,5
Jatorria,F,100,11,0,11
Brasen,M,100,0,143,143
Brittanee,F,100,664,0,664
Danyel,F,80,2495,625,3120
Antario,M,100,0,161,161
Sarye,F,100,56,0,56
Sequoyia,F,100,5,0,5
Zyonna,F,100,364,0,364
Luqmaan,M,100,0,37,37
Hue,M,72,89,234,323
Maylet,F,100,11,0,11
Mayher,F,100,5,0,5
Tyrone,M,99,703,72109,72812
Amanada,F,100,369,0,369
Auguste,M,94,13,216,229
Kyston,M,100,0,60,60
Ridgely,M,90,5,46,51
Courtnei,F,100,229,0,229
Mikeria,F,100,138,0,138
Husain,M,100,0,280,280
Viktorija,F,100,12,0,12
Jadelin,F,100,80,0,80
Kellian,F,100,15,0,15
Jocob,M,100,0,341,341
Michellie,F,100,31,0,31
Quinsha,F,100,10,0,10
Priscylla,F,100,22,0,22
Udona,F,100,5,0,5
Ralen,M,100,0,20,20
Sbeidy,F,100,5,0,5
Jaleesia,F,100,17,0,17
Xanthia,F,100,37,0,37
Nastazia,F,100,5,0,5
Devaris,M,100,0,127,127
Skylen,F,59,110,76,186
Latera,F,100,98,0,98
Mutasim,M,100,0,49,49
Sartaj,M,100,0,109,109
Xitllali,F,100,52,0,52
Jayliah,F,100,145,0,145
Rainer,M,99,10,769,779
Rhyann,F,100,307,0,307
Cortnei,F,100,35,0,35
Traneka,F,100,5,0,5
Meleana,F,100,205,0,205
Charnissa,F,100,32,0,32
Cylin,M,100,0,12,12
Kadean,M,100,0,10,10
Lydiah,F,100,194,0,194
Vy,F,97,1031,37,1068
Kehinde,M,64,81,147,228
Jamya,F,100,4841,0,4841
Rund,F,100,7,0,7
Lauritz,M,100,0,15,15
Tyishia,F,100,62,0,62
Dushaun,M,100,0,72,72
Ellenmarie,F,100,33,0,33
Loralai,F,100,212,0,212
Brithny,F,100,6,0,6
Sharletha,F,100,5,0,5
Maija,F,100,1060,0,1060
Sharan,F,94,764,53,817
Lissete,F,100,432,0,432
Zela,F,100,28,0,28
Niya,F,100,3686,0,3686
Infinite,M,100,0,44,44
Wakina,F,100,9,0,9
Neiya,F,100,6,0,6
Cathryne,F,100,278,0,278
Jersey,F,92,2425,203,2628
Shakela,F,100,456,0,456
Nephi,M,100,0,592,592
Myers,M,93,11,156,167
Astrid,F,100,6183,0,6183
Bronsen,M,100,0,129,129
Areena,F,100,11,0,11
Martinque,F,100,6,0,6
Migna,F,100,21,0,21
Aleicia,F,100,91,0,91
Zaher,M,100,0,10,10
Janila,F,100,146,0,146
Geric,M,100,0,17,17
Bailye,F,100,5,0,5
Shaquana,F,100,2286,0,2286
Rodd,M,100,0,763,763
Shaguanda,F,100,6,0,6
Nasser,M,100,0,985,985
Thaiz,F,100,54,0,54
Magdalen,F,100,1005,0,1005
Debraha,F,100,11,0,11
Kathern,F,100,1580,0,1580
Kyreem,M,100,0,30,30
Citlali,F,100,3373,0,3373
Tinzleigh,F,100,5,0,5
Shaylia,F,100,31,0,31
Kareese,F,100,5,0,5
Cartier,M,86,118,742,860
Jule,F,64,650,369,1019
Jovonn,M,81,5,22,27
Zahava,F,100,490,0,490
Bran,M,100,0,148,148
Cymon,M,100,0,15,15
Teagyn,F,93,112,8,120
Delmar,M,100,17,3747,3764
Verlane,F,100,8,0,8
Haron,M,100,0,123,123
Maryem,F,100,68,0,68
Ledarrius,M,100,0,118,118
Niza,F,100,133,0,133
Joshoua,M,100,0,10,10
Eridani,F,100,5,0,5
Effren,M,100,0,5,5
Lylli,F,100,28,0,28
Molley,F,100,219,0,219
Adlan,M,100,0,5,5
Milton,M,100,187,38079,38266
Talaiah,F,100,6,0,6
Tary,M,61,30,46,76
Arlita,F,100,86,0,86
Tristen,M,82,4051,18496,22547
Gillen,M,100,0,5,5
Daiquan,M,100,0,748,748
Cydnee,F,100,892,0,892
Revyn,M,100,0,7,7
Parris,M,53,1477,1649,3126
Mahd,M,100,0,38,38
Desireah,F,100,7,0,7
Jerelly,F,100,8,0,8
Samyia,F,100,326,0,326
Mckynsie,F,100,7,0,7
Tondalayo,F,100,7,0,7
Blazer,M,100,0,10,10
Keshea,F,100,22,0,22
Kyndrah,F,100,10,0,10
Teesa,F,100,11,0,11
Jescenia,F,100,5,0,5
Lorance,M,100,0,33,33
Delayney,F,100,11,0,11
Dalina,F,100,390,0,390
Lekecia,F,100,56,0,56
Herney,M,100,0,5,5
Ebrima,M,100,0,203,203
Shylei,F,100,5,0,5
Glendalys,F,100,12,0,12
Brelan,M,100,0,68,68
Anani,F,100,179,0,179
Jamaal,M,99,45,8022,8067
Valeriano,M,100,0,84,84
Alyia,F,100,450,0,450
Isabela,F,100,8438,0,8438
Skyye,F,100,48,0,48
Makaden,M,100,0,28,28
Dorsey,M,84,323,1695,2018
Tysen,M,99,10,1303,1313
Rayen,F,53,71,62,133
Mosi,M,85,11,62,73
Jasher,M,100,0,55,55
Jadarrien,M,100,0,5,5
Claven,M,100,0,5,5
Tristram,M,100,0,114,114
Teighlor,F,100,243,0,243
Macilyn,F,100,13,0,13
Junnie,F,100,25,0,25
Darlinda,F,100,199,0,199
Emmanul,M,100,0,5,5
Tennie,F,100,311,0,311
Shanekqa,F,100,5,0,5
Essien,M,100,0,40,40
Natnael,M,100,0,216,216
Minah,F,100,169,0,169
Trauis,M,100,0,22,22
Delshon,M,100,0,58,58
Harshan,M,100,0,41,41
Jaabir,M,100,0,5,5
Kamilla,F,100,1317,0,1317
Danicia,F,100,100,0,100
Yenitza,F,100,16,0,16
Christianne,F,100,1412,0,1412
Jermeka,F,100,107,0,107
Alayshia,F,100,559,0,559
Jakyra,F,100,918,0,918
Skipper,M,100,0,683,683
Havik,M,100,0,11,11
Ellieana,F,100,152,0,152
Yunique,F,100,97,0,97
Elom,M,100,0,11,11
Hollis,M,65,2773,5046,7819
Graydin,M,100,0,6,6
Apolonia,F,100,426,0,426
Primitivo,M,100,0,500,500
Koryna,F,100,26,0,26
Ahzariah,F,100,9,0,9
Plum,F,100,5,0,5
Michaelandrew,M,100,0,30,30
Jennarose,F,100,22,0,22
Solon,M,100,0,481,481
Aweys,M,100,0,10,10
Gracely,F,100,13,0,13
Yassmin,F,100,113,0,113
Rielle,F,100,287,0,287
Benjahmin,M,100,0,15,15
Astry,F,100,15,0,15
Jaydelin,F,100,12,0,12
Kammi,F,100,620,0,620
Jaymis,M,100,0,5,5
Vasia,F,100,5,0,5
Vana,F,100,370,0,370
Nikyla,F,100,139,0,139
Daytron,M,100,0,33,33
Dever,M,100,0,10,10
Behrang,M,100,0,9,9
Nevayah,F,100,213,0,213
Alfreida,F,100,239,0,239
Janiesha,F,100,87,0,87
Orena,F,100,10,0,10
Naseir,M,100,0,6,6
Oralee,F,100,53,0,53
Anaija,F,100,110,0,110
Felechia,F,100,30,0,30
Cherlonda,F,100,5,0,5
Lavitta,F,100,6,0,6
Halei,F,100,362,0,362
Graysen,M,77,502,1644,2146
Kimberl,F,100,62,0,62
Lingxi,F,100,5,0,5
Pradeep,M,100,0,62,62
Annajoy,F,100,5,0,5
Crystabel,F,100,5,0,5
Salay,F,100,5,0,5
Taylr,F,100,80,0,80
Arisbel,F,100,75,0,75
Vikhyath,M,100,0,5,5
Gabrielmichael,M,100,0,10,10
Meegan,F,100,979,0,979
Millisa,F,100,255,0,255
Teylar,F,100,16,0,16
Waine,M,100,0,14,14
Makynna,F,100,371,0,371
Oman,M,100,0,35,35
Jadah,F,100,1692,0,1692
Lakeira,F,100,40,0,40
Margarida,F,100,22,0,22
Chanee,F,100,176,0,176
Miraj,M,88,10,72,82
Waleed,M,100,0,1476,1476
Alif,M,100,0,119,119
Misk,F,100,40,0,40
Kagen,M,97,17,471,488
Melania,F,100,1550,0,1550
Tadarius,M,100,0,376,376
Keeson,M,100,0,5,5
Kashanta,F,100,5,0,5
Johar,M,100,0,5,5
Levern,M,87,140,927,1067
Aleycia,F,100,33,0,33
Te,F,100,10,0,10
Kosi,M,100,0,7,7
Samira,F,100,5551,0,5551
Dierk,M,100,0,15,15
Ameeyah,F,100,10,0,10
Jammal,M,100,0,282,282
Taleeah,F,100,36,0,36
Shelagh,F,100,473,0,473
Yasmeli,F,100,6,0,6
Anikin,M,100,0,63,63
Addaley,F,100,28,0,28
Iyauna,F,100,75,0,75
Johnpaul,M,100,0,4884,4884
Eun,F,98,285,5,290
Zuleika,F,100,1040,0,1040
Shanann,F,100,34,0,34
Bethanye,F,100,5,0,5
Chard,M,100,0,5,5
Pavlo,M,100,0,31,31
Jovania,F,100,5,0,5
Micahya,F,100,45,0,45
Maddlynn,F,100,6,0,6
Alcide,M,100,0,114,114
Gerrit,M,100,0,1701,1701
Llesica,F,100,14,0,14
Zinia,F,100,53,0,53
Allenmichael,M,100,0,104,104
Chyla,F,100,350,0,350
Morticia,F,100,47,0,47
Saleah,F,100,148,0,148
Tairy,F,100,6,0,6
Anosha,F,100,16,0,16
Ciaira,F,100,171,0,171
Shuhei,M,100,0,29,29
Chelseamarie,F,100,21,0,21
Minday,F,100,25,0,25
Deyonta,M,100,0,42,42
Lesean,M,97,10,322,332
Juden,M,100,0,6,6
Yoselina,F,100,5,0,5
Asaya,M,100,0,5,5
Sreyas,M,100,0,22,22
Magdelin,F,100,6,0,6
Yahire,F,100,6,0,6
Kimore,F,100,26,0,26
Zailah,F,100,64,0,64
Bettiann,F,100,10,0,10
Lametria,F,100,96,0,96
Lapatra,F,100,5,0,5
Tajuana,F,100,1085,0,1085
Ranoda,F,100,9,0,9
Itsel,F,100,197,0,197
Olyn,M,100,0,6,6
Tiege,M,100,0,5,5
Avaleena,F,100,6,0,6
Warrick,M,100,0,560,560
Ghazal,F,100,100,0,100
Shanterica,F,100,76,0,76
Mohib,M,100,0,35,35
Odel,M,55,5,6,11
Jermiyah,F,89,139,17,156
Stefin,M,100,0,11,11
Kipper,M,100,0,95,95
Joakin,M,100,0,11,11
Mirelle,F,100,131,0,131
Zuri,F,89,4257,519,4776
Dahlila,F,100,184,0,184
Shimon,M,100,0,3247,3247
Keilei,F,100,29,0,29
Keylie,F,100,193,0,193
Selso,M,100,0,76,76
Chace,M,97,122,4270,4392
Koan,M,100,0,34,34
Langford,M,100,0,17,17
Elberta,F,100,148,0,148
Symphoni,F,100,61,0,61
Haakim,M,100,0,9,9
Maan,M,100,0,52,52
Xara,F,100,114,0,114
Axel,M,100,88,25734,25822
Camilya,F,100,48,0,48
Kinsely,F,100,5,0,5
Kore,M,100,0,72,72
Atlean,F,100,5,0,5
Renat,M,100,0,6,6
Riyaz,M,100,0,10,10
Dalaya,F,100,88,0,88
Lashiya,F,100,40,0,40
Felycia,F,100,19,0,19
Yita,F,100,44,0,44
Thien,M,97,29,875,904
Kacyn,M,63,38,64,102
Genine,F,100,546,0,546
Keysean,M,100,0,235,235
Lorrainne,F,100,6,0,6
Cathyjo,F,100,50,0,50
Jeovanny,M,100,0,352,352
Alexxandra,F,100,56,0,56
Nijia,F,100,39,0,39
Justn,M,100,0,99,99
Dekwan,M,100,0,34,34
Saleem,M,100,0,1381,1381
Dreson,M,100,0,24,24
Dominic,M,99,1129,131677,132806
Doneshia,F,100,201,0,201
Tait,M,99,16,1093,1109
Jabez,M,100,0,890,890
Efran,M,100,0,33,33
Kidane,M,100,0,10,10
Gwenne,F,100,6,0,6
Hasnain,M,100,0,137,137
Marteisha,F,100,5,0,5
Garitt,M,100,0,5,5
Celestino,M,100,0,1505,1505
Davone,M,97,15,539,554
Nela,F,100,232,0,232
Oshanique,F,100,5,0,5
Iratze,F,100,34,0,34
Maryliz,F,100,6,0,6
Desirie,F,100,133,0,133
Jesseka,F,100,170,0,170
Ceila,F,100,5,0,5
Sharrae,F,100,5,0,5
Yliana,F,100,420,0,420
Terisa,F,100,1007,0,1007
Nadiah,F,100,437,0,437
Yasmeen,F,100,5028,0,5028
Chenita,F,100,376,0,376
Quintessa,F,100,388,0,388
Sandor,M,100,0,751,751
Judianne,F,100,82,0,82
Shachar,M,100,0,11,11
Daveonte,M,100,0,6,6
Trinaty,F,100,139,0,139
Halema,F,100,15,0,15
Formeka,F,100,37,0,37
Usiel,M,100,0,222,222
Jayelyn,F,100,66,0,66
Anquanette,F,100,90,0,90
Henli,F,100,40,0,40
Nakari,F,60,66,44,110
Joella,F,100,2246,0,2246
Johvanny,M,100,0,10,10
Keyan,M,99,7,972,979
Leoni,F,100,129,0,129
Jadalin,F,100,10,0,10
Aitana,F,100,340,0,340
Blandon,M,100,0,77,77
Nashima,F,100,5,0,5
Dezyre,F,100,135,0,135
Heartley,F,100,5,0,5
Naairah,F,100,18,0,18
Acheron,M,100,0,33,33
Maxmillion,M,100,0,15,15
Tomiyah,F,100,6,0,6
Katiera,F,100,16,0,16
Anquavious,M,100,0,5,5
Ozara,F,100,5,0,5
Maileigh,F,100,6,0,6
Temia,F,100,164,0,164
Akhenaton,M,100,0,10,10
Suzu,F,100,7,0,7
Blaz,M,100,0,5,5
Davan,M,75,78,240,318
Talese,F,100,15,0,15
Jaderrick,M,100,0,12,12
Darryn,M,98,39,1580,1619
Neidelin,F,100,5,0,5
Kendl,F,100,16,0,16
Dorena,F,100,491,0,491
Khansa,F,100,6,0,6
Alyona,F,100,178,0,178
Deshiya,F,100,10,0,10
Keera,F,100,709,0,709
Chaia,F,100,60,0,60
Ohn,M,100,0,156,156
Zymiere,M,100,0,76,76
Keone,M,100,0,501,501
Georgene,F,100,1299,0,1299
Elander,F,100,5,0,5
Nandana,F,100,88,0,88
Yureli,F,100,28,0,28
Orlandis,M,100,0,80,80
Adryn,M,77,6,20,26
Lafredrick,M,100,0,26,26
Henerietta,F,100,5,0,5
Orelia,F,100,211,0,211
Jasonjr,M,100,0,5,5
Yanixan,M,100,0,95,95
Shmeka,F,100,32,0,32
Lemark,M,100,0,20,20
Pariis,F,100,15,0,15
Dilcia,F,100,185,0,185
Kacelynn,F,100,17,0,17
Anaelise,F,100,5,0,5
Debbera,F,100,73,0,73
Christianalexan,M,100,0,5,5
Xitlalit,F,100,5,0,5
Jennelle,F,100,1053,0,1053
Razhane,F,100,5,0,5
Bryleigh,F,100,2474,0,2474
Raimey,F,100,23,0,23
Shelli,F,100,6944,0,6944
Ricke,M,100,0,164,164
Evaluna,F,100,40,0,40
Sauna,F,100,5,0,5
Orry,M,100,0,337,337
Trevion,M,100,0,2782,2782
Yeshia,F,50,5,5,10
Deneisha,F,100,411,0,411
Eugean,M,100,0,10,10
Altamese,F,100,90,0,90
Maelo,M,100,0,5,5
Ceceilia,F,100,246,0,246
Tarone,M,100,0,46,46
Andriena,F,100,6,0,6
Nykeema,F,100,6,0,6
Chailey,F,100,19,0,19
Grifin,M,100,0,5,5
Braeleigh,F,100,223,0,223
Deri,F,100,50,0,50
Ayvah,F,100,623,0,623
Skylur,M,59,48,69,117
Evanie,F,100,216,0,216
Bacari,M,100,0,28,28
Thaliya,F,100,10,0,10
Jazaih,M,100,0,5,5
Garyn,M,74,73,207,280
Leonidus,M,100,0,76,76
Hadessa,F,100,8,0,8
Heang,F,100,10,0,10
Jakyah,F,100,235,0,235
Ceciley,F,100,131,0,131
Tyriq,M,100,0,1391,1391
Imad,M,100,0,430,430
Zeph,M,100,0,60,60
Monzerrath,F,100,128,0,128
Bhargava,M,100,0,5,5
Emilianna,F,100,82,0,82
Araseli,F,100,1184,0,1184
Nickelas,M,100,0,43,43
Desi,M,75,701,2068,2769
Stran,M,100,0,126,126
Anngelina,F,100,6,0,6
Reitha,F,100,5,0,5
Tquan,M,100,0,6,6
Aahron,M,100,0,5,5
Gurvinder,M,100,0,17,17
Allam,M,100,0,5,5
Larwence,M,100,0,270,270
Iyon,M,100,0,33,33
Randloph,M,100,0,48,48
Aliene,F,100,56,0,56
Taiyo,M,100,0,185,185
Averyanna,F,100,111,0,111
Renitha,F,100,5,0,5
Sherrol,F,100,40,0,40
Abdalla,M,100,0,257,257
Marjoe,M,100,0,12,12
Lashunna,F,100,23,0,23
Arron,M,98,173,7432,7605
Hinckley,M,100,0,46,46
Gaspare,M,100,0,184,184
Kelsen,M,100,0,94,94
Sarell,F,100,5,0,5
Kriscinda,F,100,6,0,6
Zann,M,100,0,10,10
Alabama,F,100,205,0,205
Jahcure,M,100,0,6,6
Pavelle,F,100,5,0,5
Lisle,M,84,16,83,99
Ezera,M,100,0,5,5
Maisey,F,100,437,0,437
Irit,F,100,5,0,5
Enya,F,100,891,0,891
Alitia,F,100,5,0,5
Henning,M,100,0,51,51
Loubertha,F,100,6,0,6
Aisaiah,M,100,0,19,19
Hrag,M,100,0,22,22
Chakya,F,100,10,0,10
Kody,M,97,691,21092,21783
Aishwarya,F,100,683,0,683
Mansur,M,100,0,162,162
Meenakshi,F,100,258,0,258
Uilliam,M,100,0,5,5
Errin,F,76,842,271,1113
Tragen,M,100,0,15,15
Derba,F,100,11,0,11
Veletta,F,100,43,0,43
Crislyn,F,100,134,0,134
Kershaw,M,100,0,5,5
Roselyne,F,100,73,0,73
Leriah,F,100,5,0,5
Vivaan,M,100,0,883,883
Maheer,M,100,0,10,10
Chelesea,F,100,66,0,66
Armiya,F,100,33,0,33
Allicyn,F,100,46,0,46
Dejohn,M,100,0,394,394
Lauralai,F,100,12,0,12
Alvena,F,100,183,0,183
Bladimir,M,100,0,1008,1008
Catya,F,100,11,0,11
Syenna,F,100,127,0,127
Dartavious,M,100,0,53,53
Akoya,F,100,5,0,5
Meliyah,F,100,280,0,280
Latief,M,100,0,5,5
Seitu,M,100,0,5,5
Addriana,F,100,5,0,5
Ajanique,F,100,28,0,28
Jeno,M,100,0,249,249
Chestley,M,100,0,5,5
Sanchi,F,100,12,0,12
Tiarre,F,100,5,0,5
Emilymae,F,100,5,0,5
Lamount,M,100,0,200,200
Alric,M,100,0,174,174
Cleven,M,100,0,187,187
Roric,M,100,0,5,5
Markiest,M,100,0,11,11
Jkayla,F,100,103,0,103
Swapnil,M,100,0,6,6
Corlette,F,100,91,0,91
Shaddy,M,100,0,5,5
Deirde,F,100,6,0,6
Tydarian,M,100,0,5,5
Travionna,F,100,19,0,19
Lyndall,M,60,113,167,280
Kalianne,F,100,53,0,53
Jatavious,M,100,0,492,492
Mouctar,M,100,0,12,12
Mariangeliz,F,100,12,0,12
Anariyah,F,100,12,0,12
Seslie,F,100,19,0,19
Natorian,M,100,0,5,5
Demarcos,M,100,0,58,58
Regniald,M,100,0,24,24
Fermina,F,100,80,0,80
Ariarose,F,100,12,0,12
Wayd,M,100,0,10,10
Iven,M,100,0,526,526
Gabrille,F,100,160,0,160
Trevour,M,100,0,31,31
Lorenia,F,100,151,0,151
Dar,M,100,0,28,28
Kyah,F,99,2041,27,2068
Sajen,M,100,0,7,7
Tyaria,F,100,5,0,5
Gisell,F,100,1685,0,1685
Hazel,F,99,32553,336,32889
Jaydalyn,F,100,90,0,90
Taylour,F,94,442,29,471
Taneika,F,100,242,0,242
Ianto,M,100,0,6,6
Chavonte,F,100,5,0,5
Iasiah,M,91,7,68,75
Rosangela,F,100,324,0,324
Kayro,M,100,0,11,11
Makea,F,100,6,0,6
Alandre,M,100,0,18,18
Pooja,F,100,1957,0,1957
Ludivina,F,100,423,0,423
Ruthella,F,100,6,0,6
Donja,F,100,102,0,102
Darson,M,100,0,5,5
Gilmore,M,100,0,118,118
Jarrell,M,99,22,3370,3392
Franchester,F,100,37,0,37
Jermiya,F,100,130,0,130
Trev,M,100,0,78,78
Taniyha,F,100,44,0,44
Mariapaz,F,100,10,0,10
Kiaan,M,100,0,184,184
Lonzy,M,100,0,13,13
Mekaylah,F,100,92,0,92
Lilliona,F,100,84,0,84
Katalina,F,100,2696,0,2696
Zilla,F,100,7,0,7
Kinberlin,F,100,18,0,18
Rox,F,100,309,0,309
Julieana,F,100,375,0,375
Ancel,M,100,0,159,159
Madalaine,F,100,66,0,66
Jossica,F,100,5,0,5
Laxmy,F,100,7,0,7
Ixel,F,100,86,0,86
Kellsey,F,100,429,0,429
Windel,M,100,0,93,93
Nethaniah,M,100,0,5,5
Keaja,F,100,67,0,67
Aleksa,F,91,481,50,531
Gavriela,F,100,92,0,92
Daimar,M,100,0,10,10
Momodou,M,100,0,75,75
Kayland,F,76,57,18,75
Iliana,F,100,9834,0,9834
Levar,M,100,9,1948,1957
Julica,F,100,5,0,5
Burdett,M,100,0,6,6
Evoni,F,100,39,0,39
Demontrez,M,100,0,79,79
Chatherine,F,100,26,0,26
Maekayla,F,100,92,0,92
Aieden,M,100,0,11,11
Braedyn,M,88,250,1811,2061
Aremi,F,100,41,0,41
Kamali,M,56,79,99,178
Debhora,F,100,65,0,65
Hyacinth,F,100,335,0,335
Ragan,F,82,1736,370,2106
Sandre,F,100,11,0,11
Teige,M,100,0,66,66
Hanny,F,100,67,0,67
Andrietta,F,100,5,0,5
Kirara,F,100,6,0,6
Mersaydez,F,100,6,0,6
Vanness,M,72,5,13,18
Reyelle,F,100,5,0,5
Nijae,F,92,169,15,184
Coehn,M,100,0,11,11
Duwan,M,100,0,205,205
Eliona,F,100,30,0,30
Markeice,M,100,0,16,16
Kioka,F,100,13,0,13
Kyros,M,100,0,44,44
Carlyle,M,89,140,1167,1307
Kealey,F,100,375,0,375
Eternity,F,100,1356,0,1356
Kayona,F,100,277,0,277
Azaleia,F,100,19,0,19
Joseline,F,100,3312,0,3312
Baize,M,100,0,12,12
Dontavia,F,91,108,11,119
Jordanchristoph,M,100,0,5,5
Atzimba,F,100,10,0,10
Tabata,F,100,6,0,6
Jacarion,M,100,0,37,37
Chizitelu,F,100,6,0,6
Cassedy,F,100,39,0,39
Ellian,M,100,0,41,41
Desinae,F,100,5,0,5
Analeshia,F,100,6,0,6
Sherwin,M,99,15,2301,2316
Dayane,F,100,92,0,92
Vidette,F,100,23,0,23
Shadora,F,100,26,0,26
Keymon,M,100,0,146,146
Lacy,F,89,18099,2315,20414
Danile,M,97,5,185,190
Justice,M,52,13778,15054,28832
Serendipity,F,100,27,0,27
Kystin,M,100,0,5,5
Tradarrius,M,100,0,16,16
Jqwon,M,100,0,5,5
Josjeph,M,100,0,5,5
Roschell,F,100,39,0,39
Anglo,M,100,0,15,15
Kaydin,M,66,480,919,1399
Ziyah,F,97,518,18,536
Humna,F,100,61,0,61
Khamira,F,100,7,0,7
Aydrik,M,100,0,5,5
Teeghan,F,100,75,0,75
Itaty,F,100,39,0,39
Haki,M,100,0,23,23
Godofredo,M,100,0,16,16
Yuriana,F,100,435,0,435
Keyner,M,100,0,10,10
Zymari,M,100,0,47,47
Mokshagna,M,100,0,5,5
Derean,M,100,0,5,5
Tikiyah,F,100,5,0,5
Aureanna,F,100,10,0,10
Javein,M,100,0,16,16
Delasia,F,100,49,0,49
Dawyne,M,100,0,15,15
Geryl,F,90,95,10,105
Ellamay,F,100,11,0,11
Kaydie,F,100,132,0,132
Aelani,F,100,6,0,6
Selethia,F,100,6,0,6
Goodluck,M,100,0,8,8
Saquanna,F,100,5,0,5
Mariae,F,100,5,0,5
Rui,M,97,15,534,549
Maleena,F,100,611,0,611
Jmari,M,100,0,178,178
Hobie,M,100,0,329,329
Kimisha,F,100,181,0,181
Lenardo,M,100,0,114,114
Issah,M,100,0,27,27
Saoirse,F,100,918,0,918
Stormee,F,100,218,0,218
Baelin,M,100,0,23,23
Sharnyce,F,100,6,0,6
Orisha,F,100,11,0,11
Anabrenda,F,100,33,0,33
Darren,M,99,562,99993,100555
Kelman,M,100,0,5,5
Marnique,F,100,15,0,15
Lawrance,M,100,0,1484,1484
Badr,M,100,0,142,142
Brieah,F,100,5,0,5
Peneloperose,F,100,6,0,6
Neeraj,M,100,0,321,321
Tyshanti,F,100,12,0,12
Khamaron,M,100,0,8,8
Yohann,M,100,0,146,146
Bostyn,F,68,262,125,387
Briella,F,100,4309,0,4309
Saviana,F,100,5,0,5
Ziden,M,100,0,5,5
Qiona,F,100,6,0,6
Elber,M,100,0,100,100
Jyrese,M,100,0,35,35
Firdaus,F,100,21,0,21
Fathi,M,100,0,30,30
Huldah,F,100,12,0,12
Maleha,F,100,5,0,5
Michaelene,F,100,968,0,968
Kenard,M,100,0,674,674
Nirmal,M,100,0,32,32
Nachole,F,100,11,0,11
Airess,F,100,15,0,15
Latronda,F,100,87,0,87
Jeramih,M,100,0,50,50
Nikaiya,F,100,10,0,10
Alexs,M,100,0,34,34
Cean,M,100,0,29,29
Ceairra,F,100,173,0,173
Taylorjo,F,100,11,0,11
Emelyne,F,100,21,0,21
Vichelle,F,100,5,0,5
Teryn,F,84,1234,241,1475
Jadesha,F,100,5,0,5
Kinnedy,F,100,72,0,72
Dabriyon,M,100,0,7,7
Abdulrahman,M,100,0,1681,1681
Haize,M,55,5,6,11
Lua,F,100,207,0,207
Tyshun,M,100,0,337,337
Getty,M,100,0,5,5
Agrima,F,100,13,0,13
Brenlynn,F,100,30,0,30
Elliekate,F,100,14,0,14
Jacquon,M,100,0,21,21
Franklin,M,99,363,63795,64158
Reynardo,M,100,0,20,20
Keaghan,M,75,80,237,317
Angelous,M,100,0,14,14
Salandra,F,100,5,0,5
Ashayla,F,100,325,0,325
Genetta,F,100,268,0,268
Kowana,F,100,20,0,20
Ayden,M,97,1987,55808,57795
Satyra,F,100,7,0,7
Jesslin,F,100,38,0,38
Darley,F,100,6,0,6
Kaeloni,F,100,16,0,16
Antelmo,M,100,0,50,50
Jeimy,F,100,473,0,473
Madisun,F,100,222,0,222
Kiania,F,100,5,0,5
Jenesis,F,99,2215,12,2227
Lativa,F,100,6,0,6
Nincy,F,100,5,0,5
Nakhiya,F,100,37,0,37
Lidio,M,100,0,5,5
Chanoch,M,100,0,67,67
Jonine,F,100,22,0,22
Charlis,M,84,5,26,31
Danasia,F,100,1263,0,1263
Damariae,M,100,0,36,36
Chiffon,F,100,468,0,468
Kausar,F,100,9,0,9
Rachana,F,100,259,0,259
Jamarvion,M,100,0,5,5
Jazaya,F,100,44,0,44
Amby,F,100,28,0,28
Celesta,F,100,885,0,885
Theonita,F,100,17,0,17
Mylinn,F,100,5,0,5
Eliecer,M,100,0,28,28
Dashyia,F,100,8,0,8
Kason,M,100,32,6885,6917
Doretta,F,100,1291,0,1291
Markeyia,F,100,10,0,10
Levie,M,100,0,238,238
Shayleah,F,100,5,0,5
Quaneesha,F,100,45,0,45
Langdon,M,99,10,696,706
Deris,M,100,0,22,22
Yoshida,F,100,27,0,27
Dartanion,M,100,0,118,118
Leianna,F,100,509,0,509
Tenaj,F,100,43,0,43
Palash,M,100,0,11,11
Taegan,F,73,820,296,1116
Lanequia,F,100,12,0,12
Jermail,M,100,0,34,34
Teressa,F,100,5848,0,5848
Shiyanna,F,100,5,0,5
Tahjae,F,54,122,104,226
Taliea,F,100,6,0,6
Mischele,F,100,116,0,116
Sylia,F,100,13,0,13
Danterrius,M,100,0,5,5
Alante,M,82,101,457,558
Tamaka,F,100,182,0,182
Denaijah,F,100,20,0,20
Daycen,M,100,0,25,25
Kileen,F,100,118,0,118
Adaleine,F,100,6,0,6
Nataliz,F,100,17,0,17
Mikeyia,F,100,10,0,10
Raynique,F,100,11,0,11
Tullia,F,100,16,0,16
Annaleese,F,100,98,0,98
Valentin,M,100,0,7428,7428
Kaaren,F,100,315,0,315
Marqwon,M,100,0,6,6
Jozie,F,100,752,0,752
Forrestine,F,100,43,0,43
Cecelia,F,100,22869,0,22869
Guneet,F,100,50,0,50
Zriyah,F,100,61,0,61
Normaa,F,100,10,0,10
Farida,F,100,420,0,420
Bryam,M,100,0,73,73
Tauja,F,100,6,0,6
Aleks,M,100,0,325,325
Stark,M,100,0,82,82
Muskan,F,100,272,0,272
Aniye,F,100,5,0,5
Rianah,F,100,13,0,13
Semajai,M,100,0,5,5
Khafre,M,100,0,5,5
Brainna,F,100,20,0,20
Trenda,F,100,650,0,650
Tsuyoshi,M,100,0,6,6
Eustace,M,100,0,158,158
Josmine,F,100,6,0,6
Kaleaha,F,100,25,0,25
Kerrion,M,87,18,121,139
Kurstin,F,100,467,0,467
Delvante,M,100,0,29,29
Vanaya,F,100,13,0,13
Nicol,F,99,2020,28,2048
Kersti,F,100,62,0,62
Darnese,F,100,5,0,5
Yazmen,F,100,71,0,71
Keynen,M,100,0,22,22
Eliabeth,F,100,247,0,247
Karline,F,100,42,0,42
Emmaclaire,F,100,96,0,96
Deasja,F,100,5,0,5
Gemini,F,68,325,156,481
Kesleigh,F,100,34,0,34
Jasmien,F,100,27,0,27
Mersadie,F,100,244,0,244
Kailina,F,100,21,0,21
Anguel,M,100,0,192,192
Quameer,M,100,0,11,11
Kiahra,F,100,35,0,35
Baylon,M,100,0,210,210
Dmiyah,F,100,54,0,54
Dionysius,M,100,0,27,27
Madasin,F,100,43,0,43
Kristion,M,97,5,163,168
Nakiaya,F,100,15,0,15
Regnald,M,100,0,58,58
Roann,F,100,202,0,202
Ernesteen,F,100,7,0,7
Karmine,M,100,0,95,95
Bernarda,F,100,102,0,102
Siwar,F,100,5,0,5
Rafan,M,100,0,72,72
Jymme,F,100,18,0,18
Jesusalberto,M,100,0,30,30
Marnice,F,100,42,0,42
Raene,F,100,5,0,5
Gretchan,F,100,34,0,34
Yarismar,F,100,5,0,5
Joh,M,100,0,402,402
Omarrion,M,100,0,62,62
Xochilth,F,100,100,0,100
Athina,F,100,721,0,721
Zacorey,M,100,0,38,38
Nils,M,100,0,1948,1948
Qwendolyn,F,100,10,0,10
Cecilya,F,100,46,0,46
Sandria,F,100,504,0,504
Annaliyah,F,100,122,0,122
Treat,M,100,0,10,10
Edson,M,100,0,2598,2598
Khris,M,86,46,277,323
Esaiah,M,100,0,74,74
Maraia,F,100,12,0,12
Adalind,F,100,86,0,86
Shali,F,100,93,0,93
Lumi,F,100,55,0,55
Ellinore,F,100,35,0,35
Olaf,M,100,0,852,852
Bazil,M,100,0,39,39
Maleki,M,100,0,189,189
Beila,F,100,79,0,79
Devontai,M,100,0,35,35
Erneshia,F,100,17,0,17
Jametrius,M,100,0,21,21
Manuela,F,100,4449,0,4449
Tashanique,F,100,28,0,28
Haala,F,100,5,0,5
Keelan,M,90,293,2583,2876
Kimba,F,100,85,0,85
Natascha,F,100,901,0,901
Mubarak,M,100,0,261,261
Jeidan,M,100,0,5,5
Lakeyta,F,100,97,0,97
Alger,M,100,0,174,174
Qwanisha,F,100,23,0,23
Delandria,F,100,16,0,16
Siriana,F,100,6,0,6
Natalene,F,100,5,0,5
Lilou,F,100,109,0,109
Hadil,F,100,20,0,20
Lashundra,F,100,983,0,983
Keivin,M,100,0,19,19
Ariale,F,100,5,0,5
Kayshon,M,100,0,15,15
Isriel,M,100,0,5,5
Nasheena,F,100,19,0,19
Saathvik,M,100,0,82,82
Dhruthi,F,100,15,0,15
Jalisa,F,100,5815,6,5821
Akita,F,100,152,0,152
Caris,F,100,835,0,835
Deantae,M,100,0,260,260
Ellayah,F,100,5,0,5
Pablo,M,100,57,36244,36301
Pricsilla,F,100,68,0,68
Krishawna,F,100,72,0,72
Mailin,F,100,143,0,143
Shala,F,100,2055,0,2055
Shaunya,F,100,40,0,40
Coralyn,F,100,525,0,525
Iren,M,100,0,64,64
Zanasia,F,100,62,0,62
Roha,F,100,21,0,21
Jorin,M,100,0,45,45
Prit,M,100,0,20,20
Kaidyn,M,59,990,1433,2423
Anibella,F,100,6,0,6
Micco,M,100,0,64,64
Lorilei,F,100,219,0,219
Joleigh,F,100,564,0,564
Aniece,F,100,34,0,34
Shelana,F,100,29,0,29
Reyanne,F,100,73,0,73
Isia,F,89,39,5,44
Addysun,F,100,13,0,13
Myreya,F,100,6,0,6
Hazelmarie,F,100,5,0,5
Anushka,F,100,1416,0,1416
Earlette,F,100,7,0,7
Zhiya,F,100,6,0,6
Nichlous,M,100,0,24,24
Nickol,F,100,236,0,236
Anikan,M,100,0,10,10
Joset,M,69,5,11,16
Quoc,M,100,0,488,488
Jadamarie,F,100,97,0,97
Brisen,M,100,0,41,41
Jeoffrey,M,100,0,238,238
Sharayah,F,100,587,0,587
Jedidah,F,100,48,0,48
Yasley,F,100,5,0,5
Sanylah,F,100,28,0,28
Dalson,M,100,0,40,40
Anquinette,F,100,165,0,165
Kasir,M,100,0,112,112
Camorah,F,100,23,0,23
Anael,F,84,79,15,94
Lyrical,F,100,74,0,74
Jahmela,F,100,5,0,5
Amirbek,M,100,0,5,5
Dinasty,F,100,12,0,12
Rahi,F,79,77,20,97
Iyanni,F,100,64,0,64
Anaie,F,100,32,0,32
Kymari,M,60,139,209,348
Serinah,F,100,6,0,6
Arison,M,100,0,28,28
Rheana,F,100,248,0,248
Kordero,M,100,0,20,20
Shacari,F,100,10,0,10
Iqlas,F,100,5,0,5
Myah,F,100,7294,6,7300
Mursal,F,74,32,11,43
Quala,F,100,10,0,10
Aayanna,F,100,38,0,38
Cane,M,100,0,175,175
Sostenes,M,100,0,56,56
Jenal,F,100,12,0,12
Sang,M,93,47,611,658
Mikeyla,F,100,235,0,235
Jacek,M,100,0,429,429
Clela,F,100,5,0,5
Kristyann,F,100,54,0,54
Bitania,F,100,35,0,35
Nicloe,F,100,146,0,146
Annaie,F,100,6,0,6
Quinte,M,100,0,6,6
Godswill,M,100,0,34,34
Gwenetta,F,100,223,0,223
Chong,M,62,204,331,535
Earvin,M,100,0,695,695
Kieon,M,100,0,79,79
Kaydee,F,100,2021,0,2021
Jerrid,M,100,0,1081,1081
Aiysha,F,100,148,0,148
Anthonie,M,100,0,699,699
Kenniyah,F,100,109,0,109
Jania,F,100,2540,0,2540
Nakenzie,F,100,14,0,14
Caylynn,F,100,281,0,281
Srimayi,F,100,5,0,5
Shakevia,F,100,125,0,125
Kalo,M,100,0,18,18
Raley,F,100,302,0,302
Bakari,M,100,0,1105,1105
Tifany,F,100,960,0,960
Montego,M,100,0,50,50
Lavinnia,F,100,5,0,5
Teontae,M,100,0,8,8
Solida,F,100,11,0,11
Cearah,F,100,10,0,10
Maaya,F,100,18,0,18
Reaford,M,100,0,5,5
Sharrion,F,100,22,0,22
Montrevious,M,100,0,5,5
Avorie,F,100,32,0,32
Kelcy,F,93,918,66,984
Faithann,F,100,236,0,236
Deleena,F,100,17,0,17
Ladonta,M,100,0,22,22
Lilyth,F,100,137,0,137
Aedan,M,99,43,2876,2919
Farid,M,100,0,759,759
Primrose,F,100,109,0,109
Makayley,F,100,12,0,12
Janiece,F,100,2445,0,2445
Deloyce,F,100,12,0,12
Sameka,F,100,128,0,128
Lauana,F,100,5,0,5
Jennee,F,100,18,0,18
Dorothy,F,100,134698,420,135118
Zaravion,M,100,0,8,8
Envie,F,100,7,0,7
Nicolus,M,100,0,98,98
Tykee,M,100,0,81,81
Shvonne,F,100,50,0,50
Kierria,F,100,73,0,73
Sandie,F,100,2068,5,2073
Seyvon,M,100,0,6,6
Nereo,M,100,0,21,21
Adoncia,F,100,5,0,5
Koy,M,95,34,666,700
Kahlil,M,100,0,3406,3406
Jesu,M,100,0,19,19
Gaila,F,100,405,0,405
Shohei,M,100,0,43,43
Sangeeta,F,100,172,0,172
Quetzalli,F,100,475,0,475
Farrah,F,100,9640,7,9647
Malahki,M,100,0,56,56
Canye,M,100,0,13,13
Charlies,M,100,0,102,102
Kyeana,F,100,6,0,6
Faryl,F,100,5,0,5
Nolynn,F,100,19,0,19
Cassady,F,92,1036,87,1123
Theryn,M,65,16,30,46
Khang,M,100,0,911,911
Arriana,F,100,1382,0,1382
Zuwena,F,100,12,0,12
Sharonlee,F,100,12,0,12
Geneice,F,100,40,0,40
Kelsia,F,100,17,0,17
Polo,M,100,0,378,378
Sinead,F,100,1227,0,1227
Thyrome,M,100,0,5,5
Chidinma,F,100,257,0,257
Justas,M,100,0,5,5
Jalecia,F,100,366,0,366
Michelena,F,100,15,0,15
Vicent,M,100,0,620,620
Jocey,F,100,59,0,59
Tore,M,87,11,75,86
Sharlot,F,100,20,0,20
Yian,M,100,0,18,18
Keedon,M,100,0,5,5
Keeston,M,100,0,5,5
Aliye,F,100,11,0,11
Lehana,F,100,13,0,13
Hiliana,F,100,213,0,213
Dequaveon,M,100,0,5,5
Lonetta,F,100,208,0,208
Mandye,F,100,5,0,5
Tawonna,F,100,82,0,82
Amoriana,F,100,6,0,6
Melizza,F,100,123,0,123
Milley,F,100,53,0,53
Xylus,M,100,0,6,6
Lorianne,F,100,1596,0,1596
Corriana,F,100,11,0,11
Madaline,F,100,2064,0,2064
Ammer,M,100,0,5,5
Dannielle,F,100,3998,0,3998
Gehad,F,100,5,0,5
Ossama,M,100,0,23,23
Brenicia,F,100,5,0,5
Daemian,M,100,0,149,149
Jonell,F,88,1490,207,1697
Zebastian,M,100,0,107,107
Sashae,F,100,39,0,39
Zacoria,F,100,33,0,33
Ziclali,F,100,7,0,7
Everlin,F,100,10,0,10
Avis,F,92,4892,404,5296
Winnie,F,100,4317,0,4317
Nadezhda,F,100,203,0,203
Emberlynn,F,100,488,0,488
Manmeet,F,69,77,35,112
Renner,M,100,0,249,249
Annsleigh,F,100,72,0,72
Keeland,M,100,0,49,49
Crystallee,F,100,74,0,74
Savannah,F,100,145440,186,145626
Anyely,F,100,47,0,47
Chardonnae,F,100,26,0,26
Dekita,F,100,5,0,5
Rendon,M,100,0,65,65
Montravion,M,100,0,5,5
Gabriela,F,100,74266,370,74636
Amarachukwu,F,100,49,0,49
Takila,F,100,203,0,203
Sherlena,F,100,6,0,6
Azalee,F,100,222,0,222
Makenlie,F,100,51,0,51
Kathe,F,100,735,0,735
Reinier,M,100,0,21,21
Vianet,F,100,44,0,44
Niketa,F,100,371,0,371
Krystalee,F,100,22,0,22
Maegann,F,100,12,0,12
Maxston,M,100,0,13,13
Hadlei,F,100,40,0,40
Leeona,F,100,53,0,53
Jakiyla,F,100,30,0,30
Kiary,F,100,5,0,5
Stellina,F,100,31,0,31
Fredreka,F,100,6,0,6
Cyrine,F,100,21,0,21
Gracelynne,F,100,183,0,183
Azayliah,F,100,8,0,8
Melonia,F,100,27,0,27
Tyana,F,100,2505,0,2505
Shiny,F,100,15,0,15
Daquante,M,100,0,36,36
Adn,F,100,5,0,5
Teyahna,F,100,5,0,5
Xaniel,M,100,0,11,11
Yancy,M,82,440,2064,2504
Avanti,F,85,289,52,341
Cendi,F,100,5,0,5
Bissan,F,100,6,0,6
Chander,M,100,0,8,8
Aston,M,92,129,1543,1672
Debrha,F,100,5,0,5
Cyniah,F,100,210,0,210
Yanaira,F,100,42,0,42
Gwendy,F,100,61,0,61
Deseree,F,100,1240,0,1240
Kaviyon,M,100,0,5,5
Yazmyn,F,100,210,0,210
Keilly,F,100,437,0,437
Mushtaq,F,100,16,0,16
Shetal,F,100,6,0,6
Letavia,F,100,16,0,16
Charlotterose,F,100,5,0,5
Nissie,F,100,5,0,5
Rakwon,M,100,0,90,90
Lissandra,F,100,236,0,236
Lynkon,M,100,0,19,19
Oletta,F,100,20,0,20
Davari,M,100,0,94,94
Maryjane,F,100,7109,0,7109
Matteus,M,100,0,141,141
Jamiemarie,F,100,24,0,24
Jakoda,M,100,0,25,25
Emmalou,F,100,70,0,70
Zekia,F,100,54,0,54
Trajen,M,100,0,55,55
Lanajia,F,100,5,0,5
Jaeshaun,M,100,0,93,93
Thaison,M,100,0,56,56
Khyleigh,F,100,102,0,102
Kebbie,F,100,5,0,5
Ronnda,F,100,6,0,6
Zeida,F,100,28,0,28
Sareeta,F,100,7,0,7
Zimarion,M,100,0,6,6
Korbyn,M,82,361,1677,2038
Wandalyn,F,100,34,0,34
Chakiya,F,100,17,0,17
Masey,F,100,256,0,256
Bryanne,F,100,1030,0,1030
Fernand,M,100,0,261,261
Efren,M,100,0,6795,6795
Jonbenet,F,100,20,0,20
Rekina,F,100,7,0,7
Alyan,M,100,0,26,26
Yatasha,F,100,16,0,16
Terrance,M,99,695,60602,61297
Akya,F,100,111,0,111
Romy,F,90,1483,167,1650
Kylaya,F,100,16,0,16
Verma,F,100,134,0,134
Kalyia,F,100,15,0,15
Rosella,F,100,2546,0,2546
Trinati,F,100,23,0,23
Samarion,M,100,0,240,240
Prayze,F,100,6,0,6
Yosman,M,100,0,5,5
Yamaira,F,100,66,0,66
Florene,F,100,451,0,451
Yanick,M,53,45,50,95
Basim,M,100,0,229,229
Nimah,F,100,53,0,53
Chalisa,F,100,119,0,119
Kanissa,F,100,5,0,5
Genner,M,100,0,5,5
Analily,F,100,5,0,5
Nanisha,F,100,10,0,10
Aireon,M,90,5,43,48
Shelbra,F,100,5,0,5
Olajuwan,M,100,0,12,12
Dayanaira,F,100,10,0,10
Keori,F,100,5,0,5
Laici,F,100,5,0,5
Bobetta,F,100,52,0,52
Jenniper,F,100,5,0,5
Jurea,F,100,33,0,33
Kimmie,F,90,1212,131,1343
Nykee,M,100,0,10,10
Mardis,M,100,0,5,5
Uzair,M,100,0,368,368
Jasara,F,100,60,0,60
Gwendelyn,F,100,310,0,310
Xayne,M,100,0,42,42
Alyssamae,F,100,65,0,65
Mini,F,100,32,0,32
Juanye,M,100,0,57,57
Durriyah,F,100,12,0,12
Edrianna,F,100,6,0,6
Lataesha,F,100,6,0,6
Mercedese,F,100,12,0,12
Camberly,F,100,10,0,10
Dystinee,F,100,17,0,17
Mythri,F,100,5,0,5
Dylaney,F,100,11,0,11
Dresden,M,79,159,581,740
Wyley,M,100,0,66,66
Monisa,F,100,59,0,59
Jeniqua,F,100,13,0,13
Brielee,F,100,23,0,23
Gracemarie,F,100,154,0,154
Pacer,M,100,0,73,73
Araylia,F,100,10,0,10
Lyrica,F,100,267,0,267
Vivian,F,99,82126,511,82637
Hailynn,F,100,149,0,149
Bilen,F,100,16,0,16
Charnita,F,100,359,0,359
Jonlyn,F,100,5,0,5
Maghen,F,100,108,0,108
Jerniah,F,100,12,0,12
Almonza,M,100,0,5,5
Brayen,M,100,0,121,121
Darryal,M,100,0,55,55
Katisha,F,100,774,0,774
Burness,M,100,0,5,5
Birtie,F,100,5,0,5
Aura,F,100,2111,0,2111
Shamond,M,100,0,172,172
Haywood,M,100,0,2223,2223
Jinan,F,97,151,5,156
Iriana,F,100,462,0,462
Jhaniah,F,100,5,0,5
Dregan,M,100,0,27,27
Philece,F,100,6,0,6
Chanda,F,100,6052,16,6068
Tyranisha,F,100,14,0,14
Sheterrica,F,100,5,0,5
Brian,M,100,4515,1131304,1135819
Tatyonna,F,100,20,0,20
Anneice,F,100,6,0,6
Shanza,F,100,25,0,25
Lambert,M,100,0,1194,1194
Jaxx,M,100,0,814,814
Eliyahu,M,100,0,2199,2199
Maimoona,F,100,19,0,19
Kanye,M,98,24,1261,1285
Srithan,M,100,0,38,38
Manaf,M,100,0,7,7
Reimundo,M,100,0,10,10
Josielynn,F,100,10,0,10
Jasian,M,100,0,6,6
Ashonti,F,100,204,0,204
Jamyri,F,74,17,6,23
Meng,M,98,13,555,568
Khalya,F,100,10,0,10
Kurissa,F,100,7,0,7
Zuszeth,F,100,5,0,5
Sharona,F,100,695,0,695
Tracilyn,F,100,5,0,5
Raijon,M,100,0,64,64
Burlon,M,100,0,6,6
Londrea,F,100,5,0,5
Demetric,M,83,411,2003,2414
Dyuti,F,100,5,0,5
Joselene,F,100,29,0,29
Davette,F,100,541,0,541
Sheida,F,100,15,0,15
Charles,M,100,5380,1108300,1113680
Ilo,M,60,6,9,15
Shakeila,F,100,181,0,181
Raffaella,F,100,241,0,241
Kathalina,F,100,89,0,89
Cheyenna,F,100,715,0,715
Sylvie,F,100,2704,0,2704
Kristofe,M,100,0,9,9
Jarriah,F,100,5,0,5
Phillis,F,100,1684,0,1684
Titiyana,F,100,5,0,5
Flynn,M,91,273,2688,2961
Javell,M,100,0,357,357
Makailey,F,100,70,0,70
Dorrien,M,100,0,101,101
Tonga,F,100,159,0,159
Kyera,F,100,576,0,576
Babs,F,100,106,0,106
Flori,F,100,17,0,17
Kielin,M,100,0,5,5
Patriciaa,F,100,12,0,12
Amelle,F,100,17,0,17
Eyal,M,100,0,313,313
Trucker,M,100,0,15,15
Taneshia,F,100,1309,0,1309
Kymeir,M,100,0,5,5
Jerramie,M,100,0,30,30
Charlae,F,100,5,0,5
Samaura,F,100,29,0,29
Yubin,F,100,5,0,5
Jaemarie,F,100,45,0,45
Zedrick,M,100,0,397,397
Madalen,F,100,105,0,105
Lovonda,F,100,5,0,5
Jennyfer,F,100,1686,0,1686
Hilbert,M,100,0,326,326
Jahnya,F,100,217,0,217
Izzak,M,100,0,106,106
Nayelee,F,100,46,0,46
Morpheus,M,100,0,5,5
Khemani,M,100,0,8,8
Jaydan,M,81,552,2397,2949
Zamoria,F,100,72,0,72
Rodessa,F,100,6,0,6
Tambra,F,100,1817,0,1817
Amanoa,F,100,28,0,28
Lito,M,100,0,15,15
Shaquona,F,100,47,0,47
Alchemy,F,100,10,0,10
Magdelene,F,100,22,0,22
Feysal,M,100,0,5,5
Warnetta,F,100,31,0,31
Maleia,F,100,652,0,652
Roverto,M,100,0,76,76
Truley,F,100,9,0,9
Mekisha,F,100,106,0,106
Amerson,M,100,0,5,5
Lowry,M,93,10,131,141
Janiyaa,F,100,5,0,5
Pearletha,F,100,5,0,5
Nkechinyere,F,100,41,0,41
Jaleyah,F,100,340,0,340
Regional,M,100,0,22,22
Kc,M,69,769,1706,2475
Evaeh,F,100,5,0,5
Mishele,F,100,54,0,54
Jenson,M,98,27,1141,1168
Malonni,F,100,6,0,6
Tayler,F,82,10725,2375,13100
Pipper,F,100,29,0,29
Annalie,F,100,586,0,586
Dino,M,100,0,7636,7636
Ashelee,F,100,38,0,38
Likisha,F,100,67,0,67
Versa,F,100,44,0,44
Shanrica,F,100,5,0,5
Vonnie,F,93,1614,127,1741
Shaileen,F,100,23,0,23
Curtisha,F,100,303,0,303
Roxie,F,99,5372,30,5402
Shweta,F,100,197,0,197
Banner,M,93,12,169,181
Kebrina,F,100,99,0,99
Shateia,F,100,6,0,6
Nytisha,F,100,6,0,6
Evina,F,100,6,0,6
Yitsel,F,100,5,0,5
Laneice,F,100,82,0,82
Sidona,F,100,11,0,11
Kyrha,F,100,5,0,5
Myiesha,F,100,652,0,652
Sen,M,100,0,22,22
Lamarious,M,100,0,38,38
Nyzaire,M,100,0,6,6
Xyon,M,89,7,56,63
Yazlee,F,100,5,0,5
Ellesse,F,100,111,0,111
Norell,F,81,64,15,79
Nyjee,M,100,0,12,12
Nieve,F,100,123,0,123
Zyira,F,100,5,0,5
Thamia,F,100,5,0,5
Quineka,F,100,5,0,5
Quentel,M,100,0,24,24
Gianncarlo,M,100,0,54,54
Karynn,F,100,140,0,140
Kynda,F,100,29,0,29
Yassmine,F,100,94,0,94
Takevia,F,100,16,0,16
Aceon,M,100,0,22,22
Sydnee,F,100,7697,0,7697
Daijuan,M,100,0,20,20
Kaeisha,F,100,5,0,5
Roya,F,100,1022,0,1022
Libny,F,100,46,0,46
Louaine,F,100,5,0,5
Jylin,M,100,0,11,11
Stafford,M,100,0,1540,1540
Acasia,F,100,120,0,120
Yug,M,100,0,235,235
Milynn,F,100,83,0,83
Julisa,F,100,4097,0,4097
Fayleen,F,100,5,0,5
Abdiasis,M,100,0,6,6
Shanaira,F,100,11,0,11
Leanah,F,100,54,0,54
Jeysen,M,100,0,7,7
Hasana,F,100,89,0,89
Irianna,F,100,164,0,164
Macai,M,100,0,105,105
Olalekan,M,100,0,17,17
Ulanda,F,100,364,0,364
Kaidynn,F,61,40,26,66
Garcelle,F,100,28,0,28
Demontavious,M,100,0,10,10
Tashell,F,100,55,0,55
Faaris,M,100,0,62,62
Mahalet,F,100,5,0,5
Eula,F,100,3595,7,3602
Lezanne,F,100,6,0,6
Aldrin,M,100,0,403,403
Corolyn,F,100,28,0,28
Mikee,M,100,0,5,5
Sheranda,F,100,73,0,73
Kajsa,F,100,348,0,348
Kahseem,M,100,0,26,26
Boden,M,100,0,1953,1953
Phiona,F,100,78,0,78
Shirlynn,F,100,48,0,48
Josey,F,74,2287,795,3082
Jhayla,F,100,114,0,114
Aridai,F,100,23,0,23
Laterrell,M,100,0,5,5
Janos,M,100,0,139,139
Junxi,M,100,0,10,10
Countney,F,100,27,0,27
Deesha,F,100,22,0,22
Addrianna,F,100,15,0,15
Savonn,M,100,0,15,15
Mayela,F,100,777,0,777
Santavious,M,100,0,5,5
Laterrian,M,93,5,65,70
Sharetta,F,100,263,0,263
Susaa,F,100,10,0,10
Hendy,F,100,140,0,140
Metztli,F,100,122,0,122
Kaylisha,F,100,6,0,6
Dontaye,M,100,0,382,382
Madilyne,F,100,254,0,254
Rebel,F,54,549,460,1009
Shondrika,F,100,88,0,88
Abygael,F,100,37,0,37
Malissia,F,100,207,0,207
Cahner,M,100,0,7,7
Jahseem,M,100,0,5,5
Haroutyun,M,100,0,5,5
Amaranta,F,100,116,0,116
Geovanne,M,100,0,11,11
Joclyn,F,100,612,0,612
Quetzali,F,100,221,0,221
Jiraiya,M,100,0,219,219
Valina,F,100,96,0,96
Josif,M,100,0,10,10
Addysen,F,100,918,0,918
Cantrece,F,100,24,0,24
Chrystyna,F,100,25,0,25
Renezme,F,100,5,0,5
Shewanda,F,100,121,0,121
Nehemyah,M,100,0,32,32
Adreana,F,100,900,0,900
Zalina,F,100,11,0,11
Bastian,M,100,0,667,667
Adriela,F,100,10,0,10
Larhonda,F,100,2509,0,2509
Delayah,F,100,11,0,11
Roane,M,100,0,16,16
Coreyana,F,100,18,0,18
Heru,M,100,0,58,58
Byren,M,100,0,62,62
Drewry,M,100,0,5,5
Deajha,F,100,12,0,12
Farzona,F,100,12,0,12
Linnell,F,55,52,42,94
Tatyania,F,100,37,0,37
Takarah,F,100,8,0,8
Etter,F,100,12,0,12
Ariceli,F,100,29,0,29
Klaira,F,100,139,0,139
Gaberiel,M,100,0,508,508
Curlee,M,100,0,104,104
Zenaya,F,100,61,0,61
Rhilee,F,100,98,0,98
Crew,M,100,0,2070,2070
Jalice,F,100,23,0,23
Oshanna,F,100,5,0,5
Sidne,F,100,35,0,35
Nylea,F,100,37,0,37
Ganajah,F,100,14,0,14
Oxana,F,100,10,0,10
Delta,F,97,1434,45,1479
Moneer,M,100,0,5,5
Thorsen,M,100,0,16,16
Torye,F,100,5,0,5
Feliberto,M,100,0,106,106
Zykeia,F,100,21,0,21
Aubreyana,F,100,236,0,236
Gabryl,M,100,0,30,30
Dore,F,90,188,20,208
Laciann,F,100,5,0,5
Patiance,F,100,36,0,36
Jonnie,F,68,2498,1164,3662
Jamesedward,M,100,0,40,40
Kasaun,M,100,0,52,52
Charmi,F,100,10,0,10
Sherease,F,100,28,0,28
Adrihanna,F,100,22,0,22
Elward,M,100,0,19,19
Aariyan,M,100,0,5,5
Forest,M,98,141,5958,6099
Hussan,M,100,0,50,50
Sameeha,F,100,250,0,250
Antwanesha,F,100,10,0,10
Treye,M,100,0,45,45
Faizaan,M,100,0,135,135
Abdirisaq,M,100,0,12,12
Zohaib,M,100,0,354,354
Gamila,F,100,5,0,5
Yassine,M,100,0,304,304
Hearl,M,100,0,5,5
Tavey,F,100,5,0,5
Jamesina,F,100,84,0,84
Isandro,M,100,0,33,33
Jayms,M,100,0,17,17
Shrina,F,100,49,0,49
Barbaranne,F,100,10,0,10
Senja,F,100,11,0,11
Keijuan,M,100,0,136,136
Kasiya,F,100,72,0,72
Sherick,M,100,0,6,6
Elondra,F,100,9,0,9
Bralynne,F,100,10,0,10
Dj,M,98,13,648,661
Castin,M,100,0,69,69
Tywann,M,100,0,59,59
Toosdhi,F,100,12,0,12
Alyzea,F,100,54,0,54
Ragen,F,97,537,15,552
Shannyn,F,100,520,0,520
Katharyne,F,100,18,0,18
Christofher,M,100,0,25,25
Teller,M,100,0,12,12
Synetra,F,100,7,0,7
Adhithya,M,100,0,6,6
Ammi,F,100,119,0,119
Shyrah,F,100,25,0,25
Ileana,F,100,4520,0,4520
Shaedon,M,100,0,21,21
Jermya,F,100,301,0,301
Coralea,F,100,10,0,10
Salvador,M,100,176,37141,37317
Laike,M,100,0,5,5
Lavisha,F,100,47,0,47
Jatoria,F,100,245,0,245
Blessin,F,100,262,0,262
Autumm,F,100,124,0,124
Duaine,M,100,0,433,433
Rajko,M,100,0,15,15
Kieley,F,100,263,0,263
Breashia,F,100,30,0,30
Berni,F,100,6,0,6
Kandyse,F,100,24,0,24
Maelah,F,100,6,0,6
Antinique,F,100,32,0,32
Yami,F,100,5,0,5
Emilson,M,100,0,17,17
Hung,M,100,0,989,989
Grantland,M,100,0,108,108
Dontavius,M,100,0,943,943
Pedrito,M,100,0,27,27
Oneshia,F,100,52,0,52
Heatherlyn,F,100,11,0,11
Yoandi,M,100,0,8,8
Jacameron,M,100,0,27,27
Kritina,F,100,5,0,5
Johneshia,F,100,55,0,55
Alanny,F,100,59,0,59
Yosbel,M,100,0,26,26
Chanavia,F,100,7,0,7
Makbel,M,100,0,16,16
Titus,M,100,6,14280,14286
Negar,F,100,53,0,53
Salahuddin,M,100,0,94,94
Ontarius,M,100,0,13,13
Atalaya,F,100,142,0,142
Jamala,F,100,103,0,103
Joyden,F,50,5,5,10
Chantail,F,100,5,0,5
Niveya,F,100,9,0,9
Ivanhoe,M,100,0,15,15
Janieliz,F,100,12,0,12
Laquetha,F,100,5,0,5
Roxanne,F,100,55013,55,55068
Lakeetha,F,100,5,0,5
Victorian,F,100,98,0,98
Jermarcus,M,100,0,354,354
Analyssa,F,100,468,0,468
Kathie,F,100,11547,0,11547
Natala,F,100,7,0,7
Kadetra,F,100,6,0,6
Elison,M,88,5,35,40
Jariell,M,100,0,12,12
Sireena,F,100,17,0,17
Clintonia,F,100,36,0,36
Yamin,M,100,0,136,136
Elvera,F,100,410,0,410
Scherri,F,100,55,0,55
Krys,F,81,47,11,58
Manahil,F,100,248,0,248
Ammarie,F,100,58,0,58
Trenell,M,66,144,281,425
Ingar,F,100,7,0,7
Shanail,F,100,5,0,5
Sylvia,F,100,104690,401,105091
Myara,F,100,21,0,21
Jennaca,F,100,10,0,10
Natavius,M,100,0,32,32
Zatara,F,100,5,0,5
Randalle,F,100,5,0,5
Kylel,M,100,0,10,10
Efstathia,F,100,23,0,23
Marelyn,F,100,582,0,582
Olon,M,100,0,5,5
Kanila,F,100,5,0,5
Jametrice,F,100,5,0,5
Aivry,F,100,5,0,5
Diamonds,F,100,108,0,108
Avakate,F,100,11,0,11
Lisbeth,F,100,4934,0,4934
Suann,F,100,609,0,609
Tommia,F,100,38,0,38
Tytanna,F,100,5,0,5
Nello,M,100,0,164,164
Ekaansh,M,100,0,6,6
Khaila,F,100,390,0,390
Zoree,F,100,5,0,5
Demetress,F,91,122,12,134
Jatyra,F,100,30,0,30
Jennesy,F,100,15,0,15
Amarilis,F,100,653,0,653
Royzell,M,100,0,32,32
Isabeth,F,100,5,0,5
Jaydis,M,90,13,113,126
Cliff,M,100,0,6266,6266
Almena,F,100,10,0,10
Deyshawn,M,100,0,46,46
Givanna,F,100,20,0,20
Keveen,M,100,0,5,5
Shed,M,100,0,5,5
Jenell,F,100,2482,0,2482
Aarilyn,F,100,84,0,84
Secundino,M,100,0,170,170
Adrick,M,100,0,151,151
Labryan,M,100,0,25,25
Andonia,F,100,5,0,5
Adom,M,100,0,140,140
Charice,F,100,733,0,733
Kenedy,F,96,536,20,556
Marquinn,M,100,0,75,75
Negus,M,100,0,11,11
Delores,F,100,32333,67,32400
Robbe,M,79,6,23,29
Taniel,F,100,18,0,18
Sarilyn,F,100,7,0,7
Kessa,F,100,380,0,380
Mykeria,F,100,121,0,121
Kamalu,M,100,0,11,11
Yurith,F,100,6,0,6
Jakkson,M,100,0,5,5
Nijon,M,100,0,10,10
Garlon,M,100,0,62,62
Teasa,F,100,42,0,42
Eleanora,F,100,1281,0,1281
Belisa,F,100,64,0,64
Joyee,F,100,5,0,5
Mayzell,F,100,5,0,5
Randisha,F,100,17,0,17
Alexus,F,99,18232,237,18469
Britanni,F,100,57,0,57
Annysa,F,100,10,0,10
Daniel,M,100,7202,1624716,1631918
Korrin,F,100,518,0,518
Waris,M,100,0,38,38
Shradha,F,100,44,0,44
Idella,F,100,1118,0,1118
Kavy,M,100,0,5,5
Evennie,F,100,5,0,5
Elani,F,100,706,0,706
Sujit,M,100,0,22,22
Lazariah,F,100,119,0,119
Shyvonne,F,100,53,0,53
Kameisha,F,100,303,0,303
Jamacia,F,100,123,0,123
Nino,M,99,11,1820,1831
Hiya,F,100,115,0,115
Tredyn,M,100,0,15,15
Lively,F,100,48,0,48
Aibel,M,100,0,6,6
Gilchrist,M,100,0,18,18
Maddyson,F,100,714,0,714
Margreat,F,100,25,0,25
Antolin,M,100,0,124,124
Chirelle,F,100,5,0,5
Tranee,F,100,11,0,11
Klye,M,100,0,297,297
Birklee,F,100,5,0,5
Navah,F,100,108,0,108
Dayann,F,100,13,0,13
Ketzia,F,100,94,0,94
Kenae,F,100,62,0,62
Cathaline,F,100,5,0,5
Yohaan,M,100,0,37,37
Earlisa,F,100,5,0,5
Joniqua,F,100,89,0,89
Teajah,F,100,11,0,11
Jahmaine,M,100,0,11,11
Darayl,M,100,0,7,7
Jamiela,F,100,28,0,28
Aarron,M,100,0,1204,1204
Tishea,F,100,15,0,15
Azyla,F,100,21,0,21
Carnelia,F,100,40,0,40
Irmalinda,F,100,47,0,47
Evaristo,M,100,0,1284,1284
Yaslynn,F,100,19,0,19
Mmark,M,100,0,10,10
Flossie,F,100,1109,0,1109
Tibor,M,100,0,210,210
Niesha,F,100,2176,0,2176
Azelya,F,100,5,0,5
Leketa,F,100,31,0,31
Lameca,F,100,22,0,22
Ariyahna,F,100,50,0,50
Joeylynn,F,100,6,0,6
Denishia,F,100,223,0,223
Nydaisha,F,100,5,0,5
Decan,M,100,0,6,6
Shaylin,F,99,1689,10,1699
Rush,M,100,0,1230,1230
Shelica,F,100,5,0,5
Aamir,M,100,6,1427,1433
Shawntasia,F,100,13,0,13
Ersula,F,100,24,0,24
Lyiam,M,100,0,10,10
Raheel,M,100,0,214,214
Maston,M,100,0,82,82
Kandice,F,100,6594,0,6594
Inanna,F,100,47,0,47
Tarance,M,100,0,214,214
Brieon,F,100,5,0,5
Quadri,M,100,0,25,25
Vennetta,F,100,10,0,10
Annum,F,100,21,0,21
Dax,M,100,0,5396,5396
Breandan,M,100,0,154,154
Arish,M,100,0,98,98
Josan,M,100,0,10,10
Jencarlo,M,100,0,145,145
Demitrus,M,100,0,134,134
Paraskevi,F,100,220,0,220
Charlet,F,100,427,0,427
Katrielle,F,100,13,0,13
Abiram,M,100,0,12,12
Mahsa,F,100,80,0,80
Dejan,M,96,13,305,318
Eidan,M,100,0,155,155
Marcia,F,100,76978,150,77128
Ladrea,F,100,89,0,89
Thanhphong,M,100,0,5,5
Shainna,F,100,137,0,137
Norward,M,100,0,6,6
Heatherann,F,100,54,0,54
Avaani,F,100,6,0,6
Nell,F,100,2883,6,2889
Nanyamka,F,100,53,0,53
Semhar,F,100,40,0,40
Shaquinta,F,100,149,0,149
Caoilinn,F,100,40,0,40
Aalina,F,100,36,0,36
Yaa,F,100,218,0,218
Tejah,F,100,97,0,97
Nikodem,M,100,0,65,65
Trovon,M,100,0,16,16
Mami,F,100,13,0,13
Maylana,F,100,18,0,18
Emaley,F,100,67,0,67
Yadeliz,F,100,15,0,15
Rosamary,F,100,67,0,67
Armahni,F,64,29,16,45
Amagine,F,100,5,0,5
Valdo,M,100,0,10,10
Keenyah,F,100,17,0,17
Angalena,F,100,75,0,75
Esven,M,100,0,5,5
Ivonna,F,100,135,0,135
Shakeia,F,100,328,0,328
Jimson,M,100,0,12,12
Ashalina,F,100,5,0,5
Adryonna,F,100,5,0,5
Caroleena,F,100,55,0,55
Hussein,M,100,0,2252,2252
Avoree,F,100,9,0,9
Gerilyn,F,100,641,0,641
Stafan,M,100,0,5,5
Allison,F,99,279541,1679,281220
Kyheim,M,100,0,29,29
Shakeelah,F,100,28,0,28
Asyia,F,100,74,0,74
Lavarr,M,100,0,55,55
Deontay,M,100,0,1006,1006
Shamauri,F,63,19,11,30
Hamdi,F,72,254,100,354
Taiton,M,100,0,42,42
Tonjia,F,100,300,0,300
Shayna,F,100,15293,5,15298
Natashya,F,100,6,0,6
Eimi,F,100,94,0,94
Tirone,M,100,0,12,12
Kalid,M,100,0,154,154
Dianna,F,100,44406,48,44454
Duell,M,100,0,49,49
Rucker,M,100,0,52,52
Gregroy,M,100,0,349,349
Ensley,F,98,389,6,395
Avigayil,F,100,402,0,402
Makaela,F,100,2468,0,2468
Marretta,F,100,6,0,6
Sharmen,F,100,35,0,35
Kristela,F,100,7,0,7
Carlesha,F,100,190,0,190
Kalesha,F,100,271,0,271
Treshawn,M,100,5,1348,1353
Taighlor,F,100,5,0,5
Abilio,M,100,0,5,5
Clayre,F,100,30,0,30
Jadis,M,51,126,129,255
Aleni,F,100,118,0,118
Tinslee,F,100,77,0,77
Rajaa,F,100,17,0,17
Aprilmarie,F,100,33,0,33
Jyquan,M,100,0,85,85
Anwaar,F,100,5,0,5
Frimy,F,100,46,0,46
Emerlyn,F,100,8,0,8
Israe,F,100,5,0,5
Aldred,M,100,0,20,20
Aliyas,M,100,0,34,34
Amania,F,100,5,0,5
Chrys,F,90,184,21,205
Bienvenido,M,100,0,400,400
Iroha,F,100,6,0,6
Shahida,F,100,118,0,118
Tanayah,F,100,173,0,173
Mystikal,M,77,5,17,22
Samurai,M,100,0,10,10
Bernistine,F,100,5,0,5
Miara,F,100,163,0,163
Chevy,M,83,460,2301,2761
Nylae,F,100,5,0,5
Jekhari,M,100,0,5,5
Miyana,F,100,429,0,429
Joei,F,100,378,0,378
Sameena,F,100,60,0,60
Esteban,M,100,31,26462,26493
Judah,M,97,405,13395,13800
Quanika,F,100,126,0,126
Markwan,M,100,0,5,5
Biljana,F,100,5,0,5
Alessondra,F,100,6,0,6
Yarisleidi,F,100,6,0,6
Roemello,M,100,0,227,227
Cesilie,F,100,10,0,10
Chaley,F,100,157,0,157
Eryonna,F,100,6,0,6
Soyer,M,100,0,5,5
Zatanna,F,100,10,0,10
Treshun,M,100,0,126,126
Kacee,F,91,2003,194,2197
Sameriah,F,100,6,0,6
Daniellerose,F,100,6,0,6
Uma,F,100,1148,0,1148
Romiah,F,100,11,0,11
Micha,F,54,1086,926,2012
Jazzlynne,F,100,25,0,25
Dagen,M,92,27,292,319
Leorah,F,100,21,0,21
Shaquinda,F,100,6,0,6
Tamura,F,100,193,0,193
Joaopedro,M,100,0,160,160
Aerial,F,100,1809,6,1815
Akailah,F,100,25,0,25
Rishaan,M,100,0,354,354
Kalandria,F,100,12,0,12
Rumalda,F,100,5,0,5
Osualdo,M,100,0,388,388
Aviara,F,100,5,0,5
Alax,M,100,0,18,18
Tayona,F,100,144,0,144
Dashauna,F,100,181,0,181
Rikka,F,100,54,0,54
Zoii,F,100,68,0,68
Alphonce,M,100,0,5,5
Vickilee,F,100,5,0,5
Shamina,F,100,139,0,139
Thristen,M,100,0,6,6
Kastle,M,100,0,29,29
Okairy,F,100,5,0,5
Antoni,M,100,5,1716,1721
Dazlynn,F,100,6,0,6
Onis,M,100,0,16,16
Deah,F,100,191,0,191
Collete,F,100,10,0,10
Nazik,F,100,5,0,5
Jazarah,F,100,113,0,113
Erich,M,100,32,10386,10418
Tehesha,F,100,5,0,5
Raciel,M,100,0,71,71
Adanely,F,100,88,0,88
Sujatha,F,100,5,0,5
Jhovani,M,100,0,127,127
Saakshi,F,100,10,0,10
Berle,M,100,0,47,47
Erlinda,F,100,2441,0,2441
Karinah,F,100,22,0,22
Charito,F,100,43,0,43
Milah,F,100,802,0,802
Savvy,F,100,91,0,91
Darean,M,68,26,56,82
Cachet,F,100,285,0,285
Branston,M,100,0,60,60
Aretha,F,100,4342,0,4342
Shonia,F,100,144,0,144
Byata,F,100,8,0,8
Serrina,F,100,233,0,233
Jaryd,M,100,0,749,749
Warsame,M,100,0,29,29
Neethu,F,100,12,0,12
Shaon,M,100,0,12,12
Believe,F,100,5,0,5
Lynise,F,100,103,0,103
Lank,M,100,0,5,5
Jsoeph,M,100,0,71,71
Xee,F,100,118,0,118
Ryanjames,M,100,0,54,54
Jennarae,F,100,27,0,27
Kuzey,M,100,0,43,43
Radame,M,100,0,5,5
Lowrie,M,100,0,5,5
Rifa,F,100,10,0,10
Hazleigh,F,100,11,0,11
Obediah,M,100,0,94,94
Anterious,M,100,0,7,7
Aleigha,F,100,3565,0,3565
Dayleigh,F,100,8,0,8
Quisto,M,100,0,9,9
Aveah,F,100,192,0,192
Akeila,F,100,176,0,176
Travette,F,100,11,0,11
Ardian,M,100,0,115,115
Vyshonn,M,100,0,8,8
Janeann,F,100,93,0,93
Kindred,M,57,73,95,168
Chevas,M,100,0,23,23
Westly,M,100,0,640,640
Aveen,F,100,40,0,40
Gleneva,F,100,5,0,5
Madailein,F,100,155,0,155
Vytas,M,100,0,15,15
Elye,M,100,0,148,148
Evi,F,100,229,0,229
Syreeta,F,100,1960,0,1960
Jt,M,100,0,390,390
Rashene,M,100,0,5,5
Adianez,F,100,58,0,58
Sailee,F,100,29,0,29
Isbel,F,100,11,0,11
Lacinda,F,100,877,0,877
Ariel,F,79,60787,15871,76658
Auren,M,56,40,50,90
Ishwari,F,100,7,0,7
Nyaire,M,63,54,91,145
Jerrica,F,100,4359,0,4359
Cray,M,100,0,111,111
Shaylynne,F,100,67,0,67
Marlesha,F,100,46,0,46
Laterrance,M,100,0,196,196
Rivaan,M,100,0,44,44
Oniyah,F,100,49,0,49
Leniel,M,100,0,25,25
Kule,M,100,0,95,95
Sewit,F,100,5,0,5
Clarance,M,100,0,822,822
Jaidn,M,100,0,5,5
Elitania,F,100,10,0,10
Teneshia,F,100,558,0,558
Shariff,M,100,0,565,565
Nikhaule,F,100,5,0,5
Kiomara,F,100,43,0,43
Kacelyn,F,100,89,0,89
Kenli,F,100,412,0,412
Keyonn,M,100,0,29,29
Surayyah,F,100,15,0,15
Rayyan,M,93,100,1424,1524
Brenndon,M,100,0,26,26
Killion,M,100,0,6,6
Jemerrio,M,100,0,5,5
Elissar,F,100,5,0,5
Cosme,M,100,0,917,917
Cherin,F,100,11,0,11
Tab,M,100,0,1107,1107
Perrish,M,100,0,6,6
Sya,F,100,68,0,68
Advay,M,100,0,268,268
Moksh,M,100,0,150,150
Jailei,F,100,5,0,5
Azyiah,F,100,91,0,91
Cornelle,M,100,0,16,16
Anariah,F,100,40,0,40
Shameko,F,100,6,0,6
Ronde,M,100,0,14,14
Jaxsyn,M,86,52,331,383
Lorrinda,F,100,105,0,105
Hicham,M,100,0,14,14
Sabastain,M,100,0,50,50
Roqaya,F,100,5,0,5
Kahleb,M,100,0,120,120
Donnielle,F,100,96,0,96
Serenaty,F,100,12,0,12
Grayden,M,100,0,1357,1357
Rayshard,M,100,0,132,132
Jenyiah,F,100,5,0,5
Mekhi,M,99,112,8802,8914
Deea,F,100,6,0,6
Taydan,M,100,0,16,16
Gopal,M,100,0,80,80
Sohni,F,100,15,0,15
Laureano,M,100,0,121,121
Xaira,F,100,6,0,6
Debor,F,100,5,0,5
Annslie,F,100,5,0,5
Juliona,F,100,59,0,59
Ahmere,M,100,0,131,131
Robi,F,76,356,110,466
Jazzia,F,100,5,0,5
Ceretha,F,100,35,0,35
Chimere,F,99,817,5,822
Bellaluna,F,100,10,0,10
Denzelle,M,100,0,50,50
Hang,F,100,382,0,382
Travone,M,100,0,247,247
Alexcia,F,100,1477,0,1477
Geonna,F,100,167,0,167
Licet,F,100,75,0,75
Margerite,F,100,6,0,6
Korban,M,100,0,335,335
Daevyn,M,100,0,6,6
Graelyn,F,100,52,0,52
Brence,M,100,0,5,5
Kastyn,M,100,0,5,5
Isias,M,100,0,15,15
Deshun,M,97,40,1130,1170
Marieli,F,100,221,0,221
Shrikar,M,100,0,14,14
Asuna,F,100,5,0,5
Torilyn,F,100,30,0,30
Rayshawn,M,95,179,3505,3684
Holdyn,M,97,10,322,332
Gniya,F,100,12,0,12
Antinio,M,100,0,82,82
Shubh,M,100,0,232,232
Siarrah,F,100,40,0,40
Emanuel,M,100,82,35556,35638
Ernestene,F,100,5,0,5
Mahika,F,100,325,0,325
Jamee,F,92,2658,218,2876
Taylon,M,85,150,829,979
Syr,M,100,0,5,5
Yvonne,F,100,97122,389,97511
Havanah,F,100,60,0,60
Jaseem,M,100,0,5,5
Lamonta,M,100,0,226,226
Quartney,F,100,24,0,24
Nanita,F,100,53,0,53
Rodina,F,100,77,0,77
Eliu,M,100,0,439,439
Alyus,M,100,0,32,32
Neyland,M,100,0,164,164
Chasitee,F,100,58,0,58
Dozie,M,100,0,5,5
Wilniya,F,100,5,0,5
Cherle,F,100,5,0,5
Kileah,F,100,35,0,35
Montreal,M,100,0,1015,1015
Madysun,F,100,87,0,87
Shamil,M,71,15,37,52
Jeramiah,M,100,0,4209,4209
Aidrik,M,100,0,20,20
Livier,F,100,272,0,272
Naikia,F,100,6,0,6
Irita,F,100,5,0,5
Allahna,F,100,103,0,103
Jermanie,M,92,10,113,123
Kwanda,F,100,29,0,29
Keley,F,100,22,0,22
Shaiann,F,100,331,0,331
Tarya,F,100,37,0,37
Inayah,F,100,424,0,424
Belita,F,100,267,0,267
Keevon,M,100,0,251,251
Mylina,F,100,20,0,20
Prakhar,M,100,0,11,11
Danyaal,M,100,0,17,17
Brekka,F,100,5,0,5
Shahriar,M,100,0,21,21
Lavel,M,100,0,200,200
Kaan,M,100,0,540,540
Mersadiez,F,100,5,0,5
Kedarious,M,100,0,6,6
Ametria,F,100,16,0,16
Tu,M,74,109,318,427
Marcelino,M,100,0,4919,4919
Pattsy,F,100,6,0,6
Jaicion,M,100,0,34,34
Shasmeen,F,100,19,0,19
Ellison,F,69,2685,1186,3871
Barlow,M,100,0,38,38
Jaylarose,F,100,7,0,7
Marcoa,M,100,0,5,5
Zyniyah,F,100,45,0,45
Aadrit,M,100,0,5,5
Jaymichael,M,100,0,6,6
Noelya,F,100,14,0,14
Adith,M,100,0,82,82
Clairabelle,F,100,9,0,9
Zhanasia,F,100,5,0,5
Daschel,M,100,0,74,74
Lacoya,F,100,155,0,155
Yairis,F,100,34,0,34
Brooklyne,F,100,641,0,641
Phoenix,M,61,6457,10050,16507
Filberto,M,100,0,29,29
Monigue,F,100,474,0,474
Riata,F,100,64,0,64
Juanna,F,100,133,0,133
Shalyssa,F,100,5,0,5
Yoav,M,100,0,309,309
Anthonette,F,100,228,0,228
Annely,F,100,41,0,41
Zamyiah,F,100,65,0,65
Darrow,M,100,0,497,497
Saleana,F,100,16,0,16
Katlyn,F,100,18188,5,18193
Tharron,M,100,0,6,6
Tayvion,M,100,0,919,919
Kawaiola,M,100,0,5,5
Chatina,F,100,5,0,5
Blessy,F,100,10,0,10
Kumba,F,100,23,0,23
Kimera,F,100,28,0,28
Shakiel,M,100,0,44,44
Richards,M,100,0,35,35
Catalina,F,100,12635,7,12642
Sinit,F,100,8,0,8
Wynonna,F,100,141,0,141
Colby,M,93,3644,48264,51908
Cassaundra,F,100,2370,0,2370
Jalaia,F,100,42,0,42
Tomasi,M,100,0,20,20
Jazeera,F,100,5,0,5
Dorane,F,100,5,0,5
Quanzell,M,100,0,5,5
Melaine,F,100,2284,0,2284
Sarrinah,F,100,54,0,54
Avangelina,F,100,76,0,76
Maxime,M,94,50,760,810
Lucan,M,100,0,324,324
Zaakira,F,100,13,0,13
Karieliz,F,100,5,0,5
Yuko,F,100,151,0,151
Vedh,M,100,0,66,66
Taneesh,M,100,0,5,5
Ahnylah,F,100,11,0,11
Berish,M,100,0,144,144
Akenzie,F,100,6,0,6
Geoffrey,M,100,140,49266,49406
Belina,F,100,87,0,87
Yizelle,F,100,5,0,5
Jiwoo,F,70,38,16,54
Kaia,F,100,7591,25,7616
Erez,M,100,0,157,157
Berklie,F,100,99,0,99
Michaeal,M,100,0,135,135
Jenniferann,F,100,110,0,110
Shabaka,M,100,0,28,28
Latoyna,F,100,181,0,181
Zanae,F,100,206,0,206
Celest,F,100,949,0,949
Tekira,F,100,57,0,57
Tarryl,M,100,0,10,10
Elvita,F,100,26,0,26
Tyeesha,F,100,230,0,230
Kambryn,F,100,92,0,92
Vadra,F,100,16,0,16
Gentiana,F,100,17,0,17
Ninah,F,100,179,0,179
Joeph,M,100,0,115,115
Mckinsey,F,98,944,22,966
Arbie,M,91,10,102,112
Arcadius,M,100,0,5,5
Sadiki,M,100,0,36,36
Aericka,F,100,5,0,5
Jermaine,M,98,911,39777,40688
Keyonis,M,100,0,7,7
Myleigha,F,100,18,0,18
Latu,M,100,0,5,5
Allishia,F,100,20,0,20
Yasha,F,82,198,42,240
Kennlee,F,100,12,0,12
Angelrose,F,100,16,0,16
Kevaun,M,100,0,51,51
Damorian,M,100,0,27,27
Jalicia,F,100,632,0,632
Adlai,M,89,50,404,454
Zavery,M,89,5,39,44
Mohamedamiin,M,100,0,5,5
Ollivander,M,100,0,6,6
Maliayah,F,100,10,0,10
Meghanne,F,100,98,0,98
Madian,F,100,7,0,7
Azaree,F,100,16,0,16
Cardale,M,100,0,110,110
Shaunique,F,100,10,0,10
Kriste,F,100,621,0,621
Seante,F,100,18,0,18
Makaylla,F,100,57,0,57
Samyak,M,100,0,82,82
Isaya,M,100,0,47,47
Tatumn,F,98,285,5,290
Lakyah,F,100,56,0,56
Aonesty,F,100,28,0,28
Britinee,F,100,13,0,13
Ozil,M,100,0,58,58
Deboria,F,100,52,0,52
Meagyn,F,100,5,0,5
Judiel,M,100,0,6,6
Steward,M,100,0,555,555
Demarre,M,100,0,22,22
Townsend,M,100,0,387,387
Ardita,F,100,29,0,29
Sonjay,M,100,0,5,5
Nolene,F,100,10,0,10
Skylynn,F,100,1603,0,1603
Keyondra,F,100,373,0,373
Ketara,F,100,74,0,74
Kyiara,F,100,22,0,22
Carree,F,100,6,0,6
Kim,F,85,177759,31719,209478
Aundrea,F,96,4472,181,4653
Ragav,M,100,0,5,5
Yonic,M,100,0,53,53
Furaha,F,100,5,0,5
Shatoyia,F,100,13,0,13
Arah,F,100,252,0,252
Keavin,M,100,0,41,41
Eriyon,M,52,10,11,21
Rhenda,F,100,150,0,150
Leilend,M,100,0,5,5
Kyosha,F,100,10,0,10
Machi,M,100,0,244,244
Danazha,F,100,5,0,5
Khrishna,F,100,5,0,5
Cydny,F,100,5,0,5
Madgeline,F,100,12,0,12
Ranaye,F,100,11,0,11
Diamone,F,100,96,0,96
Khloii,F,100,5,0,5
Leota,F,100,699,0,699
Cruzita,F,100,166,0,166
Minaal,F,100,57,0,57
Fernan,M,100,0,7,7
Spoorthi,F,100,25,0,25
Carlens,M,100,0,5,5
Alexandro,M,100,0,6112,6112
Euna,F,100,144,0,144
Kingcharles,M,100,0,6,6
Dalerie,F,100,10,0,10
Ahnalise,F,100,6,0,6
Laneesha,F,100,41,0,41
Kordel,M,100,0,111,111
Lateefa,F,100,115,0,115
Oshai,M,64,10,18,28
Kerra,F,100,1123,0,1123
Heath,M,99,181,26609,26790
Aramie,F,100,5,0,5
Madlen,F,100,8,0,8
Jaymz,M,100,0,321,321
Shira,F,100,4971,0,4971
Millee,F,100,68,0,68
Heavenleigh,F,100,341,0,341
Kebin,M,100,0,84,84
Deker,M,100,0,6,6
Yanari,F,100,11,0,11
Jaira,F,100,460,0,460
Carra,F,100,862,0,862
Tresha,F,100,624,0,624
Titanna,F,100,43,0,43
Melisha,F,100,912,0,912
Shuchi,F,100,5,0,5
Aruna,F,100,134,0,134
Malena,F,100,3159,0,3159
Breawna,F,100,198,0,198
Brilliant,M,100,0,12,12
Piere,M,100,0,40,40
Genessa,F,100,392,0,392
Alireza,M,100,0,211,211
Darleena,F,100,5,0,5
Braulio,M,100,0,4021,4021
Kyralynn,F,100,5,0,5
Xochilt,F,100,1356,0,1356
Kathlyne,F,100,38,0,38
Teniyah,F,100,173,0,173
Aubreigh,F,100,734,0,734
Hay,M,100,0,7,7
Loletha,F,100,234,0,234
Saelah,F,100,10,0,10
Faithful,F,100,21,0,21
Adya,F,100,209,0,209
Haydin,M,62,236,377,613
Babara,F,100,242,0,242
Cataleya,F,100,2037,0,2037
Yesly,F,100,148,0,148
Ryley,M,56,2608,3331,5939
Zabdi,F,81,117,28,145
Annisa,F,100,632,0,632
Enoe,M,100,0,5,5
Shalynne,F,100,35,0,35
Diallo,M,99,5,727,732
Daijia,F,100,40,0,40
Raif,M,100,0,222,222
Veonka,F,100,6,0,6
Kizuwanda,F,100,5,0,5
July,F,83,629,133,762
Welmer,M,100,0,5,5
Meritxell,F,100,22,0,22
Srinika,F,100,145,0,145
Danaysia,F,100,165,0,165
Eulala,F,100,5,0,5
Anga,F,100,15,0,15
Leighla,F,100,458,0,458
Yaqub,M,100,0,225,225
Raewyn,F,100,16,0,16
Meridian,F,100,263,0,263
Lipa,M,100,0,690,690
Keaura,F,100,15,0,15
Sadiyya,F,100,5,0,5
Lacrisha,F,100,408,0,408
Simrit,F,100,44,0,44
Beyounce,F,100,61,0,61
Baelyn,F,87,74,11,85
Marisleysis,F,100,44,0,44
Shyenne,F,100,576,0,576
Rovin,M,100,0,6,6
Delvon,M,100,0,1054,1054
Deilany,F,100,16,0,16
Shyda,F,100,5,0,5
Yahsir,M,100,0,79,79
Jenessy,F,100,48,0,48
Jeanise,F,100,84,0,84
Ayoki,F,100,5,0,5
Alvon,M,100,0,100,100
Nesma,F,100,10,0,10
Melquisedec,M,100,0,88,88
Jabir,M,100,0,232,232
Liammichael,M,100,0,7,7
Lakista,F,100,5,0,5
Anyja,F,100,18,0,18
Yizza,F,100,5,0,5
Najla,F,100,539,0,539
Amree,F,100,48,0,48
Keambria,F,100,27,0,27
Marquay,M,100,0,195,195
Debar,F,100,130,0,130
Delijah,F,59,42,29,71
Yanielis,F,100,21,0,21
Dermott,M,100,0,20,20
Keymaya,F,100,10,0,10
Karysma,F,100,17,0,17
Malichi,M,100,0,395,395
Jericah,F,100,31,0,31
Vallie,F,98,485,10,495
Adyan,M,100,0,265,265
Vernelle,F,100,218,0,218
Natalii,F,100,5,0,5
Cayo,M,100,0,10,10
Clowey,F,100,19,0,19
Damaire,M,100,0,5,5
Katrine,F,100,764,0,764
Janear,F,100,20,0,20
Davidlee,M,100,0,163,163
Kamilyah,F,100,6,0,6
Oronde,M,100,0,292,292
Rachelann,F,100,146,0,146
Zoi,F,100,593,0,593
Alyza,F,100,1083,0,1083
Maahika,F,100,5,0,5
Kailaya,F,100,17,0,17
Japheth,M,100,0,987,987
Aseel,F,90,517,57,574
Saavan,M,100,0,22,22
Brithanny,F,100,7,0,7
Shealyn,F,100,1189,0,1189
Jashad,M,100,0,72,72
Danapaola,F,100,23,0,23
Trashun,M,100,0,11,11
Shia,M,60,641,954,1595
Yousra,F,100,150,0,150
Derrice,M,100,0,5,5
Jadelynn,F,100,885,0,885
Rodie,M,100,0,10,10
Tasheanna,F,100,25,0,25
Rodgerick,M,100,0,110,110
Minji,F,100,45,0,45
Berklee,F,100,374,0,374
Malcolmjamal,M,100,0,10,10
Anaily,F,100,66,0,66
Kenterious,M,100,0,5,5
Cilicia,F,100,149,0,149
Nadelie,F,100,10,0,10
Kaysi,F,100,485,0,485
Dorleen,F,100,63,0,63
Sarahbella,F,100,5,0,5
Sarayu,F,100,359,0,359
Camaron,M,93,52,671,723
Matthiew,M,100,0,45,45
Camee,F,100,13,0,13
Azyah,F,100,104,0,104
Caed,M,100,0,11,11
Matthewjames,M,100,0,73,73
Treyvonte,M,100,0,7,7
Torryn,F,77,76,23,99
Lariah,F,100,794,0,794
Lovelle,M,70,32,75,107
Mikaylia,F,100,20,0,20
Dearria,F,100,6,0,6
Patryk,M,100,0,925,925
Kushagra,M,100,0,24,24
Garion,M,100,0,433,433
Krissia,F,100,80,0,80
Kyntrell,M,100,0,5,5
Tpring,F,100,6,0,6
Shakeva,F,100,47,0,47
Mekka,F,100,42,0,42
Reko,M,100,0,31,31
Briam,M,100,0,32,32
Lutalo,M,100,0,10,10
Malachi,M,99,200,37353,37553
Adhvik,M,100,0,81,81
Maleya,F,100,342,0,342
Mathis,M,100,0,945,945
Salem,M,51,1342,1410,2752
Kysir,M,100,0,31,31
Sabastin,M,100,0,6,6
Mahaliah,F,100,5,0,5
Brete,M,100,0,7,7
Clemma,F,100,5,0,5
Tanyra,F,100,21,0,21
Krishika,F,100,21,0,21
Debhra,F,100,20,0,20
Juwairiyah,F,100,5,0,5
Shacourtney,F,100,5,0,5
Genelia,F,100,5,0,5
Kaloni,F,95,246,12,258
Hajj,M,100,0,6,6
Breonda,F,100,37,0,37
Shean,M,99,6,414,420
Zaveah,F,100,10,0,10
Ralpheal,M,100,0,235,235
Tyjon,M,100,0,268,268
Lucyanna,F,100,26,0,26
Lydia,F,100,104090,169,104259
Daveonna,F,100,5,0,5
Alexand,M,100,0,5,5
Ladonte,M,100,0,170,170
Kaiulani,F,100,316,0,316
Hunny,F,100,7,0,7
Carvel,M,100,0,167,167
Tanaya,F,100,1955,0,1955
Jiovana,F,100,10,0,10
Mazyah,F,100,5,0,5
Amiyah,F,100,8474,0,8474
Raylenn,F,100,5,0,5
Sarajean,F,100,71,0,71
Maulin,M,100,0,5,5
Berea,F,100,57,0,57
Naria,F,100,227,0,227
Chinua,M,100,0,10,10
Jaysin,M,100,0,194,194
Jeriesha,F,100,34,0,34
Alexious,F,100,41,0,41
Rontae,M,100,0,71,71
Jaimelyn,F,100,38,0,38
Temon,M,100,0,5,5
Naquon,M,100,0,17,17
Macalister,M,100,0,69,69
Rosaangelica,F,100,10,0,10
Amanii,F,100,78,0,78
Shenya,F,100,5,0,5
Esaul,M,100,0,138,138
Samauri,F,56,58,45,103
Jevonta,M,100,0,24,24
Vibol,M,100,0,5,5
Miera,F,100,10,0,10
Kaytlynne,F,100,64,0,64
Noy,F,100,17,0,17
Atina,F,100,201,0,201
Alyisa,F,100,26,0,26
Devonda,F,100,231,0,231
Merilee,F,100,864,0,864
Dandra,F,91,605,60,665
Natalyia,F,100,123,0,123
Camacho,M,100,0,5,5
Rissa,F,100,269,0,269
Itali,F,100,91,0,91
Praneel,M,100,0,163,163
Shashona,F,100,25,0,25
Handsome,M,100,0,56,56
Danyetta,F,100,104,0,104
Detrich,M,91,11,112,123
Princetin,M,100,0,13,13
Undre,M,100,0,15,15
Shayde,M,58,55,76,131
Malieya,F,100,5,0,5
Keyaria,F,100,62,0,62
Urmila,F,100,5,0,5
Emmersyn,F,100,418,0,418
Abbagayle,F,100,112,0,112
Samaiya,F,100,373,0,373
Jamorie,M,100,0,41,41
Rozay,F,59,16,11,27
Lorae,F,100,67,0,67
Jhalin,M,100,0,10,10
Oluwatoyosi,F,100,5,0,5
Orvill,M,100,0,5,5
Shimeek,M,100,0,5,5
Pryce,M,96,29,713,742
Yukiko,F,100,153,0,153
Suzzane,F,100,133,0,133
Jakeb,M,100,0,1143,1143
Vanise,F,100,6,0,6
Brendaa,F,100,5,0,5
Chontel,F,100,62,0,62
Kerriann,F,100,713,0,713
Kammy,F,100,655,0,655
Lamariyah,F,100,11,0,11
Nouchee,F,100,16,0,16
Waynette,F,100,458,0,458
Dyllan,M,89,384,2993,3377
Donrico,M,100,0,10,10
Cystal,F,100,155,0,155
Emberleigh,F,100,82,0,82
Raiya,F,100,218,0,218
Calian,M,100,0,15,15
Khari,M,82,484,2164,2648
Renier,M,100,0,21,21
Evelet,F,100,9,0,9
Miklo,M,100,0,208,208
Brookleigh,F,100,23,0,23
Jullianna,F,100,143,0,143
Latara,F,100,1394,0,1394
Lixy,F,100,6,0,6
Keshawna,F,100,459,0,459
Wanderlei,M,100,0,5,5
Kamerion,M,100,0,49,49
Maisie,F,100,3014,0,3014
Raavi,F,100,7,0,7
Airial,F,100,20,0,20
Chassidi,F,100,5,0,5
Raeanah,F,100,5,0,5
Khylar,M,100,0,5,5
Fynnley,F,100,11,0,11
Llia,F,100,6,0,6
Gwinda,F,100,41,0,41
Danielys,F,100,30,0,30
Sharin,F,100,315,0,315
Sophiemarie,F,100,5,0,5
Jalishia,F,100,20,0,20
Maisha,F,100,1708,0,1708
Ricardo,M,99,697,128599,129296
Mcclinton,M,100,0,5,5
Eddica,F,100,5,0,5
Oney,M,100,0,13,13
Destinyrose,F,100,14,0,14
Baleria,F,100,410,0,410
Miona,F,100,10,0,10
Rebecka,F,100,3229,0,3229
Lismarie,F,100,23,0,23
Tarcia,F,100,5,0,5
Robret,M,100,0,10,10
Jairo,M,100,0,8847,8847
Chontelle,F,100,5,0,5
Dyemond,F,100,50,0,50
Jeel,F,50,5,5,10
Torah,F,100,140,0,140
Shoumik,M,100,0,6,6
Dallton,M,100,0,5,5
Natajha,F,100,29,0,29
Joshula,M,100,0,5,5
Debraa,F,100,6,0,6
Fredys,M,100,0,26,26
Garrey,M,100,0,6,6
Ziion,M,100,0,18,18
Jajaira,F,100,205,0,205
Emoni,F,95,1846,97,1943
Patrea,F,100,10,0,10
Freja,F,100,175,0,175
Keeshon,M,100,0,26,26
Alexisa,F,100,10,0,10
Rikhia,F,100,5,0,5
Yaciel,M,100,0,10,10
Abdrahman,M,100,0,15,15
Monika,F,100,9407,0,9407
Dariun,M,100,0,17,17
Jastin,M,93,14,200,214
Johnalyn,F,100,5,0,5
Tairra,F,100,46,0,46
Jarmarion,M,100,0,9,9
Brooklyn,F,99,79995,1158,81153
Chasitity,F,100,29,0,29
Trinten,M,100,0,98,98
Leksi,F,100,32,0,32
Jonah,M,99,495,53339,53834
Lyjah,M,100,0,5,5
Reanne,F,100,636,0,636
Saryan,M,100,0,5,5
Daymen,M,100,0,57,57
Kalee,F,98,3669,68,3737
Andrewjames,M,100,0,129,129
Genina,F,100,13,0,13
Addalynne,F,100,39,0,39
Kristlyn,F,100,55,0,55
Urooj,F,100,31,0,31
Ellianah,F,100,112,0,112
Aubrynn,F,100,95,0,95
Carlita,F,100,1155,0,1155
Deitrick,M,100,0,123,123
Amara,F,98,9003,164,9167
Kenderrick,M,100,0,49,49
Jams,M,100,0,145,145
Vada,F,94,2508,162,2670
Marcuse,M,100,0,5,5
Keen,M,100,0,100,100
Nyazia,F,100,70,0,70
Sherry,F,100,192370,646,193016
Tazmin,F,78,18,5,23
Donavyn,M,100,0,475,475
Mayra,F,99,31627,345,31972
Dameian,M,100,0,163,163
Demilade,M,68,13,27,40
Amulya,F,100,274,0,274
Idette,F,100,6,0,6
Matheu,M,100,0,208,208
Asti,F,100,67,0,67
Marton,M,100,0,68,68
Shiketa,F,100,5,0,5
Spero,M,100,0,127,127
Wilberto,M,100,0,511,511
Kosisochukwu,F,56,59,46,105
Roselinda,F,100,165,0,165
Arcola,F,100,11,0,11
Jaziyah,F,98,587,10,597
Brayam,M,100,0,264,264
Abubakar,M,100,0,438,438
Azzan,M,100,0,64,64
Jakeria,F,100,649,0,649
Kamsiyochi,F,100,5,0,5
Dontate,M,100,0,17,17
Mylz,M,100,0,59,59
Lanitra,F,100,196,0,196
Tywayne,M,100,0,28,28
Ilai,M,100,0,63,63
Victoriana,F,100,211,0,211
Safoora,F,100,6,0,6
Vadhir,M,100,0,166,166
Hantz,M,100,0,5,5
Hillman,M,100,0,51,51
Ryli,F,100,501,0,501
Hakob,M,100,0,20,20
Keragan,F,100,18,0,18
Jareal,M,100,0,15,15
Makinly,F,100,40,0,40
Lynthia,F,100,12,0,12
Tredell,M,100,0,12,12
Trendyn,M,100,0,20,20
Cotrina,F,100,46,0,46
Hines,M,100,0,39,39
Jaea,F,100,11,0,11
Login,M,92,11,126,137
Samiria,F,100,45,0,45
Cirenia,F,100,6,0,6
Eujin,F,100,10,0,10
Deerick,M,100,0,16,16
Dajane,F,100,67,0,67
Sujata,F,100,123,0,123
Shawntae,F,98,854,15,869
Theadora,F,100,433,0,433
Hayleen,F,100,56,0,56
Lukman,M,100,0,12,12
Koneta,F,100,16,0,16
Moe,M,58,56,78,134
Dayanera,F,100,20,0,20
Denasha,F,100,40,0,40
Stan,M,100,0,5947,5947
Zinda,F,100,31,0,31
Sheralyn,F,100,464,0,464
Mahaela,F,100,6,0,6
Kuwan,M,100,0,5,5
Marichuy,F,100,5,0,5
Zacharian,M,100,0,49,49
Saish,M,100,0,20,20
Yoshua,M,100,0,344,344
Junice,F,100,11,0,11
Marea,F,100,469,0,469
Shari,F,100,38453,46,38499
Tianee,F,100,6,0,6
Zacory,M,100,0,66,66
Kaiyden,M,94,5,72,77
Xaia,F,100,6,0,6
Yaschia,F,100,5,0,5
Shanoah,F,100,103,0,103
Florina,F,100,178,0,178
Deeqa,F,100,5,0,5
Navreet,F,100,45,0,45
Akiem,M,100,0,62,62
Hurley,M,95,44,829,873
Aiham,M,100,0,5,5
Konny,F,100,5,0,5
Gracean,F,100,5,0,5
Tupou,F,71,12,5,17
Pessel,F,100,25,0,25
Miykael,M,100,0,25,25
Valerieanne,F,100,5,0,5
Anshu,F,91,107,10,117
Tranda,F,100,5,0,5
Camaryn,F,100,141,0,141
Jaquasia,F,100,116,0,116
Edda,F,100,266,0,266
Khole,F,84,361,69,430
Anusha,F,100,1007,0,1007
Shereta,F,100,64,0,64
Rahquan,M,100,0,11,11
Shamain,F,100,5,0,5
Javionna,F,100,58,0,58
Marcus,M,99,1281,210323,211604
Harden,M,100,0,103,103
Allesandra,F,100,161,0,161
Kerston,F,100,68,0,68
Andrena,F,100,656,0,656
Yoli,F,100,21,0,21
Alexandra,F,100,220497,859,221356
Chyeanne,F,100,15,0,15
Jovaughn,M,100,0,348,348
Kashari,F,100,61,0,61
Mcgarrett,M,100,0,22,22
Venancio,M,100,0,396,396
Si,M,88,19,141,160
Torrian,M,98,11,449,460
Johnthon,M,100,0,5,5
Zorien,M,100,0,5,5
Korben,M,100,0,1349,1349
Goddess,F,100,219,0,219
Zacherie,M,100,0,77,77
Tanyiah,F,100,120,0,120
Edmon,M,100,0,353,353
Trindon,M,100,0,91,91
Braylei,F,100,54,0,54
Merick,M,100,0,130,130
Trayvion,M,100,0,387,387
Brenard,M,100,0,5,5
Sutter,M,97,6,174,180
Miamor,F,100,164,0,164
Chryssa,F,100,21,0,21
Asul,F,100,5,0,5
Salle,F,100,38,0,38
Kaelei,F,100,101,0,101
Whitny,F,100,28,0,28
Caylin,F,96,2197,87,2284
Jrake,M,100,0,62,62
Angeliya,F,100,5,0,5
Krister,M,69,16,36,52
Gavan,M,100,0,930,930
Jaxston,M,100,0,228,228
Sakena,F,100,47,0,47
Athyna,F,100,23,0,23
Kortney,F,92,5220,436,5656
Tiaura,F,100,9,0,9
Maticia,F,100,5,0,5
Stanford,M,100,0,3765,3765
Fermin,M,100,0,3492,3492
Lolene,F,100,6,0,6
Kimely,F,100,11,0,11
Ahzhane,F,100,5,0,5
Nycolas,M,100,0,10,10
Shaundel,F,100,5,0,5
Salema,F,100,38,0,38
Shamara,F,100,1604,0,1604
Yamaya,F,100,8,0,8
Dalles,M,100,0,26,26
Kendal,F,66,8155,4112,12267
Kashala,F,100,27,0,27
Emmelene,F,100,5,0,5
Micai,M,100,0,84,84
Bracy,M,90,5,47,52
Bravon,M,100,0,5,5
Breella,F,100,51,0,51
Kipton,M,100,0,624,624
Arkell,M,100,0,31,31
Tenequa,F,100,34,0,34
Emali,F,100,98,0,98
Ryerson,M,100,0,23,23
Shalev,M,100,0,58,58
Deserea,F,100,216,0,216
Malikah,F,92,868,76,944
Vikramjit,M,100,0,5,5
Lachyna,F,100,14,0,14
Leiny,F,100,35,0,35
Adetola,M,100,0,5,5
Hopper,M,100,0,13,13
Keyden,M,100,0,171,171
Itzel,F,99,14027,101,14128
Damien,M,99,260,51376,51636
Jaydn,M,62,370,594,964
Jaydeliz,F,100,12,0,12
Kristian,M,73,6560,17718,24278
Zandrea,F,100,202,0,202
Tayley,F,100,50,0,50
Dominie,M,96,6,137,143
Jamarious,M,100,0,708,708
Michalene,F,100,328,0,328
Dannion,M,100,0,18,18
Tayber,M,100,0,10,10
Arushi,F,100,543,0,543
Tennesia,F,100,5,0,5
Kyndyl,F,100,5,0,5
Rosaida,F,100,17,0,17
Azaliyah,F,100,50,0,50
Yamen,M,100,0,82,82
Sahaira,F,100,12,0,12
Tyrence,M,100,0,23,23
Ele,F,100,5,0,5
Jenitha,F,100,5,0,5
Andelynn,F,100,8,0,8
Geovani,M,100,0,1188,1188
Eliset,F,100,18,0,18
Terriell,M,100,0,5,5
Mechella,F,100,5,0,5
Roxsana,F,100,55,0,55
Domnique,F,66,138,71,209
Kalvin,M,100,0,5159,5159
Cheniece,F,100,9,0,9
Anahlia,F,100,29,0,29
Lytonya,F,100,7,0,7
Nazim,M,100,0,172,172
Deeann,F,100,2590,0,2590
Daksh,M,100,0,307,307
Angilee,F,100,39,0,39
Elloise,F,100,89,0,89
Kadiesha,F,100,24,0,24
Anett,F,100,144,0,144
Keniah,F,100,187,0,187
Dezstany,F,100,7,0,7
Malesa,F,100,32,0,32
Kahlie,F,100,121,0,121
Ijeoma,F,100,467,0,467
Gwendlyon,F,100,42,0,42
Khepri,F,100,5,0,5
Connell,M,100,0,1141,1141
Lynel,F,81,65,15,80
Jahwan,M,100,0,5,5
Yida,M,100,0,136,136
Keylor,M,100,0,34,34
Cormari,M,100,0,7,7
Quenia,F,100,21,0,21
Kristne,F,100,11,0,11
Bretten,M,100,0,21,21
Jaylisse,F,100,5,0,5
Ahnalee,F,100,12,0,12
Kynan,M,100,0,350,350
Eathin,M,100,0,23,23
Amelya,F,100,420,0,420
Jeralee,F,100,23,0,23
Maevyn,F,100,15,0,15
Aerius,M,100,0,7,7
Shua,F,100,11,0,11
Shriyan,M,100,0,119,119
Glynis,F,99,1938,10,1948
Nawaal,F,100,59,0,59
Nilyne,F,100,9,0,9
Tiron,M,100,0,175,175
Lashay,F,100,2708,10,2718
Rhonda,F,100,202564,571,203135
Arlena,F,100,1272,0,1272
Arnica,F,100,5,0,5
Fredderick,M,100,0,121,121
Lusero,F,100,131,0,131
Juandedios,M,100,0,211,211
Whitnie,F,100,416,0,416
Shang,M,100,0,25,25
Lamisha,F,100,343,0,343
Busra,F,100,35,0,35
Memphys,M,77,5,17,22
Michelina,F,100,766,0,766
Emaleah,F,100,14,0,14
Aarianna,F,100,167,0,167
Vasiliki,F,100,1063,0,1063
Celines,F,100,176,0,176
Michaelryan,M,100,0,24,24
Cortni,F,100,818,0,818
Genises,F,100,40,0,40
Camerina,F,100,23,0,23
Shahzaib,M,100,0,162,162
Addalyn,F,100,1143,0,1143
Vincene,F,100,7,0,7
Marycatherine,F,100,832,0,832
Kaimana,M,92,54,598,652
Rell,F,50,5,5,10
Tomiya,F,100,38,0,38
Anlin,F,100,5,0,5
Kroy,M,100,0,123,123
Amitabh,M,100,0,12,12
Shepherd,M,100,5,1079,1084
Lakedra,F,100,240,0,240
Renu,F,100,71,0,71
Lavene,F,100,5,0,5
Hafeez,M,100,0,17,17
Perscilla,F,100,5,0,5
Bernice,F,98,23312,418,23730
Shacarla,F,100,11,0,11
Cadie,F,100,712,0,712
Brittane,F,100,226,0,226
Hadin,M,100,0,6,6
Terease,F,100,66,0,66
Brialle,F,100,14,0,14
Lashinda,F,100,7,0,7
Jakeena,F,100,11,0,11
Cheronda,F,100,164,0,164
Jivon,M,100,0,12,12
Zachari,M,100,0,762,762
Prateek,M,100,0,210,210
Andyn,M,100,0,102,102
Angles,F,100,65,0,65
Meryn,F,100,140,0,140
Audrielle,F,100,104,0,104
Abiela,F,100,15,0,15
Laterius,M,100,0,15,15
Gilles,M,100,0,191,191
Jashia,F,100,57,0,57
Naksh,M,100,0,64,64
Wanya,M,96,17,458,475
Broedy,M,100,0,69,69
Elenah,F,100,11,0,11
Auston,M,100,0,2872,2872
Thereza,F,100,5,0,5
Madaya,F,100,15,0,15
Ahnisty,F,100,6,0,6
Xaden,M,100,0,211,211
Barret,M,100,5,1075,1080
Elaini,F,100,28,0,28
Akria,F,100,5,0,5
Demeshia,F,100,96,0,96
Dairian,F,100,10,0,10
Temaria,F,100,7,0,7
Brijesh,M,100,0,13,13
Rom,M,100,0,23,23
Oreal,F,100,23,0,23
Brodie,M,96,338,8152,8490
Sheeva,F,100,40,0,40
Nereyda,F,100,1107,0,1107
Wendelin,F,100,346,0,346
Oretha,F,100,319,0,319
Sybill,F,100,7,0,7
Durville,M,100,0,5,5
Shneur,M,100,0,373,373
Kassiana,F,100,11,0,11
Sayd,M,100,0,26,26
Michaelanthony,M,100,0,525,525
Yojaira,F,100,6,0,6
Berne,M,100,0,5,5
Charrell,F,100,19,0,19
Elky,F,100,119,0,119
Insiya,F,100,34,0,34
Dondray,M,100,0,11,11
Staten,M,100,0,10,10
Randolph,M,100,97,33233,33330
Reniel,M,100,0,5,5
Coutney,F,100,77,0,77
Celso,M,100,0,1712,1712
Allyannah,F,100,17,0,17
Tashee,F,100,30,0,30
Brend,F,100,56,0,56
Zaynah,F,100,679,0,679
Yanelle,F,100,107,0,107
Ahziyah,F,100,12,0,12
Arshiya,F,100,103,0,103
Aliha,F,100,139,0,139
Edelynn,F,100,15,0,15
Natural,F,100,5,0,5
Kasai,M,100,0,153,153
Mckensey,F,100,246,0,246
Everrett,M,100,0,93,93
Agostina,F,100,17,0,17
Alaini,F,100,19,0,19
Dyron,M,100,0,519,519
Brooklan,F,100,31,0,31
Delorese,F,100,17,0,17
Brysun,M,100,0,47,47
Jennell,F,100,1098,0,1098
Galinda,F,100,11,0,11
Johnika,F,100,107,0,107
Adeon,M,100,0,6,6
Haithem,M,100,0,11,11
Cecely,F,100,80,0,80
Sofina,F,100,24,0,24
Edison,M,99,65,5448,5513
Morganne,F,100,1158,0,1158
Yasamin,F,100,194,0,194
Yulitzy,F,100,5,0,5
Lakye,M,100,0,5,5
Bandi,F,100,52,0,52
Kerrick,M,100,0,675,675
Crystalmarie,F,100,62,0,62
Fuzail,M,100,0,5,5
Simiyah,F,100,58,0,58
Jackee,F,100,314,0,314
Epic,M,81,12,50,62
Zaneria,F,100,5,0,5
Tramar,M,100,0,61,61
Osmani,M,100,0,56,56
Eran,M,86,87,553,640
Braylee,F,99,3321,49,3370
Demaro,M,100,0,5,5
Padro,M,100,0,5,5
Bonita,F,100,21978,12,21990
Anndi,F,100,6,0,6
Jazanae,F,100,10,0,10
Ajaye,M,100,0,5,5
Binky,F,100,5,0,5
Bonda,F,100,12,0,12
Adhira,F,100,42,0,42
Lesia,F,100,3169,0,3169
Quill,M,100,0,11,11
Khalisah,F,100,6,0,6
Riyanna,F,100,172,0,172
Saryiah,F,100,96,0,96
Roizy,F,100,239,0,239
Arniece,F,100,5,0,5
Isahbella,F,100,5,0,5
Hewitt,M,100,0,269,269
Dishita,F,100,11,0,11
Evalisse,F,100,49,0,49
Barry,M,100,600,135800,136400
Lizmary,F,100,169,0,169
Garlyn,M,100,0,6,6
Calah,F,100,464,0,464
Patricka,F,100,18,0,18
Kasean,M,100,0,179,179
Atom,M,100,0,516,516
Achsah,F,100,21,0,21
Alivyah,F,100,22,0,22
Eronda,F,100,11,0,11
Lamel,M,100,0,306,306
Jamalyn,F,100,6,0,6
Curt,M,100,0,14937,14937
Riesha,F,100,15,0,15
Arthuree,F,100,5,0,5
Allise,F,100,42,0,42
Chistie,F,100,5,0,5
Kamm,M,100,0,5,5
Littleton,M,100,0,25,25
Letarsha,F,100,6,0,6
Anant,M,100,0,235,235
Seriana,F,100,17,0,17
Makynli,F,100,152,0,152
Rex,M,100,84,33778,33862
Waynisha,F,100,28,0,28
Enrica,F,100,118,0,118
Jewlz,F,100,5,0,5
Shirell,F,100,324,0,324
Evalie,F,100,63,0,63
Haileigh,F,100,1631,0,1631
Kmari,M,52,109,119,228
Olsen,M,100,0,107,107
Chelonda,F,100,5,0,5
Sopheap,F,63,80,46,126
Darianna,F,100,789,0,789
Vandora,F,100,49,0,49
Ranjani,F,100,10,0,10
Chevone,F,100,11,0,11
Zerik,M,100,0,42,42
Eijah,M,100,0,5,5
Mishia,F,100,5,0,5
Laren,F,65,513,273,786
Glyndora,F,100,5,0,5
Essex,M,100,0,126,126
Azalia,F,100,1414,0,1414
Paig,F,100,5,0,5
Ahona,F,100,5,0,5
Arlow,M,100,0,12,12
Ghislane,F,100,11,0,11
Wonya,M,100,0,6,6
Addisynn,F,100,131,0,131
Denalia,F,100,5,0,5
Shatonia,F,100,117,0,117
Jabreena,F,100,9,0,9
Leriyah,F,100,10,0,10
Ayiana,F,100,564,0,564
Nijee,M,100,0,63,63
Stasha,F,100,764,0,764
Homar,M,100,0,547,547
Richerd,M,100,0,141,141
Raelee,F,100,1019,0,1019
Marti,F,95,3932,216,4148
Collette,F,100,5678,0,5678
Zowey,F,100,10,0,10
Lucey,F,100,30,0,30
Izriel,M,100,0,5,5
Verinica,F,100,5,0,5
Efram,M,100,0,41,41
Shatique,M,100,0,12,12
Lendia,F,100,31,0,31
Queston,M,100,0,10,10
Trison,M,100,0,22,22
Kallum,M,100,0,80,80
Ilianah,F,100,12,0,12
Denazia,F,100,15,0,15
Brahin,M,100,0,10,10
Manal,F,100,1006,0,1006
Talla,F,100,11,0,11
Ellisia,F,100,17,0,17
Chisa,F,100,201,0,201
Romalis,M,100,0,5,5
Toccaro,F,100,15,0,15
Penne,F,100,346,0,346
Rahkia,F,100,5,0,5
Saurabh,M,100,0,67,67
Prudy,F,100,51,0,51
Doaa,F,100,81,0,81
Davean,M,100,0,10,10
Haven,F,77,9727,2919,12646
Jamyrah,F,100,145,0,145
Morlon,M,100,0,5,5
Taybree,F,100,10,0,10
Yalisa,F,100,20,0,20
Rothana,M,55,5,6,11
Yveth,F,100,8,0,8
Kanyon,M,92,81,921,1002
Artemiy,M,100,0,5,5
Asherah,F,100,45,0,45
Kalieb,M,100,0,199,199
Nayah,F,100,343,0,343
Shaniyha,F,100,10,0,10
Aleksy,M,100,0,42,42
Damesha,F,100,281,0,281
Khaseem,M,100,0,10,10
Meziah,M,100,0,33,33
Shariana,F,100,6,0,6
Enisha,F,100,40,0,40
Asheli,F,100,34,0,34
Yanice,F,100,68,0,68
Avel,M,100,0,334,334
Christianmichae,M,100,0,11,11
Adontae,M,100,0,7,7
Anala,F,100,170,0,170
Chrishaunda,F,100,5,0,5
Najam,M,100,0,5,5
Lolita,F,100,6057,0,6057
Aasin,M,100,0,52,52
Gordan,M,100,0,459,459
Grahm,M,100,0,532,532
Dyle,M,100,0,10,10
Abiel,M,98,23,924,947
Ilirian,M,100,0,5,5
Maiha,F,100,5,0,5
Semaja,F,90,147,17,164
Yousof,M,100,0,51,51
Laketia,F,100,141,0,141
Blakeney,F,100,20,0,20
Arlicia,F,100,205,0,205
Bianaca,F,100,7,0,7
Prabhleen,F,100,49,0,49
Iciss,F,100,13,0,13
Achol,F,100,40,0,40
Jef,M,100,0,129,129
Dominae,F,100,15,0,15
Tylr,M,100,0,6,6
Datavious,M,100,0,27,27
Lyman,M,100,0,2079,2079
Stephanie,F,100,716490,2622,719112
Goretty,F,100,10,0,10
Tisheena,F,100,60,0,60
Carmah,F,100,14,0,14
Dannyell,F,100,15,0,15
Declyn,M,64,66,119,185
Sheridan,F,76,4798,1528,6326
Caydin,M,91,36,352,388
Tamanika,F,100,69,0,69
Ambriana,F,100,73,0,73
Rekayla,F,100,5,0,5
Yazir,M,100,0,90,90
Kanaloa,M,100,0,24,24
Samena,F,100,6,0,6
Chidozie,M,100,0,58,58
Baelor,M,100,0,5,5
Jestin,M,100,0,1100,1100
Kristijan,M,100,0,22,22
Brittish,F,100,34,0,34
Jeanifer,F,100,100,0,100
Artemia,F,100,5,0,5
Tanya,F,100,113538,405,113943
Janzen,M,100,0,73,73
Lureen,F,100,6,0,6
Tremere,M,100,0,6,6
Tanisa,F,100,76,0,76
Milaya,F,100,133,0,133
Ripken,M,100,0,97,97
Alysan,F,100,22,0,22
Tessa,F,100,42507,13,42520
Abbegayle,F,100,73,0,73
Zulai,F,100,10,0,10
Mamoudou,M,100,0,63,63
Ensar,M,100,0,29,29
Haripriya,F,100,5,0,5
Ashleh,F,100,11,0,11
Shahmeer,M,100,0,64,64
Linsy,F,100,233,0,233
Steuart,M,100,0,6,6
Siran,M,100,0,6,6
Eshana,F,100,40,0,40
Alkeem,M,100,0,11,11
Evani,F,100,133,0,133
Carma,F,100,2178,0,2178
Gera,F,100,136,0,136
Lelen,M,100,0,6,6
Fishel,M,100,0,132,132
Diya,F,100,3209,12,3221
Mariaelena,F,100,1732,0,1732
Iestyn,M,100,0,5,5
Masataka,M,100,0,5,5
Nielsen,M,100,0,5,5
Milt,M,100,0,21,21
Devlyn,M,64,176,309,485
Falynn,F,100,423,0,423
Winslet,F,100,6,0,6
Raelan,F,92,56,5,61
Insha,F,100,46,0,46
Vandi,F,100,34,0,34
Izahbella,F,100,10,0,10
Akasia,F,100,88,0,88
Naod,M,100,0,113,113
Viviana,F,100,18403,22,18425
Evaline,F,100,373,0,373
Chamari,F,100,84,0,84
Belvin,M,95,7,132,139
Jaquavius,M,100,0,362,362
Jalaiah,F,100,41,0,41
Roslind,F,100,134,0,134
Chales,M,100,0,124,124
Avion,M,84,275,1449,1724
Thuytien,F,100,39,0,39
Raielle,F,100,14,0,14
Monnica,F,100,66,0,66
Sora,F,86,907,148,1055
Francel,F,100,5,0,5
Cariya,F,100,8,0,8
Bj,M,99,5,681,686
Sundas,F,100,31,0,31
Imron,M,100,0,5,5
Royanna,F,100,5,0,5
Nikkos,M,100,0,16,16
Dinese,F,100,16,0,16
Clareese,F,100,5,0,5
Blakeleigh,F,100,171,0,171
Welford,M,100,0,103,103
Taijae,F,62,18,11,29
Carlose,M,100,0,12,12
Kielynn,F,100,42,0,42
Allyana,F,100,287,0,287
Musab,M,100,0,343,343
Arkeen,M,100,0,15,15
Kishonna,F,100,5,0,5
Temkia,F,100,5,0,5
Kylealexander,M,100,0,5,5
Hermoine,F,100,21,0,21
Kalique,M,100,0,45,45
Alai,M,55,5,6,11
Adalie,F,100,898,0,898
Renoda,F,100,26,0,26
Britnay,F,100,120,0,120
Daeshun,M,100,0,20,20
Attie,F,100,5,0,5
Luetta,F,100,244,0,244
Artorius,M,100,0,31,31
Linhchi,F,100,5,0,5
Saji,M,100,0,5,5
Filsan,F,100,12,0,12
Magon,F,100,179,0,179
Amrit,M,58,338,474,812
Volanda,F,100,97,0,97
Khailen,M,100,0,12,12
Warran,M,100,0,5,5
Malakiah,M,100,0,38,38
Kayanna,F,100,858,0,858
Annahy,F,100,24,0,24
Uyen,F,100,373,0,373
Knox,M,99,27,5251,5278
Landree,F,99,433,6,439
Jacaria,F,100,79,0,79
Cushena,F,100,20,0,20
Elizabeht,F,100,53,0,53
Editha,F,100,34,0,34
Jozef,M,100,0,896,896
Latreice,F,100,7,0,7
Philippe,M,100,0,2415,2415
Teffany,F,100,253,0,253
Kimbelry,F,100,35,0,35
Lekendric,M,100,0,5,5
Riniyah,F,100,53,0,53
Keyondre,M,100,0,313,313
Blynn,M,100,0,5,5
Rayleah,F,100,11,0,11
Camerron,M,100,0,51,51
Navian,M,100,0,16,16
Javierjr,M,100,0,5,5
Pahola,F,100,188,0,188
Sherriann,F,100,124,0,124
Tomyra,F,100,7,0,7
Cloee,F,100,225,0,225
Ajanea,F,100,12,0,12
Gilman,M,100,0,158,158
Devel,M,100,0,5,5
Mckenzie,F,96,51185,2049,53234
Vontella,F,100,31,0,31
Maryjoe,F,100,6,0,6
Svetlana,F,100,666,0,666
Janay,F,100,5554,0,5554
Willow,F,99,17277,161,17438
Phatima,F,100,21,0,21
Olamiposi,M,100,0,6,6
Draysen,M,100,0,40,40
Shambreka,F,100,16,0,16
Tysheia,F,100,5,0,5
Connye,F,100,21,0,21
Jafar,M,100,0,495,495
Maddilynn,F,100,352,0,352
Jajuan,M,100,11,2249,2260
Hollyann,F,100,597,0,597
Kaeleb,M,100,0,499,499
Juvens,M,100,0,25,25
Mikeya,F,100,300,0,300
Dzenita,F,100,5,0,5
Sofiah,F,100,156,0,156
Nycholas,M,100,0,201,201
Tyannia,F,100,5,0,5
Henessey,F,100,22,0,22
Rosa,F,99,79283,575,79858
Johnnie,M,76,11511,37177,48688
Myli,F,100,137,0,137
Deberah,F,100,331,0,331
Annah,F,100,1544,0,1544
Samyukta,F,100,74,0,74
Abeni,F,100,360,0,360
Jiovanni,M,100,0,1377,1377
Joseenrique,M,100,0,42,42
Genora,F,100,165,0,165
Lanaija,F,100,5,0,5
Daileen,F,100,42,0,42
Milliona,F,100,5,0,5
Mimose,F,100,5,0,5
Vitina,F,100,29,0,29
Jestiny,F,100,29,0,29
Shaqua,F,100,28,0,28
Kendin,M,100,0,6,6
Tolbert,M,100,0,211,211
Terran,M,70,544,1294,1838
Davana,F,100,44,0,44
Jalei,F,100,61,0,61
Afrika,F,100,239,0,239
Cliffie,F,100,7,0,7
Pelham,M,100,0,22,22
Zeda,F,100,41,0,41
Maaike,F,100,10,0,10
Rhina,F,100,101,0,101
Kerric,M,100,0,6,6
Keidon,M,100,0,12,12
Daiquiri,F,100,42,0,42
Shamik,M,91,5,51,56
Tarvarus,M,100,0,20,20
Deverne,M,100,0,6,6
Larayna,F,100,15,0,15
Caite,F,100,10,0,10
Arthor,M,100,0,95,95
Leandrea,F,99,674,5,679
Shresta,F,100,63,0,63
Jiaming,M,100,0,6,6
Derell,M,100,0,695,695
Chrisly,F,100,5,0,5
Adairis,F,100,5,0,5
Anaalicia,F,100,201,0,201
Zaiden,M,99,28,4462,4490
Ayaz,M,100,0,67,67
Gelene,F,100,19,0,19
Yeyson,M,100,0,12,12
Charna,F,100,441,0,441
Dekia,F,100,10,0,10
Joceyln,F,100,41,0,41
Lessly,F,100,601,0,601
Charu,F,100,12,0,12
Oluchi,F,100,161,0,161
Theodis,M,100,0,1304,1304
Ishaq,M,100,0,313,313
Brandley,M,100,0,67,67
Thor,M,100,0,3493,3493
Brishana,F,100,5,0,5
Afzal,M,100,0,14,14
Shernika,F,100,48,0,48
Xitlalie,F,100,6,0,6
Gavino,M,100,0,1269,1269
Smiya,F,100,5,0,5
Shirae,F,100,5,0,5
Lielle,F,100,157,0,157
Hailie,F,100,5302,0,5302
Lisabella,F,100,19,0,19
Lyndsea,F,100,22,0,22
Jaclynn,F,100,2501,0,2501
Anthonyjr,M,100,0,14,14
Joathan,M,100,0,31,31
Nazeem,M,100,0,13,13
Kevins,M,100,0,21,21
Fion,F,100,37,0,37
Jameris,M,100,0,5,5
Khadyn,M,100,0,42,42
Danishia,F,100,53,0,53
Zady,F,100,12,0,12
Karelie,F,100,5,0,5
Sandia,F,100,77,0,77
Shaindy,F,100,1435,0,1435
Chamille,F,100,69,0,69
Ramyah,F,100,116,0,116
Carlyrose,F,100,7,0,7
Jaen,M,100,0,34,34
Diti,F,100,7,0,7
Reahna,F,100,10,0,10
Diontaye,M,100,0,5,5
Marymargaret,F,100,771,0,771
Raheen,M,100,0,400,400
Keysha,F,100,1722,0,1722
Xenia,F,100,2062,0,2062
Syndi,F,100,255,0,255
Needham,M,100,0,37,37
Zacheus,M,100,0,33,33
Islynn,F,100,10,0,10
Cordai,M,100,0,89,89
Deshaunte,M,100,0,5,5
Marypat,F,100,115,0,115
Josephdaniel,M,100,0,15,15
Momoka,F,100,121,0,121
Jandee,F,100,11,0,11
Ayzlin,F,100,5,0,5
Arijit,M,100,0,5,5
Chaylene,F,100,27,0,27
Garyl,M,100,0,5,5
Dyllin,M,100,0,146,146
Corrine,F,100,10642,0,10642
Audry,F,97,1935,58,1993
Yolenda,F,100,5,0,5
Maxene,F,100,23,0,23
Valire,F,100,26,0,26
Aladrian,F,100,5,0,5
Karcher,M,100,0,5,5
Kiristen,F,100,31,0,31
Arizel,F,100,7,0,7
Adry,F,100,5,0,5
Tanajha,F,100,16,0,16
Daray,M,100,0,66,66
Kissey,F,100,29,0,29
Anieyah,F,100,23,0,23
Amirali,M,100,0,12,12
Furious,M,100,0,91,91
Tonyeka,F,100,6,0,6
Ethaen,M,100,0,5,5
Eldad,M,100,0,5,5
Sevasti,F,100,25,0,25
Jazline,F,100,201,0,201
Raychel,F,100,1443,0,1443
Khalin,M,95,6,124,130
Kymberleigh,F,100,21,0,21
Naleigh,F,100,52,0,52
Umayah,F,100,7,0,7
Kalpesh,M,100,0,17,17
Tuesdai,F,100,5,0,5
Shyheem,M,100,0,293,293
Ohana,F,100,80,0,80
Aldyn,M,65,31,58,89
Larone,M,100,0,251,251
Jazmond,M,63,10,17,27
Daijanay,F,100,5,0,5
Simoni,F,100,5,0,5
Shirene,F,100,36,0,36
Reshea,F,100,15,0,15
Yenesis,F,100,62,0,62
Yendi,F,100,48,0,48
Jolena,F,100,977,0,977
Larod,M,100,0,16,16
Lakeitha,F,100,917,0,917
Chyrell,F,100,23,0,23
Yesica,F,100,2264,5,2269
Jaynesha,F,100,17,0,17
Tommi,F,99,1495,16,1511
Shandel,F,97,365,10,375
Shalonna,F,100,40,0,40
Izeiah,M,100,0,39,39
Arzu,F,100,76,0,76
Arieliz,F,100,44,0,44
Kataryna,F,100,111,0,111
Jeana,F,100,7331,0,7331
Quanell,M,100,0,62,62
Raymere,M,100,0,37,37
Cacie,F,100,75,0,75
Dantay,M,100,0,30,30
Lillion,F,100,5,0,5
Adewale,M,100,0,137,137
Gayanne,F,100,31,0,31
Keniyah,F,100,563,0,563
Aleya,F,100,1350,0,1350
Jayleigh,F,100,922,0,922
Kandise,F,100,256,0,256
Alamar,F,100,16,0,16
Theophile,M,100,0,20,20
Uriana,F,100,17,0,17
Nazhir,M,100,0,5,5
Sylivia,F,100,35,0,35
Miqueas,M,100,0,209,209
Marisue,F,100,105,0,105
Edyn,F,90,608,68,676
Jackqueline,F,100,1212,0,1212
Djuana,F,100,669,0,669
Damariye,M,100,0,5,5
Amiee,F,100,1657,0,1657
Mcihelle,F,100,5,0,5
Thaliana,F,100,8,0,8
Remberto,M,100,0,79,79
Fronnie,F,100,5,0,5
Laqueta,F,100,331,0,331
Taliq,M,100,0,44,44
Hulali,F,100,5,0,5
Chiya,F,100,18,0,18
Dahabo,F,100,11,0,11
Gemelli,F,100,5,0,5
Aazan,M,100,0,5,5
Victora,F,100,132,0,132
Kurtis,M,100,25,17280,17305
Allyonna,F,100,5,0,5
Joemichael,M,100,0,13,13
Marqueze,M,100,0,128,128
Heet,M,100,0,5,5
Vitus,M,100,0,7,7
Aeden,M,99,7,874,881
Laelani,F,100,118,0,118
Ahyonna,F,100,5,0,5
Raqib,M,100,0,6,6
Landra,F,100,364,0,364
Josia,M,96,5,109,114
Giuliano,M,100,0,585,585
Chanel,F,100,15528,33,15561
Vermel,F,100,10,0,10
Ellenore,F,100,76,0,76
Penellope,F,100,7,0,7
Akem,M,100,0,5,5
Mariaeduarda,F,100,179,0,179
Aelish,F,100,5,0,5
Magic,M,85,34,200,234
Bengi,M,100,0,7,7
Lazandra,F,100,29,0,29
Bictor,M,100,0,7,7
Wrigley,M,60,136,208,344
Verdine,F,100,24,0,24
Shyheed,M,100,0,17,17
Zahriyah,F,100,53,0,53
Cante,F,100,5,0,5
Syndy,F,100,11,0,11
Mai,F,100,4698,20,4718
Guye,M,100,0,16,16
Emily,F,100,732342,1555,733897
Denie,F,100,17,0,17
Suheyb,M,100,0,41,41
Genasis,F,100,43,0,43
Jackelyne,F,100,413,0,413
Prajna,F,100,73,0,73
Jadeyn,F,94,626,38,664
Moneka,F,100,266,0,266
Ethanjames,M,100,0,122,122
Naman,M,100,0,347,347
Quynn,F,100,134,0,134
Emerie,F,99,1684,10,1694
Aleshka,F,100,68,0,68
Shyhem,M,100,0,5,5
Onye,F,100,21,0,21
Lubertha,F,100,105,0,105
Arneshia,F,100,123,0,123
Treymaine,M,100,0,5,5
Angelynne,F,100,26,0,26
Shawntell,F,100,495,0,495
Lewin,M,100,0,48,48
Quadre,M,100,0,187,187
Tesheka,F,100,11,0,11
Fateh,M,100,0,74,74
Dalessandro,M,100,0,147,147
Sharlita,F,100,22,0,22
Mykhail,M,100,0,11,11
Hawkins,M,100,0,287,287
Geffery,M,100,0,16,16
Antwonn,M,100,0,5,5
Firman,M,100,0,56,56
Orell,M,100,0,18,18
Sammya,F,100,5,0,5
Lissette,F,100,7291,5,7296
Christerphor,M,100,0,8,8
Fikisha,F,100,45,0,45
Kevonna,F,100,289,0,289
Canelo,M,100,0,22,22
Shyloe,F,100,10,0,10
Shifa,F,100,197,0,197
Taquetta,F,100,11,0,11
Zithlaly,F,100,12,0,12
Danyia,F,100,90,0,90
Camar,M,100,0,132,132
Lewayne,M,100,0,44,44
Reigan,F,100,182,0,182
Darya,F,100,907,0,907
Earnestine,F,100,4527,0,4527
Emilce,F,100,59,0,59
Silvester,M,100,0,670,670
Bethzi,F,100,18,0,18
Loresa,F,100,39,0,39
Mykiya,F,100,10,0,10
Jaimyn,M,100,0,6,6
Jakeya,F,100,180,0,180
Temika,F,100,911,0,911
Kiniah,F,100,5,0,5
Abernathy,F,100,28,0,28
Elda,F,100,2305,0,2305
Buster,M,100,0,1792,1792
Raylen,M,62,374,604,978
Kyuss,M,100,0,46,46
Shadea,F,100,52,0,52
Sabeen,F,100,183,0,183
Karryn,F,100,40,0,40
Nicodemo,M,100,0,18,18
Sharaea,F,100,6,0,6
Daaiel,M,100,0,76,76
Zsolt,M,100,0,6,6
Neysa,F,100,955,0,955
Ackeem,M,100,0,32,32
Zace,M,100,0,5,5
Cathline,F,100,74,0,74
Janalyn,F,100,486,0,486
Almin,M,100,0,74,74
Mariesa,F,100,347,0,347
Tomieka,F,100,48,0,48
Nieasha,F,100,13,0,13
Toluwani,F,53,48,43,91
Arabell,F,100,23,0,23
Johandy,M,100,0,16,16
Calixto,M,100,0,404,404
Phaith,F,100,32,0,32
Exander,M,100,0,55,55
Hadlyn,F,100,21,0,21
Meldin,M,100,0,6,6
Janariah,F,100,32,0,32
Marshall,M,99,783,53478,54261
Jayland,M,100,0,330,330
Charlette,F,100,2890,0,2890
Shatavia,F,100,739,0,739
Kemonte,M,100,0,314,314
Qadeera,F,100,5,0,5
Temprence,F,100,98,0,98
Eternal,M,100,0,5,5
Chandrell,F,100,10,0,10
Laurette,F,100,1279,0,1279
Jun,M,93,84,1060,1144
Yosmairy,F,100,5,0,5
Trevone,M,100,0,256,256
Elyis,M,100,0,6,6
Phebee,F,100,5,0,5
Tamitha,F,100,454,0,454
Anthny,M,100,0,13,13
Kitten,F,100,42,0,42
Maelei,F,100,6,0,6
Armond,M,100,0,2368,2368
Kevana,F,100,17,0,17
Kees,M,100,0,130,130
Enalina,F,100,11,0,11
Marguel,M,100,0,5,5
Neeva,F,100,92,0,92
Oviya,F,100,129,0,129
Chaeli,F,100,262,0,262
Dajion,M,100,0,110,110
Makennzie,F,100,5,0,5
Bradyen,M,100,0,7,7
Tejean,M,100,0,16,16
Edsson,M,100,0,5,5
Tamer,M,100,0,731,731
Nuraz,M,100,0,5,5
Eliziah,M,100,0,24,24
Vergia,F,100,6,0,6
Ramiya,F,100,284,0,284
Emelda,F,100,517,0,517
Dellanira,F,100,71,0,71
Lyrah,F,100,66,0,66
Manetta,F,100,11,0,11
Kyrsta,F,100,5,0,5
Beatty,M,100,0,5,5
Bence,M,100,0,110,110
Jamieon,M,100,0,61,61
Kimetha,F,100,114,0,114
Ansu,M,100,0,5,5
Ryeland,M,100,0,46,46
Dedria,F,100,426,0,426
Alyxa,F,100,32,0,32
Koston,M,100,0,155,155
Tavian,M,100,0,1780,1780
Terrisha,F,100,130,0,130
Horton,M,100,0,64,64
Latacha,F,100,168,0,168
Kambrya,F,100,23,0,23
Hima,F,100,32,0,32
Aziyah,F,97,808,27,835
Nelisa,F,100,11,0,11
Nyeesha,F,100,57,0,57
Shareny,F,100,5,0,5
Tiffoni,F,100,6,0,6
Davani,F,100,5,0,5
Alvah,M,100,0,328,328
Arnolfo,M,100,0,5,5
Tennison,M,100,0,17,17
Yewande,F,100,28,0,28
Dejoire,F,100,8,0,8
Jordaan,M,100,0,25,25
Wonnie,F,50,5,5,10
Zaul,M,100,0,205,205
Fergie,F,100,120,0,120
Raxton,M,100,0,6,6
Takaiya,F,100,57,0,57
Amoriah,F,100,45,0,45
Adileigh,F,100,14,0,14
Melanya,F,100,5,0,5
Antrone,M,100,0,165,165
Acelynn,F,100,488,0,488
Daonna,F,100,18,0,18
Jonalee,F,100,5,0,5
Shanterrica,F,100,45,0,45
Kristlynn,F,100,5,0,5
Ahjah,F,100,49,0,49
Blayse,M,100,0,10,10
Joyetta,F,100,6,0,6
Jasaya,F,100,15,0,15
Tanis,F,63,798,474,1272
Magdalia,F,100,7,0,7
Tansy,F,100,287,0,287
Addysan,F,100,47,0,47
Noran,F,100,29,0,29
Keneasha,F,100,6,0,6
Dreydan,M,100,0,42,42
Natash,F,100,125,0,125
Skilynn,F,100,124,0,124
Marteen,F,100,35,0,35
Jermond,M,100,0,190,190
Josenid,F,100,31,0,31
Anyha,F,100,21,0,21
Deandre,M,98,452,26155,26607
Benjammin,M,100,0,5,5
Meeya,F,100,142,0,142
Nathean,M,100,0,12,12
Janzel,M,100,0,12,12
Aymara,F,100,74,0,74
Ryheem,M,100,0,186,186
Beverlee,F,100,841,0,841
Ieysha,F,100,5,0,5
Leilah,F,100,2347,0,2347
Jameir,M,100,0,388,388
Fredis,M,100,0,171,171
Yvens,M,100,0,31,31
Darth,M,100,0,29,29
Abrienne,F,100,15,0,15
Mirena,F,100,21,0,21
Turea,F,100,5,0,5
Briena,F,100,132,0,132
Braegan,M,100,0,5,5
Ahleah,F,100,85,0,85
Anyae,F,100,203,0,203
Janathan,M,100,0,380,380
Abishai,M,87,20,139,159
Sivi,F,100,47,0,47
Heyley,F,100,21,0,21
Zeenat,F,100,131,0,131
Leyana,F,100,205,0,205
Acacia,F,100,3447,0,3447
Caisey,F,100,44,0,44
Zanai,F,100,150,0,150
Lynnley,F,100,32,0,32
Omaurion,M,100,0,7,7
Nithya,F,100,534,0,534
Janikqua,F,100,5,0,5
Rayahna,F,100,43,0,43
Nakee,F,100,5,0,5
Lijah,M,90,10,93,103
Sihaam,F,100,48,0,48
Kiriakos,M,100,0,10,10
Theordore,M,100,0,221,221
Grasyn,M,65,21,39,60
Jaterrious,M,100,0,18,18
Tampa,F,100,10,0,10
Gurkirat,M,90,6,54,60
Marquaveon,M,100,0,14,14
Lakeyshia,F,100,108,0,108
Jenascia,F,100,81,0,81
Yahriel,M,100,0,5,5
Paulus,M,100,0,16,16
Rickita,F,100,121,0,121
Lanston,M,100,0,6,6
Jandriel,M,100,0,10,10
Ante,M,100,0,204,204
Rembrandt,M,100,0,15,15
Samija,F,100,5,0,5
Sheriden,F,100,64,0,64
Jaremy,M,100,0,200,200
Nicholis,M,100,0,733,733
Kanija,F,100,108,0,108
Elecia,F,100,515,0,515
Lauron,F,100,24,0,24
Tahjai,M,71,28,70,98
Suzelle,F,100,20,0,20
Cassandera,F,100,10,0,10
Adeola,F,93,317,24,341
Zyriyah,F,100,11,0,11
Chandice,F,100,49,0,49
Keland,M,100,0,140,140
Lakinya,F,100,27,0,27
Bunnie,F,100,443,0,443
Kaedon,M,100,0,515,515
Mitchelle,F,76,502,160,662
Gervis,M,100,0,23,23
Karman,F,95,514,29,543
Talmadge,M,100,0,1890,1890
Julya,F,100,157,0,157
Marle,F,100,39,0,39
Isaaq,M,100,0,6,6
Arieana,F,100,702,0,702
Arnae,F,100,5,0,5
Keilany,F,100,170,0,170
Shekena,F,100,36,0,36
Hafeeza,F,100,12,0,12
Feyisayo,F,100,5,0,5
Chrisiyah,F,100,5,0,5
Skyden,M,100,0,13,13
Zandar,M,100,0,5,5
Monir,M,100,0,5,5
Shamier,M,100,0,34,34
Redonna,F,100,191,0,191
Breionna,F,100,74,0,74
Zaahir,M,100,0,143,143
Helaine,F,100,891,0,891
Shanyah,F,100,423,0,423
Kahlina,F,100,10,0,10
Shareefah,F,100,43,0,43
Larnce,M,100,0,13,13
Tanveer,M,81,29,122,151
Allysyn,F,100,16,0,16
Jaylon,M,97,247,8745,8992
Donato,M,100,0,1742,1742
Arianna,F,100,76418,65,76483
Niraj,M,100,0,319,319
Nolberto,M,100,0,538,538
Kadis,M,100,0,6,6
Ndia,F,100,254,0,254
Xylen,M,100,0,6,6
Carlyn,F,100,3034,10,3044
Shacquille,M,100,0,6,6
Yosilin,F,100,5,0,5
Laydon,M,100,0,72,72
Kadeyn,M,100,0,45,45
Tayzlee,F,100,19,0,19
Kedeem,M,100,0,14,14
Dicky,M,100,0,493,493
Takuto,M,100,0,53,53
Wania,F,100,108,0,108
Nakoda,M,100,0,11,11
Klevis,M,100,0,10,10
Shannon,F,85,292193,50310,342503
Ruman,F,100,5,0,5
Junya,F,100,5,0,5
Jahzion,M,100,0,45,45
Daveion,M,100,0,562,562
Ajitesh,M,100,0,10,10
Steohanie,F,100,6,0,6
Elidia,F,100,505,0,505
Roselle,F,100,762,0,762
Ramis,M,100,0,15,15
Novie,F,100,15,0,15
Nube,F,100,34,0,34
Mattalyn,F,100,155,0,155
Moss,M,100,0,188,188
Danajha,F,100,21,0,21
Ises,F,100,5,0,5
Vinit,M,100,0,21,21
Bobbiejean,F,100,38,0,38
Ghaleb,M,100,0,6,6
Dawann,M,100,0,5,5
Carole,F,100,31017,7,31024
Therin,M,100,0,79,79
Jeremaiah,M,100,0,22,22
Derf,M,100,0,6,6
Keekee,F,100,5,0,5
Aliandra,F,100,29,0,29
Rufio,M,100,0,12,12
Ladaya,F,100,17,0,17
Verdis,M,87,6,41,47
Laquay,F,71,12,5,17
Chaelynn,F,100,18,0,18
Cammy,F,100,1498,0,1498
Lazarius,M,100,0,149,149
Zenith,F,60,55,36,91
Antonnia,F,100,5,0,5
Ryliegh,F,100,206,0,206
Donnajo,F,100,27,0,27
Adriunna,F,100,5,0,5
Tavontae,M,100,0,5,5
Kemariya,F,100,15,0,15
Adriana,F,100,82474,399,82873
Khalel,M,100,0,155,155
Taiwan,M,92,71,784,855
Lamisa,F,100,15,0,15
Cheila,F,100,121,0,121
Samanthagrace,F,100,17,0,17
Lelynn,M,100,0,14,14
Qumari,M,100,0,6,6
Aamya,F,100,121,0,121
Timiko,F,100,97,0,97
Chloeigh,F,100,6,0,6
Taisley,F,100,48,0,48
Bismarck,M,100,0,25,25
Naheim,M,100,0,86,86
Tahiem,M,100,0,18,18
Ambriehl,F,100,17,0,17
Zakarah,F,100,6,0,6
Shaquanah,F,100,13,0,13
Anjalika,F,100,5,0,5
Menphis,M,100,0,10,10
Jetzael,M,100,0,8,8
Chinonso,M,100,0,73,73
Angeldaniel,M,100,0,31,31
Brookly,F,100,10,0,10
Ayleth,F,100,34,0,34
Kathryn,F,100,301122,774,301896
Lillynn,F,100,26,0,26
Fania,F,100,37,0,37
Shaelyn,F,100,3042,0,3042
Damonii,M,100,0,10,10
Alveiro,M,100,0,12,12
Ruthellen,F,100,42,0,42
Trynt,M,100,0,30,30
Carizma,F,100,108,0,108
Gershom,M,100,0,159,159
Kham,M,84,6,32,38
Lyzette,F,100,338,0,338
Aradhana,F,100,64,0,64
Zanayla,F,100,5,0,5
Nancee,F,100,855,0,855
Daqwon,M,100,0,49,49
Shamariah,F,100,79,0,79
Morgane,F,100,195,0,195
Damonte,M,100,0,1441,1441
Brentin,M,100,0,151,151
Allyn,M,52,1574,1727,3301
Exa,F,100,6,0,6
Fumiko,F,100,10,0,10
Taeron,M,100,0,20,20
Emilse,F,100,35,0,35
Dontario,M,100,0,66,66
Marden,M,100,0,11,11
Feliza,F,100,109,0,109
Shanteya,F,100,5,0,5
Genieve,F,100,130,0,130
Alberteen,F,100,10,0,10
Rim,F,100,62,0,62
Geremie,M,100,0,5,5
Mykalia,F,100,33,0,33
Quantravious,M,100,0,16,16
Yalexis,F,100,10,0,10
Robrick,M,100,0,5,5
Hamin,M,100,0,33,33
Aurorah,F,100,84,0,84
Armanti,M,100,0,10,10
Eiva,F,100,5,0,5
Trent,M,100,102,48116,48218
Yuliza,F,100,524,0,524
Nilajah,F,100,5,0,5
Skai,F,95,276,16,292
Madisynne,F,100,12,0,12
Asharri,F,100,5,0,5
Sayona,F,100,5,0,5
Emariah,F,100,34,0,34
Ved,M,100,0,618,618
Roche,M,63,15,26,41
Tiaira,F,100,461,0,461
Makeisha,F,100,229,0,229
Twain,M,100,0,130,130
Kumi,F,100,5,0,5
Kirsten,F,100,51957,211,52168
Denyse,F,100,1128,0,1128
Natalei,F,100,12,0,12
Kaydens,F,100,5,0,5
Raja,M,68,316,679,995
Shandreka,F,100,233,0,233
Aggeliki,F,100,5,0,5
Caydance,F,100,281,0,281
Danene,F,100,309,0,309
Illyria,F,100,73,0,73
Hyman,M,100,0,407,407
Avrik,M,100,0,5,5
Cyarra,F,100,35,0,35
Tayde,F,81,22,5,27
Grantlee,M,100,0,5,5
Zavhary,M,100,0,6,6
Atonia,F,100,18,0,18
Robertlee,M,100,0,76,76
Nakirah,F,100,22,0,22
Moniquea,F,100,28,0,28
Branen,M,100,0,5,5
Kathrynanne,F,100,5,0,5
Allee,F,100,998,0,998
Quayvon,M,100,0,53,53
Rihonna,F,100,42,0,42
Mckaylee,F,100,497,0,497
Courvoisier,M,100,0,62,62
Micheal,M,99,1723,137424,139147
Stanya,F,100,16,0,16
Avir,M,100,0,5,5
Shawanda,F,100,2853,0,2853
Taveon,M,100,0,640,640
Sing,M,77,5,17,22
Akishia,F,100,6,0,6
Darese,M,100,0,5,5
Mekiyah,F,100,60,0,60
Erik,M,100,666,147582,148248
Shequila,F,100,154,0,154
Parinita,F,100,11,0,11
Tahsin,M,80,19,77,96
Jahnessa,F,100,95,0,95
Darika,F,100,67,0,67
Keniya,F,100,569,0,569
Quante,M,98,6,288,294
Terae,F,50,5,5,10
Erbie,M,100,0,5,5
Darlys,F,100,101,0,101
Creosha,F,100,6,0,6
Tomarra,F,100,43,0,43
Zathan,M,100,0,34,34
Hannya,F,100,33,0,33
Jaretssi,F,100,34,0,34
Nasiere,M,100,0,5,5
Kiayla,F,100,26,0,26
Siera,F,100,2486,0,2486
Ensleigh,F,100,5,0,5
Kortlan,M,100,0,6,6
Ishana,F,100,237,0,237
Jenecia,F,100,27,0,27
Jashyia,F,100,5,0,5
Jaxton,M,100,0,3216,3216
Eilon,M,100,0,5,5
Jessalin,F,100,28,0,28
Avaiyah,F,100,16,0,16
Payeng,F,100,6,0,6
Karmyn,F,100,1189,0,1189
Nataliemarie,F,100,6,0,6
Denzale,M,100,0,32,32
Barr,M,100,0,11,11
Kamran,M,99,10,1742,1752
Sharenna,F,100,6,0,6
Janeisy,F,100,26,0,26
Vencil,M,100,0,10,10
Cleland,M,100,0,19,19
Anea,F,100,46,0,46
Rikya,F,100,7,0,7
Michael,M,100,19203,3835174,3854377
Veronice,F,100,16,0,16
Sahra,F,100,698,0,698
Ludwika,F,100,101,0,101
Saamya,F,100,11,0,11
Jayben,M,100,0,5,5
Neymar,M,100,5,1420,1425
Yerachmiel,M,100,0,122,122
Kylle,M,93,5,70,75
Karia,F,100,398,0,398
Sharida,F,100,30,0,30
Dhru,M,100,0,11,11
Lovelee,F,100,63,0,63
Jaidalynn,F,100,15,0,15
Marlena,F,100,10070,0,10070
Jahaad,M,100,0,189,189
Jayden,M,90,19764,169456,189220
Sebastyen,M,100,0,10,10
Annaalicia,F,100,25,0,25
Kaveh,M,100,0,314,314
Dulcey,F,100,105,0,105
Zephen,M,100,0,26,26
Maiquel,F,100,6,0,6
Wa,M,100,0,48,48
Searah,F,100,5,0,5
Carrianne,F,100,294,0,294
Sochi,F,100,10,0,10
Satya,F,72,279,109,388
Ibraham,M,100,0,60,60
Oaklen,M,100,0,28,28
Kaeman,M,100,0,5,5
Hiliary,F,100,141,0,141
Floriana,F,100,22,0,22
Lavarius,M,100,0,120,120
Elisha,F,59,13178,9285,22463
Naydia,F,100,12,0,12
Glenora,F,100,72,0,72
Larri,F,76,197,62,259
Aksel,M,100,0,892,892
Timnesha,F,100,6,0,6
Shalani,F,100,11,0,11
Tayshun,M,100,0,74,74
Aveigha,F,100,5,0,5
Yiorgos,M,100,0,5,5
Lynnia,F,100,23,0,23
Deneta,F,100,13,0,13
Anquan,M,100,0,223,223
Shandrea,F,100,459,0,459
Kattrina,F,100,23,0,23
Kyrsten,F,100,1930,0,1930
Darnisha,F,100,877,0,877
Brittana,F,100,11,0,11
Shelita,F,100,966,0,966
Edelle,F,100,12,0,12
Talecia,F,100,85,0,85
Hydiyah,F,100,5,0,5
Khayri,M,100,0,218,218
Schylar,F,67,225,111,336
Jacquez,M,100,0,1559,1559
Anjolena,F,100,5,0,5
Shoniece,F,100,7,0,7
Beatris,F,100,1019,0,1019
Bladen,M,100,0,699,699
Sherin,F,100,340,0,340
Cartha,F,100,5,0,5
Sheryln,F,100,11,0,11
Tyveon,M,100,0,40,40
Xaedyn,M,100,0,5,5
Randesha,F,100,5,0,5
Rumaisa,F,100,118,0,118
Shametria,F,100,44,0,44
Jannell,F,100,853,0,853
Jaheem,M,100,0,956,956
Parham,M,100,0,10,10
Ismah,F,100,5,0,5
Amilla,F,100,6,0,6
Debralee,F,100,198,0,198
Shanon,F,74,4791,1726,6517
Ladrick,M,100,0,8,8
Nalani,F,100,2892,0,2892
Krikor,M,100,0,48,48
Mckaye,F,100,5,0,5
Makenzy,F,100,1276,0,1276
Tayana,F,100,696,0,696
Hakimah,F,100,10,0,10
Michela,F,100,1989,0,1989
Beckem,M,100,0,103,103
Zaedon,M,100,0,20,20
Alyah,F,100,975,0,975
Edahi,M,100,0,43,43
Duilio,M,100,0,62,62
Daeson,M,100,0,33,33
Lesvia,F,100,31,0,31
Antonella,F,100,2888,0,2888
Rumonda,F,100,5,0,5
Mauryn,F,100,6,0,6
Miaha,F,100,6,0,6
Remi,F,72,3228,1242,4470
Juelze,M,100,0,5,5
Rheese,F,100,5,0,5
Amaari,M,100,0,5,5
Coleston,M,100,0,68,68
Laki,M,100,0,5,5
Jerren,M,100,0,493,493
Aquil,M,100,0,457,457
Aloysius,M,100,0,1060,1060
Shaquria,F,100,10,0,10
Atanacio,M,100,0,180,180
Auree,F,100,5,0,5
Alexis,F,85,326985,59616,386601
Suehay,F,100,11,0,11
Lavana,F,100,46,0,46
Khalfani,M,100,0,162,162
Trinea,F,100,5,0,5
Josselin,F,100,685,0,685
Penni,F,100,2344,0,2344
Akeil,M,100,0,30,30
Cadeisha,F,100,5,0,5
Lakely,F,100,67,0,67
Kerl,F,100,10,0,10
Gyanni,F,100,5,0,5
Carolos,M,100,0,59,59
Ruann,F,100,5,0,5
Kahlo,M,100,0,5,5
Suparna,F,100,5,0,5
Alaundra,F,100,10,0,10
Lakindra,F,100,94,0,94
Andrejs,M,100,0,21,21
Raushana,F,100,11,0,11
Donnita,F,100,757,0,757
Dyshaun,M,100,0,68,68
Jacquelyne,F,100,2345,0,2345
Misa,F,100,586,0,586
Seya,F,100,5,0,5
Chizara,F,100,108,0,108
Samai,F,100,114,0,114
Arean,M,100,0,5,5
Terreance,M,100,0,54,54
Doel,M,100,0,20,20
Hensley,F,85,377,68,445
Aalaysia,F,100,109,0,109
Lavanna,F,100,46,0,46
Aurea,F,100,898,0,898
Navya,F,100,996,0,996
Dorathea,F,100,36,0,36
Amoi,F,100,13,0,13
Ajiya,F,100,5,0,5
Shemeika,F,100,186,0,186
Nilka,F,100,38,0,38
Shayal,F,100,10,0,10
Crissi,F,100,48,0,48
Affaan,M,100,0,5,5
Jilma,F,100,5,0,5
Dashona,F,100,34,0,34
Lazaro,M,100,0,5334,5334
Sabino,M,100,0,1171,1171
Venisa,F,100,78,0,78
Amey,F,96,622,27,649
Yon,M,100,0,87,87
Razel,F,100,5,0,5
Draedyn,M,100,0,47,47
Tonjua,F,100,114,0,114
Elioenai,M,100,0,32,32
Sametria,F,100,55,0,55
Velva,F,100,709,0,709
Tatyanna,F,100,1909,0,1909
Morrow,M,100,0,5,5
Esbeydi,F,100,73,0,73
Zackery,M,100,5,17036,17041
Rashanda,F,100,695,0,695
Annaelise,F,100,15,0,15
Mckaya,F,100,23,0,23
Rexine,F,100,35,0,35
Lynesha,F,100,89,0,89
Senovia,F,100,92,0,92
Kenessa,F,100,5,0,5
Tyvaughn,M,100,0,5,5
Keity,F,100,11,0,11
Saatvik,M,100,0,125,125
Danyeal,F,100,59,0,59
Rockford,M,100,0,502,502
Courtni,F,100,932,0,932
Salia,F,100,123,0,123
Aydren,M,100,0,19,19
Meir,M,100,0,2333,2333
Jackalynn,F,100,116,0,116
Kezzy,F,100,9,0,9
Zachi,M,100,0,11,11
Aylyn,F,100,96,0,96
Sidhanth,M,100,0,29,29
Ralphell,M,100,0,5,5
Trayquan,M,100,0,90,90
Loken,M,100,0,8,8
Eliz,F,100,127,0,127
Lindsae,F,100,17,0,17
Htoo,M,100,0,26,26
Gabreil,M,91,22,224,246
Soley,F,100,91,0,91
Daphen,F,100,6,0,6
Nayya,F,100,5,0,5
Crystopher,M,100,0,24,24
Jermiah,M,96,115,2773,2888
Markdaniel,M,100,0,10,10
Jaesa,F,100,6,0,6
Loisann,F,100,28,0,28
Divontae,M,100,0,5,5
Deyanara,F,100,34,0,34
Essense,F,100,81,0,81
Anyelin,F,100,164,0,164
Jewels,F,100,799,0,799
Emrie,F,100,540,0,540
Taitum,F,85,316,55,371
Oisin,M,100,0,254,254
Amiylah,F,100,30,0,30
Brandessa,F,100,5,0,5
Keystle,F,100,7,0,7
Qualen,M,100,0,10,10
Filisha,F,100,5,0,5
Evanyelin,F,100,5,0,5
Eriel,F,88,468,61,529
Mackayla,F,100,1111,0,1111
Nakyia,F,100,220,0,220
Nitzy,F,100,5,0,5
Breisha,F,100,15,0,15
Daedrian,M,100,0,6,6
Naela,F,100,75,0,75
Jonte,M,83,226,1137,1363
Rubyn,M,100,0,5,5
Kaniyha,F,100,8,0,8
Earlie,M,77,149,508,657
Fiora,F,100,81,0,81
Lorna,F,100,15164,15,15179
Danthony,M,100,0,1358,1358
Jamikal,M,100,0,24,24
Janea,F,100,1916,0,1916
Atzel,M,100,0,135,135
Deamber,F,100,186,0,186
Lucero,F,97,6267,191,6458
Sejin,M,100,0,6,6
Ezquiel,M,100,0,5,5
Paulinda,F,100,5,0,5
Dariyah,F,100,297,0,297
Jeyda,F,100,81,0,81
Emberlyn,F,100,405,0,405
Glorius,F,100,5,0,5
Cabel,M,100,0,34,34
Axa,F,100,17,0,17
Viet,M,99,11,1053,1064
Boyd,M,100,0,10404,10404
Aben,M,100,0,17,17
Keishaun,M,100,0,338,338
Jaana,F,100,65,0,65
Elmir,M,100,0,11,11
Kohei,M,100,0,140,140
Rache,F,100,74,0,74
Aurbree,F,100,11,0,11
Skyrah,F,100,42,0,42
Kendarrius,M,100,0,131,131
Haskell,M,100,0,764,764
Jayen,M,100,0,138,138
Laziya,F,100,17,0,17
Treighton,M,100,0,49,49
Solea,F,100,40,0,40
Shanrika,F,100,10,0,10
Nashwan,M,100,0,26,26
Rieleigh,F,100,5,0,5
Destyn,M,78,92,319,411
Kepa,M,100,0,6,6
Alymuhammad,M,100,0,5,5
Khristiana,F,100,22,0,22
Billiejo,F,100,1455,0,1455
Claudeen,F,100,26,0,26
Jhon,M,100,0,1624,1624
Zola,F,100,1513,0,1513
Madge,F,100,781,0,781
Jaydean,M,100,0,12,12
Benjamen,M,100,0,3098,3098
Jourdynn,F,100,6,0,6
Liyat,F,100,34,0,34
Kirbi,F,100,191,0,191
Veronnica,F,100,59,0,59
Raeana,F,100,223,0,223
Jashay,F,100,86,0,86
Chrisette,F,100,341,0,341
Dametrice,F,100,5,0,5
Shephard,M,100,0,11,11
Zuberi,M,100,0,19,19
Camoya,F,100,10,0,10
Dabid,M,100,0,113,113
Buff,F,60,47,31,78
Jwuan,M,100,0,7,7
Noralynn,F,100,17,0,17
Charlea,F,100,326,0,326
Circe,F,100,111,0,111
Kazuya,M,100,0,48,48
Suheb,M,100,0,29,29
Junius,M,100,0,1308,1308
Agata,F,100,284,0,284
Niviah,F,100,20,0,20
Samyrah,F,100,163,0,163
Kemya,F,100,496,0,496
Avalena,F,100,38,0,38
Kaylan,F,87,4146,612,4758
Tanazia,F,100,111,0,111
Jeylianis,F,100,11,0,11
Lakyia,F,100,91,0,91
Viann,F,100,92,0,92
Vontez,M,100,0,38,38
Daureen,F,100,22,0,22
Miciah,F,50,228,226,454
Jaili,F,100,38,0,38
Korrina,F,100,357,0,357
Shantie,F,100,5,0,5
Azaelia,F,100,23,0,23
Jaquon,M,100,0,683,683
My,F,81,1021,239,1260
Kie,M,95,5,99,104
Ahyana,F,100,81,0,81
Antoinesha,F,100,5,0,5
Madissen,F,100,174,0,174
Vincint,M,100,0,29,29
Vallyn,F,100,5,0,5
Maelani,F,100,108,0,108
Freddy,M,100,66,19051,19117
Gisele,F,100,4262,0,4262
Merrick,M,91,327,3147,3474
Josedaniel,M,100,0,141,141
Yamani,F,88,38,5,43
Lachisha,F,100,5,0,5
